date,county,fips,population,confirmed_cases,reported_cases,probable_cases,reported_and_probable_cases,reported_deaths
2023-01-31,Alameda,001,1643700,374074,374080,22199,396279,2153
2023-01-31,Alpine,003,1148,139,139,4,143,0
2023-01-31,Amador,005,37829,10468,10469,962,11431,98
2023-01-31,Butte,007,227075,41393,41393,10056,51449,486
2023-01-31,Calaveras,009,45235,8925,8925,639,9564,140
2023-01-31,Colusa,011,21464,3940,3942,1334,5276,22
2023-01-31,Contra Costa,013,1133247,269276,269280,22105,291385,1522
2023-01-31,Del Norte,015,27424,7748,7749,455,8204,58
2023-01-31,El Dorado,017,186661,34310,34310,4512,38822,240
2023-01-31,Fresno,019,978130,291134,291147,34018,325165,2969
2023-01-31,Glenn,021,27897,5754,5754,1996,7750,58
2023-01-31,Humboldt,023,135768,23078,23081,5804,28885,169
2023-01-31,Imperial,025,180216,69390,69391,18585,87976,974
2023-01-31,Inyo,027,18085,4733,4733,1255,5988,63
2023-01-31,Kern,029,883053,228231,228236,70774,299010,2470
2023-01-31,Kings,031,150075,62444,62444,4390,66834,470
2023-01-31,Lake,033,64148,13542,13542,1287,14829,151
2023-01-31,Lassen,035,31185,10232,10232,1059,11291,66
2023-01-31,Los Angeles,037,10098052,3463094,3463362,212051,3675413,35040
2023-01-31,Madera,039,155013,45954,45956,8823,54779,377
2023-01-31,Marin,041,260295,48474,48478,5633,54111,317
2023-01-31,Mariposa,043,17540,3330,3330,388,3718,32
2023-01-31,Mendocino,045,87422,16755,16755,4787,21542,142
2023-01-31,Merced,047,269075,75737,75741,12624,88365,903
2023-01-31,Modoc,049,8938,951,951,366,1317,11
2023-01-31,Mono,051,14174,3313,3313,298,3611,8
2023-01-31,Monterey,053,433212,97258,97259,22683,119942,790
2023-01-31,Napa,055,140530,34033,34034,1528,35562,165
2023-01-31,Nevada,057,99092,20007,20012,2258,22270,132
2023-01-31,Orange,059,3164182,704156,704157,75024,779181,7806
2023-01-31,Placer,061,380077,80269,80269,10150,90419,679
2023-01-31,Plumas,063,18699,3814,3814,459,4273,14
2023-01-31,Riverside,065,2383286,729541,729601,40847,770448,6789
2023-01-31,Sacramento,067,1510023,367269,367271,36987,404258,3487
2023-01-31,San Benito,069,59416,17467,17469,1123,18592,115
2023-01-31,San Bernardino,071,2135413,704888,704949,34687,739636,8170
2023-01-31,San Diego,073,3302833,976987,976987,80099,1057086,5728
2023-01-31,San Francisco,075,870044,193351,193361,13148,206509,1152
2023-01-31,San Joaquin,077,732212,208060,208068,16596,224664,2395
2023-01-31,San Luis Obispo,079,281455,65881,65882,8072,73954,549
2023-01-31,San Mateo,081,765935,180687,180691,11275,191966,749
2023-01-31,Santa Barbara,083,443738,111211,111213,7573,118786,758
2023-01-31,Santa Clara,085,1922200,469311,469329,21475,490804,2672
2023-01-31,Santa Cruz,087,273765,67589,67589,3784,71373,277
2023-01-31,Shasta,089,179085,36324,36324,8233,44557,605
2023-01-31,Sierra,091,2930,311,311,61,372,5
2023-01-31,Siskiyou,093,43540,5407,5407,3422,8829,95
2023-01-31,Solano,095,438530,112454,112466,8461,120927,482
2023-01-31,Sonoma,097,501317,112501,112508,5737,118245,544
2023-01-31,Stanislaus,099,539301,143962,143982,22809,166791,1827
2023-01-31,Sutter,101,95872,25523,25528,2545,28073,237
2023-01-31,Tehama,103,63373,14379,14379,3385,17764,222
2023-01-31,Trinity,105,12862,1468,1468,505,1973,24
2023-01-31,Tulare,107,460477,127199,127199,39498,166697,1562
2023-01-31,Tuolumne,109,53932,16708,16709,1006,17715,203
2023-01-31,Ventura,111,848112,219462,219465,17924,237389,1659
2023-01-31,Yolo,113,214977,49661,49661,4758,54419,436
2023-01-31,Yuba,115,75493,19903,19907,1835,21742,134
2023-01-30,Alameda,001,1643700,374074,373183,22199,395382,2138
2023-01-30,Alpine,003,1148,139,139,4,143,0
2023-01-30,Amador,005,37829,10468,10443,962,11405,98
2023-01-30,Butte,007,227075,41393,41340,10056,51396,486
2023-01-30,Calaveras,009,45235,8925,8906,639,9545,140
2023-01-30,Colusa,011,21464,3940,3936,1334,5270,22
2023-01-30,Contra Costa,013,1133247,269276,268472,22105,290577,1521
2023-01-30,Del Norte,015,27424,7748,7725,455,8180,57
2023-01-30,El Dorado,017,186661,34310,34271,4512,38783,238
2023-01-30,Fresno,019,978130,291134,290101,34018,324119,2962
2023-01-30,Glenn,021,27897,5754,5752,1996,7748,58
2023-01-30,Humboldt,023,135768,23078,23039,5804,28843,167
2023-01-30,Imperial,025,180216,69390,69274,18585,87859,973
2023-01-30,Inyo,027,18085,4733,4722,1255,5977,63
2023-01-30,Kern,029,883053,228231,227749,70774,298523,2467
2023-01-30,Kings,031,150075,62444,62312,4390,66702,471
2023-01-30,Lake,033,64148,13542,13502,1287,14789,149
2023-01-30,Lassen,035,31185,10232,10225,1059,11284,67
2023-01-30,Los Angeles,037,10098052,3463094,3457684,212051,3669735,34926
2023-01-30,Madera,039,155013,45954,45883,8823,54706,377
2023-01-30,Marin,041,260295,48474,48374,5633,54007,317
2023-01-30,Mariposa,043,17540,3330,3305,388,3693,32
2023-01-30,Mendocino,045,87422,16755,16728,4787,21515,139
2023-01-30,Merced,047,269075,75737,75565,12624,88189,897
2023-01-30,Modoc,049,8938,951,951,366,1317,11
2023-01-30,Mono,051,14174,3313,3311,298,3609,8
2023-01-30,Monterey,053,433212,97258,97118,22683,119801,789
2023-01-30,Napa,055,140530,34033,33957,1528,35485,164
2023-01-30,Nevada,057,99092,20007,19981,2258,22239,132
2023-01-30,Orange,059,3164182,704156,702777,75024,777801,7781
2023-01-30,Placer,061,380077,80269,80107,10150,90257,679
2023-01-30,Plumas,063,18699,3814,3811,459,4270,13
2023-01-30,Riverside,065,2383286,729541,728514,40847,769361,6788
2023-01-30,Sacramento,067,1510023,367269,366562,36987,403549,3472
2023-01-30,San Benito,069,59416,17467,17434,1123,18557,115
2023-01-30,San Bernardino,071,2135413,704888,703892,34687,738579,8163
2023-01-30,San Diego,073,3302833,976987,974936,80099,1055035,5716
2023-01-30,San Francisco,075,870044,193351,192738,13148,205886,1152
2023-01-30,San Joaquin,077,732212,208060,207738,16596,224334,2391
2023-01-30,San Luis Obispo,079,281455,65881,65721,8072,73793,549
2023-01-30,San Mateo,081,765935,180687,180043,11275,191318,749
2023-01-30,Santa Barbara,083,443738,111211,110976,7573,118549,755
2023-01-30,Santa Clara,085,1922200,469311,467820,21475,489295,2655
2023-01-30,Santa Cruz,087,273765,67589,67454,3784,71238,276
2023-01-30,Shasta,089,179085,36324,36311,8233,44544,605
2023-01-30,Sierra,091,2930,311,311,61,372,5
2023-01-30,Siskiyou,093,43540,5407,5406,3422,8828,95
2023-01-30,Solano,095,438530,112454,112210,8461,120671,482
2023-01-30,Sonoma,097,501317,112501,112332,5737,118069,541
2023-01-30,Stanislaus,099,539301,143962,143769,22809,166578,1816
2023-01-30,Sutter,101,95872,25523,25478,2545,28023,237
2023-01-30,Tehama,103,63373,14379,14356,3385,17741,222
2023-01-30,Trinity,105,12862,1468,1459,505,1964,23
2023-01-30,Tulare,107,460477,127199,126918,39498,166416,1559
2023-01-30,Tuolumne,109,53932,16708,16639,1006,17645,203
2023-01-30,Ventura,111,848112,219462,219015,17924,236939,1650
2023-01-30,Yolo,113,214977,49661,49563,4758,54321,435
2023-01-30,Yuba,115,75493,19903,19871,1835,21706,134
2023-01-29,Alameda,001,1643700,373982,373183,22199,395382,2138
2023-01-29,Alpine,003,1148,139,139,4,143,0
2023-01-29,Amador,005,37829,10467,10443,962,11405,98
2023-01-29,Butte,007,227075,41389,41340,10056,51396,486
2023-01-29,Calaveras,009,45235,8923,8906,639,9545,140
2023-01-29,Colusa,011,21464,3940,3936,1334,5270,22
2023-01-29,Contra Costa,013,1133247,269218,268472,22105,290577,1521
2023-01-29,Del Norte,015,27424,7745,7725,455,8180,57
2023-01-29,El Dorado,017,186661,34305,34271,4512,38783,238
2023-01-29,Fresno,019,978130,291110,290101,34018,324119,2962
2023-01-29,Glenn,021,27897,5754,5752,1996,7748,58
2023-01-29,Humboldt,023,135768,23077,23039,5804,28843,167
2023-01-29,Imperial,025,180216,69380,69274,18585,87859,973
2023-01-29,Inyo,027,18085,4732,4722,1255,5977,63
2023-01-29,Kern,029,883053,228219,227749,70774,298523,2467
2023-01-29,Kings,031,150075,62433,62312,4390,66702,471
2023-01-29,Lake,033,64148,13540,13502,1287,14789,149
2023-01-29,Lassen,035,31185,10232,10225,1059,11284,67
2023-01-29,Los Angeles,037,10098052,3463033,3457684,212051,3669735,34926
2023-01-29,Madera,039,155013,45954,45883,8823,54706,377
2023-01-29,Marin,041,260295,48463,48374,5633,54007,317
2023-01-29,Mariposa,043,17540,3330,3305,388,3693,32
2023-01-29,Mendocino,045,87422,16751,16728,4787,21515,139
2023-01-29,Merced,047,269075,75731,75565,12624,88189,897
2023-01-29,Modoc,049,8938,951,951,366,1317,11
2023-01-29,Mono,051,14174,3313,3311,298,3609,8
2023-01-29,Monterey,053,433212,97245,97118,22683,119801,789
2023-01-29,Napa,055,140530,34024,33957,1528,35485,164
2023-01-29,Nevada,057,99092,20007,19981,2258,22239,132
2023-01-29,Orange,059,3164182,704099,702777,75024,777801,7781
2023-01-29,Placer,061,380077,80259,80107,10150,90257,679
2023-01-29,Plumas,063,18699,3814,3811,459,4270,13
2023-01-29,Riverside,065,2383286,729514,728514,40847,769361,6788
2023-01-29,Sacramento,067,1510023,367209,366562,36987,403549,3472
2023-01-29,San Benito,069,59416,17462,17434,1123,18557,115
2023-01-29,San Bernardino,071,2135413,704860,703892,34687,738579,8163
2023-01-29,San Diego,073,3302833,976904,974936,80099,1055035,5716
2023-01-29,San Francisco,075,870044,193316,192738,13148,205886,1152
2023-01-29,San Joaquin,077,732212,208027,207738,16596,224334,2391
2023-01-29,San Luis Obispo,079,281455,65872,65721,8072,73793,549
2023-01-29,San Mateo,081,765935,180658,180043,11275,191318,749
2023-01-29,Santa Barbara,083,443738,111193,110976,7573,118549,755
2023-01-29,Santa Clara,085,1922200,469230,467820,21475,489295,2655
2023-01-29,Santa Cruz,087,273765,67584,67454,3784,71238,276
2023-01-29,Shasta,089,179085,36324,36311,8233,44544,605
2023-01-29,Sierra,091,2930,311,311,61,372,5
2023-01-29,Siskiyou,093,43540,5407,5406,3422,8828,95
2023-01-29,Solano,095,438530,112421,112210,8461,120671,482
2023-01-29,Sonoma,097,501317,112488,112332,5737,118069,541
2023-01-29,Stanislaus,099,539301,143942,143769,22809,166578,1816
2023-01-29,Sutter,101,95872,25515,25478,2545,28023,237
2023-01-29,Tehama,103,63373,14378,14356,3385,17741,222
2023-01-29,Trinity,105,12862,1462,1459,505,1964,23
2023-01-29,Tulare,107,460477,127176,126918,39498,166416,1559
2023-01-29,Tuolumne,109,53932,16705,16639,1006,17645,203
2023-01-29,Ventura,111,848112,219441,219015,17924,236939,1650
2023-01-29,Yolo,113,214977,49657,49563,4758,54321,435
2023-01-29,Yuba,115,75493,19900,19871,1835,21706,134
2023-01-28,Alameda,001,1643700,373917,373183,22199,395382,2138
2023-01-28,Alpine,003,1148,139,139,4,143,0
2023-01-28,Amador,005,37829,10466,10443,962,11405,98
2023-01-28,Butte,007,227075,41385,41340,10056,51396,486
2023-01-28,Calaveras,009,45235,8922,8906,639,9545,140
2023-01-28,Colusa,011,21464,3940,3936,1334,5270,22
2023-01-28,Contra Costa,013,1133247,269171,268472,22105,290577,1521
2023-01-28,Del Norte,015,27424,7745,7725,455,8180,57
2023-01-28,El Dorado,017,186661,34302,34271,4512,38783,238
2023-01-28,Fresno,019,978130,291083,290101,34018,324119,2962
2023-01-28,Glenn,021,27897,5753,5752,1996,7748,58
2023-01-28,Humboldt,023,135768,23076,23039,5804,28843,167
2023-01-28,Imperial,025,180216,69373,69274,18585,87859,973
2023-01-28,Inyo,027,18085,4732,4722,1255,5977,63
2023-01-28,Kern,029,883053,228207,227749,70774,298523,2467
2023-01-28,Kings,031,150075,62421,62312,4390,66702,471
2023-01-28,Lake,033,64148,13538,13502,1287,14789,149
2023-01-28,Lassen,035,31185,10232,10225,1059,11284,67
2023-01-28,Los Angeles,037,10098052,3462862,3457684,212051,3669735,34926
2023-01-28,Madera,039,155013,45952,45883,8823,54706,377
2023-01-28,Marin,041,260295,48454,48374,5633,54007,317
2023-01-28,Mariposa,043,17540,3330,3305,388,3693,32
2023-01-28,Mendocino,045,87422,16751,16728,4787,21515,139
2023-01-28,Merced,047,269075,75723,75565,12624,88189,897
2023-01-28,Modoc,049,8938,951,951,366,1317,11
2023-01-28,Mono,051,14174,3313,3311,298,3609,8
2023-01-28,Monterey,053,433212,97233,97118,22683,119801,789
2023-01-28,Napa,055,140530,34021,33957,1528,35485,164
2023-01-28,Nevada,057,99092,20006,19981,2258,22239,132
2023-01-28,Orange,059,3164182,704021,702777,75024,777801,7781
2023-01-28,Placer,061,380077,80241,80107,10150,90257,679
2023-01-28,Plumas,063,18699,3814,3811,459,4270,13
2023-01-28,Riverside,065,2383286,729458,728514,40847,769361,6788
2023-01-28,Sacramento,067,1510023,367168,366562,36987,403549,3472
2023-01-28,San Benito,069,59416,17461,17434,1123,18557,115
2023-01-28,San Bernardino,071,2135413,704812,703892,34687,738579,8163
2023-01-28,San Diego,073,3302833,976799,974936,80099,1055035,5716
2023-01-28,San Francisco,075,870044,193284,192738,13148,205886,1152
2023-01-28,San Joaquin,077,732212,208002,207738,16596,224334,2391
2023-01-28,San Luis Obispo,079,281455,65864,65721,8072,73793,549
2023-01-28,San Mateo,081,765935,180639,180043,11275,191318,749
2023-01-28,Santa Barbara,083,443738,111173,110976,7573,118549,755
2023-01-28,Santa Clara,085,1922200,469156,467820,21475,489295,2655
2023-01-28,Santa Cruz,087,273765,67572,67454,3784,71238,276
2023-01-28,Shasta,089,179085,36324,36311,8233,44544,605
2023-01-28,Sierra,091,2930,311,311,61,372,5
2023-01-28,Siskiyou,093,43540,5407,5406,3422,8828,95
2023-01-28,Solano,095,438530,112401,112210,8461,120671,482
2023-01-28,Sonoma,097,501317,112481,112332,5737,118069,541
2023-01-28,Stanislaus,099,539301,143928,143769,22809,166578,1816
2023-01-28,Sutter,101,95872,25514,25478,2545,28023,237
2023-01-28,Tehama,103,63373,14378,14356,3385,17741,222
2023-01-28,Trinity,105,12862,1462,1459,505,1964,23
2023-01-28,Tulare,107,460477,127169,126918,39498,166416,1559
2023-01-28,Tuolumne,109,53932,16704,16639,1006,17645,203
2023-01-28,Ventura,111,848112,219411,219015,17924,236939,1650
2023-01-28,Yolo,113,214977,49652,49563,4758,54321,435
2023-01-28,Yuba,115,75493,19896,19871,1835,21706,134
2023-01-27,Alameda,001,1643700,373841,373183,22199,395382,2138
2023-01-27,Alpine,003,1148,139,139,4,143,0
2023-01-27,Amador,005,37829,10464,10443,962,11405,98
2023-01-27,Butte,007,227075,41382,41340,10056,51396,486
2023-01-27,Calaveras,009,45235,8921,8906,639,9545,140
2023-01-27,Colusa,011,21464,3940,3936,1334,5270,22
2023-01-27,Contra Costa,013,1133247,269126,268472,22105,290577,1521
2023-01-27,Del Norte,015,27424,7744,7725,455,8180,57
2023-01-27,El Dorado,017,186661,34296,34271,4512,38783,238
2023-01-27,Fresno,019,978130,291048,290101,34018,324119,2962
2023-01-27,Glenn,021,27897,5753,5752,1996,7748,58
2023-01-27,Humboldt,023,135768,23073,23039,5804,28843,167
2023-01-27,Imperial,025,180216,69371,69274,18585,87859,973
2023-01-27,Inyo,027,18085,4732,4722,1255,5977,63
2023-01-27,Kern,029,883053,228183,227749,70774,298523,2467
2023-01-27,Kings,031,150075,62414,62312,4390,66702,471
2023-01-27,Lake,033,64148,13537,13502,1287,14789,149
2023-01-27,Lassen,035,31185,10232,10225,1059,11284,67
2023-01-27,Los Angeles,037,10098052,3462527,3457684,212051,3669735,34926
2023-01-27,Madera,039,155013,45949,45883,8823,54706,377
2023-01-27,Marin,041,260295,48444,48374,5633,54007,317
2023-01-27,Mariposa,043,17540,3330,3305,388,3693,32
2023-01-27,Mendocino,045,87422,16750,16728,4787,21515,139
2023-01-27,Merced,047,269075,75712,75565,12624,88189,897
2023-01-27,Modoc,049,8938,951,951,366,1317,11
2023-01-27,Mono,051,14174,3313,3311,298,3609,8
2023-01-27,Monterey,053,433212,97217,97118,22683,119801,789
2023-01-27,Napa,055,140530,34012,33957,1528,35485,164
2023-01-27,Nevada,057,99092,19999,19981,2258,22239,132
2023-01-27,Orange,059,3164182,703908,702777,75024,777801,7781
2023-01-27,Placer,061,380077,80234,80107,10150,90257,679
2023-01-27,Plumas,063,18699,3814,3811,459,4270,13
2023-01-27,Riverside,065,2383286,729380,728514,40847,769361,6788
2023-01-27,Sacramento,067,1510023,367103,366562,36987,403549,3472
2023-01-27,San Benito,069,59416,17459,17434,1123,18557,115
2023-01-27,San Bernardino,071,2135413,704741,703892,34687,738579,8163
2023-01-27,San Diego,073,3302833,976627,974936,80099,1055035,5716
2023-01-27,San Francisco,075,870044,193253,192738,13148,205886,1152
2023-01-27,San Joaquin,077,732212,207985,207738,16596,224334,2391
2023-01-27,San Luis Obispo,079,281455,65854,65721,8072,73793,549
2023-01-27,San Mateo,081,765935,180609,180043,11275,191318,749
2023-01-27,Santa Barbara,083,443738,111163,110976,7573,118549,755
2023-01-27,Santa Clara,085,1922200,469055,467820,21475,489295,2655
2023-01-27,Santa Cruz,087,273765,67565,67454,3784,71238,276
2023-01-27,Shasta,089,179085,36323,36311,8233,44544,605
2023-01-27,Sierra,091,2930,311,311,61,372,5
2023-01-27,Siskiyou,093,43540,5407,5406,3422,8828,95
2023-01-27,Solano,095,438530,112374,112210,8461,120671,482
2023-01-27,Sonoma,097,501317,112464,112332,5737,118069,541
2023-01-27,Stanislaus,099,539301,143908,143769,22809,166578,1816
2023-01-27,Sutter,101,95872,25507,25478,2545,28023,237
2023-01-27,Tehama,103,63373,14377,14356,3385,17741,222
2023-01-27,Trinity,105,12862,1462,1459,505,1964,23
2023-01-27,Tulare,107,460477,127155,126918,39498,166416,1559
2023-01-27,Tuolumne,109,53932,16699,16639,1006,17645,203
2023-01-27,Ventura,111,848112,219381,219015,17924,236939,1650
2023-01-27,Yolo,113,214977,49646,49563,4758,54321,435
2023-01-27,Yuba,115,75493,19891,19871,1835,21706,134
2023-01-26,Alameda,001,1643700,373721,373183,22199,395382,2138
2023-01-26,Alpine,003,1148,139,139,4,143,0
2023-01-26,Amador,005,37829,10463,10443,962,11405,98
2023-01-26,Butte,007,227075,41376,41340,10056,51396,486
2023-01-26,Calaveras,009,45235,8918,8906,639,9545,140
2023-01-26,Colusa,011,21464,3939,3936,1334,5270,22
2023-01-26,Contra Costa,013,1133247,269048,268472,22105,290577,1521
2023-01-26,Del Norte,015,27424,7743,7725,455,8180,57
2023-01-26,El Dorado,017,186661,34288,34271,4512,38783,238
2023-01-26,Fresno,019,978130,290988,290101,34018,324119,2962
2023-01-26,Glenn,021,27897,5753,5752,1996,7748,58
2023-01-26,Humboldt,023,135768,23072,23039,5804,28843,167
2023-01-26,Imperial,025,180216,69365,69274,18585,87859,973
2023-01-26,Inyo,027,18085,4729,4722,1255,5977,63
2023-01-26,Kern,029,883053,228137,227749,70774,298523,2467
2023-01-26,Kings,031,150075,62394,62312,4390,66702,471
2023-01-26,Lake,033,64148,13534,13502,1287,14789,149
2023-01-26,Lassen,035,31185,10231,10225,1059,11284,67
2023-01-26,Los Angeles,037,10098052,3461956,3457684,212051,3669735,34926
2023-01-26,Madera,039,155013,45945,45883,8823,54706,377
2023-01-26,Marin,041,260295,48433,48374,5633,54007,317
2023-01-26,Mariposa,043,17540,3330,3305,388,3693,32
2023-01-26,Mendocino,045,87422,16747,16728,4787,21515,139
2023-01-26,Merced,047,269075,75693,75565,12624,88189,897
2023-01-26,Modoc,049,8938,951,951,366,1317,11
2023-01-26,Mono,051,14174,3313,3311,298,3609,8
2023-01-26,Monterey,053,433212,97205,97118,22683,119801,789
2023-01-26,Napa,055,140530,34003,33957,1528,35485,164
2023-01-26,Nevada,057,99092,19998,19981,2258,22239,132
2023-01-26,Orange,059,3164182,703758,702777,75024,777801,7781
2023-01-26,Placer,061,380077,80209,80107,10150,90257,679
2023-01-26,Plumas,063,18699,3814,3811,459,4270,13
2023-01-26,Riverside,065,2383286,729283,728514,40847,769361,6788
2023-01-26,Sacramento,067,1510023,367008,366562,36987,403549,3472
2023-01-26,San Benito,069,59416,17458,17434,1123,18557,115
2023-01-26,San Bernardino,071,2135413,704625,703892,34687,738579,8163
2023-01-26,San Diego,073,3302833,976378,974936,80099,1055035,5716
2023-01-26,San Francisco,075,870044,193186,192738,13148,205886,1152
2023-01-26,San Joaquin,077,732212,207944,207738,16596,224334,2391
2023-01-26,San Luis Obispo,079,281455,65841,65721,8072,73793,549
2023-01-26,San Mateo,081,765935,180550,180043,11275,191318,749
2023-01-26,Santa Barbara,083,443738,111133,110976,7573,118549,755
2023-01-26,Santa Clara,085,1922200,468898,467820,21475,489295,2655
2023-01-26,Santa Cruz,087,273765,67557,67454,3784,71238,276
2023-01-26,Shasta,089,179085,36319,36311,8233,44544,605
2023-01-26,Sierra,091,2930,311,311,61,372,5
2023-01-26,Siskiyou,093,43540,5407,5406,3422,8828,95
2023-01-26,Solano,095,438530,112343,112210,8461,120671,482
2023-01-26,Sonoma,097,501317,112429,112332,5737,118069,541
2023-01-26,Stanislaus,099,539301,143884,143769,22809,166578,1816
2023-01-26,Sutter,101,95872,25505,25478,2545,28023,237
2023-01-26,Tehama,103,63373,14377,14356,3385,17741,222
2023-01-26,Trinity,105,12862,1462,1459,505,1964,23
2023-01-26,Tulare,107,460477,127125,126918,39498,166416,1559
2023-01-26,Tuolumne,109,53932,16691,16639,1006,17645,203
2023-01-26,Ventura,111,848112,219346,219015,17924,236939,1650
2023-01-26,Yolo,113,214977,49633,49563,4758,54321,435
2023-01-26,Yuba,115,75493,19890,19871,1835,21706,134
2023-01-25,Alameda,001,1643700,373606,373183,22199,395382,2138
2023-01-25,Alpine,003,1148,139,139,4,143,0
2023-01-25,Amador,005,37829,10460,10443,962,11405,98
2023-01-25,Butte,007,227075,41368,41340,10056,51396,486
2023-01-25,Calaveras,009,45235,8918,8906,639,9545,140
2023-01-25,Colusa,011,21464,3939,3936,1334,5270,22
2023-01-25,Contra Costa,013,1133247,268954,268472,22105,290577,1521
2023-01-25,Del Norte,015,27424,7738,7725,455,8180,57
2023-01-25,El Dorado,017,186661,34282,34271,4512,38783,238
2023-01-25,Fresno,019,978130,290926,290101,34018,324119,2962
2023-01-25,Glenn,021,27897,5753,5752,1996,7748,58
2023-01-25,Humboldt,023,135768,23070,23039,5804,28843,167
2023-01-25,Imperial,025,180216,69354,69274,18585,87859,973
2023-01-25,Inyo,027,18085,4728,4722,1255,5977,63
2023-01-25,Kern,029,883053,228094,227749,70774,298523,2467
2023-01-25,Kings,031,150075,62375,62312,4390,66702,471
2023-01-25,Lake,033,64148,13531,13502,1287,14789,149
2023-01-25,Lassen,035,31185,10231,10225,1059,11284,67
2023-01-25,Los Angeles,037,10098052,3461390,3457684,212051,3669735,34926
2023-01-25,Madera,039,155013,45940,45883,8823,54706,377
2023-01-25,Marin,041,260295,48416,48374,5633,54007,317
2023-01-25,Mariposa,043,17540,3330,3305,388,3693,32
2023-01-25,Mendocino,045,87422,16743,16728,4787,21515,139
2023-01-25,Merced,047,269075,75683,75565,12624,88189,897
2023-01-25,Modoc,049,8938,951,951,366,1317,11
2023-01-25,Mono,051,14174,3313,3311,298,3609,8
2023-01-25,Monterey,053,433212,97190,97118,22683,119801,789
2023-01-25,Napa,055,140530,33992,33957,1528,35485,164
2023-01-25,Nevada,057,99092,19997,19981,2258,22239,132
2023-01-25,Orange,059,3164182,703572,702777,75024,777801,7781
2023-01-25,Placer,061,380077,80186,80107,10150,90257,679
2023-01-25,Plumas,063,18699,3814,3811,459,4270,13
2023-01-25,Riverside,065,2383286,729164,728514,40847,769361,6788
2023-01-25,Sacramento,067,1510023,366940,366562,36987,403549,3472
2023-01-25,San Benito,069,59416,17450,17434,1123,18557,115
2023-01-25,San Bernardino,071,2135413,704542,703892,34687,738579,8163
2023-01-25,San Diego,073,3302833,976116,974936,80099,1055035,5716
2023-01-25,San Francisco,075,870044,193132,192738,13148,205886,1152
2023-01-25,San Joaquin,077,732212,207903,207738,16596,224334,2391
2023-01-25,San Luis Obispo,079,281455,65829,65721,8072,73793,549
2023-01-25,San Mateo,081,765935,180483,180043,11275,191318,749
2023-01-25,Santa Barbara,083,443738,111108,110976,7573,118549,755
2023-01-25,Santa Clara,085,1922200,468745,467820,21475,489295,2655
2023-01-25,Santa Cruz,087,273765,67547,67454,3784,71238,276
2023-01-25,Shasta,089,179085,36319,36311,8233,44544,605
2023-01-25,Sierra,091,2930,311,311,61,372,5
2023-01-25,Siskiyou,093,43540,5407,5406,3422,8828,95
2023-01-25,Solano,095,438530,112311,112210,8461,120671,482
2023-01-25,Sonoma,097,501317,112411,112332,5737,118069,541
2023-01-25,Stanislaus,099,539301,143852,143769,22809,166578,1816
2023-01-25,Sutter,101,95872,25501,25478,2545,28023,237
2023-01-25,Tehama,103,63373,14376,14356,3385,17741,222
2023-01-25,Trinity,105,12862,1462,1459,505,1964,23
2023-01-25,Tulare,107,460477,127096,126918,39498,166416,1559
2023-01-25,Tuolumne,109,53932,16689,16639,1006,17645,203
2023-01-25,Ventura,111,848112,219305,219015,17924,236939,1650
2023-01-25,Yolo,113,214977,49626,49563,4758,54321,435
2023-01-25,Yuba,115,75493,19887,19871,1835,21706,134
2023-01-24,Alameda,001,1643700,373505,373183,22199,395382,2138
2023-01-24,Alpine,003,1148,139,139,4,143,0
2023-01-24,Amador,005,37829,10453,10443,962,11405,98
2023-01-24,Butte,007,227075,41362,41340,10056,51396,486
2023-01-24,Calaveras,009,45235,8915,8906,639,9545,140
2023-01-24,Colusa,011,21464,3938,3936,1334,5270,22
2023-01-24,Contra Costa,013,1133247,268858,268472,22105,290577,1521
2023-01-24,Del Norte,015,27424,7735,7725,455,8180,57
2023-01-24,El Dorado,017,186661,34276,34271,4512,38783,238
2023-01-24,Fresno,019,978130,290862,290101,34018,324119,2962
2023-01-24,Glenn,021,27897,5753,5752,1996,7748,58
2023-01-24,Humboldt,023,135768,23065,23039,5804,28843,167
2023-01-24,Imperial,025,180216,69342,69274,18585,87859,973
2023-01-24,Inyo,027,18085,4726,4722,1255,5977,63
2023-01-24,Kern,029,883053,228045,227749,70774,298523,2467
2023-01-24,Kings,031,150075,62360,62312,4390,66702,471
2023-01-24,Lake,033,64148,13526,13502,1287,14789,149
2023-01-24,Lassen,035,31185,10229,10225,1059,11284,67
2023-01-24,Los Angeles,037,10098052,3460648,3457684,212051,3669735,34926
2023-01-24,Madera,039,155013,45935,45883,8823,54706,377
2023-01-24,Marin,041,260295,48407,48374,5633,54007,317
2023-01-24,Mariposa,043,17540,3330,3305,388,3693,32
2023-01-24,Mendocino,045,87422,16738,16728,4787,21515,139
2023-01-24,Merced,047,269075,75668,75565,12624,88189,897
2023-01-24,Modoc,049,8938,951,951,366,1317,11
2023-01-24,Mono,051,14174,3313,3311,298,3609,8
2023-01-24,Monterey,053,433212,97175,97118,22683,119801,789
2023-01-24,Napa,055,140530,33982,33957,1528,35485,164
2023-01-24,Nevada,057,99092,19993,19981,2258,22239,132
2023-01-24,Orange,059,3164182,703384,702777,75024,777801,7781
2023-01-24,Placer,061,380077,80155,80107,10150,90257,679
2023-01-24,Plumas,063,18699,3814,3811,459,4270,13
2023-01-24,Riverside,065,2383286,729022,728514,40847,769361,6788
2023-01-24,Sacramento,067,1510023,366825,366562,36987,403549,3472
2023-01-24,San Benito,069,59416,17449,17434,1123,18557,115
2023-01-24,San Bernardino,071,2135413,704419,703892,34687,738579,8163
2023-01-24,San Diego,073,3302833,975807,974936,80099,1055035,5716
2023-01-24,San Francisco,075,870044,193060,192738,13148,205886,1152
2023-01-24,San Joaquin,077,732212,207861,207738,16596,224334,2391
2023-01-24,San Luis Obispo,079,281455,65811,65721,8072,73793,549
2023-01-24,San Mateo,081,765935,180434,180043,11275,191318,749
2023-01-24,Santa Barbara,083,443738,111075,110976,7573,118549,755
2023-01-24,Santa Clara,085,1922200,468585,467820,21475,489295,2655
2023-01-24,Santa Cruz,087,273765,67526,67454,3784,71238,276
2023-01-24,Shasta,089,179085,36317,36311,8233,44544,605
2023-01-24,Sierra,091,2930,311,311,61,372,5
2023-01-24,Siskiyou,093,43540,5407,5406,3422,8828,95
2023-01-24,Solano,095,438530,112277,112210,8461,120671,482
2023-01-24,Sonoma,097,501317,112392,112332,5737,118069,541
2023-01-24,Stanislaus,099,539301,143816,143769,22809,166578,1816
2023-01-24,Sutter,101,95872,25494,25478,2545,28023,237
2023-01-24,Tehama,103,63373,14374,14356,3385,17741,222
2023-01-24,Trinity,105,12862,1462,1459,505,1964,23
2023-01-24,Tulare,107,460477,127054,126918,39498,166416,1559
2023-01-24,Tuolumne,109,53932,16683,16639,1006,17645,203
2023-01-24,Ventura,111,848112,219249,219015,17924,236939,1650
2023-01-24,Yolo,113,214977,49612,49563,4758,54321,435
2023-01-24,Yuba,115,75493,19878,19871,1835,21706,134
2023-01-23,Alameda,001,1643700,373388,372424,22199,394623,2125
2023-01-23,Alpine,003,1148,139,139,4,143,0
2023-01-23,Amador,005,37829,10449,10401,962,11363,97
2023-01-23,Butte,007,227075,41351,41293,10056,51349,481
2023-01-23,Calaveras,009,45235,8914,8893,639,9532,139
2023-01-23,Colusa,011,21464,3937,3925,1334,5259,22
2023-01-23,Contra Costa,013,1133247,268770,267942,22105,290047,1518
2023-01-23,Del Norte,015,27424,7733,7708,455,8163,57
2023-01-23,El Dorado,017,186661,34268,34211,4512,38723,237
2023-01-23,Fresno,019,978130,290786,288834,34018,322852,2952
2023-01-23,Glenn,021,27897,5753,5749,1996,7745,58
2023-01-23,Humboldt,023,135768,23064,23013,5804,28817,167
2023-01-23,Imperial,025,180216,69319,69148,18585,87733,969
2023-01-23,Inyo,027,18085,4725,4717,1255,5972,62
2023-01-23,Kern,029,883053,228001,227433,70774,298207,2461
2023-01-23,Kings,031,150075,62331,62192,4390,66582,470
2023-01-23,Lake,033,64148,13520,13471,1287,14758,149
2023-01-23,Lassen,035,31185,10228,10219,1059,11278,66
2023-01-23,Los Angeles,037,10098052,3459798,3451542,212051,3663593,34790
2023-01-23,Madera,039,155013,45930,45839,8823,54662,377
2023-01-23,Marin,041,260295,48395,48236,5633,53869,317
2023-01-23,Mariposa,043,17540,3328,3290,388,3678,32
2023-01-23,Mendocino,045,87422,16737,16706,4787,21493,139
2023-01-23,Merced,047,269075,75654,75414,12624,88038,883
2023-01-23,Modoc,049,8938,951,950,366,1316,11
2023-01-23,Mono,051,14174,3312,3304,298,3602,8
2023-01-23,Monterey,053,433212,97162,96993,22683,119676,784
2023-01-23,Napa,055,140530,33974,33873,1528,35401,164
2023-01-23,Nevada,057,99092,19991,19957,2258,22215,132
2023-01-23,Orange,059,3164182,703190,701534,75024,776558,7754
2023-01-23,Placer,061,380077,80138,79943,10150,90093,671
2023-01-23,Plumas,063,18699,3812,3805,459,4264,13
2023-01-23,Riverside,065,2383286,728878,727487,40847,768334,6788
2023-01-23,Sacramento,067,1510023,366726,365898,36987,402885,3454
2023-01-23,San Benito,069,59416,17443,17407,1123,18530,115
2023-01-23,San Bernardino,071,2135413,704289,702778,34687,737465,8155
2023-01-23,San Diego,073,3302833,975486,973112,80099,1053211,5703
2023-01-23,San Francisco,075,870044,192994,192280,13148,205428,1147
2023-01-23,San Joaquin,077,732212,207817,207428,16596,224024,2388
2023-01-23,San Luis Obispo,079,281455,65793,65596,8072,73668,545
2023-01-23,San Mateo,081,765935,180368,179715,11275,190990,749
2023-01-23,Santa Barbara,083,443738,111046,110772,7573,118345,752
2023-01-23,Santa Clara,085,1922200,468413,467082,21475,488557,2633
2023-01-23,Santa Cruz,087,273765,67520,67312,3784,71096,277
2023-01-23,Shasta,089,179085,36314,36230,8233,44463,603
2023-01-23,Sierra,091,2930,311,311,61,372,5
2023-01-23,Siskiyou,093,43540,5407,5400,3422,8822,95
2023-01-23,Solano,095,438530,112240,111971,8461,120432,482
2023-01-23,Sonoma,097,501317,112375,112137,5737,117874,541
2023-01-23,Stanislaus,099,539301,143784,143576,22809,166385,1813
2023-01-23,Sutter,101,95872,25491,25442,2545,27987,237
2023-01-23,Tehama,103,63373,14371,14342,3385,17727,222
2023-01-23,Trinity,105,12862,1462,1452,505,1957,23
2023-01-23,Tulare,107,460477,127022,126692,39498,166190,1554
2023-01-23,Tuolumne,109,53932,16674,16613,1006,17619,205
2023-01-23,Ventura,111,848112,219195,218678,17924,236602,1640
2023-01-23,Yolo,113,214977,49598,49481,4758,54239,436
2023-01-23,Yuba,115,75493,19874,19840,1835,21675,133
2023-01-22,Alameda,001,1643700,373269,372424,22199,394623,2125
2023-01-22,Alpine,003,1148,139,139,4,143,0
2023-01-22,Amador,005,37829,10448,10401,962,11363,97
2023-01-22,Butte,007,227075,41342,41293,10056,51349,481
2023-01-22,Calaveras,009,45235,8910,8893,639,9532,139
2023-01-22,Colusa,011,21464,3936,3925,1333,5258,22
2023-01-22,Contra Costa,013,1133247,268692,267942,22105,290047,1518
2023-01-22,Del Norte,015,27424,7730,7708,455,8163,57
2023-01-22,El Dorado,017,186661,34266,34211,4512,38723,237
2023-01-22,Fresno,019,978130,290704,288834,34018,322852,2952
2023-01-22,Glenn,021,27897,5752,5749,1996,7745,58
2023-01-22,Humboldt,023,135768,23060,23013,5804,28817,167
2023-01-22,Imperial,025,180216,69302,69148,18585,87733,969
2023-01-22,Inyo,027,18085,4724,4717,1255,5972,62
2023-01-22,Kern,029,883053,227954,227433,70774,298207,2461
2023-01-22,Kings,031,150075,62303,62192,4390,66582,470
2023-01-22,Lake,033,64148,13515,13471,1287,14758,149
2023-01-22,Lassen,035,31185,10227,10219,1059,11278,66
2023-01-22,Los Angeles,037,10098052,3458919,3451542,212050,3663592,34790
2023-01-22,Madera,039,155013,45919,45839,8823,54662,377
2023-01-22,Marin,041,260295,48382,48236,5633,53869,317
2023-01-22,Mariposa,043,17540,3328,3290,388,3678,32
2023-01-22,Mendocino,045,87422,16730,16706,4787,21493,139
2023-01-22,Merced,047,269075,75626,75414,12624,88038,883
2023-01-22,Modoc,049,8938,951,950,366,1316,11
2023-01-22,Mono,051,14174,3311,3304,298,3602,8
2023-01-22,Monterey,053,433212,97145,96993,22683,119676,784
2023-01-22,Napa,055,140530,33964,33873,1528,35401,164
2023-01-22,Nevada,057,99092,19990,19957,2258,22215,132
2023-01-22,Orange,059,3164182,703006,701534,75024,776558,7754
2023-01-22,Placer,061,380077,80118,79943,10150,90093,671
2023-01-22,Plumas,063,18699,3812,3805,459,4264,13
2023-01-22,Riverside,065,2383286,728718,727487,40847,768334,6788
2023-01-22,Sacramento,067,1510023,366612,365898,36987,402885,3454
2023-01-22,San Benito,069,59416,17437,17407,1123,18530,115
2023-01-22,San Bernardino,071,2135413,704121,702778,34687,737465,8155
2023-01-22,San Diego,073,3302833,975138,973112,80069,1053181,5703
2023-01-22,San Francisco,075,870044,192927,192280,13148,205428,1147
2023-01-22,San Joaquin,077,732212,207775,207428,16593,224021,2388
2023-01-22,San Luis Obispo,079,281455,65773,65596,8072,73668,545
2023-01-22,San Mateo,081,765935,180297,179715,11275,190990,749
2023-01-22,Santa Barbara,083,443738,111009,110772,7573,118345,752
2023-01-22,Santa Clara,085,1922200,468269,467082,21475,488557,2633
2023-01-22,Santa Cruz,087,273765,67495,67312,3784,71096,277
2023-01-22,Shasta,089,179085,36310,36230,8233,44463,603
2023-01-22,Sierra,091,2930,311,311,61,372,5
2023-01-22,Siskiyou,093,43540,5406,5400,3422,8822,95
2023-01-22,Solano,095,438530,112198,111971,8461,120432,482
2023-01-22,Sonoma,097,501317,112343,112137,5737,117874,541
2023-01-22,Stanislaus,099,539301,143756,143576,22805,166381,1813
2023-01-22,Sutter,101,95872,25487,25442,2545,27987,237
2023-01-22,Tehama,103,63373,14367,14342,3385,17727,222
2023-01-22,Trinity,105,12862,1461,1452,505,1957,23
2023-01-22,Tulare,107,460477,126988,126692,39496,166188,1554
2023-01-22,Tuolumne,109,53932,16669,16613,1006,17619,205
2023-01-22,Ventura,111,848112,219143,218678,17924,236602,1640
2023-01-22,Yolo,113,214977,49584,49481,4758,54239,436
2023-01-22,Yuba,115,75493,19869,19840,1835,21675,133
2023-01-21,Alameda,001,1643700,373197,372424,22199,394623,2125
2023-01-21,Alpine,003,1148,139,139,4,143,0
2023-01-21,Amador,005,37829,10447,10401,962,11363,97
2023-01-21,Butte,007,227075,41339,41293,10056,51349,481
2023-01-21,Calaveras,009,45235,8908,8893,639,9532,139
2023-01-21,Colusa,011,21464,3935,3925,1333,5258,22
2023-01-21,Contra Costa,013,1133247,268644,267942,22105,290047,1518
2023-01-21,Del Norte,015,27424,7727,7708,455,8163,57
2023-01-21,El Dorado,017,186661,34256,34211,4512,38723,237
2023-01-21,Fresno,019,978130,290669,288834,34018,322852,2952
2023-01-21,Glenn,021,27897,5752,5749,1996,7745,58
2023-01-21,Humboldt,023,135768,23058,23013,5804,28817,167
2023-01-21,Imperial,025,180216,69297,69148,18585,87733,969
2023-01-21,Inyo,027,18085,4724,4717,1255,5972,62
2023-01-21,Kern,029,883053,227919,227433,70774,298207,2461
2023-01-21,Kings,031,150075,62297,62192,4390,66582,470
2023-01-21,Lake,033,64148,13512,13471,1287,14758,149
2023-01-21,Lassen,035,31185,10227,10219,1059,11278,66
2023-01-21,Los Angeles,037,10098052,3458442,3451542,212035,3663577,34790
2023-01-21,Madera,039,155013,45914,45839,8823,54662,377
2023-01-21,Marin,041,260295,48364,48236,5632,53868,317
2023-01-21,Mariposa,043,17540,3327,3290,388,3678,32
2023-01-21,Mendocino,045,87422,16729,16706,4787,21493,139
2023-01-21,Merced,047,269075,75619,75414,12624,88038,883
2023-01-21,Modoc,049,8938,951,950,366,1316,11
2023-01-21,Mono,051,14174,3311,3304,298,3602,8
2023-01-21,Monterey,053,433212,97140,96993,22683,119676,784
2023-01-21,Napa,055,140530,33958,33873,1528,35401,164
2023-01-21,Nevada,057,99092,19989,19957,2258,22215,132
2023-01-21,Orange,059,3164182,702913,701534,75024,776558,7754
2023-01-21,Placer,061,380077,80100,79943,10150,90093,671
2023-01-21,Plumas,063,18699,3812,3805,459,4264,13
2023-01-21,Riverside,065,2383286,728641,727487,40846,768333,6788
2023-01-21,Sacramento,067,1510023,366552,365898,36987,402885,3454
2023-01-21,San Benito,069,59416,17435,17407,1123,18530,115
2023-01-21,San Bernardino,071,2135413,704026,702778,34687,737465,8155
2023-01-21,San Diego,073,3302833,974983,973112,80062,1053174,5703
2023-01-21,San Francisco,075,870044,192884,192280,13148,205428,1147
2023-01-21,San Joaquin,077,732212,207753,207428,16593,224021,2388
2023-01-21,San Luis Obispo,079,281455,65770,65596,8072,73668,545
2023-01-21,San Mateo,081,765935,180267,179715,11275,190990,749
2023-01-21,Santa Barbara,083,443738,110992,110772,7573,118345,752
2023-01-21,Santa Clara,085,1922200,468157,467082,21475,488557,2633
2023-01-21,Santa Cruz,087,273765,67488,67312,3784,71096,277
2023-01-21,Shasta,089,179085,36306,36230,8233,44463,603
2023-01-21,Sierra,091,2930,311,311,61,372,5
2023-01-21,Siskiyou,093,43540,5406,5400,3422,8822,95
2023-01-21,Solano,095,438530,112188,111971,8461,120432,482
2023-01-21,Sonoma,097,501317,112319,112137,5737,117874,541
2023-01-21,Stanislaus,099,539301,143743,143576,22805,166381,1813
2023-01-21,Sutter,101,95872,25484,25442,2545,27987,237
2023-01-21,Tehama,103,63373,14365,14342,3385,17727,222
2023-01-21,Trinity,105,12862,1461,1452,505,1957,23
2023-01-21,Tulare,107,460477,126969,126692,39496,166188,1554
2023-01-21,Tuolumne,109,53932,16664,16613,1006,17619,205
2023-01-21,Ventura,111,848112,219106,218678,17924,236602,1640
2023-01-21,Yolo,113,214977,49577,49481,4758,54239,436
2023-01-21,Yuba,115,75493,19868,19840,1835,21675,133
2023-01-20,Alameda,001,1643700,373139,372424,22199,394623,2125
2023-01-20,Alpine,003,1148,139,139,4,143,0
2023-01-20,Amador,005,37829,10446,10401,962,11363,97
2023-01-20,Butte,007,227075,41338,41293,10056,51349,481
2023-01-20,Calaveras,009,45235,8908,8893,639,9532,139
2023-01-20,Colusa,011,21464,3935,3925,1333,5258,22
2023-01-20,Contra Costa,013,1133247,268595,267942,22105,290047,1518
2023-01-20,Del Norte,015,27424,7727,7708,455,8163,57
2023-01-20,El Dorado,017,186661,34250,34211,4512,38723,237
2023-01-20,Fresno,019,978130,290619,288834,34018,322852,2952
2023-01-20,Glenn,021,27897,5752,5749,1996,7745,58
2023-01-20,Humboldt,023,135768,23056,23013,5804,28817,167
2023-01-20,Imperial,025,180216,69292,69148,18585,87733,969
2023-01-20,Inyo,027,18085,4723,4717,1255,5972,62
2023-01-20,Kern,029,883053,227892,227433,70774,298207,2461
2023-01-20,Kings,031,150075,62285,62192,4390,66582,470
2023-01-20,Lake,033,64148,13512,13471,1287,14758,149
2023-01-20,Lassen,035,31185,10227,10219,1059,11278,66
2023-01-20,Los Angeles,037,10098052,3457987,3451542,211981,3663523,34790
2023-01-20,Madera,039,155013,45909,45839,8823,54662,377
2023-01-20,Marin,041,260295,48354,48236,5632,53868,317
2023-01-20,Mariposa,043,17540,3325,3290,388,3678,32
2023-01-20,Mendocino,045,87422,16727,16706,4787,21493,139
2023-01-20,Merced,047,269075,75612,75414,12622,88036,883
2023-01-20,Modoc,049,8938,951,950,366,1316,11
2023-01-20,Mono,051,14174,3311,3304,298,3602,8
2023-01-20,Monterey,053,433212,97129,96993,22677,119670,784
2023-01-20,Napa,055,140530,33951,33873,1528,35401,164
2023-01-20,Nevada,057,99092,19986,19957,2258,22215,132
2023-01-20,Orange,059,3164182,702789,701534,75024,776558,7754
2023-01-20,Placer,061,380077,80089,79943,10150,90093,671
2023-01-20,Plumas,063,18699,3811,3805,459,4264,13
2023-01-20,Riverside,065,2383286,728539,727487,40845,768332,6788
2023-01-20,Sacramento,067,1510023,366510,365898,36987,402885,3454
2023-01-20,San Benito,069,59416,17434,17407,1123,18530,115
2023-01-20,San Bernardino,071,2135413,703929,702778,34687,737465,8155
2023-01-20,San Diego,073,3302833,974799,973112,80047,1053159,5703
2023-01-20,San Francisco,075,870044,192844,192280,13148,205428,1147
2023-01-20,San Joaquin,077,732212,207735,207428,16593,224021,2388
2023-01-20,San Luis Obispo,079,281455,65763,65596,8072,73668,545
2023-01-20,San Mateo,081,765935,180242,179715,11275,190990,749
2023-01-20,Santa Barbara,083,443738,110976,110772,7573,118345,752
2023-01-20,Santa Clara,085,1922200,468049,467082,21475,488557,2633
2023-01-20,Santa Cruz,087,273765,67467,67312,3784,71096,277
2023-01-20,Shasta,089,179085,36305,36230,8233,44463,603
2023-01-20,Sierra,091,2930,311,311,61,372,5
2023-01-20,Siskiyou,093,43540,5405,5400,3422,8822,95
2023-01-20,Solano,095,438530,112170,111971,8461,120432,482
2023-01-20,Sonoma,097,501317,112306,112137,5737,117874,541
2023-01-20,Stanislaus,099,539301,143720,143576,22805,166381,1813
2023-01-20,Sutter,101,95872,25481,25442,2545,27987,237
2023-01-20,Tehama,103,63373,14364,14342,3385,17727,222
2023-01-20,Trinity,105,12862,1461,1452,505,1957,23
2023-01-20,Tulare,107,460477,126948,126692,39492,166184,1554
2023-01-20,Tuolumne,109,53932,16657,16613,1006,17619,205
2023-01-20,Ventura,111,848112,219071,218678,17924,236602,1640
2023-01-20,Yolo,113,214977,49566,49481,4758,54239,436
2023-01-20,Yuba,115,75493,19867,19840,1835,21675,133
2023-01-19,Alameda,001,1643700,373039,372424,22199,394623,2125
2023-01-19,Alpine,003,1148,139,139,4,143,0
2023-01-19,Amador,005,37829,10445,10401,962,11363,97
2023-01-19,Butte,007,227075,41332,41293,10056,51349,481
2023-01-19,Calaveras,009,45235,8908,8893,639,9532,139
2023-01-19,Colusa,011,21464,3933,3925,1333,5258,22
2023-01-19,Contra Costa,013,1133247,268527,267942,22105,290047,1518
2023-01-19,Del Norte,015,27424,7725,7708,455,8163,57
2023-01-19,El Dorado,017,186661,34247,34211,4511,38722,237
2023-01-19,Fresno,019,978130,290556,288834,34018,322852,2952
2023-01-19,Glenn,021,27897,5752,5749,1996,7745,58
2023-01-19,Humboldt,023,135768,23052,23013,5803,28816,167
2023-01-19,Imperial,025,180216,69281,69148,18585,87733,969
2023-01-19,Inyo,027,18085,4722,4717,1255,5972,62
2023-01-19,Kern,029,883053,227845,227433,70772,298205,2461
2023-01-19,Kings,031,150075,62268,62192,4390,66582,470
2023-01-19,Lake,033,64148,13510,13471,1287,14758,149
2023-01-19,Lassen,035,31185,10227,10219,1059,11278,66
2023-01-19,Los Angeles,037,10098052,3457274,3451542,211919,3663461,34790
2023-01-19,Madera,039,155013,45901,45839,8823,54662,377
2023-01-19,Marin,041,260295,48336,48236,5632,53868,317
2023-01-19,Mariposa,043,17540,3324,3290,388,3678,32
2023-01-19,Mendocino,045,87422,16725,16706,4787,21493,139
2023-01-19,Merced,047,269075,75597,75414,12622,88036,883
2023-01-19,Modoc,049,8938,950,950,366,1316,11
2023-01-19,Mono,051,14174,3311,3304,297,3601,8
2023-01-19,Monterey,053,433212,97117,96993,22677,119670,784
2023-01-19,Napa,055,140530,33943,33873,1528,35401,164
2023-01-19,Nevada,057,99092,19985,19957,2257,22214,132
2023-01-19,Orange,059,3164182,702626,701534,75024,776558,7754
2023-01-19,Placer,061,380077,80067,79943,10150,90093,671
2023-01-19,Plumas,063,18699,3811,3805,459,4264,13
2023-01-19,Riverside,065,2383286,728398,727487,40841,768328,6788
2023-01-19,Sacramento,067,1510023,366421,365898,36985,402883,3454
2023-01-19,San Benito,069,59416,17431,17407,1123,18530,115
2023-01-19,San Bernardino,071,2135413,703802,702778,34687,737465,8155
2023-01-19,San Diego,073,3302833,974565,973112,79997,1053109,5703
2023-01-19,San Francisco,075,870044,192771,192280,13148,205428,1147
2023-01-19,San Joaquin,077,732212,207698,207428,16592,224020,2388
2023-01-19,San Luis Obispo,079,281455,65749,65596,8072,73668,545
2023-01-19,San Mateo,081,765935,180194,179715,11275,190990,749
2023-01-19,Santa Barbara,083,443738,110952,110772,7573,118345,752
2023-01-19,Santa Clara,085,1922200,467927,467082,21475,488557,2633
2023-01-19,Santa Cruz,087,273765,67455,67312,3784,71096,277
2023-01-19,Shasta,089,179085,36303,36230,8233,44463,603
2023-01-19,Sierra,091,2930,311,311,61,372,5
2023-01-19,Siskiyou,093,43540,5403,5400,3422,8822,95
2023-01-19,Solano,095,438530,112130,111971,8461,120432,482
2023-01-19,Sonoma,097,501317,112283,112137,5737,117874,541
2023-01-19,Stanislaus,099,539301,143690,143576,22766,166342,1813
2023-01-19,Sutter,101,95872,25478,25442,2545,27987,237
2023-01-19,Tehama,103,63373,14362,14342,3385,17727,222
2023-01-19,Trinity,105,12862,1461,1452,505,1957,23
2023-01-19,Tulare,107,460477,126915,126692,39488,166180,1554
2023-01-19,Tuolumne,109,53932,16651,16613,1006,17619,205
2023-01-19,Ventura,111,848112,219023,218678,17924,236602,1640
2023-01-19,Yolo,113,214977,49558,49481,4758,54239,436
2023-01-19,Yuba,115,75493,19864,19840,1835,21675,133
2023-01-18,Alameda,001,1643700,372924,372424,22199,394623,2125
2023-01-18,Alpine,003,1148,139,139,4,143,0
2023-01-18,Amador,005,37829,10431,10401,962,11363,97
2023-01-18,Butte,007,227075,41325,41293,10056,51349,481
2023-01-18,Calaveras,009,45235,8905,8893,639,9532,139
2023-01-18,Colusa,011,21464,3929,3925,1333,5258,22
2023-01-18,Contra Costa,013,1133247,268443,267942,22105,290047,1518
2023-01-18,Del Norte,015,27424,7722,7708,448,8156,57
2023-01-18,El Dorado,017,186661,34244,34211,4511,38722,237
2023-01-18,Fresno,019,978130,290509,288834,34017,322851,2952
2023-01-18,Glenn,021,27897,5751,5749,1996,7745,58
2023-01-18,Humboldt,023,135768,23049,23013,5801,28814,167
2023-01-18,Imperial,025,180216,69267,69148,18585,87733,969
2023-01-18,Inyo,027,18085,4722,4717,1255,5972,62
2023-01-18,Kern,029,883053,227796,227433,70759,298192,2461
2023-01-18,Kings,031,150075,62253,62192,4390,66582,470
2023-01-18,Lake,033,64148,13507,13471,1287,14758,149
2023-01-18,Lassen,035,31185,10227,10219,1059,11278,66
2023-01-18,Los Angeles,037,10098052,3456515,3451542,211804,3663346,34790
2023-01-18,Madera,039,155013,45893,45839,8823,54662,377
2023-01-18,Marin,041,260295,48319,48236,5632,53868,317
2023-01-18,Mariposa,043,17540,3324,3290,388,3678,32
2023-01-18,Mendocino,045,87422,16723,16706,4787,21493,139
2023-01-18,Merced,047,269075,75578,75414,12622,88036,883
2023-01-18,Modoc,049,8938,950,950,366,1316,11
2023-01-18,Mono,051,14174,3311,3304,297,3601,8
2023-01-18,Monterey,053,433212,97100,96993,22677,119670,784
2023-01-18,Napa,055,140530,33928,33873,1528,35401,164
2023-01-18,Nevada,057,99092,19981,19957,2257,22214,132
2023-01-18,Orange,059,3164182,702440,701534,75021,776555,7754
2023-01-18,Placer,061,380077,80043,79943,10149,90092,671
2023-01-18,Plumas,063,18699,3810,3805,459,4264,13
2023-01-18,Riverside,065,2383286,728259,727487,40840,768327,6788
2023-01-18,Sacramento,067,1510023,366353,365898,36975,402873,3454
2023-01-18,San Benito,069,59416,17429,17407,1123,18530,115
2023-01-18,San Bernardino,071,2135413,703697,702778,34684,737462,8155
2023-01-18,San Diego,073,3302833,974260,973112,79951,1053063,5703
2023-01-18,San Francisco,075,870044,192703,192280,13148,205428,1147
2023-01-18,San Joaquin,077,732212,207658,207428,16590,224018,2388
2023-01-18,San Luis Obispo,079,281455,65732,65596,8072,73668,545
2023-01-18,San Mateo,081,765935,180143,179715,11275,190990,749
2023-01-18,Santa Barbara,083,443738,110924,110772,7573,118345,752
2023-01-18,Santa Clara,085,1922200,467774,467082,21475,488557,2633
2023-01-18,Santa Cruz,087,273765,67446,67312,3784,71096,277
2023-01-18,Shasta,089,179085,36298,36230,8233,44463,603
2023-01-18,Sierra,091,2930,311,311,61,372,5
2023-01-18,Siskiyou,093,43540,5402,5400,3422,8822,95
2023-01-18,Solano,095,438530,112097,111971,8461,120432,482
2023-01-18,Sonoma,097,501317,112256,112137,5737,117874,541
2023-01-18,Stanislaus,099,539301,143659,143576,22764,166340,1813
2023-01-18,Sutter,101,95872,25468,25442,2544,27986,237
2023-01-18,Tehama,103,63373,14361,14342,3385,17727,222
2023-01-18,Trinity,105,12862,1460,1452,505,1957,23
2023-01-18,Tulare,107,460477,126887,126692,39485,166177,1554
2023-01-18,Tuolumne,109,53932,16646,16613,1006,17619,205
2023-01-18,Ventura,111,848112,218963,218678,17924,236602,1640
2023-01-18,Yolo,113,214977,49546,49481,4758,54239,436
2023-01-18,Yuba,115,75493,19856,19840,1835,21675,133
2023-01-17,Alameda,001,1643700,372809,372424,22199,394623,2125
2023-01-17,Alpine,003,1148,139,139,4,143,0
2023-01-17,Amador,005,37829,10425,10401,962,11363,97
2023-01-17,Butte,007,227075,41321,41293,10056,51349,481
2023-01-17,Calaveras,009,45235,8903,8893,639,9532,139
2023-01-17,Colusa,011,21464,3928,3925,1332,5257,22
2023-01-17,Contra Costa,013,1133247,268354,267942,22105,290047,1518
2023-01-17,Del Norte,015,27424,7717,7708,448,8156,57
2023-01-17,El Dorado,017,186661,34239,34211,4510,38721,237
2023-01-17,Fresno,019,978130,290445,288834,34015,322849,2952
2023-01-17,Glenn,021,27897,5751,5749,1996,7745,58
2023-01-17,Humboldt,023,135768,23044,23013,5800,28813,167
2023-01-17,Imperial,025,180216,69250,69148,18585,87733,969
2023-01-17,Inyo,027,18085,4722,4717,1253,5970,62
2023-01-17,Kern,029,883053,227755,227433,70724,298157,2461
2023-01-17,Kings,031,150075,62236,62192,4389,66581,470
2023-01-17,Lake,033,64148,13503,13471,1287,14758,149
2023-01-17,Lassen,035,31185,10225,10219,1059,11278,66
2023-01-17,Los Angeles,037,10098052,3455680,3451542,211678,3663220,34790
2023-01-17,Madera,039,155013,45890,45839,8823,54662,377
2023-01-17,Marin,041,260295,48303,48236,5631,53867,317
2023-01-17,Mariposa,043,17540,3324,3290,388,3678,32
2023-01-17,Mendocino,045,87422,16721,16706,4787,21493,139
2023-01-17,Merced,047,269075,75563,75414,12619,88033,883
2023-01-17,Modoc,049,8938,950,950,366,1316,11
2023-01-17,Mono,051,14174,3308,3304,297,3601,8
2023-01-17,Monterey,053,433212,97090,96993,22677,119670,784
2023-01-17,Napa,055,140530,33914,33873,1528,35401,164
2023-01-17,Nevada,057,99092,19980,19957,2257,22214,132
2023-01-17,Orange,059,3164182,702253,701534,75021,776555,7754
2023-01-17,Placer,061,380077,80026,79943,10149,90092,671
2023-01-17,Plumas,063,18699,3807,3805,459,4264,13
2023-01-17,Riverside,065,2383286,728099,727487,40840,768327,6788
2023-01-17,Sacramento,067,1510023,366240,365898,36975,402873,3454
2023-01-17,San Benito,069,59416,17426,17407,1123,18530,115
2023-01-17,San Bernardino,071,2135413,703520,702778,34673,737451,8155
2023-01-17,San Diego,073,3302833,973928,973112,79904,1053016,5703
2023-01-17,San Francisco,075,870044,192633,192280,13148,205428,1147
2023-01-17,San Joaquin,077,732212,207618,207428,16590,224018,2388
2023-01-17,San Luis Obispo,079,281455,65718,65596,8070,73666,545
2023-01-17,San Mateo,081,765935,180087,179715,11275,190990,749
2023-01-17,Santa Barbara,083,443738,110885,110772,7573,118345,752
2023-01-17,Santa Clara,085,1922200,467615,467082,21475,488557,2633
2023-01-17,Santa Cruz,087,273765,67429,67312,3784,71096,277
2023-01-17,Shasta,089,179085,36294,36230,8233,44463,603
2023-01-17,Sierra,091,2930,311,311,61,372,5
2023-01-17,Siskiyou,093,43540,5402,5400,3422,8822,95
2023-01-17,Solano,095,438530,112052,111971,8461,120432,482
2023-01-17,Sonoma,097,501317,112215,112137,5737,117874,541
2023-01-17,Stanislaus,099,539301,143635,143576,22762,166338,1813
2023-01-17,Sutter,101,95872,25460,25442,2544,27986,237
2023-01-17,Tehama,103,63373,14360,14342,3385,17727,222
2023-01-17,Trinity,105,12862,1459,1452,505,1957,23
2023-01-17,Tulare,107,460477,126844,126692,39480,166172,1554
2023-01-17,Tuolumne,109,53932,16643,16613,1006,17619,205
2023-01-17,Ventura,111,848112,218911,218678,17924,236602,1640
2023-01-17,Yolo,113,214977,49533,49481,4758,54239,436
2023-01-17,Yuba,115,75493,19851,19840,1835,21675,133
2023-01-16,Alameda,001,1643700,372670,371533,22199,393732,2112
2023-01-16,Alpine,003,1148,139,139,4,143,0
2023-01-16,Amador,005,37829,10417,10384,962,11346,96
2023-01-16,Butte,007,227075,41308,41228,10055,51283,478
2023-01-16,Calaveras,009,45235,8901,8878,639,9517,138
2023-01-16,Colusa,011,21464,3927,3919,1332,5251,22
2023-01-16,Contra Costa,013,1133247,268275,267212,22105,289317,1505
2023-01-16,Del Norte,015,27424,7717,7700,448,8148,57
2023-01-16,El Dorado,017,186661,34232,34153,4510,38663,236
2023-01-16,Fresno,019,978130,290364,287748,34013,321761,2940
2023-01-16,Glenn,021,27897,5750,5747,1996,7743,58
2023-01-16,Humboldt,023,135768,23038,22986,5799,28785,166
2023-01-16,Imperial,025,180216,69241,69018,18585,87603,964
2023-01-16,Inyo,027,18085,4721,4709,1253,5962,62
2023-01-16,Kern,029,883053,227708,226971,70689,297660,2457
2023-01-16,Kings,031,150075,62226,62044,4388,66432,469
2023-01-16,Lake,033,64148,13494,13448,1287,14735,149
2023-01-16,Lassen,035,31185,10223,10212,1059,11271,66
2023-01-16,Los Angeles,037,10098052,3454617,3443850,211502,3655352,34651
2023-01-16,Madera,039,155013,45885,45761,8823,54584,377
2023-01-16,Marin,041,260295,48288,48130,5628,53758,317
2023-01-16,Mariposa,043,17540,3323,3285,388,3673,32
2023-01-16,Mendocino,045,87422,16719,16682,4787,21469,137
2023-01-16,Merced,047,269075,75544,75253,12619,87872,883
2023-01-16,Modoc,049,8938,950,946,366,1312,11
2023-01-16,Mono,051,14174,3307,3299,297,3596,8
2023-01-16,Monterey,053,433212,97073,96874,22677,119551,781
2023-01-16,Napa,055,140530,33898,33808,1528,35336,165
2023-01-16,Nevada,057,99092,19974,19927,2257,22184,132
2023-01-16,Orange,059,3164182,702050,699881,75018,774899,7723
2023-01-16,Placer,061,380077,80000,79766,10147,89913,671
2023-01-16,Plumas,063,18699,3807,3804,459,4263,13
2023-01-16,Riverside,065,2383286,727907,725898,40836,766734,6761
2023-01-16,Sacramento,067,1510023,366144,365352,36969,402321,3434
2023-01-16,San Benito,069,59416,17420,17378,1123,18501,115
2023-01-16,San Bernardino,071,2135413,703309,701674,34671,736345,8146
2023-01-16,San Diego,073,3302833,973511,970800,79841,1050641,5681
2023-01-16,San Francisco,075,870044,192553,191765,13148,204913,1123
2023-01-16,San Joaquin,077,732212,207579,207038,16586,223624,2378
2023-01-16,San Luis Obispo,079,281455,65695,65502,8066,73568,539
2023-01-16,San Mateo,081,765935,180032,179319,11275,190594,749
2023-01-16,Santa Barbara,083,443738,110854,110537,7573,118110,750
2023-01-16,Santa Clara,085,1922200,467412,465994,21475,487469,2601
2023-01-16,Santa Cruz,087,273765,67405,67144,3784,70928,276
2023-01-16,Shasta,089,179085,36290,36179,8232,44411,604
2023-01-16,Sierra,091,2930,311,311,61,372,5
2023-01-16,Siskiyou,093,43540,5401,5384,3422,8806,95
2023-01-16,Solano,095,438530,112017,111700,8461,120161,479
2023-01-16,Sonoma,097,501317,112181,111955,5737,117692,542
2023-01-16,Stanislaus,099,539301,143602,143318,22760,166078,1800
2023-01-16,Sutter,101,95872,25455,25392,2544,27936,237
2023-01-16,Tehama,103,63373,14358,14320,3385,17705,221
2023-01-16,Trinity,105,12862,1459,1448,505,1953,23
2023-01-16,Tulare,107,460477,126813,126451,39478,165929,1552
2023-01-16,Tuolumne,109,53932,16638,16552,1006,17558,209
2023-01-16,Ventura,111,848112,218849,218234,17924,236158,1632
2023-01-16,Yolo,113,214977,49518,49393,4757,54150,433
2023-01-16,Yuba,115,75493,19847,19804,1833,21637,132
2023-01-15,Alameda,001,1643700,372555,371533,22196,393729,2112
2023-01-15,Alpine,003,1148,139,139,4,143,0
2023-01-15,Amador,005,37829,10415,10384,962,11346,96
2023-01-15,Butte,007,227075,41303,41228,10052,51280,478
2023-01-15,Calaveras,009,45235,8901,8878,639,9517,138
2023-01-15,Colusa,011,21464,3926,3919,1332,5251,22
2023-01-15,Contra Costa,013,1133247,268208,267212,22104,289316,1505
2023-01-15,Del Norte,015,27424,7715,7700,447,8147,57
2023-01-15,El Dorado,017,186661,34222,34153,4510,38663,236
2023-01-15,Fresno,019,978130,290309,287748,33998,321746,2940
2023-01-15,Glenn,021,27897,5749,5747,1996,7743,58
2023-01-15,Humboldt,023,135768,23035,22986,5797,28783,166
2023-01-15,Imperial,025,180216,69227,69018,18576,87594,964
2023-01-15,Inyo,027,18085,4720,4709,1251,5960,62
2023-01-15,Kern,029,883053,227644,226971,70655,297626,2457
2023-01-15,Kings,031,150075,62211,62044,4388,66432,469
2023-01-15,Lake,033,64148,13492,13448,1287,14735,149
2023-01-15,Lassen,035,31185,10222,10212,1059,11271,66
2023-01-15,Los Angeles,037,10098052,3453860,3443850,211356,3655206,34651
2023-01-15,Madera,039,155013,45877,45761,8823,54584,377
2023-01-15,Marin,041,260295,48262,48130,5626,53756,317
2023-01-15,Mariposa,043,17540,3322,3285,388,3673,32
2023-01-15,Mendocino,045,87422,16717,16682,4787,21469,137
2023-01-15,Merced,047,269075,75529,75253,12618,87871,883
2023-01-15,Modoc,049,8938,949,946,366,1312,11
2023-01-15,Mono,051,14174,3306,3299,297,3596,8
2023-01-15,Monterey,053,433212,97059,96874,22675,119549,781
2023-01-15,Napa,055,140530,33890,33808,1528,35336,165
2023-01-15,Nevada,057,99092,19968,19927,2256,22183,132
2023-01-15,Orange,059,3164182,701833,699881,74977,774858,7723
2023-01-15,Placer,061,380077,79978,79766,10147,89913,671
2023-01-15,Plumas,063,18699,3806,3804,459,4263,13
2023-01-15,Riverside,065,2383286,727734,725898,40831,766729,6761
2023-01-15,Sacramento,067,1510023,366070,365352,36968,402320,3434
2023-01-15,San Benito,069,59416,17417,17378,1123,18501,115
2023-01-15,San Bernardino,071,2135413,703171,701674,34664,736338,8146
2023-01-15,San Diego,073,3302833,973258,970800,79803,1050603,5681
2023-01-15,San Francisco,075,870044,192486,191765,13145,204910,1123
2023-01-15,San Joaquin,077,732212,207535,207038,16583,223621,2378
2023-01-15,San Luis Obispo,079,281455,65679,65502,8064,73566,539
2023-01-15,San Mateo,081,765935,179986,179319,11274,190593,749
2023-01-15,Santa Barbara,083,443738,110817,110537,7572,118109,750
2023-01-15,Santa Clara,085,1922200,467300,465994,21473,487467,2601
2023-01-15,Santa Cruz,087,273765,67378,67144,3784,70928,276
2023-01-15,Shasta,089,179085,36286,36179,8231,44410,604
2023-01-15,Sierra,091,2930,311,311,61,372,5
2023-01-15,Siskiyou,093,43540,5400,5384,3422,8806,95
2023-01-15,Solano,095,438530,111990,111700,8459,120159,479
2023-01-15,Sonoma,097,501317,112150,111955,5737,117692,542
2023-01-15,Stanislaus,099,539301,143572,143318,22759,166077,1800
2023-01-15,Sutter,101,95872,25448,25392,2544,27936,237
2023-01-15,Tehama,103,63373,14358,14320,3385,17705,221
2023-01-15,Trinity,105,12862,1459,1448,505,1953,23
2023-01-15,Tulare,107,460477,126755,126451,39465,165916,1552
2023-01-15,Tuolumne,109,53932,16634,16552,1006,17558,209
2023-01-15,Ventura,111,848112,218801,218234,17921,236155,1632
2023-01-15,Yolo,113,214977,49509,49393,4757,54150,433
2023-01-15,Yuba,115,75493,19844,19804,1833,21637,132
2023-01-14,Alameda,001,1643700,372473,371533,22191,393724,2112
2023-01-14,Alpine,003,1148,139,139,4,143,0
2023-01-14,Amador,005,37829,10411,10384,962,11346,96
2023-01-14,Butte,007,227075,41300,41228,10048,51276,478
2023-01-14,Calaveras,009,45235,8899,8878,638,9516,138
2023-01-14,Colusa,011,21464,3925,3919,1332,5251,22
2023-01-14,Contra Costa,013,1133247,268148,267212,22100,289312,1505
2023-01-14,Del Norte,015,27424,7714,7700,447,8147,57
2023-01-14,El Dorado,017,186661,34216,34153,4509,38662,236
2023-01-14,Fresno,019,978130,290269,287748,33998,321746,2940
2023-01-14,Glenn,021,27897,5749,5747,1996,7743,58
2023-01-14,Humboldt,023,135768,23033,22986,5795,28781,166
2023-01-14,Imperial,025,180216,69212,69018,18576,87594,964
2023-01-14,Inyo,027,18085,4718,4709,1251,5960,62
2023-01-14,Kern,029,883053,227609,226971,70625,297596,2457
2023-01-14,Kings,031,150075,62202,62044,4387,66431,469
2023-01-14,Lake,033,64148,13491,13448,1287,14735,149
2023-01-14,Lassen,035,31185,10222,10212,1059,11271,66
2023-01-14,Los Angeles,037,10098052,3453294,3443850,211291,3655141,34651
2023-01-14,Madera,039,155013,45874,45761,8822,54583,377
2023-01-14,Marin,041,260295,48250,48130,5625,53755,317
2023-01-14,Mariposa,043,17540,3322,3285,388,3673,32
2023-01-14,Mendocino,045,87422,16713,16682,4787,21469,137
2023-01-14,Merced,047,269075,75516,75253,12618,87871,883
2023-01-14,Modoc,049,8938,949,946,365,1311,11
2023-01-14,Mono,051,14174,3305,3299,297,3596,8
2023-01-14,Monterey,053,433212,97049,96874,22671,119545,781
2023-01-14,Napa,055,140530,33884,33808,1528,35336,165
2023-01-14,Nevada,057,99092,19968,19927,2255,22182,132
2023-01-14,Orange,059,3164182,701705,699881,74949,774830,7723
2023-01-14,Placer,061,380077,79968,79766,10147,89913,671
2023-01-14,Plumas,063,18699,3806,3804,459,4263,13
2023-01-14,Riverside,065,2383286,727633,725898,40823,766721,6761
2023-01-14,Sacramento,067,1510023,366021,365352,36964,402316,3434
2023-01-14,San Benito,069,59416,17413,17378,1122,18500,115
2023-01-14,San Bernardino,071,2135413,703079,701674,34653,736327,8146
2023-01-14,San Diego,073,3302833,973061,970800,79787,1050587,5681
2023-01-14,San Francisco,075,870044,192442,191765,13145,204910,1123
2023-01-14,San Joaquin,077,732212,207511,207038,16583,223621,2378
2023-01-14,San Luis Obispo,079,281455,65673,65502,8060,73562,539
2023-01-14,San Mateo,081,765935,179960,179319,11268,190587,749
2023-01-14,Santa Barbara,083,443738,110793,110537,7567,118104,750
2023-01-14,Santa Clara,085,1922200,467214,465994,21469,487463,2601
2023-01-14,Santa Cruz,087,273765,67372,67144,3781,70925,276
2023-01-14,Shasta,089,179085,36283,36179,8231,44410,604
2023-01-14,Sierra,091,2930,311,311,61,372,5
2023-01-14,Siskiyou,093,43540,5400,5384,3422,8806,95
2023-01-14,Solano,095,438530,111981,111700,8456,120156,479
2023-01-14,Sonoma,097,501317,112140,111955,5734,117689,542
2023-01-14,Stanislaus,099,539301,143551,143318,22755,166073,1800
2023-01-14,Sutter,101,95872,25445,25392,2544,27936,237
2023-01-14,Tehama,103,63373,14354,14320,3385,17705,221
2023-01-14,Trinity,105,12862,1459,1448,505,1953,23
2023-01-14,Tulare,107,460477,126734,126451,39462,165913,1552
2023-01-14,Tuolumne,109,53932,16632,16552,1005,17557,209
2023-01-14,Ventura,111,848112,218766,218234,17914,236148,1632
2023-01-14,Yolo,113,214977,49496,49393,4755,54148,433
2023-01-14,Yuba,115,75493,19842,19804,1833,21637,132
2023-01-13,Alameda,001,1643700,372386,371533,22184,393717,2112
2023-01-13,Alpine,003,1148,139,139,4,143,0
2023-01-13,Amador,005,37829,10409,10384,962,11346,96
2023-01-13,Butte,007,227075,41296,41228,10043,51271,478
2023-01-13,Calaveras,009,45235,8898,8878,638,9516,138
2023-01-13,Colusa,011,21464,3924,3919,1332,5251,22
2023-01-13,Contra Costa,013,1133247,268088,267212,22096,289308,1505
2023-01-13,Del Norte,015,27424,7713,7700,447,8147,57
2023-01-13,El Dorado,017,186661,34211,34153,4509,38662,236
2023-01-13,Fresno,019,978130,290227,287748,33992,321740,2940
2023-01-13,Glenn,021,27897,5749,5747,1996,7743,58
2023-01-13,Humboldt,023,135768,23032,22986,5794,28780,166
2023-01-13,Imperial,025,180216,69202,69018,18572,87590,964
2023-01-13,Inyo,027,18085,4717,4709,1249,5958,62
2023-01-13,Kern,029,883053,227576,226971,70597,297568,2457
2023-01-13,Kings,031,150075,62190,62044,4386,66430,469
2023-01-13,Lake,033,64148,13491,13448,1287,14735,149
2023-01-13,Lassen,035,31185,10221,10212,1059,11271,66
2023-01-13,Los Angeles,037,10098052,3452741,3443850,211224,3655074,34651
2023-01-13,Madera,039,155013,45867,45761,8821,54582,377
2023-01-13,Marin,041,260295,48237,48130,5622,53752,317
2023-01-13,Mariposa,043,17540,3322,3285,387,3672,32
2023-01-13,Mendocino,045,87422,16710,16682,4787,21469,137
2023-01-13,Merced,047,269075,75508,75253,12618,87871,883
2023-01-13,Modoc,049,8938,949,946,365,1311,11
2023-01-13,Mono,051,14174,3304,3299,297,3596,8
2023-01-13,Monterey,053,433212,97030,96874,22665,119539,781
2023-01-13,Napa,055,140530,33875,33808,1525,35333,165
2023-01-13,Nevada,057,99092,19965,19927,2255,22182,132
2023-01-13,Orange,059,3164182,701589,699881,74915,774796,7723
2023-01-13,Placer,061,380077,79950,79766,10147,89913,671
2023-01-13,Plumas,063,18699,3806,3804,459,4263,13
2023-01-13,Riverside,065,2383286,727530,725898,40813,766711,6761
2023-01-13,Sacramento,067,1510023,365959,365352,36962,402314,3434
2023-01-13,San Benito,069,59416,17412,17378,1121,18499,115
2023-01-13,San Bernardino,071,2135413,702990,701674,34646,736320,8146
2023-01-13,San Diego,073,3302833,972874,970800,79755,1050555,5681
2023-01-13,San Francisco,075,870044,192401,191765,13144,204909,1123
2023-01-13,San Joaquin,077,732212,207476,207038,16582,223620,2378
2023-01-13,San Luis Obispo,079,281455,65659,65502,8059,73561,539
2023-01-13,San Mateo,081,765935,179905,179319,11265,190584,749
2023-01-13,Santa Barbara,083,443738,110777,110537,7566,118103,750
2023-01-13,Santa Clara,085,1922200,467104,465994,21466,487460,2601
2023-01-13,Santa Cruz,087,273765,67356,67144,3780,70924,276
2023-01-13,Shasta,089,179085,36282,36179,8230,44409,604
2023-01-13,Sierra,091,2930,311,311,61,372,5
2023-01-13,Siskiyou,093,43540,5398,5384,3422,8806,95
2023-01-13,Solano,095,438530,111953,111700,8451,120151,479
2023-01-13,Sonoma,097,501317,112119,111955,5734,117689,542
2023-01-13,Stanislaus,099,539301,143528,143318,22752,166070,1800
2023-01-13,Sutter,101,95872,25443,25392,2544,27936,237
2023-01-13,Tehama,103,63373,14354,14320,3384,17704,221
2023-01-13,Trinity,105,12862,1458,1448,505,1953,23
2023-01-13,Tulare,107,460477,126705,126451,39450,165901,1552
2023-01-13,Tuolumne,109,53932,16622,16552,1005,17557,209
2023-01-13,Ventura,111,848112,218727,218234,17910,236144,1632
2023-01-13,Yolo,113,214977,49486,49393,4753,54146,433
2023-01-13,Yuba,115,75493,19840,19804,1833,21637,132
2023-01-12,Alameda,001,1643700,372257,371533,22171,393704,2112
2023-01-12,Alpine,003,1148,139,139,4,143,0
2023-01-12,Amador,005,37829,10406,10384,962,11346,96
2023-01-12,Butte,007,227075,41287,41228,10041,51269,478
2023-01-12,Calaveras,009,45235,8896,8878,638,9516,138
2023-01-12,Colusa,011,21464,3923,3919,1332,5251,22
2023-01-12,Contra Costa,013,1133247,267994,267212,22090,289302,1505
2023-01-12,Del Norte,015,27424,7713,7700,445,8145,57
2023-01-12,El Dorado,017,186661,34203,34153,4506,38659,236
2023-01-12,Fresno,019,978130,290172,287748,33974,321722,2940
2023-01-12,Glenn,021,27897,5749,5747,1996,7743,58
2023-01-12,Humboldt,023,135768,23025,22986,5794,28780,166
2023-01-12,Imperial,025,180216,69185,69018,18567,87585,964
2023-01-12,Inyo,027,18085,4715,4709,1247,5956,62
2023-01-12,Kern,029,883053,227503,226971,70567,297538,2457
2023-01-12,Kings,031,150075,62172,62044,4383,66427,469
2023-01-12,Lake,033,64148,13490,13448,1285,14733,149
2023-01-12,Lassen,035,31185,10220,10212,1059,11271,66
2023-01-12,Los Angeles,037,10098052,3451853,3443850,211110,3654960,34651
2023-01-12,Madera,039,155013,45852,45761,8819,54580,377
2023-01-12,Marin,041,260295,48220,48130,5620,53750,317
2023-01-12,Mariposa,043,17540,3321,3285,385,3670,32
2023-01-12,Mendocino,045,87422,16707,16682,4787,21469,137
2023-01-12,Merced,047,269075,75488,75253,12616,87869,883
2023-01-12,Modoc,049,8938,949,946,365,1311,11
2023-01-12,Mono,051,14174,3303,3299,297,3596,8
2023-01-12,Monterey,053,433212,97018,96874,22653,119527,781
2023-01-12,Napa,055,140530,33866,33808,1525,35333,165
2023-01-12,Nevada,057,99092,19962,19927,2254,22181,132
2023-01-12,Orange,059,3164182,701368,699881,74874,774755,7723
2023-01-12,Placer,061,380077,79916,79766,10147,89913,671
2023-01-12,Plumas,063,18699,3806,3804,459,4263,13
2023-01-12,Riverside,065,2383286,727347,725898,40782,766680,6761
2023-01-12,Sacramento,067,1510023,365884,365352,36950,402302,3434
2023-01-12,San Benito,069,59416,17410,17378,1121,18499,115
2023-01-12,San Bernardino,071,2135413,702853,701674,34619,736293,8146
2023-01-12,San Diego,073,3302833,972585,970800,79715,1050515,5681
2023-01-12,San Francisco,075,870044,192328,191765,13135,204900,1123
2023-01-12,San Joaquin,077,732212,207422,207038,16577,223615,2378
2023-01-12,San Luis Obispo,079,281455,65646,65502,8043,73545,539
2023-01-12,San Mateo,081,765935,179849,179319,11263,190582,749
2023-01-12,Santa Barbara,083,443738,110732,110537,7565,118102,750
2023-01-12,Santa Clara,085,1922200,466939,465994,21457,487451,2601
2023-01-12,Santa Cruz,087,273765,67326,67144,3779,70923,276
2023-01-12,Shasta,089,179085,36272,36179,8225,44404,604
2023-01-12,Sierra,091,2930,311,311,61,372,5
2023-01-12,Siskiyou,093,43540,5398,5384,3422,8806,95
2023-01-12,Solano,095,438530,111919,111700,8448,120148,479
2023-01-12,Sonoma,097,501317,112095,111955,5733,117688,542
2023-01-12,Stanislaus,099,539301,143508,143318,22670,165988,1800
2023-01-12,Sutter,101,95872,25436,25392,2544,27936,237
2023-01-12,Tehama,103,63373,14354,14320,3383,17703,221
2023-01-12,Trinity,105,12862,1458,1448,503,1951,23
2023-01-12,Tulare,107,460477,126681,126451,39434,165885,1552
2023-01-12,Tuolumne,109,53932,16616,16552,1003,17555,209
2023-01-12,Ventura,111,848112,218669,218234,17897,236131,1632
2023-01-12,Yolo,113,214977,49477,49393,4752,54145,433
2023-01-12,Yuba,115,75493,19834,19804,1833,21637,132
2023-01-11,Alameda,001,1643700,372114,371533,22161,393694,2112
2023-01-11,Alpine,003,1148,139,139,4,143,0
2023-01-11,Amador,005,37829,10402,10384,962,11346,96
2023-01-11,Butte,007,227075,41276,41228,10039,51267,478
2023-01-11,Calaveras,009,45235,8895,8878,637,9515,138
2023-01-11,Colusa,011,21464,3922,3919,1331,5250,22
2023-01-11,Contra Costa,013,1133247,267891,267212,22081,289293,1505
2023-01-11,Del Norte,015,27424,7712,7700,445,8145,57
2023-01-11,El Dorado,017,186661,34189,34153,4506,38659,236
2023-01-11,Fresno,019,978130,290101,287748,33956,321704,2940
2023-01-11,Glenn,021,27897,5749,5747,1996,7743,58
2023-01-11,Humboldt,023,135768,23017,22986,5792,28778,166
2023-01-11,Imperial,025,180216,69158,69018,18555,87573,964
2023-01-11,Inyo,027,18085,4713,4709,1245,5954,62
2023-01-11,Kern,029,883053,227434,226971,70513,297484,2457
2023-01-11,Kings,031,150075,62145,62044,4383,66427,469
2023-01-11,Lake,033,64148,13482,13448,1285,14733,149
2023-01-11,Lassen,035,31185,10220,10212,1059,11271,66
2023-01-11,Los Angeles,037,10098052,3450877,3443850,210942,3654792,34651
2023-01-11,Madera,039,155013,45842,45761,8817,54578,377
2023-01-11,Marin,041,260295,48205,48130,5618,53748,317
2023-01-11,Mariposa,043,17540,3319,3285,385,3670,32
2023-01-11,Mendocino,045,87422,16704,16682,4784,21466,137
2023-01-11,Merced,047,269075,75473,75253,12611,87864,883
2023-01-11,Modoc,049,8938,948,946,365,1311,11
2023-01-11,Mono,051,14174,3303,3299,297,3596,8
2023-01-11,Monterey,053,433212,97000,96874,22647,119521,781
2023-01-11,Napa,055,140530,33856,33808,1525,35333,165
2023-01-11,Nevada,057,99092,19958,19927,2253,22180,132
2023-01-11,Orange,059,3164182,701122,699881,74819,774700,7723
2023-01-11,Placer,061,380077,79892,79766,10143,89909,671
2023-01-11,Plumas,063,18699,3806,3804,459,4263,13
2023-01-11,Riverside,065,2383286,727149,725898,40757,766655,6761
2023-01-11,Sacramento,067,1510023,365794,365352,36936,402288,3434
2023-01-11,San Benito,069,59416,17403,17378,1119,18497,115
2023-01-11,San Bernardino,071,2135413,702718,701674,34585,736259,8146
2023-01-11,San Diego,073,3302833,972263,970800,79661,1050461,5681
2023-01-11,San Francisco,075,870044,192273,191765,13130,204895,1123
2023-01-11,San Joaquin,077,732212,207358,207038,16574,223612,2378
2023-01-11,San Luis Obispo,079,281455,65638,65502,8033,73535,539
2023-01-11,San Mateo,081,765935,179798,179319,11256,190575,749
2023-01-11,Santa Barbara,083,443738,110695,110537,7558,118095,750
2023-01-11,Santa Clara,085,1922200,466755,465994,21452,487446,2601
2023-01-11,Santa Cruz,087,273765,67305,67144,3776,70920,276
2023-01-11,Shasta,089,179085,36266,36179,8225,44404,604
2023-01-11,Sierra,091,2930,311,311,61,372,5
2023-01-11,Siskiyou,093,43540,5397,5384,3422,8806,95
2023-01-11,Solano,095,438530,111890,111700,8445,120145,479
2023-01-11,Sonoma,097,501317,112064,111955,5728,117683,542
2023-01-11,Stanislaus,099,539301,143488,143318,22622,165940,1800
2023-01-11,Sutter,101,95872,25429,25392,2543,27935,237
2023-01-11,Tehama,103,63373,14351,14320,3381,17701,221
2023-01-11,Trinity,105,12862,1458,1448,503,1951,23
2023-01-11,Tulare,107,460477,126650,126451,39414,165865,1552
2023-01-11,Tuolumne,109,53932,16607,16552,1001,17553,209
2023-01-11,Ventura,111,848112,218612,218234,17885,236119,1632
2023-01-11,Yolo,113,214977,49465,49393,4750,54143,433
2023-01-11,Yuba,115,75493,19829,19804,1830,21634,132
2023-01-10,Alameda,001,1643700,372000,371533,22144,393677,2112
2023-01-10,Alpine,003,1148,139,139,4,143,0
2023-01-10,Amador,005,37829,10402,10384,962,11346,96
2023-01-10,Butte,007,227075,41264,41228,10033,51261,478
2023-01-10,Calaveras,009,45235,8894,8878,637,9515,138
2023-01-10,Colusa,011,21464,3922,3919,1330,5249,22
2023-01-10,Contra Costa,013,1133247,267799,267212,22060,289272,1505
2023-01-10,Del Norte,015,27424,7711,7700,443,8143,57
2023-01-10,El Dorado,017,186661,34180,34153,4503,38656,236
2023-01-10,Fresno,019,978130,290020,287748,33946,321694,2940
2023-01-10,Glenn,021,27897,5748,5747,1996,7743,58
2023-01-10,Humboldt,023,135768,23015,22986,5787,28773,166
2023-01-10,Imperial,025,180216,69138,69018,18544,87562,964
2023-01-10,Inyo,027,18085,4712,4709,1245,5954,62
2023-01-10,Kern,029,883053,227381,226971,70466,297437,2457
2023-01-10,Kings,031,150075,62123,62044,4381,66425,469
2023-01-10,Lake,033,64148,13477,13448,1285,14733,149
2023-01-10,Lassen,035,31185,10217,10212,1059,11271,66
2023-01-10,Los Angeles,037,10098052,3449710,3443850,210792,3654642,34651
2023-01-10,Madera,039,155013,45834,45761,8812,54573,377
2023-01-10,Marin,041,260295,48184,48130,5617,53747,317
2023-01-10,Mariposa,043,17540,3319,3285,382,3667,32
2023-01-10,Mendocino,045,87422,16700,16682,4782,21464,137
2023-01-10,Merced,047,269075,75453,75253,12604,87857,883
2023-01-10,Modoc,049,8938,948,946,365,1311,11
2023-01-10,Mono,051,14174,3303,3299,296,3595,8
2023-01-10,Monterey,053,433212,96984,96874,22629,119503,781
2023-01-10,Napa,055,140530,33844,33808,1525,35333,165
2023-01-10,Nevada,057,99092,19953,19927,2252,22179,132
2023-01-10,Orange,059,3164182,700888,699881,74774,774655,7723
2023-01-10,Placer,061,380077,79864,79766,10141,89907,671
2023-01-10,Plumas,063,18699,3806,3804,459,4263,13
2023-01-10,Riverside,065,2383286,726914,725898,40728,766626,6761
2023-01-10,Sacramento,067,1510023,365692,365352,36917,402269,3434
2023-01-10,San Benito,069,59416,17399,17378,1118,18496,115
2023-01-10,San Bernardino,071,2135413,702527,701674,34561,736235,8146
2023-01-10,San Diego,073,3302833,971893,970800,79607,1050407,5681
2023-01-10,San Francisco,075,870044,192202,191765,13125,204890,1123
2023-01-10,San Joaquin,077,732212,207289,207038,16569,223607,2378
2023-01-10,San Luis Obispo,079,281455,65616,65502,8018,73520,539
2023-01-10,San Mateo,081,765935,179730,179319,11251,190570,749
2023-01-10,Santa Barbara,083,443738,110650,110537,7545,118082,750
2023-01-10,Santa Clara,085,1922200,466527,465994,21438,487432,2601
2023-01-10,Santa Cruz,087,273765,67278,67144,3769,70913,276
2023-01-10,Shasta,089,179085,36254,36179,8224,44403,604
2023-01-10,Sierra,091,2930,311,311,61,372,5
2023-01-10,Siskiyou,093,43540,5396,5384,3422,8806,95
2023-01-10,Solano,095,438530,111848,111700,8441,120141,479
2023-01-10,Sonoma,097,501317,112032,111955,5724,117679,542
2023-01-10,Stanislaus,099,539301,143445,143318,22617,165935,1800
2023-01-10,Sutter,101,95872,25418,25392,2543,27935,237
2023-01-10,Tehama,103,63373,14346,14320,3380,17700,221
2023-01-10,Trinity,105,12862,1456,1448,503,1951,23
2023-01-10,Tulare,107,460477,126599,126451,39393,165844,1552
2023-01-10,Tuolumne,109,53932,16602,16552,1001,17553,209
2023-01-10,Ventura,111,848112,218535,218234,17863,236097,1632
2023-01-10,Yolo,113,214977,49458,49393,4748,54141,433
2023-01-10,Yuba,115,75493,19821,19804,1829,21633,132
2023-01-09,Alameda,001,1643700,371826,369872,22129,392001,2098
2023-01-09,Alpine,003,1148,139,138,4,142,0
2023-01-09,Amador,005,37829,10397,10340,962,11302,96
2023-01-09,Butte,007,227075,41254,41102,10027,51129,478
2023-01-09,Calaveras,009,45235,8891,8852,637,9489,137
2023-01-09,Colusa,011,21464,3920,3911,1330,5241,22
2023-01-09,Contra Costa,013,1133247,267686,265846,22050,287896,1501
2023-01-09,Del Norte,015,27424,7711,7680,443,8123,57
2023-01-09,El Dorado,017,186661,34175,34009,4503,38512,236
2023-01-09,Fresno,019,978130,289917,286556,33929,320485,2924
2023-01-09,Glenn,021,27897,5747,5732,1996,7728,58
2023-01-09,Humboldt,023,135768,23010,22878,5778,28656,164
2023-01-09,Imperial,025,180216,69115,68809,18536,87345,964
2023-01-09,Inyo,027,18085,4710,4687,1241,5928,62
2023-01-09,Kern,029,883053,227342,226454,70422,296876,2450
2023-01-09,Kings,031,150075,62101,61886,4380,66266,466
2023-01-09,Lake,033,64148,13475,13363,1284,14647,149
2023-01-09,Lassen,035,31185,10216,10189,1058,11247,66
2023-01-09,Los Angeles,037,10098052,3448630,3434193,210623,3644816,34492
2023-01-09,Madera,039,155013,45823,45608,8803,54411,377
2023-01-09,Marin,041,260295,48165,47893,5613,53506,317
2023-01-09,Mariposa,043,17540,3319,3223,382,3605,32
2023-01-09,Mendocino,045,87422,16696,16582,4780,21362,137
2023-01-09,Merced,047,269075,75431,74969,12601,87570,883
2023-01-09,Modoc,049,8938,948,940,365,1305,11
2023-01-09,Mono,051,14174,3301,3284,296,3580,8
2023-01-09,Monterey,053,433212,96965,96607,22616,119223,778
2023-01-09,Napa,055,140530,33837,33666,1522,35188,164
2023-01-09,Nevada,057,99092,19950,19845,2251,22096,132
2023-01-09,Orange,059,3164182,700625,697391,74707,772098,7683
2023-01-09,Placer,061,380077,79837,79461,10138,89599,672
2023-01-09,Plumas,063,18699,3806,3798,458,4256,13
2023-01-09,Riverside,065,2383286,726695,723578,40701,764279,6748
2023-01-09,Sacramento,067,1510023,365576,364212,36907,401119,3422
2023-01-09,San Benito,069,59416,17395,17293,1118,18411,115
2023-01-09,San Bernardino,071,2135413,702363,699531,34535,734066,8143
2023-01-09,San Diego,073,3302833,971457,967383,79534,1046917,5662
2023-01-09,San Francisco,075,870044,192120,190940,13116,204056,1114
2023-01-09,San Joaquin,077,732212,207226,206280,16558,222838,2369
2023-01-09,San Luis Obispo,079,281455,65599,65166,8011,73177,539
2023-01-09,San Mateo,081,765935,179656,178472,11243,189715,749
2023-01-09,Santa Barbara,083,443738,110623,110007,7543,117550,748
2023-01-09,Santa Clara,085,1922200,466323,463958,21423,485381,2601
2023-01-09,Santa Cruz,087,273765,67241,66937,3765,70702,276
2023-01-09,Shasta,089,179085,36250,36083,8222,44305,602
2023-01-09,Sierra,091,2930,311,310,61,371,5
2023-01-09,Siskiyou,093,43540,5395,5373,3421,8794,95
2023-01-09,Solano,095,438530,111796,111243,8435,119678,478
2023-01-09,Sonoma,097,501317,112002,111530,5721,117251,537
2023-01-09,Stanislaus,099,539301,143402,142918,22607,165525,1801
2023-01-09,Sutter,101,95872,25408,25308,2543,27851,235
2023-01-09,Tehama,103,63373,14344,14258,3377,17635,221
2023-01-09,Trinity,105,12862,1456,1448,501,1949,24
2023-01-09,Tulare,107,460477,126552,125773,39371,165144,1546
2023-01-09,Tuolumne,109,53932,16596,16425,1000,17425,211
2023-01-09,Ventura,111,848112,218456,217286,17851,235137,1610
2023-01-09,Yolo,113,214977,49447,49138,4746,53884,428
2023-01-09,Yuba,115,75493,19810,19743,1829,21572,132
2023-01-08,Alameda,001,1643700,371616,369872,22108,391980,2098
2023-01-08,Alpine,003,1148,139,138,4,142,0
2023-01-08,Amador,005,37829,10391,10340,962,11302,96
2023-01-08,Butte,007,227075,41240,41102,10021,51123,478
2023-01-08,Calaveras,009,45235,8886,8852,637,9489,137
2023-01-08,Colusa,011,21464,3920,3911,1328,5239,22
2023-01-08,Contra Costa,013,1133247,267559,265846,22039,287885,1501
2023-01-08,Del Norte,015,27424,7708,7680,443,8123,57
2023-01-08,El Dorado,017,186661,34167,34009,4503,38512,236
2023-01-08,Fresno,019,978130,289808,286556,33915,320471,2924
2023-01-08,Glenn,021,27897,5746,5732,1996,7728,58
2023-01-08,Humboldt,023,135768,23004,22878,5767,28645,164
2023-01-08,Imperial,025,180216,69093,68809,18526,87335,964
2023-01-08,Inyo,027,18085,4709,4687,1239,5926,62
2023-01-08,Kern,029,883053,227263,226454,70360,296814,2450
2023-01-08,Kings,031,150075,62077,61886,4378,66264,466
2023-01-08,Lake,033,64148,13469,13363,1284,14647,149
2023-01-08,Lassen,035,31185,10215,10189,1056,11245,66
2023-01-08,Los Angeles,037,10098052,3447270,3434193,210379,3644572,34492
2023-01-08,Madera,039,155013,45805,45608,8796,54404,377
2023-01-08,Marin,041,260295,48143,47893,5609,53502,317
2023-01-08,Mariposa,043,17540,3319,3223,382,3605,32
2023-01-08,Mendocino,045,87422,16686,16582,4777,21359,137
2023-01-08,Merced,047,269075,75407,74969,12592,87561,883
2023-01-08,Modoc,049,8938,948,940,364,1304,11
2023-01-08,Mono,051,14174,3298,3284,296,3580,8
2023-01-08,Monterey,053,433212,96942,96607,22597,119204,778
2023-01-08,Napa,055,140530,33813,33666,1520,35186,164
2023-01-08,Nevada,057,99092,19944,19845,2247,22092,132
2023-01-08,Orange,059,3164182,700314,697391,74606,771997,7683
2023-01-08,Placer,061,380077,79797,79461,10134,89595,672
2023-01-08,Plumas,063,18699,3806,3798,458,4256,13
2023-01-08,Riverside,065,2383286,726426,723578,40639,764217,6748
2023-01-08,Sacramento,067,1510023,365436,364212,36879,401091,3422
2023-01-08,San Benito,069,59416,17390,17293,1118,18411,115
2023-01-08,San Bernardino,071,2135413,702120,699531,34498,734029,8143
2023-01-08,San Diego,073,3302833,970916,967383,79436,1046819,5662
2023-01-08,San Francisco,075,870044,191994,190940,13104,204044,1114
2023-01-08,San Joaquin,077,732212,207144,206280,16548,222828,2369
2023-01-08,San Luis Obispo,079,281455,65584,65166,8000,73166,539
2023-01-08,San Mateo,081,765935,179562,178472,11237,189709,749
2023-01-08,Santa Barbara,083,443738,110594,110007,7534,117541,748
2023-01-08,Santa Clara,085,1922200,466030,463958,21400,485358,2601
2023-01-08,Santa Cruz,087,273765,67221,66937,3764,70701,276
2023-01-08,Shasta,089,179085,36243,36083,8218,44301,602
2023-01-08,Sierra,091,2930,311,310,61,371,5
2023-01-08,Siskiyou,093,43540,5391,5373,3421,8794,95
2023-01-08,Solano,095,438530,111718,111243,8430,119673,478
2023-01-08,Sonoma,097,501317,111949,111530,5717,117247,537
2023-01-08,Stanislaus,099,539301,143362,142918,22597,165515,1801
2023-01-08,Sutter,101,95872,25398,25308,2543,27851,235
2023-01-08,Tehama,103,63373,14341,14258,3375,17633,221
2023-01-08,Trinity,105,12862,1456,1448,501,1949,24
2023-01-08,Tulare,107,460477,126501,125773,39349,165122,1546
2023-01-08,Tuolumne,109,53932,16590,16425,998,17423,211
2023-01-08,Ventura,111,848112,218372,217286,17829,235115,1610
2023-01-08,Yolo,113,214977,49427,49138,4742,53880,428
2023-01-08,Yuba,115,75493,19807,19743,1829,21572,132
2023-01-07,Alameda,001,1643700,371522,369872,22092,391964,2098
2023-01-07,Alpine,003,1148,139,138,4,142,0
2023-01-07,Amador,005,37829,10390,10340,962,11302,96
2023-01-07,Butte,007,227075,41234,41102,10017,51119,478
2023-01-07,Calaveras,009,45235,8885,8852,636,9488,137
2023-01-07,Colusa,011,21464,3919,3911,1328,5239,22
2023-01-07,Contra Costa,013,1133247,267479,265846,22032,287878,1501
2023-01-07,Del Norte,015,27424,7706,7680,443,8123,57
2023-01-07,El Dorado,017,186661,34159,34009,4501,38510,236
2023-01-07,Fresno,019,978130,289753,286556,33912,320468,2924
2023-01-07,Glenn,021,27897,5745,5732,1994,7726,58
2023-01-07,Humboldt,023,135768,22999,22878,5761,28639,164
2023-01-07,Imperial,025,180216,69079,68809,18525,87334,964
2023-01-07,Inyo,027,18085,4709,4687,1239,5926,62
2023-01-07,Kern,029,883053,227222,226454,70310,296764,2450
2023-01-07,Kings,031,150075,62060,61886,4376,66262,466
2023-01-07,Lake,033,64148,13467,13363,1284,14647,149
2023-01-07,Lassen,035,31185,10213,10189,1056,11245,66
2023-01-07,Los Angeles,037,10098052,3446420,3434193,210245,3644438,34492
2023-01-07,Madera,039,155013,45798,45608,8795,54403,377
2023-01-07,Marin,041,260295,48129,47893,5609,53502,317
2023-01-07,Mariposa,043,17540,3318,3223,382,3605,32
2023-01-07,Mendocino,045,87422,16680,16582,4776,21358,137
2023-01-07,Merced,047,269075,75392,74969,12592,87561,883
2023-01-07,Modoc,049,8938,948,940,364,1304,11
2023-01-07,Mono,051,14174,3298,3284,296,3580,8
2023-01-07,Monterey,053,433212,96926,96607,22591,119198,778
2023-01-07,Napa,055,140530,33810,33666,1519,35185,164
2023-01-07,Nevada,057,99092,19944,19845,2245,22090,132
2023-01-07,Orange,059,3164182,700126,697391,74530,771921,7683
2023-01-07,Placer,061,380077,79770,79461,10133,89594,672
2023-01-07,Plumas,063,18699,3806,3798,458,4256,13
2023-01-07,Riverside,065,2383286,726282,723578,40612,764190,6748
2023-01-07,Sacramento,067,1510023,365368,364212,36874,401086,3422
2023-01-07,San Benito,069,59416,17386,17293,1118,18411,115
2023-01-07,San Bernardino,071,2135413,701957,699531,34476,734007,8143
2023-01-07,San Diego,073,3302833,970643,967383,79418,1046801,5662
2023-01-07,San Francisco,075,870044,191931,190940,13095,204035,1114
2023-01-07,San Joaquin,077,732212,207097,206280,16537,222817,2369
2023-01-07,San Luis Obispo,079,281455,65576,65166,7994,73160,539
2023-01-07,San Mateo,081,765935,179523,178472,11226,189698,749
2023-01-07,Santa Barbara,083,443738,110558,110007,7521,117528,748
2023-01-07,Santa Clara,085,1922200,465887,463958,21386,485344,2601
2023-01-07,Santa Cruz,087,273765,67209,66937,3762,70699,276
2023-01-07,Shasta,089,179085,36237,36083,8217,44300,602
2023-01-07,Sierra,091,2930,311,310,61,371,5
2023-01-07,Siskiyou,093,43540,5388,5373,3421,8794,95
2023-01-07,Solano,095,438530,111692,111243,8428,119671,478
2023-01-07,Sonoma,097,501317,111941,111530,5716,117246,537
2023-01-07,Stanislaus,099,539301,143331,142918,22588,165506,1801
2023-01-07,Sutter,101,95872,25392,25308,2542,27850,235
2023-01-07,Tehama,103,63373,14339,14258,3373,17631,221
2023-01-07,Trinity,105,12862,1456,1448,501,1949,24
2023-01-07,Tulare,107,460477,126483,125773,39335,165108,1546
2023-01-07,Tuolumne,109,53932,16582,16425,998,17423,211
2023-01-07,Ventura,111,848112,218324,217286,17807,235093,1610
2023-01-07,Yolo,113,214977,49417,49138,4740,53878,428
2023-01-07,Yuba,115,75493,19800,19743,1829,21572,132
2023-01-06,Alameda,001,1643700,371403,369872,22083,391955,2098
2023-01-06,Alpine,003,1148,139,138,4,142,0
2023-01-06,Amador,005,37829,10387,10340,962,11302,96
2023-01-06,Butte,007,227075,41226,41102,10013,51115,478
2023-01-06,Calaveras,009,45235,8885,8852,636,9488,137
2023-01-06,Colusa,011,21464,3918,3911,1328,5239,22
2023-01-06,Contra Costa,013,1133247,267401,265846,22026,287872,1501
2023-01-06,Del Norte,015,27424,7705,7680,443,8123,57
2023-01-06,El Dorado,017,186661,34149,34009,4500,38509,236
2023-01-06,Fresno,019,978130,289676,286556,33893,320449,2924
2023-01-06,Glenn,021,27897,5743,5732,1994,7726,58
2023-01-06,Humboldt,023,135768,22994,22878,5757,28635,164
2023-01-06,Imperial,025,180216,69067,68809,18523,87332,964
2023-01-06,Inyo,027,18085,4708,4687,1237,5924,62
2023-01-06,Kern,029,883053,227190,226454,70258,296712,2450
2023-01-06,Kings,031,150075,62043,61886,4376,66262,466
2023-01-06,Lake,033,64148,13466,13363,1282,14645,149
2023-01-06,Lassen,035,31185,10210,10189,1056,11245,66
2023-01-06,Los Angeles,037,10098052,3445445,3434193,210063,3644256,34492
2023-01-06,Madera,039,155013,45790,45608,8790,54398,377
2023-01-06,Marin,041,260295,48114,47893,5607,53500,317
2023-01-06,Mariposa,043,17540,3318,3223,381,3604,32
2023-01-06,Mendocino,045,87422,16677,16582,4775,21357,137
2023-01-06,Merced,047,269075,75376,74969,12591,87560,883
2023-01-06,Modoc,049,8938,948,940,364,1304,11
2023-01-06,Mono,051,14174,3298,3284,295,3579,8
2023-01-06,Monterey,053,433212,96912,96607,22572,119179,778
2023-01-06,Napa,055,140530,33799,33666,1515,35181,164
2023-01-06,Nevada,057,99092,19942,19845,2244,22089,132
2023-01-06,Orange,059,3164182,699869,697391,74453,771844,7683
2023-01-06,Placer,061,380077,79744,79461,10132,89593,672
2023-01-06,Plumas,063,18699,3806,3798,458,4256,13
2023-01-06,Riverside,065,2383286,726100,723578,40579,764157,6748
2023-01-06,Sacramento,067,1510023,365272,364212,36870,401082,3422
2023-01-06,San Benito,069,59416,17379,17293,1113,18406,115
2023-01-06,San Bernardino,071,2135413,701783,699531,34457,733988,8143
2023-01-06,San Diego,073,3302833,970323,967383,79381,1046764,5662
2023-01-06,San Francisco,075,870044,191861,190940,13089,204029,1114
2023-01-06,San Joaquin,077,732212,207034,206280,16532,222812,2369
2023-01-06,San Luis Obispo,079,281455,65562,65166,7989,73155,539
2023-01-06,San Mateo,081,765935,179473,178472,11219,189691,749
2023-01-06,Santa Barbara,083,443738,110511,110007,7518,117525,748
2023-01-06,Santa Clara,085,1922200,465718,463958,21359,485317,2601
2023-01-06,Santa Cruz,087,273765,67194,66937,3758,70695,276
2023-01-06,Shasta,089,179085,36232,36083,8215,44298,602
2023-01-06,Sierra,091,2930,311,310,61,371,5
2023-01-06,Siskiyou,093,43540,5386,5373,3421,8794,95
2023-01-06,Solano,095,438530,111652,111243,8424,119667,478
2023-01-06,Sonoma,097,501317,111919,111530,5709,117239,537
2023-01-06,Stanislaus,099,539301,143310,142918,22584,165502,1801
2023-01-06,Sutter,101,95872,25389,25308,2542,27850,235
2023-01-06,Tehama,103,63373,14336,14258,3371,17629,221
2023-01-06,Trinity,105,12862,1456,1448,498,1946,24
2023-01-06,Tulare,107,460477,126460,125773,39318,165091,1546
2023-01-06,Tuolumne,109,53932,16571,16425,998,17423,211
2023-01-06,Ventura,111,848112,218263,217286,17796,235082,1610
2023-01-06,Yolo,113,214977,49406,49138,4738,53876,428
2023-01-06,Yuba,115,75493,19791,19743,1829,21572,132
2023-01-05,Alameda,001,1643700,371188,369872,22066,391938,2098
2023-01-05,Alpine,003,1148,139,138,4,142,0
2023-01-05,Amador,005,37829,10386,10340,962,11302,96
2023-01-05,Butte,007,227075,41217,41102,10005,51107,478
2023-01-05,Calaveras,009,45235,8884,8852,636,9488,137
2023-01-05,Colusa,011,21464,3915,3911,1328,5239,22
2023-01-05,Contra Costa,013,1133247,267246,265846,22021,287867,1501
2023-01-05,Del Norte,015,27424,7703,7680,443,8123,57
2023-01-05,El Dorado,017,186661,34134,34009,4500,38509,236
2023-01-05,Fresno,019,978130,289575,286556,33873,320429,2924
2023-01-05,Glenn,021,27897,5742,5732,1993,7725,58
2023-01-05,Humboldt,023,135768,22988,22878,5746,28624,164
2023-01-05,Imperial,025,180216,69040,68809,18510,87319,964
2023-01-05,Inyo,027,18085,4708,4687,1236,5923,62
2023-01-05,Kern,029,883053,227097,226454,70192,296646,2450
2023-01-05,Kings,031,150075,62020,61886,4376,66262,466
2023-01-05,Lake,033,64148,13458,13363,1279,14642,149
2023-01-05,Lassen,035,31185,10208,10189,1051,11240,66
2023-01-05,Los Angeles,037,10098052,3444021,3434193,209805,3643998,34492
2023-01-05,Madera,039,155013,45778,45608,8777,54385,377
2023-01-05,Marin,041,260295,48097,47893,5605,53498,317
2023-01-05,Mariposa,043,17540,3316,3223,380,3603,32
2023-01-05,Mendocino,045,87422,16671,16582,4775,21357,137
2023-01-05,Merced,047,269075,75351,74969,12582,87551,883
2023-01-05,Modoc,049,8938,948,940,364,1304,11
2023-01-05,Mono,051,14174,3294,3284,295,3579,8
2023-01-05,Monterey,053,433212,96887,96607,22544,119151,778
2023-01-05,Napa,055,140530,33784,33666,1512,35178,164
2023-01-05,Nevada,057,99092,19935,19845,2243,22088,132
2023-01-05,Orange,059,3164182,699514,697391,74349,771740,7683
2023-01-05,Placer,061,380077,79705,79461,10130,89591,672
2023-01-05,Plumas,063,18699,3803,3798,458,4256,13
2023-01-05,Riverside,065,2383286,725832,723578,40530,764108,6748
2023-01-05,Sacramento,067,1510023,365103,364212,36852,401064,3422
2023-01-05,San Benito,069,59416,17373,17293,1111,18404,115
2023-01-05,San Bernardino,071,2135413,701565,699531,34431,733962,8143
2023-01-05,San Diego,073,3302833,969870,967383,79293,1046676,5662
2023-01-05,San Francisco,075,870044,191717,190940,13072,204012,1114
2023-01-05,San Joaquin,077,732212,206949,206280,16525,222805,2369
2023-01-05,San Luis Obispo,079,281455,65539,65166,7975,73141,539
2023-01-05,San Mateo,081,765935,179371,178472,11207,189679,749
2023-01-05,Santa Barbara,083,443738,110453,110007,7507,117514,748
2023-01-05,Santa Clara,085,1922200,465402,463958,21327,485285,2601
2023-01-05,Santa Cruz,087,273765,67169,66937,3756,70693,276
2023-01-05,Shasta,089,179085,36224,36083,8209,44292,602
2023-01-05,Sierra,091,2930,311,310,61,371,5
2023-01-05,Siskiyou,093,43540,5383,5373,3421,8794,95
2023-01-05,Solano,095,438530,111592,111243,8417,119660,478
2023-01-05,Sonoma,097,501317,111863,111530,5703,117233,537
2023-01-05,Stanislaus,099,539301,143263,142918,22570,165488,1801
2023-01-05,Sutter,101,95872,25376,25308,2542,27850,235
2023-01-05,Tehama,103,63373,14331,14258,3367,17625,221
2023-01-05,Trinity,105,12862,1456,1448,496,1944,24
2023-01-05,Tulare,107,460477,126417,125773,39288,165061,1546
2023-01-05,Tuolumne,109,53932,16554,16425,998,17423,211
2023-01-05,Ventura,111,848112,218166,217286,17772,235058,1610
2023-01-05,Yolo,113,214977,49393,49138,4735,53873,428
2023-01-05,Yuba,115,75493,19785,19743,1828,21571,132
2023-01-04,Alameda,001,1643700,370969,369872,22041,391913,2098
2023-01-04,Alpine,003,1148,139,138,4,142,0
2023-01-04,Amador,005,37829,10380,10340,962,11302,96
2023-01-04,Butte,007,227075,41204,41102,9991,51093,478
2023-01-04,Calaveras,009,45235,8883,8852,634,9486,137
2023-01-04,Colusa,011,21464,3913,3911,1325,5236,22
2023-01-04,Contra Costa,013,1133247,267081,265846,22002,287848,1501
2023-01-04,Del Norte,015,27424,7701,7680,443,8123,57
2023-01-04,El Dorado,017,186661,34126,34009,4499,38508,236
2023-01-04,Fresno,019,978130,289456,286556,33858,320414,2924
2023-01-04,Glenn,021,27897,5742,5732,1990,7722,58
2023-01-04,Humboldt,023,135768,22984,22878,5743,28621,164
2023-01-04,Imperial,025,180216,69028,68809,18493,87302,964
2023-01-04,Inyo,027,18085,4704,4687,1233,5920,62
2023-01-04,Kern,029,883053,227000,226454,70117,296571,2450
2023-01-04,Kings,031,150075,61998,61886,4376,66262,466
2023-01-04,Lake,033,64148,13455,13363,1278,14641,149
2023-01-04,Lassen,035,31185,10204,10189,1049,11238,66
2023-01-04,Los Angeles,037,10098052,3442517,3434193,209565,3643758,34492
2023-01-04,Madera,039,155013,45765,45608,8773,54381,377
2023-01-04,Marin,041,260295,48072,47893,5602,53495,317
2023-01-04,Mariposa,043,17540,3316,3223,380,3603,32
2023-01-04,Mendocino,045,87422,16669,16582,4768,21350,137
2023-01-04,Merced,047,269075,75331,74969,12578,87547,883
2023-01-04,Modoc,049,8938,946,940,364,1304,11
2023-01-04,Mono,051,14174,3293,3284,295,3579,8
2023-01-04,Monterey,053,433212,96853,96607,22521,119128,778
2023-01-04,Napa,055,140530,33757,33666,1512,35178,164
2023-01-04,Nevada,057,99092,19927,19845,2241,22086,132
2023-01-04,Orange,059,3164182,699172,697391,74251,771642,7683
2023-01-04,Placer,061,380077,79671,79461,10127,89588,672
2023-01-04,Plumas,063,18699,3803,3798,458,4256,13
2023-01-04,Riverside,065,2383286,725552,723578,40473,764051,6748
2023-01-04,Sacramento,067,1510023,364980,364212,36817,401029,3422
2023-01-04,San Benito,069,59416,17363,17293,1111,18404,115
2023-01-04,San Bernardino,071,2135413,701353,699531,34388,733919,8143
2023-01-04,San Diego,073,3302833,969329,967383,79190,1046573,5662
2023-01-04,San Francisco,075,870044,191622,190940,13065,204005,1114
2023-01-04,San Joaquin,077,732212,206854,206280,16515,222795,2369
2023-01-04,San Luis Obispo,079,281455,65515,65166,7958,73124,539
2023-01-04,San Mateo,081,765935,179292,178472,11199,189671,749
2023-01-04,Santa Barbara,083,443738,110402,110007,7499,117506,748
2023-01-04,Santa Clara,085,1922200,465118,463958,21294,485252,2601
2023-01-04,Santa Cruz,087,273765,67144,66937,3754,70691,276
2023-01-04,Shasta,089,179085,36207,36083,8209,44292,602
2023-01-04,Sierra,091,2930,311,310,61,371,5
2023-01-04,Siskiyou,093,43540,5381,5373,3421,8794,95
2023-01-04,Solano,095,438530,111538,111243,8411,119654,478
2023-01-04,Sonoma,097,501317,111826,111530,5699,117229,537
2023-01-04,Stanislaus,099,539301,143226,142918,22560,165478,1801
2023-01-04,Sutter,101,95872,25367,25308,2541,27849,235
2023-01-04,Tehama,103,63373,14328,14258,3366,17624,221
2023-01-04,Trinity,105,12862,1455,1448,496,1944,24
2023-01-04,Tulare,107,460477,126367,125773,39253,165026,1546
2023-01-04,Tuolumne,109,53932,16544,16425,997,17422,211
2023-01-04,Ventura,111,848112,218077,217286,17749,235035,1610
2023-01-04,Yolo,113,214977,49380,49138,4735,53873,428
2023-01-04,Yuba,115,75493,19779,19743,1826,21569,132
2023-01-03,Alameda,001,1643700,370730,369872,22012,391884,2098
2023-01-03,Alpine,003,1148,139,138,4,142,0
2023-01-03,Amador,005,37829,10372,10340,962,11302,96
2023-01-03,Butte,007,227075,41192,41102,9987,51089,478
2023-01-03,Calaveras,009,45235,8878,8852,633,9485,137
2023-01-03,Colusa,011,21464,3913,3911,1325,5236,22
2023-01-03,Contra Costa,013,1133247,266906,265846,21989,287835,1501
2023-01-03,Del Norte,015,27424,7698,7680,441,8121,57
2023-01-03,El Dorado,017,186661,34111,34009,4497,38506,236
2023-01-03,Fresno,019,978130,289316,286556,33833,320389,2924
2023-01-03,Glenn,021,27897,5741,5732,1987,7719,58
2023-01-03,Humboldt,023,135768,22976,22878,5738,28616,164
2023-01-03,Imperial,025,180216,69001,68809,18476,87285,964
2023-01-03,Inyo,027,18085,4703,4687,1232,5919,62
2023-01-03,Kern,029,883053,226891,226454,70019,296473,2450
2023-01-03,Kings,031,150075,61961,61886,4376,66262,466
2023-01-03,Lake,033,64148,13447,13363,1277,14640,149
2023-01-03,Lassen,035,31185,10201,10189,1047,11236,66
2023-01-03,Los Angeles,037,10098052,3440788,3434193,209263,3643456,34492
2023-01-03,Madera,039,155013,45752,45608,8765,54373,377
2023-01-03,Marin,041,260295,48058,47893,5597,53490,317
2023-01-03,Mariposa,043,17540,3315,3223,380,3603,32
2023-01-03,Mendocino,045,87422,16667,16582,4766,21348,137
2023-01-03,Merced,047,269075,75304,74969,12568,87537,883
2023-01-03,Modoc,049,8938,944,940,364,1304,11
2023-01-03,Mono,051,14174,3292,3284,295,3579,8
2023-01-03,Monterey,053,433212,96826,96607,22498,119105,778
2023-01-03,Napa,055,140530,33730,33666,1510,35176,164
2023-01-03,Nevada,057,99092,19922,19845,2241,22086,132
2023-01-03,Orange,059,3164182,698761,697391,74121,771512,7683
2023-01-03,Placer,061,380077,79624,79461,10119,89580,672
2023-01-03,Plumas,063,18699,3803,3798,458,4256,13
2023-01-03,Riverside,065,2383286,725182,723578,40406,763984,6748
2023-01-03,Sacramento,067,1510023,364798,364212,36792,401004,3422
2023-01-03,San Benito,069,59416,17358,17293,1108,18401,115
2023-01-03,San Bernardino,071,2135413,701051,699531,34337,733868,8143
2023-01-03,San Diego,073,3302833,968666,967383,79074,1046457,5662
2023-01-03,San Francisco,075,870044,191522,190940,13062,204002,1114
2023-01-03,San Joaquin,077,732212,206762,206280,16498,222778,2369
2023-01-03,San Luis Obispo,079,281455,65484,65166,7934,73100,539
2023-01-03,San Mateo,081,765935,179218,178472,11192,189664,749
2023-01-03,Santa Barbara,083,443738,110340,110007,7484,117491,748
2023-01-03,Santa Clara,085,1922200,464857,463958,21266,485224,2601
2023-01-03,Santa Cruz,087,273765,67121,66937,3752,70689,276
2023-01-03,Shasta,089,179085,36205,36083,8209,44292,602
2023-01-03,Sierra,091,2930,311,310,61,371,5
2023-01-03,Siskiyou,093,43540,5379,5373,3421,8794,95
2023-01-03,Solano,095,438530,111484,111243,8405,119648,478
2023-01-03,Sonoma,097,501317,111779,111530,5698,117228,537
2023-01-03,Stanislaus,099,539301,143173,142918,22553,165471,1801
2023-01-03,Sutter,101,95872,25360,25308,2540,27848,235
2023-01-03,Tehama,103,63373,14325,14258,3362,17620,221
2023-01-03,Trinity,105,12862,1455,1448,494,1942,24
2023-01-03,Tulare,107,460477,126309,125773,39211,164984,1546
2023-01-03,Tuolumne,109,53932,16530,16425,996,17421,211
2023-01-03,Ventura,111,848112,217967,217286,17704,234990,1610
2023-01-03,Yolo,113,214977,49368,49138,4732,53870,428
2023-01-03,Yuba,115,75493,19775,19743,1824,21567,132
2023-01-02,Alameda,001,1643700,370401,367954,21967,389921,2094
2023-01-02,Alpine,003,1148,139,138,4,142,0
2023-01-02,Amador,005,37829,10369,10313,962,11275,96
2023-01-02,Butte,007,227075,41170,41018,9985,51003,474
2023-01-02,Calaveras,009,45235,8873,8818,633,9451,135
2023-01-02,Colusa,011,21464,3912,3906,1325,5231,22
2023-01-02,Contra Costa,013,1133247,266680,264448,21976,286424,1502
2023-01-02,Del Norte,015,27424,7695,7645,439,8084,56
2023-01-02,El Dorado,017,186661,34093,33865,4494,38359,236
2023-01-02,Fresno,019,978130,289141,285444,33806,319250,2918
2023-01-02,Glenn,021,27897,5739,5719,1985,7704,58
2023-01-02,Humboldt,023,135768,22965,22835,5723,28558,163
2023-01-02,Imperial,025,180216,68964,68622,18437,87059,963
2023-01-02,Inyo,027,18085,4701,4670,1229,5899,62
2023-01-02,Kern,029,883053,226775,225659,69893,295552,2450
2023-01-02,Kings,031,150075,61917,61692,4374,66066,466
2023-01-02,Lake,033,64148,13435,13312,1275,14587,149
2023-01-02,Lassen,035,31185,10198,10172,1045,11217,66
2023-01-02,Los Angeles,037,10098052,3438612,3420383,208863,3629246,34360
2023-01-02,Madera,039,155013,45731,45448,8754,54202,377
2023-01-02,Marin,041,260295,48023,47686,5595,53281,317
2023-01-02,Mariposa,043,17540,3311,3211,380,3591,32
2023-01-02,Mendocino,045,87422,16662,16508,4757,21265,137
2023-01-02,Merced,047,269075,75275,74732,12560,87292,883
2023-01-02,Modoc,049,8938,940,931,364,1295,11
2023-01-02,Mono,051,14174,3289,3274,294,3568,8
2023-01-02,Monterey,053,433212,96809,96380,22478,118858,776
2023-01-02,Napa,055,140530,33707,33534,1507,35041,163
2023-01-02,Nevada,057,99092,19916,19774,2240,22014,132
2023-01-02,Orange,059,3164182,698246,694080,73938,768018,7656
2023-01-02,Placer,061,380077,79587,79154,10111,89265,672
2023-01-02,Plumas,063,18699,3801,3787,458,4245,13
2023-01-02,Riverside,065,2383286,724722,720437,40322,760759,6738
2023-01-02,Sacramento,067,1510023,364588,362664,36759,399423,3414
2023-01-02,San Benito,069,59416,17350,17211,1103,18314,108
2023-01-02,San Bernardino,071,2135413,700675,696472,34260,730732,8142
2023-01-02,San Diego,073,3302833,967908,962601,78948,1041549,5641
2023-01-02,San Francisco,075,870044,191343,190012,13056,203068,1104
2023-01-02,San Joaquin,077,732212,206649,205467,16487,221954,2363
2023-01-02,San Luis Obispo,079,281455,65427,64966,7903,72869,536
2023-01-02,San Mateo,081,765935,179068,177703,11178,188881,749
2023-01-02,Santa Barbara,083,443738,110268,109576,7463,117039,747
2023-01-02,Santa Clara,085,1922200,464395,461535,21219,482754,2587
2023-01-02,Santa Cruz,087,273765,67090,66735,3744,70479,276
2023-01-02,Shasta,089,179085,36196,35950,8201,44151,602
2023-01-02,Sierra,091,2930,311,309,61,370,5
2023-01-02,Siskiyou,093,43540,5375,5355,3420,8775,95
2023-01-02,Solano,095,438530,111405,110589,8396,118985,475
2023-01-02,Sonoma,097,501317,111721,111095,5693,116788,536
2023-01-02,Stanislaus,099,539301,143110,142392,22540,164932,1795
2023-01-02,Sutter,101,95872,25348,25207,2538,27745,235
2023-01-02,Tehama,103,63373,14322,14187,3361,17548,219
2023-01-02,Trinity,105,12862,1454,1442,489,1931,23
2023-01-02,Tulare,107,460477,126226,125303,39160,164463,1546
2023-01-02,Tuolumne,109,53932,16526,16340,995,17335,211
2023-01-02,Ventura,111,848112,217835,216327,17644,233971,1605
2023-01-02,Yolo,113,214977,49342,48970,4730,53700,426
2023-01-02,Yuba,115,75493,19761,19654,1823,21477,132
2023-01-01,Alameda,001,1643700,370206,367954,21943,389897,2094
2023-01-01,Alpine,003,1148,139,138,4,142,0
2023-01-01,Amador,005,37829,10367,10313,962,11275,96
2023-01-01,Butte,007,227075,41158,41018,9975,50993,474
2023-01-01,Calaveras,009,45235,8871,8818,632,9450,135
2023-01-01,Colusa,011,21464,3911,3906,1325,5231,22
2023-01-01,Contra Costa,013,1133247,266511,264448,21967,286415,1502
2023-01-01,Del Norte,015,27424,7693,7645,439,8084,56
2023-01-01,El Dorado,017,186661,34069,33865,4493,38358,236
2023-01-01,Fresno,019,978130,289009,285444,33784,319228,2918
2023-01-01,Glenn,021,27897,5736,5719,1976,7695,58
2023-01-01,Humboldt,023,135768,22955,22835,5717,28552,163
2023-01-01,Imperial,025,180216,68947,68622,18429,87051,963
2023-01-01,Inyo,027,18085,4699,4670,1225,5895,62
2023-01-01,Kern,029,883053,226704,225659,69803,295462,2450
2023-01-01,Kings,031,150075,61890,61692,4372,66064,466
2023-01-01,Lake,033,64148,13426,13312,1275,14587,149
2023-01-01,Lassen,035,31185,10197,10172,1044,11216,66
2023-01-01,Los Angeles,037,10098052,3436790,3420383,208596,3628979,34360
2023-01-01,Madera,039,155013,45719,45448,8751,54199,377
2023-01-01,Marin,041,260295,47995,47686,5591,53277,317
2023-01-01,Mariposa,043,17540,3309,3211,379,3590,32
2023-01-01,Mendocino,045,87422,16656,16508,4755,21263,137
2023-01-01,Merced,047,269075,75248,74732,12551,87283,883
2023-01-01,Modoc,049,8938,940,931,364,1295,11
2023-01-01,Mono,051,14174,3288,3274,293,3567,8
2023-01-01,Monterey,053,433212,96782,96380,22461,118841,776
2023-01-01,Napa,055,140530,33696,33534,1506,35040,163
2023-01-01,Nevada,057,99092,19911,19774,2239,22013,132
2023-01-01,Orange,059,3164182,697849,694080,73747,767827,7656
2023-01-01,Placer,061,380077,79557,79154,10104,89258,672
2023-01-01,Plumas,063,18699,3799,3787,458,4245,13
2023-01-01,Riverside,065,2383286,724325,720437,40252,760689,6738
2023-01-01,Sacramento,067,1510023,364418,362664,36732,399396,3414
2023-01-01,San Benito,069,59416,17346,17211,1102,18313,108
2023-01-01,San Bernardino,071,2135413,700357,696472,34222,730694,8142
2023-01-01,San Diego,073,3302833,967402,962601,78858,1041459,5641
2023-01-01,San Francisco,075,870044,191226,190012,13043,203055,1104
2023-01-01,San Joaquin,077,732212,206573,205467,16481,221948,2363
2023-01-01,San Luis Obispo,079,281455,65406,64966,7890,72856,536
2023-01-01,San Mateo,081,765935,178981,177703,11170,188873,749
2023-01-01,Santa Barbara,083,443738,110197,109576,7460,117036,747
2023-01-01,Santa Clara,085,1922200,464106,461535,21183,482718,2587
2023-01-01,Santa Cruz,087,273765,67076,66735,3742,70477,276
2023-01-01,Shasta,089,179085,36186,35950,8197,44147,602
2023-01-01,Sierra,091,2930,311,309,61,370,5
2023-01-01,Siskiyou,093,43540,5373,5355,3420,8775,95
2023-01-01,Solano,095,438530,111337,110589,8387,118976,475
2023-01-01,Sonoma,097,501317,111679,111095,5690,116785,536
2023-01-01,Stanislaus,099,539301,143056,142392,22533,164925,1795
2023-01-01,Sutter,101,95872,25339,25207,2538,27745,235
2023-01-01,Tehama,103,63373,14316,14187,3359,17546,219
2023-01-01,Trinity,105,12862,1454,1442,489,1931,23
2023-01-01,Tulare,107,460477,126174,125303,39120,164423,1546
2023-01-01,Tuolumne,109,53932,16524,16340,994,17334,211
2023-01-01,Ventura,111,848112,217736,216327,17618,233945,1605
2023-01-01,Yolo,113,214977,49328,48970,4728,53698,426
2023-01-01,Yuba,115,75493,19752,19654,1822,21476,132
2022-12-31,Alameda,001,1643700,370074,367954,21927,389881,2094
2022-12-31,Alpine,003,1148,139,138,4,142,0
2022-12-31,Amador,005,37829,10365,10313,962,11275,96
2022-12-31,Butte,007,227075,41149,41018,9971,50989,474
2022-12-31,Calaveras,009,45235,8869,8818,632,9450,135
2022-12-31,Colusa,011,21464,3910,3906,1324,5230,22
2022-12-31,Contra Costa,013,1133247,266409,264448,21964,286412,1502
2022-12-31,Del Norte,015,27424,7691,7645,439,8084,56
2022-12-31,El Dorado,017,186661,34056,33865,4491,38356,236
2022-12-31,Fresno,019,978130,288952,285444,33781,319225,2918
2022-12-31,Glenn,021,27897,5735,5719,1973,7692,58
2022-12-31,Humboldt,023,135768,22951,22835,5714,28549,163
2022-12-31,Imperial,025,180216,68939,68622,18428,87050,963
2022-12-31,Inyo,027,18085,4697,4670,1225,5895,62
2022-12-31,Kern,029,883053,226650,225659,69777,295436,2450
2022-12-31,Kings,031,150075,61883,61692,4372,66064,466
2022-12-31,Lake,033,64148,13422,13312,1275,14587,149
2022-12-31,Lassen,035,31185,10196,10172,1044,11216,66
2022-12-31,Los Angeles,037,10098052,3435955,3420383,208421,3628804,34360
2022-12-31,Madera,039,155013,45709,45448,8750,54198,377
2022-12-31,Marin,041,260295,47980,47686,5591,53277,317
2022-12-31,Mariposa,043,17540,3308,3211,379,3590,32
2022-12-31,Mendocino,045,87422,16654,16508,4754,21262,137
2022-12-31,Merced,047,269075,75239,74732,12548,87280,883
2022-12-31,Modoc,049,8938,940,931,364,1295,11
2022-12-31,Mono,051,14174,3288,3274,293,3567,8
2022-12-31,Monterey,053,433212,96758,96380,22449,118829,776
2022-12-31,Napa,055,140530,33692,33534,1506,35040,163
2022-12-31,Nevada,057,99092,19906,19774,2237,22011,132
2022-12-31,Orange,059,3164182,697662,694080,73668,767748,7656
2022-12-31,Placer,061,380077,79527,79154,10099,89253,672
2022-12-31,Plumas,063,18699,3798,3787,458,4245,13
2022-12-31,Riverside,065,2383286,724153,720437,40204,760641,6738
2022-12-31,Sacramento,067,1510023,364337,362664,36719,399383,3414
2022-12-31,San Benito,069,59416,17343,17211,1102,18313,108
2022-12-31,San Bernardino,071,2135413,700207,696472,34199,730671,8142
2022-12-31,San Diego,073,3302833,967213,962601,78819,1041420,5641
2022-12-31,San Francisco,075,870044,191162,190012,13037,203049,1104
2022-12-31,San Joaquin,077,732212,206524,205467,16476,221943,2363
2022-12-31,San Luis Obispo,079,281455,65395,64966,7889,72855,536
2022-12-31,San Mateo,081,765935,178936,177703,11164,188867,749
2022-12-31,Santa Barbara,083,443738,110165,109576,7453,117029,747
2022-12-31,Santa Clara,085,1922200,463962,461535,21157,482692,2587
2022-12-31,Santa Cruz,087,273765,67069,66735,3739,70474,276
2022-12-31,Shasta,089,179085,36184,35950,8196,44146,602
2022-12-31,Sierra,091,2930,311,309,61,370,5
2022-12-31,Siskiyou,093,43540,5372,5355,3420,8775,95
2022-12-31,Solano,095,438530,111310,110589,8384,118973,475
2022-12-31,Sonoma,097,501317,111639,111095,5687,116782,536
2022-12-31,Stanislaus,099,539301,143021,142392,22530,164922,1795
2022-12-31,Sutter,101,95872,25333,25207,2538,27745,235
2022-12-31,Tehama,103,63373,14313,14187,3358,17545,219
2022-12-31,Trinity,105,12862,1454,1442,489,1931,23
2022-12-31,Tulare,107,460477,126141,125303,39101,164404,1546
2022-12-31,Tuolumne,109,53932,16516,16340,993,17333,211
2022-12-31,Ventura,111,848112,217661,216327,17602,233929,1605
2022-12-31,Yolo,113,214977,49321,48970,4726,53696,426
2022-12-31,Yuba,115,75493,19751,19654,1822,21476,132
2022-12-30,Alameda,001,1643700,369913,367954,21914,389868,2094
2022-12-30,Alpine,003,1148,139,138,4,142,0
2022-12-30,Amador,005,37829,10365,10313,962,11275,96
2022-12-30,Butte,007,227075,41145,41018,9968,50986,474
2022-12-30,Calaveras,009,45235,8865,8818,632,9450,135
2022-12-30,Colusa,011,21464,3910,3906,1323,5229,22
2022-12-30,Contra Costa,013,1133247,266298,264448,21953,286401,1502
2022-12-30,Del Norte,015,27424,7685,7645,439,8084,56
2022-12-30,El Dorado,017,186661,34050,33865,4487,38352,236
2022-12-30,Fresno,019,978130,288857,285444,33768,319212,2918
2022-12-30,Glenn,021,27897,5735,5719,1972,7691,58
2022-12-30,Humboldt,023,135768,22946,22835,5712,28547,163
2022-12-30,Imperial,025,180216,68926,68622,18426,87048,963
2022-12-30,Inyo,027,18085,4694,4670,1223,5893,62
2022-12-30,Kern,029,883053,226582,225659,69708,295367,2450
2022-12-30,Kings,031,150075,61875,61692,4371,66063,466
2022-12-30,Lake,033,64148,13417,13312,1275,14587,149
2022-12-30,Lassen,035,31185,10195,10172,1043,11215,66
2022-12-30,Los Angeles,037,10098052,3434845,3420383,208196,3628579,34360
2022-12-30,Madera,039,155013,45702,45448,8749,54197,377
2022-12-30,Marin,041,260295,47957,47686,5586,53272,317
2022-12-30,Mariposa,043,17540,3306,3211,379,3590,32
2022-12-30,Mendocino,045,87422,16648,16508,4752,21260,137
2022-12-30,Merced,047,269075,75224,74732,12546,87278,883
2022-12-30,Modoc,049,8938,940,931,364,1295,11
2022-12-30,Mono,051,14174,3288,3274,293,3567,8
2022-12-30,Monterey,053,433212,96737,96380,22434,118814,776
2022-12-30,Napa,055,140530,33682,33534,1506,35040,163
2022-12-30,Nevada,057,99092,19900,19774,2236,22010,132
2022-12-30,Orange,059,3164182,697362,694080,73568,767648,7656
2022-12-30,Placer,061,380077,79499,79154,10088,89242,672
2022-12-30,Plumas,063,18699,3798,3787,458,4245,13
2022-12-30,Riverside,065,2383286,723877,720437,40150,760587,6738
2022-12-30,Sacramento,067,1510023,364223,362664,36707,399371,3414
2022-12-30,San Benito,069,59416,17339,17211,1102,18313,108
2022-12-30,San Bernardino,071,2135413,699957,696472,34169,730641,8142
2022-12-30,San Diego,073,3302833,966815,962601,78746,1041347,5641
2022-12-30,San Francisco,075,870044,191097,190012,13029,203041,1104
2022-12-30,San Joaquin,077,732212,206456,205467,16470,221937,2363
2022-12-30,San Luis Obispo,079,281455,65384,64966,7884,72850,536
2022-12-30,San Mateo,081,765935,178893,177703,11156,188859,749
2022-12-30,Santa Barbara,083,443738,110133,109576,7449,117025,747
2022-12-30,Santa Clara,085,1922200,463784,461535,21129,482664,2587
2022-12-30,Santa Cruz,087,273765,67051,66735,3738,70473,276
2022-12-30,Shasta,089,179085,36178,35950,8196,44146,602
2022-12-30,Sierra,091,2930,311,309,61,370,5
2022-12-30,Siskiyou,093,43540,5371,5355,3419,8774,95
2022-12-30,Solano,095,438530,111266,110589,8378,118967,475
2022-12-30,Sonoma,097,501317,111589,111095,5683,116778,536
2022-12-30,Stanislaus,099,539301,142981,142392,22524,164916,1795
2022-12-30,Sutter,101,95872,25323,25207,2538,27745,235
2022-12-30,Tehama,103,63373,14308,14187,3358,17545,219
2022-12-30,Trinity,105,12862,1454,1442,489,1931,23
2022-12-30,Tulare,107,460477,126116,125303,39072,164375,1546
2022-12-30,Tuolumne,109,53932,16506,16340,993,17333,211
2022-12-30,Ventura,111,848112,217601,216327,17580,233907,1605
2022-12-30,Yolo,113,214977,49303,48970,4724,53694,426
2022-12-30,Yuba,115,75493,19736,19654,1822,21476,132
2022-12-29,Alameda,001,1643700,369643,367954,21877,389831,2094
2022-12-29,Alpine,003,1148,139,138,3,141,0
2022-12-29,Amador,005,37829,10360,10313,961,11274,96
2022-12-29,Butte,007,227075,41133,41018,9955,50973,474
2022-12-29,Calaveras,009,45235,8861,8818,631,9449,135
2022-12-29,Colusa,011,21464,3910,3906,1323,5229,22
2022-12-29,Contra Costa,013,1133247,266137,264448,21941,286389,1502
2022-12-29,Del Norte,015,27424,7680,7645,439,8084,56
2022-12-29,El Dorado,017,186661,34034,33865,4483,38348,236
2022-12-29,Fresno,019,978130,288717,285444,33740,319184,2918
2022-12-29,Glenn,021,27897,5732,5719,1971,7690,58
2022-12-29,Humboldt,023,135768,22943,22835,5701,28536,163
2022-12-29,Imperial,025,180216,68905,68622,18409,87031,963
2022-12-29,Inyo,027,18085,4691,4670,1221,5891,62
2022-12-29,Kern,029,883053,226430,225659,69601,295260,2450
2022-12-29,Kings,031,150075,61849,61692,4371,66063,466
2022-12-29,Lake,033,64148,13411,13312,1275,14587,149
2022-12-29,Lassen,035,31185,10192,10172,1042,11214,66
2022-12-29,Los Angeles,037,10098052,3432893,3420383,207828,3628211,34360
2022-12-29,Madera,039,155013,45681,45448,8732,54180,377
2022-12-29,Marin,041,260295,47925,47686,5578,53264,317
2022-12-29,Mariposa,043,17540,3305,3211,379,3590,32
2022-12-29,Mendocino,045,87422,16640,16508,4752,21260,137
2022-12-29,Merced,047,269075,75202,74732,12540,87272,883
2022-12-29,Modoc,049,8938,940,931,364,1295,11
2022-12-29,Mono,051,14174,3287,3274,292,3566,8
2022-12-29,Monterey,053,433212,96702,96380,22418,118798,776
2022-12-29,Napa,055,140530,33661,33534,1505,35039,163
2022-12-29,Nevada,057,99092,19893,19774,2234,22008,132
2022-12-29,Orange,059,3164182,696895,694080,73400,767480,7656
2022-12-29,Placer,061,380077,79455,79154,10083,89237,672
2022-12-29,Plumas,063,18699,3798,3787,458,4245,13
2022-12-29,Riverside,065,2383286,723459,720437,40060,760497,6738
2022-12-29,Sacramento,067,1510023,363955,362664,36683,399347,3414
2022-12-29,San Benito,069,59416,17335,17211,1097,18308,108
2022-12-29,San Bernardino,071,2135413,699557,696472,34117,730589,8142
2022-12-29,San Diego,073,3302833,966104,962601,78613,1041214,5641
2022-12-29,San Francisco,075,870044,190949,190012,13013,203025,1104
2022-12-29,San Joaquin,077,732212,206338,205467,16453,221920,2363
2022-12-29,San Luis Obispo,079,281455,65354,64966,7861,72827,536
2022-12-29,San Mateo,081,765935,178806,177703,11148,188851,749
2022-12-29,Santa Barbara,083,443738,110060,109576,7441,117017,747
2022-12-29,Santa Clara,085,1922200,463363,461535,21103,482638,2587
2022-12-29,Santa Cruz,087,273765,67031,66735,3731,70466,276
2022-12-29,Shasta,089,179085,36160,35950,8189,44139,602
2022-12-29,Sierra,091,2930,311,309,61,370,5
2022-12-29,Siskiyou,093,43540,5370,5355,3415,8770,95
2022-12-29,Solano,095,438530,111168,110589,8366,118955,475
2022-12-29,Sonoma,097,501317,111530,111095,5673,116768,536
2022-12-29,Stanislaus,099,539301,142912,142392,22503,164895,1795
2022-12-29,Sutter,101,95872,25310,25207,2535,27742,235
2022-12-29,Tehama,103,63373,14303,14187,3356,17543,219
2022-12-29,Trinity,105,12862,1454,1442,489,1931,23
2022-12-29,Tulare,107,460477,126039,125303,39042,164345,1546
2022-12-29,Tuolumne,109,53932,16493,16340,993,17333,211
2022-12-29,Ventura,111,848112,217479,216327,17537,233864,1605
2022-12-29,Yolo,113,214977,49279,48970,4719,53689,426
2022-12-29,Yuba,115,75493,19722,19654,1820,21474,132
2022-12-28,Alameda,001,1643700,369313,367954,21851,389805,2094
2022-12-28,Alpine,003,1148,139,138,3,141,0
2022-12-28,Amador,005,37829,10351,10313,961,11274,96
2022-12-28,Butte,007,227075,41122,41018,9948,50966,474
2022-12-28,Calaveras,009,45235,8854,8818,631,9449,135
2022-12-28,Colusa,011,21464,3908,3906,1322,5228,22
2022-12-28,Contra Costa,013,1133247,265916,264448,21913,286361,1502
2022-12-28,Del Norte,015,27424,7677,7645,439,8084,56
2022-12-28,El Dorado,017,186661,34012,33865,4482,38347,236
2022-12-28,Fresno,019,978130,288558,285444,33718,319162,2918
2022-12-28,Glenn,021,27897,5730,5719,1969,7688,58
2022-12-28,Humboldt,023,135768,22941,22835,5688,28523,163
2022-12-28,Imperial,025,180216,68867,68622,18373,86995,963
2022-12-28,Inyo,027,18085,4690,4670,1220,5890,62
2022-12-28,Kern,029,883053,226266,225659,69481,295140,2450
2022-12-28,Kings,031,150075,61803,61692,4368,66060,466
2022-12-28,Lake,033,64148,13404,13312,1274,14586,149
2022-12-28,Lassen,035,31185,10192,10172,1042,11214,66
2022-12-28,Los Angeles,037,10098052,3430724,3420383,207384,3627767,34360
2022-12-28,Madera,039,155013,45642,45448,8730,54178,377
2022-12-28,Marin,041,260295,47897,47686,5574,53260,317
2022-12-28,Mariposa,043,17540,3303,3211,378,3589,32
2022-12-28,Mendocino,045,87422,16632,16508,4744,21252,137
2022-12-28,Merced,047,269075,75173,74732,12532,87264,883
2022-12-28,Modoc,049,8938,938,931,363,1294,11
2022-12-28,Mono,051,14174,3285,3274,292,3566,8
2022-12-28,Monterey,053,433212,96681,96380,22397,118777,776
2022-12-28,Napa,055,140530,33631,33534,1503,35037,163
2022-12-28,Nevada,057,99092,19885,19774,2232,22006,132
2022-12-28,Orange,059,3164182,696364,694080,73207,767287,7656
2022-12-28,Placer,061,380077,79400,79154,10068,89222,672
2022-12-28,Plumas,063,18699,3793,3787,458,4245,13
2022-12-28,Riverside,065,2383286,722951,720437,39972,760409,6738
2022-12-28,Sacramento,067,1510023,363717,362664,36653,399317,3414
2022-12-28,San Benito,069,59416,17319,17211,1091,18302,108
2022-12-28,San Bernardino,071,2135413,699057,696472,34050,730522,8142
2022-12-28,San Diego,073,3302833,965289,962601,78488,1041089,5641
2022-12-28,San Francisco,075,870044,190816,190012,13005,203017,1104
2022-12-28,San Joaquin,077,732212,206189,205467,16432,221899,2363
2022-12-28,San Luis Obispo,079,281455,65314,64966,7847,72813,536
2022-12-28,San Mateo,081,765935,178682,177703,11132,188835,749
2022-12-28,Santa Barbara,083,443738,109993,109576,7423,116999,747
2022-12-28,Santa Clara,085,1922200,462985,461535,21085,482620,2587
2022-12-28,Santa Cruz,087,273765,67000,66735,3727,70462,276
2022-12-28,Shasta,089,179085,36141,35950,8180,44130,602
2022-12-28,Sierra,091,2930,311,309,61,370,5
2022-12-28,Siskiyou,093,43540,5368,5355,3414,8769,95
2022-12-28,Solano,095,438530,111038,110589,8358,118947,475
2022-12-28,Sonoma,097,501317,111463,111095,5663,116758,536
2022-12-28,Stanislaus,099,539301,142836,142392,22497,164889,1795
2022-12-28,Sutter,101,95872,25290,25207,2534,27741,235
2022-12-28,Tehama,103,63373,14293,14187,3354,17541,219
2022-12-28,Trinity,105,12862,1454,1442,489,1931,23
2022-12-28,Tulare,107,460477,125956,125303,38996,164299,1546
2022-12-28,Tuolumne,109,53932,16486,16340,992,17332,211
2022-12-28,Ventura,111,848112,217328,216327,17494,233821,1605
2022-12-28,Yolo,113,214977,49255,48970,4716,53686,426
2022-12-28,Yuba,115,75493,19708,19654,1815,21469,132
2022-12-27,Alameda,001,1643700,368977,367954,21818,389772,2094
2022-12-27,Alpine,003,1148,139,138,3,141,0
2022-12-27,Amador,005,37829,10342,10313,960,11273,96
2022-12-27,Butte,007,227075,41102,41018,9939,50957,474
2022-12-27,Calaveras,009,45235,8847,8818,631,9449,135
2022-12-27,Colusa,011,21464,3907,3906,1322,5228,22
2022-12-27,Contra Costa,013,1133247,265652,264448,21894,286342,1502
2022-12-27,Del Norte,015,27424,7668,7645,436,8081,56
2022-12-27,El Dorado,017,186661,33979,33865,4478,38343,236
2022-12-27,Fresno,019,978130,288329,285444,33677,319121,2918
2022-12-27,Glenn,021,27897,5728,5719,1968,7687,58
2022-12-27,Humboldt,023,135768,22934,22835,5666,28501,163
2022-12-27,Imperial,025,180216,68817,68622,18355,86977,963
2022-12-27,Inyo,027,18085,4688,4670,1209,5879,62
2022-12-27,Kern,029,883053,226082,225659,69355,295014,2450
2022-12-27,Kings,031,150075,61765,61692,4368,66060,466
2022-12-27,Lake,033,64148,13393,13312,1272,14584,149
2022-12-27,Lassen,035,31185,10187,10172,1039,11211,66
2022-12-27,Los Angeles,037,10098052,3428185,3420383,206874,3627257,34360
2022-12-27,Madera,039,155013,45622,45448,8719,54167,377
2022-12-27,Marin,041,260295,47851,47686,5570,53256,317
2022-12-27,Mariposa,043,17540,3300,3211,377,3588,32
2022-12-27,Mendocino,045,87422,16619,16508,4738,21246,137
2022-12-27,Merced,047,269075,75132,74732,12515,87247,883
2022-12-27,Modoc,049,8938,934,931,363,1294,11
2022-12-27,Mono,051,14174,3283,3274,291,3565,8
2022-12-27,Monterey,053,433212,96641,96380,22375,118755,776
2022-12-27,Napa,055,140530,33608,33534,1502,35036,163
2022-12-27,Nevada,057,99092,19877,19774,2228,22002,132
2022-12-27,Orange,059,3164182,695762,694080,73012,767092,7656
2022-12-27,Placer,061,380077,79339,79154,10057,89211,672
2022-12-27,Plumas,063,18699,3791,3787,458,4245,13
2022-12-27,Riverside,065,2383286,722388,720437,39888,760325,6738
2022-12-27,Sacramento,067,1510023,363411,362664,36616,399280,3414
2022-12-27,San Benito,069,59416,17312,17211,1091,18302,108
2022-12-27,San Bernardino,071,2135413,698518,696472,33958,730430,8142
2022-12-27,San Diego,073,3302833,964383,962601,78335,1040936,5641
2022-12-27,San Francisco,075,870044,190682,190012,12995,203007,1104
2022-12-27,San Joaquin,077,732212,206061,205467,16398,221865,2363
2022-12-27,San Luis Obispo,079,281455,65277,64966,7820,72786,536
2022-12-27,San Mateo,081,765935,178534,177703,11112,188815,749
2022-12-27,Santa Barbara,083,443738,109923,109576,7403,116979,747
2022-12-27,Santa Clara,085,1922200,462531,461535,21060,482595,2587
2022-12-27,Santa Cruz,087,273765,66962,66735,3719,70454,276
2022-12-27,Shasta,089,179085,36120,35950,8168,44118,602
2022-12-27,Sierra,091,2930,310,309,61,370,5
2022-12-27,Siskiyou,093,43540,5365,5355,3413,8768,95
2022-12-27,Solano,095,438530,110904,110589,8351,118940,475
2022-12-27,Sonoma,097,501317,111394,111095,5640,116735,536
2022-12-27,Stanislaus,099,539301,142733,142392,22477,164869,1795
2022-12-27,Sutter,101,95872,25272,25207,2530,27737,235
2022-12-27,Tehama,103,63373,14278,14187,3351,17538,219
2022-12-27,Trinity,105,12862,1453,1442,489,1931,23
2022-12-27,Tulare,107,460477,125867,125303,38953,164256,1546
2022-12-27,Tuolumne,109,53932,16475,16340,989,17329,211
2022-12-27,Ventura,111,848112,217171,216327,17446,233773,1605
2022-12-27,Yolo,113,214977,49230,48970,4713,53683,426
2022-12-27,Yuba,115,75493,19697,19654,1814,21468,132
2022-12-26,Alameda,001,1643700,368621,366018,21781,387799,2088
2022-12-26,Alpine,003,1148,139,138,3,141,0
2022-12-26,Amador,005,37829,10337,10269,960,11229,96
2022-12-26,Butte,007,227075,41075,40923,9912,50835,473
2022-12-26,Calaveras,009,45235,8840,8794,630,9424,135
2022-12-26,Colusa,011,21464,3907,3891,1322,5213,22
2022-12-26,Contra Costa,013,1133247,265364,262951,21866,284817,1492
2022-12-26,Del Norte,015,27424,7663,7612,436,8048,56
2022-12-26,El Dorado,017,186661,33948,33729,4472,38201,236
2022-12-26,Fresno,019,978130,288096,284361,33629,317990,2907
2022-12-26,Glenn,021,27897,5727,5702,1967,7669,58
2022-12-26,Humboldt,023,135768,22922,22760,5644,28404,161
2022-12-26,Imperial,025,180216,68756,68403,18295,86698,963
2022-12-26,Inyo,027,18085,4685,4655,1205,5860,60
2022-12-26,Kern,029,883053,225899,224945,69225,294170,2446
2022-12-26,Kings,031,150075,61730,61461,4365,65826,467
2022-12-26,Lake,033,64148,13389,13254,1268,14522,149
2022-12-26,Lassen,035,31185,10184,10151,1037,11188,66
2022-12-26,Los Angeles,037,10098052,3425389,3399852,206271,3606123,34170
2022-12-26,Madera,039,155013,45581,45290,8707,53997,377
2022-12-26,Marin,041,260295,47802,47457,5563,53020,315
2022-12-26,Mariposa,043,17540,3297,3201,373,3574,32
2022-12-26,Mendocino,045,87422,16605,16435,4722,21157,137
2022-12-26,Merced,047,269075,75106,74498,12501,86999,880
2022-12-26,Modoc,049,8938,931,927,363,1290,11
2022-12-26,Mono,051,14174,3279,3264,291,3555,8
2022-12-26,Monterey,053,433212,96602,96192,22358,118550,776
2022-12-26,Napa,055,140530,33584,33370,1501,34871,163
2022-12-26,Nevada,057,99092,19863,19696,2218,21914,132
2022-12-26,Orange,059,3164182,695091,690845,72791,763636,7628
2022-12-26,Placer,061,380077,79285,78813,10050,88863,669
2022-12-26,Plumas,063,18699,3789,3778,458,4236,13
2022-12-26,Riverside,065,2383286,721702,717576,39775,757351,6738
2022-12-26,Sacramento,067,1510023,363072,361095,36578,397673,3407
2022-12-26,San Benito,069,59416,17295,17109,1085,18194,108
2022-12-26,San Bernardino,071,2135413,697883,693567,33861,727428,8136
2022-12-26,San Diego,073,3302833,963324,957866,78152,1036018,5626
2022-12-26,San Francisco,075,870044,190472,188947,12987,201934,1095
2022-12-26,San Joaquin,077,732212,205903,204712,16368,221080,2353
2022-12-26,San Luis Obispo,079,281455,65227,64748,7788,72536,536
2022-12-26,San Mateo,081,765935,178354,176920,11096,188016,748
2022-12-26,Santa Barbara,083,443738,109840,109074,7389,116463,744
2022-12-26,Santa Clara,085,1922200,462005,459089,21033,480122,2579
2022-12-26,Santa Cruz,087,273765,66922,66560,3712,70272,277
2022-12-26,Shasta,089,179085,36095,35856,8158,44014,601
2022-12-26,Sierra,091,2930,310,308,61,369,5
2022-12-26,Siskiyou,093,43540,5360,5334,3411,8745,95
2022-12-26,Solano,095,438530,110771,109900,8343,118243,474
2022-12-26,Sonoma,097,501317,111301,110643,5628,116271,536
2022-12-26,Stanislaus,099,539301,142640,141956,22455,164411,1795
2022-12-26,Sutter,101,95872,25253,25088,2523,27611,235
2022-12-26,Tehama,103,63373,14272,14127,3344,17471,218
2022-12-26,Trinity,105,12862,1452,1438,489,1927,23
2022-12-26,Tulare,107,460477,125761,124848,38893,163741,1546
2022-12-26,Tuolumne,109,53932,16465,16261,987,17248,209
2022-12-26,Ventura,111,848112,216947,215497,17395,232892,1604
2022-12-26,Yolo,113,214977,49206,48842,4708,53550,422
2022-12-26,Yuba,115,75493,19681,19553,1810,21363,132
2022-12-25,Alameda,001,1643700,368335,366018,21757,387775,2088
2022-12-25,Alpine,003,1148,139,138,3,141,0
2022-12-25,Amador,005,37829,10331,10269,960,11229,96
2022-12-25,Butte,007,227075,41060,40923,9897,50820,473
2022-12-25,Calaveras,009,45235,8836,8794,629,9423,135
2022-12-25,Colusa,011,21464,3906,3891,1321,5212,22
2022-12-25,Contra Costa,013,1133247,265130,262951,21859,284810,1492
2022-12-25,Del Norte,015,27424,7658,7612,436,8048,56
2022-12-25,El Dorado,017,186661,33933,33729,4468,38197,236
2022-12-25,Fresno,019,978130,287957,284361,33611,317972,2907
2022-12-25,Glenn,021,27897,5727,5702,1965,7667,58
2022-12-25,Humboldt,023,135768,22912,22760,5635,28395,161
2022-12-25,Imperial,025,180216,68721,68403,18279,86682,963
2022-12-25,Inyo,027,18085,4683,4655,1203,5858,60
2022-12-25,Kern,029,883053,225803,224945,69079,294024,2446
2022-12-25,Kings,031,150075,61690,61461,4364,65825,467
2022-12-25,Lake,033,64148,13386,13254,1268,14522,149
2022-12-25,Lassen,035,31185,10182,10151,1035,11186,66
2022-12-25,Los Angeles,037,10098052,3423102,3399852,205807,3605659,34170
2022-12-25,Madera,039,155013,45564,45290,8706,53996,377
2022-12-25,Marin,041,260295,47770,47457,5561,53018,315
2022-12-25,Mariposa,043,17540,3297,3201,373,3574,32
2022-12-25,Mendocino,045,87422,16591,16435,4720,21155,137
2022-12-25,Merced,047,269075,75066,74498,12493,86991,880
2022-12-25,Modoc,049,8938,930,927,363,1290,11
2022-12-25,Mono,051,14174,3274,3264,291,3555,8
2022-12-25,Monterey,053,433212,96574,96192,22350,118542,776
2022-12-25,Napa,055,140530,33566,33370,1498,34868,163
2022-12-25,Nevada,057,99092,19854,19696,2214,21910,132
2022-12-25,Orange,059,3164182,694552,690845,72561,763406,7628
2022-12-25,Placer,061,380077,79250,78813,10044,88857,669
2022-12-25,Plumas,063,18699,3789,3778,458,4236,13
2022-12-25,Riverside,065,2383286,721208,717576,39676,757252,6738
2022-12-25,Sacramento,067,1510023,362888,361095,36552,397647,3407
2022-12-25,San Benito,069,59416,17285,17109,1085,18194,108
2022-12-25,San Bernardino,071,2135413,697415,693567,33791,727358,8136
2022-12-25,San Diego,073,3302833,962682,957866,78055,1035921,5626
2022-12-25,San Francisco,075,870044,190304,188947,12980,201927,1095
2022-12-25,San Joaquin,077,732212,205792,204712,16358,221070,2353
2022-12-25,San Luis Obispo,079,281455,65201,64748,7777,72525,536
2022-12-25,San Mateo,081,765935,178233,176920,11087,188007,748
2022-12-25,Santa Barbara,083,443738,109779,109074,7387,116461,744
2022-12-25,Santa Clara,085,1922200,461650,459089,20991,480080,2579
2022-12-25,Santa Cruz,087,273765,66860,66560,3711,70271,277
2022-12-25,Shasta,089,179085,36082,35856,8154,44010,601
2022-12-25,Sierra,091,2930,310,308,61,369,5
2022-12-25,Siskiyou,093,43540,5359,5334,3411,8745,95
2022-12-25,Solano,095,438530,110678,109900,8336,118236,474
2022-12-25,Sonoma,097,501317,111239,110643,5624,116267,536
2022-12-25,Stanislaus,099,539301,142572,141956,22446,164402,1795
2022-12-25,Sutter,101,95872,25239,25088,2520,27608,235
2022-12-25,Tehama,103,63373,14265,14127,3343,17470,218
2022-12-25,Trinity,105,12862,1452,1438,489,1927,23
2022-12-25,Tulare,107,460477,125678,124848,38850,163698,1546
2022-12-25,Tuolumne,109,53932,16443,16261,985,17246,209
2022-12-25,Ventura,111,848112,216807,215497,17358,232855,1604
2022-12-25,Yolo,113,214977,49186,48842,4706,53548,422
2022-12-25,Yuba,115,75493,19664,19553,1809,21362,132
2022-12-24,Alameda,001,1643700,368194,366018,21744,387762,2088
2022-12-24,Alpine,003,1148,139,138,3,141,0
2022-12-24,Amador,005,37829,10329,10269,960,11229,96
2022-12-24,Butte,007,227075,41052,40923,9889,50812,473
2022-12-24,Calaveras,009,45235,8835,8794,628,9422,135
2022-12-24,Colusa,011,21464,3906,3891,1321,5212,22
2022-12-24,Contra Costa,013,1133247,265045,262951,21854,284805,1492
2022-12-24,Del Norte,015,27424,7655,7612,436,8048,56
2022-12-24,El Dorado,017,186661,33920,33729,4466,38195,236
2022-12-24,Fresno,019,978130,287878,284361,33608,317969,2907
2022-12-24,Glenn,021,27897,5727,5702,1965,7667,58
2022-12-24,Humboldt,023,135768,22905,22760,5625,28385,161
2022-12-24,Imperial,025,180216,68707,68403,18273,86676,963
2022-12-24,Inyo,027,18085,4682,4655,1203,5858,60
2022-12-24,Kern,029,883053,225759,224945,69067,294012,2446
2022-12-24,Kings,031,150075,61684,61461,4364,65825,467
2022-12-24,Lake,033,64148,13376,13254,1266,14520,149
2022-12-24,Lassen,035,31185,10180,10151,1035,11186,66
2022-12-24,Los Angeles,037,10098052,3422342,3399852,205624,3605476,34170
2022-12-24,Madera,039,155013,45545,45290,8705,53995,377
2022-12-24,Marin,041,260295,47754,47457,5558,53015,315
2022-12-24,Mariposa,043,17540,3295,3201,372,3573,32
2022-12-24,Mendocino,045,87422,16587,16435,4720,21155,137
2022-12-24,Merced,047,269075,75055,74498,12488,86986,880
2022-12-24,Modoc,049,8938,930,927,363,1290,11
2022-12-24,Mono,051,14174,3272,3264,291,3555,8
2022-12-24,Monterey,053,433212,96548,96192,22340,118532,776
2022-12-24,Napa,055,140530,33551,33370,1498,34868,163
2022-12-24,Nevada,057,99092,19847,19696,2212,21908,132
2022-12-24,Orange,059,3164182,694380,690845,72544,763389,7628
2022-12-24,Placer,061,380077,79222,78813,10042,88855,669
2022-12-24,Plumas,063,18699,3788,3778,456,4234,13
2022-12-24,Riverside,065,2383286,721031,717576,39637,757213,6738
2022-12-24,Sacramento,067,1510023,362816,361095,36544,397639,3407
2022-12-24,San Benito,069,59416,17281,17109,1085,18194,108
2022-12-24,San Bernardino,071,2135413,697239,693567,33763,727330,8136
2022-12-24,San Diego,073,3302833,962461,957866,78004,1035870,5626
2022-12-24,San Francisco,075,870044,190240,188947,12977,201924,1095
2022-12-24,San Joaquin,077,732212,205735,204712,16353,221065,2353
2022-12-24,San Luis Obispo,079,281455,65188,64748,7770,72518,536
2022-12-24,San Mateo,081,765935,178168,176920,11085,188005,748
2022-12-24,Santa Barbara,083,443738,109741,109074,7382,116456,744
2022-12-24,Santa Clara,085,1922200,461489,459089,20978,480067,2579
2022-12-24,Santa Cruz,087,273765,66842,66560,3711,70271,277
2022-12-24,Shasta,089,179085,36076,35856,8151,44007,601
2022-12-24,Sierra,091,2930,310,308,61,369,5
2022-12-24,Siskiyou,093,43540,5356,5334,3411,8745,95
2022-12-24,Solano,095,438530,110651,109900,8333,118233,474
2022-12-24,Sonoma,097,501317,111207,110643,5622,116265,536
2022-12-24,Stanislaus,099,539301,142523,141956,22440,164396,1795
2022-12-24,Sutter,101,95872,25230,25088,2520,27608,235
2022-12-24,Tehama,103,63373,14257,14127,3342,17469,218
2022-12-24,Trinity,105,12862,1452,1438,489,1927,23
2022-12-24,Tulare,107,460477,125637,124848,38827,163675,1546
2022-12-24,Tuolumne,109,53932,16435,16261,983,17244,209
2022-12-24,Ventura,111,848112,216737,215497,17343,232840,1604
2022-12-24,Yolo,113,214977,49174,48842,4704,53546,422
2022-12-24,Yuba,115,75493,19656,19553,1809,21362,132
2022-12-23,Alameda,001,1643700,368029,366018,21714,387732,2088
2022-12-23,Alpine,003,1148,139,138,3,141,0
2022-12-23,Amador,005,37829,10324,10269,960,11229,96
2022-12-23,Butte,007,227075,41044,40923,9873,50796,473
2022-12-23,Calaveras,009,45235,8834,8794,627,9421,135
2022-12-23,Colusa,011,21464,3904,3891,1319,5210,22
2022-12-23,Contra Costa,013,1133247,264920,262951,21841,284792,1492
2022-12-23,Del Norte,015,27424,7650,7612,436,8048,56
2022-12-23,El Dorado,017,186661,33900,33729,4466,38195,236
2022-12-23,Fresno,019,978130,287774,284361,33587,317948,2907
2022-12-23,Glenn,021,27897,5724,5702,1964,7666,58
2022-12-23,Humboldt,023,135768,22900,22760,5622,28382,161
2022-12-23,Imperial,025,180216,68680,68403,18268,86671,963
2022-12-23,Inyo,027,18085,4679,4655,1201,5856,60
2022-12-23,Kern,029,883053,225711,224945,69006,293951,2446
2022-12-23,Kings,031,150075,61667,61461,4363,65824,467
2022-12-23,Lake,033,64148,13369,13254,1266,14520,149
2022-12-23,Lassen,035,31185,10178,10151,1035,11186,66
2022-12-23,Los Angeles,037,10098052,3421165,3399852,205307,3605159,34170
2022-12-23,Madera,039,155013,45528,45290,8704,53994,377
2022-12-23,Marin,041,260295,47732,47457,5557,53014,315
2022-12-23,Mariposa,043,17540,3295,3201,372,3573,32
2022-12-23,Mendocino,045,87422,16582,16435,4718,21153,137
2022-12-23,Merced,047,269075,75043,74498,12485,86983,880
2022-12-23,Modoc,049,8938,930,927,363,1290,11
2022-12-23,Mono,051,14174,3272,3264,290,3554,8
2022-12-23,Monterey,053,433212,96522,96192,22325,118517,776
2022-12-23,Napa,055,140530,33532,33370,1497,34867,163
2022-12-23,Nevada,057,99092,19843,19696,2206,21902,132
2022-12-23,Orange,059,3164182,694126,690845,72390,763235,7628
2022-12-23,Placer,061,380077,79198,78813,10036,88849,669
2022-12-23,Plumas,063,18699,3787,3778,456,4234,13
2022-12-23,Riverside,065,2383286,720762,717576,39576,757152,6738
2022-12-23,Sacramento,067,1510023,362706,361095,36535,397630,3407
2022-12-23,San Benito,069,59416,17269,17109,1083,18192,108
2022-12-23,San Bernardino,071,2135413,696982,693567,33720,727287,8136
2022-12-23,San Diego,073,3302833,962051,957866,77942,1035808,5626
2022-12-23,San Francisco,075,870044,190140,188947,12965,201912,1095
2022-12-23,San Joaquin,077,732212,205676,204712,16351,221063,2353
2022-12-23,San Luis Obispo,079,281455,65170,64748,7766,72514,536
2022-12-23,San Mateo,081,765935,178108,176920,11072,187992,748
2022-12-23,Santa Barbara,083,443738,109702,109074,7377,116451,744
2022-12-23,Santa Clara,085,1922200,461314,459089,20955,480044,2579
2022-12-23,Santa Cruz,087,273765,66823,66560,3705,70265,277
2022-12-23,Shasta,089,179085,36069,35856,8149,44005,601
2022-12-23,Sierra,091,2930,310,308,61,369,5
2022-12-23,Siskiyou,093,43540,5355,5334,3411,8745,95
2022-12-23,Solano,095,438530,110594,109900,8327,118227,474
2022-12-23,Sonoma,097,501317,111162,110643,5621,116264,536
2022-12-23,Stanislaus,099,539301,142483,141956,22438,164394,1795
2022-12-23,Sutter,101,95872,25217,25088,2520,27608,235
2022-12-23,Tehama,103,63373,14254,14127,3342,17469,218
2022-12-23,Trinity,105,12862,1451,1438,489,1927,23
2022-12-23,Tulare,107,460477,125603,124848,38799,163647,1546
2022-12-23,Tuolumne,109,53932,16428,16261,981,17242,209
2022-12-23,Ventura,111,848112,216642,215497,17320,232817,1604
2022-12-23,Yolo,113,214977,49163,48842,4703,53545,422
2022-12-23,Yuba,115,75493,19648,19553,1809,21362,132
2022-12-22,Alameda,001,1643700,367700,366018,21682,387700,2088
2022-12-22,Alpine,003,1148,139,138,3,141,0
2022-12-22,Amador,005,37829,10318,10269,959,11228,96
2022-12-22,Butte,007,227075,41034,40923,9860,50783,473
2022-12-22,Calaveras,009,45235,8834,8794,627,9421,135
2022-12-22,Colusa,011,21464,3899,3891,1319,5210,22
2022-12-22,Contra Costa,013,1133247,264672,262951,21832,284783,1492
2022-12-22,Del Norte,015,27424,7643,7612,432,8044,56
2022-12-22,El Dorado,017,186661,33878,33729,4466,38195,236
2022-12-22,Fresno,019,978130,287612,284361,33549,317910,2907
2022-12-22,Glenn,021,27897,5722,5702,1964,7666,58
2022-12-22,Humboldt,023,135768,22889,22760,5615,28375,161
2022-12-22,Imperial,025,180216,68645,68403,18256,86659,963
2022-12-22,Inyo,027,18085,4679,4655,1200,5855,60
2022-12-22,Kern,029,883053,225618,224945,68925,293870,2446
2022-12-22,Kings,031,150075,61653,61461,4363,65824,467
2022-12-22,Lake,033,64148,13363,13254,1265,14519,149
2022-12-22,Lassen,035,31185,10175,10151,1034,11185,66
2022-12-22,Los Angeles,037,10098052,3419151,3399852,204860,3604712,34170
2022-12-22,Madera,039,155013,45495,45290,8695,53985,377
2022-12-22,Marin,041,260295,47702,47457,5555,53012,315
2022-12-22,Mariposa,043,17540,3293,3201,372,3573,32
2022-12-22,Mendocino,045,87422,16572,16435,4717,21152,137
2022-12-22,Merced,047,269075,75009,74498,12477,86975,880
2022-12-22,Modoc,049,8938,928,927,363,1290,11
2022-12-22,Mono,051,14174,3272,3264,290,3554,8
2022-12-22,Monterey,053,433212,96500,96192,22308,118500,776
2022-12-22,Napa,055,140530,33514,33370,1497,34867,163
2022-12-22,Nevada,057,99092,19833,19696,2200,21896,132
2022-12-22,Orange,059,3164182,693663,690845,72205,763050,7628
2022-12-22,Placer,061,380077,79153,78813,10031,88844,669
2022-12-22,Plumas,063,18699,3785,3778,456,4234,13
2022-12-22,Riverside,065,2383286,720351,717576,39496,757072,6738
2022-12-22,Sacramento,067,1510023,362465,361095,36516,397611,3407
2022-12-22,San Benito,069,59416,17252,17109,1076,18185,108
2022-12-22,San Bernardino,071,2135413,696570,693567,33646,727213,8136
2022-12-22,San Diego,073,3302833,961349,957866,77780,1035646,5626
2022-12-22,San Francisco,075,870044,190005,188947,12941,201888,1095
2022-12-22,San Joaquin,077,732212,205567,204712,16340,221052,2353
2022-12-22,San Luis Obispo,079,281455,65129,64748,7739,72487,536
2022-12-22,San Mateo,081,765935,177994,176920,11063,187983,748
2022-12-22,Santa Barbara,083,443738,109624,109074,7359,116433,744
2022-12-22,Santa Clara,085,1922200,460938,459089,20930,480019,2579
2022-12-22,Santa Cruz,087,273765,66797,66560,3697,70257,277
2022-12-22,Shasta,089,179085,36055,35856,8144,44000,601
2022-12-22,Sierra,091,2930,310,308,61,369,5
2022-12-22,Siskiyou,093,43540,5350,5334,3410,8744,95
2022-12-22,Solano,095,438530,110508,109900,8317,118217,474
2022-12-22,Sonoma,097,501317,111093,110643,5615,116258,536
2022-12-22,Stanislaus,099,539301,142418,141956,22426,164382,1795
2022-12-22,Sutter,101,95872,25195,25088,2517,27605,235
2022-12-22,Tehama,103,63373,14249,14127,3342,17469,218
2022-12-22,Trinity,105,12862,1450,1438,488,1926,23
2022-12-22,Tulare,107,460477,125542,124848,38758,163606,1546
2022-12-22,Tuolumne,109,53932,16418,16261,981,17242,209
2022-12-22,Ventura,111,848112,216536,215497,17284,232781,1604
2022-12-22,Yolo,113,214977,49150,48842,4699,53541,422
2022-12-22,Yuba,115,75493,19634,19553,1807,21360,132
2022-12-21,Alameda,001,1643700,367372,366018,21648,387666,2088
2022-12-21,Alpine,003,1148,139,138,3,141,0
2022-12-21,Amador,005,37829,10315,10269,959,11228,96
2022-12-21,Butte,007,227075,41016,40923,9845,50768,473
2022-12-21,Calaveras,009,45235,8827,8794,621,9415,135
2022-12-21,Colusa,011,21464,3896,3891,1319,5210,22
2022-12-21,Contra Costa,013,1133247,264451,262951,21808,284759,1492
2022-12-21,Del Norte,015,27424,7638,7612,421,8033,56
2022-12-21,El Dorado,017,186661,33853,33729,4460,38189,236
2022-12-21,Fresno,019,978130,287418,284361,33525,317886,2907
2022-12-21,Glenn,021,27897,5721,5702,1963,7665,58
2022-12-21,Humboldt,023,135768,22878,22760,5597,28357,161
2022-12-21,Imperial,025,180216,68604,68403,18230,86633,963
2022-12-21,Inyo,027,18085,4678,4655,1199,5854,60
2022-12-21,Kern,029,883053,225491,224945,68832,293777,2446
2022-12-21,Kings,031,150075,61610,61461,4361,65822,467
2022-12-21,Lake,033,64148,13357,13254,1263,14517,149
2022-12-21,Lassen,035,31185,10169,10151,1034,11185,66
2022-12-21,Los Angeles,037,10098052,3416961,3399852,204406,3604258,34170
2022-12-21,Madera,039,155013,45484,45290,8692,53982,377
2022-12-21,Marin,041,260295,47658,47457,5545,53002,315
2022-12-21,Mariposa,043,17540,3285,3201,365,3566,32
2022-12-21,Mendocino,045,87422,16560,16435,4708,21143,137
2022-12-21,Merced,047,269075,74973,74498,12470,86968,880
2022-12-21,Modoc,049,8938,928,927,363,1290,11
2022-12-21,Mono,051,14174,3272,3264,290,3554,8
2022-12-21,Monterey,053,433212,96468,96192,22297,118489,776
2022-12-21,Napa,055,140530,33495,33370,1494,34864,163
2022-12-21,Nevada,057,99092,19824,19696,2198,21894,132
2022-12-21,Orange,059,3164182,693147,690845,71986,762831,7628
2022-12-21,Placer,061,380077,79097,78813,10016,88829,669
2022-12-21,Plumas,063,18699,3782,3778,455,4233,13
2022-12-21,Riverside,065,2383286,719849,717576,39403,756979,6738
2022-12-21,Sacramento,067,1510023,362233,361095,36475,397570,3407
2022-12-21,San Benito,069,59416,17234,17109,1068,18177,108
2022-12-21,San Bernardino,071,2135413,696100,693567,33565,727132,8136
2022-12-21,San Diego,073,3302833,960556,957866,77631,1035497,5626
2022-12-21,San Francisco,075,870044,189862,188947,12928,201875,1095
2022-12-21,San Joaquin,077,732212,205423,204712,16317,221029,2353
2022-12-21,San Luis Obispo,079,281455,65094,64748,7720,72468,536
2022-12-21,San Mateo,081,765935,177849,176920,11050,187970,748
2022-12-21,Santa Barbara,083,443738,109543,109074,7343,116417,744
2022-12-21,Santa Clara,085,1922200,460550,459089,20886,479975,2579
2022-12-21,Santa Cruz,087,273765,66752,66560,3694,70254,277
2022-12-21,Shasta,089,179085,36030,35856,8134,43990,601
2022-12-21,Sierra,091,2930,310,308,61,369,5
2022-12-21,Siskiyou,093,43540,5348,5334,3410,8744,95
2022-12-21,Solano,095,438530,110383,109900,8310,118210,474
2022-12-21,Sonoma,097,501317,111025,110643,5602,116245,536
2022-12-21,Stanislaus,099,539301,142345,141956,22415,164371,1795
2022-12-21,Sutter,101,95872,25178,25088,2515,27603,235
2022-12-21,Tehama,103,63373,14246,14127,3339,17466,218
2022-12-21,Trinity,105,12862,1450,1438,483,1921,23
2022-12-21,Tulare,107,460477,125477,124848,38707,163555,1546
2022-12-21,Tuolumne,109,53932,16396,16261,981,17242,209
2022-12-21,Ventura,111,848112,216401,215497,17247,232744,1604
2022-12-21,Yolo,113,214977,49124,48842,4694,53536,422
2022-12-21,Yuba,115,75493,19612,19553,1806,21359,132
2022-12-20,Alameda,001,1643700,367036,366018,21611,387629,2088
2022-12-20,Alpine,003,1148,139,138,2,140,0
2022-12-20,Amador,005,37829,10309,10269,959,11228,96
2022-12-20,Butte,007,227075,40999,40923,9826,50749,473
2022-12-20,Calaveras,009,45235,8819,8794,621,9415,135
2022-12-20,Colusa,011,21464,3895,3891,1318,5209,22
2022-12-20,Contra Costa,013,1133247,264224,262951,21789,284740,1492
2022-12-20,Del Norte,015,27424,7635,7612,419,8031,56
2022-12-20,El Dorado,017,186661,33829,33729,4455,38184,236
2022-12-20,Fresno,019,978130,287207,284361,33490,317851,2907
2022-12-20,Glenn,021,27897,5719,5702,1961,7663,58
2022-12-20,Humboldt,023,135768,22861,22760,5579,28339,161
2022-12-20,Imperial,025,180216,68574,68403,18203,86606,963
2022-12-20,Inyo,027,18085,4674,4655,1198,5853,60
2022-12-20,Kern,029,883053,225340,224945,68730,293675,2446
2022-12-20,Kings,031,150075,61563,61461,4358,65819,467
2022-12-20,Lake,033,64148,13342,13254,1249,14503,149
2022-12-20,Lassen,035,31185,10163,10151,1033,11184,66
2022-12-20,Los Angeles,037,10098052,3414610,3399852,203915,3603767,34170
2022-12-20,Madera,039,155013,45452,45290,8682,53972,377
2022-12-20,Marin,041,260295,47621,47457,5541,52998,315
2022-12-20,Mariposa,043,17540,3282,3201,364,3565,32
2022-12-20,Mendocino,045,87422,16547,16435,4701,21136,137
2022-12-20,Merced,047,269075,74934,74498,12457,86955,880
2022-12-20,Modoc,049,8938,927,927,363,1290,11
2022-12-20,Mono,051,14174,3270,3264,286,3550,8
2022-12-20,Monterey,053,433212,96441,96192,22286,118478,776
2022-12-20,Napa,055,140530,33470,33370,1493,34863,163
2022-12-20,Nevada,057,99092,19806,19696,2184,21880,132
2022-12-20,Orange,059,3164182,692572,690845,71792,762637,7628
2022-12-20,Placer,061,380077,79043,78813,10007,88820,669
2022-12-20,Plumas,063,18699,3781,3778,454,4232,13
2022-12-20,Riverside,065,2383286,719355,717576,39313,756889,6738
2022-12-20,Sacramento,067,1510023,361988,361095,36445,397540,3407
2022-12-20,San Benito,069,59416,17211,17109,1065,18174,108
2022-12-20,San Bernardino,071,2135413,695594,693567,33513,727080,8136
2022-12-20,San Diego,073,3302833,959791,957866,77485,1035351,5626
2022-12-20,San Francisco,075,870044,189649,188947,12919,201866,1095
2022-12-20,San Joaquin,077,732212,205284,204712,16297,221009,2353
2022-12-20,San Luis Obispo,079,281455,65053,64748,7704,72452,536
2022-12-20,San Mateo,081,765935,177716,176920,11032,187952,748
2022-12-20,Santa Barbara,083,443738,109448,109074,7329,116403,744
2022-12-20,Santa Clara,085,1922200,460152,459089,20845,479934,2579
2022-12-20,Santa Cruz,087,273765,66730,66560,3689,70249,277
2022-12-20,Shasta,089,179085,36012,35856,8131,43987,601
2022-12-20,Sierra,091,2930,310,308,61,369,5
2022-12-20,Siskiyou,093,43540,5344,5334,3408,8742,95
2022-12-20,Solano,095,438530,110266,109900,8304,118204,474
2022-12-20,Sonoma,097,501317,110939,110643,5586,116229,536
2022-12-20,Stanislaus,099,539301,142275,141956,22403,164359,1795
2022-12-20,Sutter,101,95872,25153,25088,2514,27602,235
2022-12-20,Tehama,103,63373,14237,14127,3334,17461,218
2022-12-20,Trinity,105,12862,1450,1438,479,1917,23
2022-12-20,Tulare,107,460477,125406,124848,38675,163523,1546
2022-12-20,Tuolumne,109,53932,16381,16261,975,17236,209
2022-12-20,Ventura,111,848112,216245,215497,17188,232685,1604
2022-12-20,Yolo,113,214977,49099,48842,4684,53526,422
2022-12-20,Yuba,115,75493,19594,19553,1805,21358,132
2022-12-19,Alameda,001,1643700,366696,363758,21558,385316,2082
2022-12-19,Alpine,003,1148,139,139,2,141,0
2022-12-19,Amador,005,37829,10294,10236,959,11195,96
2022-12-19,Butte,007,227075,40979,40800,9810,50610,471
2022-12-19,Calaveras,009,45235,8816,8758,620,9378,135
2022-12-19,Colusa,011,21464,3893,3882,1318,5200,22
2022-12-19,Contra Costa,013,1133247,263961,261280,21767,283047,1491
2022-12-19,Del Norte,015,27424,7631,7586,418,8004,56
2022-12-19,El Dorado,017,186661,33800,33598,4449,38047,235
2022-12-19,Fresno,019,978130,287027,283068,33452,316520,2905
2022-12-19,Glenn,021,27897,5715,5690,1960,7650,58
2022-12-19,Humboldt,023,135768,22849,22679,5570,28249,161
2022-12-19,Imperial,025,180216,68521,68094,18173,86267,963
2022-12-19,Inyo,027,18085,4672,4649,1195,5844,60
2022-12-19,Kern,029,883053,225207,223971,68627,292598,2444
2022-12-19,Kings,031,150075,61530,61254,4356,65610,466
2022-12-19,Lake,033,64148,13331,13201,1246,14447,149
2022-12-19,Lassen,035,31185,10157,10142,1033,11175,66
2022-12-19,Los Angeles,037,10098052,3412024,3390335,203383,3593718,34114
2022-12-19,Madera,039,155013,45416,45131,8666,53797,377
2022-12-19,Marin,041,260295,47590,47184,5538,52722,315
2022-12-19,Mariposa,043,17540,3275,3202,360,3562,32
2022-12-19,Mendocino,045,87422,16531,16396,4699,21095,136
2022-12-19,Merced,047,269075,74904,74307,12452,86759,880
2022-12-19,Modoc,049,8938,927,918,362,1280,11
2022-12-19,Mono,051,14174,3269,3251,283,3534,8
2022-12-19,Monterey,053,433212,96420,95970,22255,118225,776
2022-12-19,Napa,055,140530,33442,33212,1488,34700,162
2022-12-19,Nevada,057,99092,19799,19663,2177,21840,132
2022-12-19,Orange,059,3164182,691956,687587,71594,759181,7596
2022-12-19,Placer,061,380077,78995,78475,10005,88480,666
2022-12-19,Plumas,063,18699,3779,3769,453,4222,13
2022-12-19,Riverside,065,2383286,718840,714426,39221,753647,6694
2022-12-19,Sacramento,067,1510023,361702,359420,36393,395813,3395
2022-12-19,San Benito,069,59416,17190,17018,1059,18077,108
2022-12-19,San Bernardino,071,2135413,695045,690423,33441,723864,8136
2022-12-19,San Diego,073,3302833,958862,953029,77349,1030378,5608
2022-12-19,San Francisco,075,870044,189467,187665,12907,200572,1087
2022-12-19,San Joaquin,077,732212,205153,203845,16276,220121,2353
2022-12-19,San Luis Obispo,079,281455,65016,64540,7687,72227,533
2022-12-19,San Mateo,081,765935,177539,175963,11021,186984,748
2022-12-19,Santa Barbara,083,443738,109354,108635,7317,115952,743
2022-12-19,Santa Clara,085,1922200,459734,456121,20806,476927,2566
2022-12-19,Santa Cruz,087,273765,66700,66157,3686,69843,275
2022-12-19,Shasta,089,179085,35996,35797,8119,43916,599
2022-12-19,Sierra,091,2930,310,309,61,370,5
2022-12-19,Siskiyou,093,43540,5343,5325,3408,8733,94
2022-12-19,Solano,095,438530,110124,109297,8300,117597,472
2022-12-19,Sonoma,097,501317,110852,110159,5575,115734,533
2022-12-19,Stanislaus,099,539301,142191,141472,22387,163859,1796
2022-12-19,Sutter,101,95872,25126,25020,2512,27532,235
2022-12-19,Tehama,103,63373,14225,14104,3331,17435,218
2022-12-19,Trinity,105,12862,1449,1434,477,1911,23
2022-12-19,Tulare,107,460477,125321,124442,38635,163077,1546
2022-12-19,Tuolumne,109,53932,16373,16161,973,17134,209
2022-12-19,Ventura,111,848112,216063,214659,17144,231803,1597
2022-12-19,Yolo,113,214977,49069,48765,4679,53444,416
2022-12-19,Yuba,115,75493,19582,19482,1802,21284,132
2022-12-18,Alameda,001,1643700,366293,363758,21504,385262,2082
2022-12-18,Alpine,003,1148,139,139,2,141,0
2022-12-18,Amador,005,37829,10287,10236,959,11195,96
2022-12-18,Butte,007,227075,40961,40800,9789,50589,471
2022-12-18,Calaveras,009,45235,8811,8758,615,9373,135
2022-12-18,Colusa,011,21464,3892,3882,1318,5200,22
2022-12-18,Contra Costa,013,1133247,263643,261280,21742,283022,1491
2022-12-18,Del Norte,015,27424,7623,7586,417,8003,56
2022-12-18,El Dorado,017,186661,33774,33598,4443,38041,235
2022-12-18,Fresno,019,978130,286819,283068,33411,316479,2905
2022-12-18,Glenn,021,27897,5713,5690,1958,7648,58
2022-12-18,Humboldt,023,135768,22837,22679,5544,28223,161
2022-12-18,Imperial,025,180216,68469,68094,18126,86220,963
2022-12-18,Inyo,027,18085,4669,4649,1193,5842,60
2022-12-18,Kern,029,883053,225043,223971,68526,292497,2444
2022-12-18,Kings,031,150075,61481,61254,4353,65607,466
2022-12-18,Lake,033,64148,13315,13201,1246,14447,149
2022-12-18,Lassen,035,31185,10155,10142,1033,11175,66
2022-12-18,Los Angeles,037,10098052,3409257,3390335,202874,3593209,34114
2022-12-18,Madera,039,155013,45386,45131,8647,53778,377
2022-12-18,Marin,041,260295,47544,47184,5525,52709,315
2022-12-18,Mariposa,043,17540,3273,3202,359,3561,32
2022-12-18,Mendocino,045,87422,16515,16396,4688,21084,136
2022-12-18,Merced,047,269075,74865,74307,12434,86741,880
2022-12-18,Modoc,049,8938,927,918,360,1278,11
2022-12-18,Mono,051,14174,3264,3251,283,3534,8
2022-12-18,Monterey,053,433212,96373,95970,22236,118206,776
2022-12-18,Napa,055,140530,33390,33212,1485,34697,162
2022-12-18,Nevada,057,99092,19782,19663,2169,21832,132
2022-12-18,Orange,059,3164182,691362,687587,71401,758988,7596
2022-12-18,Placer,061,380077,78928,78475,9994,88469,666
2022-12-18,Plumas,063,18699,3777,3769,453,4222,13
2022-12-18,Riverside,065,2383286,718268,714426,39090,753516,6694
2022-12-18,Sacramento,067,1510023,361384,359420,36330,395750,3395
2022-12-18,San Benito,069,59416,17176,17018,1059,18077,108
2022-12-18,San Bernardino,071,2135413,694455,690423,33360,723783,8136
2022-12-18,San Diego,073,3302833,957998,953029,77222,1030251,5608
2022-12-18,San Francisco,075,870044,189207,187665,12891,200556,1087
2022-12-18,San Joaquin,077,732212,204989,203845,16257,220102,2353
2022-12-18,San Luis Obispo,079,281455,64968,64540,7653,72193,533
2022-12-18,San Mateo,081,765935,177359,175963,10997,186960,748
2022-12-18,Santa Barbara,083,443738,109256,108635,7303,115938,743
2022-12-18,Santa Clara,085,1922200,459214,456121,20766,476887,2566
2022-12-18,Santa Cruz,087,273765,66665,66157,3685,69842,275
2022-12-18,Shasta,089,179085,35985,35797,8110,43907,599
2022-12-18,Sierra,091,2930,310,309,61,370,5
2022-12-18,Siskiyou,093,43540,5338,5325,3405,8730,94
2022-12-18,Solano,095,438530,109983,109297,8292,117589,472
2022-12-18,Sonoma,097,501317,110773,110159,5567,115726,533
2022-12-18,Stanislaus,099,539301,142100,141472,22363,163835,1796
2022-12-18,Sutter,101,95872,25114,25020,2510,27530,235
2022-12-18,Tehama,103,63373,14214,14104,3328,17432,218
2022-12-18,Trinity,105,12862,1449,1434,476,1910,23
2022-12-18,Tulare,107,460477,125207,124442,38576,163018,1546
2022-12-18,Tuolumne,109,53932,16360,16161,972,17133,209
2022-12-18,Ventura,111,848112,215882,214659,17096,231755,1597
2022-12-18,Yolo,113,214977,49042,48765,4672,53437,416
2022-12-18,Yuba,115,75493,19559,19482,1797,21279,132
2022-12-17,Alameda,001,1643700,366081,363758,21483,385241,2082
2022-12-17,Alpine,003,1148,139,139,2,141,0
2022-12-17,Amador,005,37829,10281,10236,957,11193,96
2022-12-17,Butte,007,227075,40945,40800,9778,50578,471
2022-12-17,Calaveras,009,45235,8807,8758,611,9369,135
2022-12-17,Colusa,011,21464,3892,3882,1318,5200,22
2022-12-17,Contra Costa,013,1133247,263471,261280,21728,283008,1491
2022-12-17,Del Norte,015,27424,7620,7586,417,8003,56
2022-12-17,El Dorado,017,186661,33759,33598,4443,38041,235
2022-12-17,Fresno,019,978130,286718,283068,33391,316459,2905
2022-12-17,Glenn,021,27897,5711,5690,1958,7648,58
2022-12-17,Humboldt,023,135768,22819,22679,5536,28215,161
2022-12-17,Imperial,025,180216,68454,68094,18123,86217,963
2022-12-17,Inyo,027,18085,4669,4649,1192,5841,60
2022-12-17,Kern,029,883053,224989,223971,68462,292433,2444
2022-12-17,Kings,031,150075,61468,61254,4352,65606,466
2022-12-17,Lake,033,64148,13310,13201,1244,14445,149
2022-12-17,Lassen,035,31185,10155,10142,1033,11175,66
2022-12-17,Los Angeles,037,10098052,3407978,3390335,202622,3592957,34114
2022-12-17,Madera,039,155013,45366,45131,8642,53773,377
2022-12-17,Marin,041,260295,47526,47184,5520,52704,315
2022-12-17,Mariposa,043,17540,3273,3202,359,3561,32
2022-12-17,Mendocino,045,87422,16512,16396,4684,21080,136
2022-12-17,Merced,047,269075,74849,74307,12426,86733,880
2022-12-17,Modoc,049,8938,927,918,360,1278,11
2022-12-17,Mono,051,14174,3263,3251,283,3534,8
2022-12-17,Monterey,053,433212,96347,95970,22224,118194,776
2022-12-17,Napa,055,140530,33380,33212,1484,34696,162
2022-12-17,Nevada,057,99092,19771,19663,2169,21832,132
2022-12-17,Orange,059,3164182,691073,687587,71268,758855,7596
2022-12-17,Placer,061,380077,78885,78475,9993,88468,666
2022-12-17,Plumas,063,18699,3777,3769,453,4222,13
2022-12-17,Riverside,065,2383286,717917,714426,39016,753442,6694
2022-12-17,Sacramento,067,1510023,361262,359420,36316,395736,3395
2022-12-17,San Benito,069,59416,17167,17018,1056,18074,108
2022-12-17,San Bernardino,071,2135413,694162,690423,33327,723750,8136
2022-12-17,San Diego,073,3302833,957606,953029,77163,1030192,5608
2022-12-17,San Francisco,075,870044,189101,187665,12883,200548,1087
2022-12-17,San Joaquin,077,732212,204922,203845,16244,220089,2353
2022-12-17,San Luis Obispo,079,281455,64950,64540,7644,72184,533
2022-12-17,San Mateo,081,765935,177272,175963,10980,186943,748
2022-12-17,Santa Barbara,083,443738,109212,108635,7287,115922,743
2022-12-17,Santa Clara,085,1922200,458978,456121,20737,476858,2566
2022-12-17,Santa Cruz,087,273765,66649,66157,3683,69840,275
2022-12-17,Shasta,089,179085,35975,35797,8110,43907,599
2022-12-17,Sierra,091,2930,310,309,61,370,5
2022-12-17,Siskiyou,093,43540,5338,5325,3405,8730,94
2022-12-17,Solano,095,438530,109946,109297,8291,117588,472
2022-12-17,Sonoma,097,501317,110718,110159,5554,115713,533
2022-12-17,Stanislaus,099,539301,142050,141472,22353,163825,1796
2022-12-17,Sutter,101,95872,25107,25020,2507,27527,235
2022-12-17,Tehama,103,63373,14210,14104,3325,17429,218
2022-12-17,Trinity,105,12862,1449,1434,475,1909,23
2022-12-17,Tulare,107,460477,125154,124442,38547,162989,1546
2022-12-17,Tuolumne,109,53932,16353,16161,970,17131,209
2022-12-17,Ventura,111,848112,215786,214659,17066,231725,1597
2022-12-17,Yolo,113,214977,49019,48765,4665,53430,416
2022-12-17,Yuba,115,75493,19552,19482,1797,21279,132
2022-12-16,Alameda,001,1643700,365852,363758,21456,385214,2082
2022-12-16,Alpine,003,1148,139,139,2,141,0
2022-12-16,Amador,005,37829,10275,10236,956,11192,96
2022-12-16,Butte,007,227075,40938,40800,9769,50569,471
2022-12-16,Calaveras,009,45235,8803,8758,610,9368,135
2022-12-16,Colusa,011,21464,3891,3882,1318,5200,22
2022-12-16,Contra Costa,013,1133247,263287,261280,21713,282993,1491
2022-12-16,Del Norte,015,27424,7617,7586,417,8003,56
2022-12-16,El Dorado,017,186661,33738,33598,4443,38041,235
2022-12-16,Fresno,019,978130,286585,283068,33369,316437,2905
2022-12-16,Glenn,021,27897,5710,5690,1956,7646,58
2022-12-16,Humboldt,023,135768,22808,22679,5531,28210,161
2022-12-16,Imperial,025,180216,68446,68094,18112,86206,963
2022-12-16,Inyo,027,18085,4667,4649,1188,5837,60
2022-12-16,Kern,029,883053,224897,223971,68399,292370,2444
2022-12-16,Kings,031,150075,61445,61254,4351,65605,466
2022-12-16,Lake,033,64148,13300,13201,1242,14443,149
2022-12-16,Lassen,035,31185,10152,10142,1033,11175,66
2022-12-16,Los Angeles,037,10098052,3406520,3390335,202309,3592644,34114
2022-12-16,Madera,039,155013,45345,45131,8637,53768,377
2022-12-16,Marin,041,260295,47486,47184,5519,52703,315
2022-12-16,Mariposa,043,17540,3269,3202,356,3558,32
2022-12-16,Mendocino,045,87422,16497,16396,4684,21080,136
2022-12-16,Merced,047,269075,74829,74307,12419,86726,880
2022-12-16,Modoc,049,8938,927,918,360,1278,11
2022-12-16,Mono,051,14174,3260,3251,283,3534,8
2022-12-16,Monterey,053,433212,96324,95970,22211,118181,776
2022-12-16,Napa,055,140530,33356,33212,1483,34695,162
2022-12-16,Nevada,057,99092,19768,19663,2166,21829,132
2022-12-16,Orange,059,3164182,690763,687587,71132,758719,7596
2022-12-16,Placer,061,380077,78851,78475,9988,88463,666
2022-12-16,Plumas,063,18699,3776,3769,453,4222,13
2022-12-16,Riverside,065,2383286,717592,714426,38957,753383,6694
2022-12-16,Sacramento,067,1510023,361101,359420,36298,395718,3395
2022-12-16,San Benito,069,59416,17155,17018,1054,18072,108
2022-12-16,San Bernardino,071,2135413,693860,690423,33285,723708,8136
2022-12-16,San Diego,073,3302833,957165,953029,77098,1030127,5608
2022-12-16,San Francisco,075,870044,188984,187665,12863,200528,1087
2022-12-16,San Joaquin,077,732212,204840,203845,16231,220076,2353
2022-12-16,San Luis Obispo,079,281455,64938,64540,7640,72180,533
2022-12-16,San Mateo,081,765935,177189,175963,10969,186932,748
2022-12-16,Santa Barbara,083,443738,109165,108635,7284,115919,743
2022-12-16,Santa Clara,085,1922200,458708,456121,20708,476829,2566
2022-12-16,Santa Cruz,087,273765,66623,66157,3676,69833,275
2022-12-16,Shasta,089,179085,35969,35797,8106,43903,599
2022-12-16,Sierra,091,2930,310,309,61,370,5
2022-12-16,Siskiyou,093,43540,5336,5325,3405,8730,94
2022-12-16,Solano,095,438530,109880,109297,8286,117583,472
2022-12-16,Sonoma,097,501317,110658,110159,5547,115706,533
2022-12-16,Stanislaus,099,539301,142009,141472,22352,163824,1796
2022-12-16,Sutter,101,95872,25093,25020,2506,27526,235
2022-12-16,Tehama,103,63373,14201,14104,3324,17428,218
2022-12-16,Trinity,105,12862,1449,1434,475,1909,23
2022-12-16,Tulare,107,460477,125102,124442,38516,162958,1546
2022-12-16,Tuolumne,109,53932,16340,16161,969,17130,209
2022-12-16,Ventura,111,848112,215701,214659,17043,231702,1597
2022-12-16,Yolo,113,214977,48999,48765,4662,53427,416
2022-12-16,Yuba,115,75493,19545,19482,1797,21279,132
2022-12-15,Alameda,001,1643700,365529,363758,21404,385162,2082
2022-12-15,Alpine,003,1148,139,139,2,141,0
2022-12-15,Amador,005,37829,10266,10236,956,11192,96
2022-12-15,Butte,007,227075,40918,40800,9750,50550,471
2022-12-15,Calaveras,009,45235,8800,8758,608,9366,135
2022-12-15,Colusa,011,21464,3889,3882,1318,5200,22
2022-12-15,Contra Costa,013,1133247,263044,261280,21697,282977,1491
2022-12-15,Del Norte,015,27424,7611,7586,417,8003,56
2022-12-15,El Dorado,017,186661,33716,33598,4438,38036,235
2022-12-15,Fresno,019,978130,286431,283068,33323,316391,2905
2022-12-15,Glenn,021,27897,5707,5690,1954,7644,58
2022-12-15,Humboldt,023,135768,22799,22679,5524,28203,161
2022-12-15,Imperial,025,180216,68412,68094,18082,86176,963
2022-12-15,Inyo,027,18085,4666,4649,1186,5835,60
2022-12-15,Kern,029,883053,224749,223971,68291,292262,2444
2022-12-15,Kings,031,150075,61425,61254,4346,65600,466
2022-12-15,Lake,033,64148,13293,13201,1242,14443,149
2022-12-15,Lassen,035,31185,10150,10142,1031,11173,66
2022-12-15,Los Angeles,037,10098052,3404526,3390335,201928,3592263,34114
2022-12-15,Madera,039,155013,45323,45131,8622,53753,377
2022-12-15,Marin,041,260295,47441,47184,5519,52703,315
2022-12-15,Mariposa,043,17540,3266,3202,355,3557,32
2022-12-15,Mendocino,045,87422,16488,16396,4682,21078,136
2022-12-15,Merced,047,269075,74795,74307,12417,86724,880
2022-12-15,Modoc,049,8938,927,918,360,1278,11
2022-12-15,Mono,051,14174,3259,3251,281,3532,8
2022-12-15,Monterey,053,433212,96293,95970,22190,118160,776
2022-12-15,Napa,055,140530,33328,33212,1481,34693,162
2022-12-15,Nevada,057,99092,19762,19663,2155,21818,132
2022-12-15,Orange,059,3164182,690329,687587,70983,758570,7596
2022-12-15,Placer,061,380077,78800,78475,9975,88450,666
2022-12-15,Plumas,063,18699,3775,3769,453,4222,13
2022-12-15,Riverside,065,2383286,717171,714426,38878,753304,6694
2022-12-15,Sacramento,067,1510023,360827,359420,36264,395684,3395
2022-12-15,San Benito,069,59416,17145,17018,1053,18071,108
2022-12-15,San Bernardino,071,2135413,693451,690423,33232,723655,8136
2022-12-15,San Diego,073,3302833,956506,953029,76965,1029994,5608
2022-12-15,San Francisco,075,870044,188798,187665,12847,200512,1087
2022-12-15,San Joaquin,077,732212,204714,203845,16204,220049,2353
2022-12-15,San Luis Obispo,079,281455,64893,64540,7621,72161,533
2022-12-15,San Mateo,081,765935,177061,175963,10950,186913,748
2022-12-15,Santa Barbara,083,443738,109105,108635,7276,115911,743
2022-12-15,Santa Clara,085,1922200,458301,456121,20686,476807,2566
2022-12-15,Santa Cruz,087,273765,66596,66157,3672,69829,275
2022-12-15,Shasta,089,179085,35951,35797,8096,43893,599
2022-12-15,Sierra,091,2930,310,309,61,370,5
2022-12-15,Siskiyou,093,43540,5334,5325,3403,8728,94
2022-12-15,Solano,095,438530,109794,109297,8281,117578,472
2022-12-15,Sonoma,097,501317,110608,110159,5537,115696,533
2022-12-15,Stanislaus,099,539301,141943,141472,22346,163818,1796
2022-12-15,Sutter,101,95872,25084,25020,2506,27526,235
2022-12-15,Tehama,103,63373,14192,14104,3321,17425,218
2022-12-15,Trinity,105,12862,1449,1434,474,1908,23
2022-12-15,Tulare,107,460477,125052,124442,38469,162911,1546
2022-12-15,Tuolumne,109,53932,16329,16161,966,17127,209
2022-12-15,Ventura,111,848112,215559,214659,17019,231678,1597
2022-12-15,Yolo,113,214977,48971,48765,4657,53422,416
2022-12-15,Yuba,115,75493,19534,19482,1796,21278,132
2022-12-14,Alameda,001,1643700,365206,363758,21364,385122,2082
2022-12-14,Alpine,003,1148,139,139,2,141,0
2022-12-14,Amador,005,37829,10264,10236,955,11191,96
2022-12-14,Butte,007,227075,40904,40800,9730,50530,471
2022-12-14,Calaveras,009,45235,8794,8758,608,9366,135
2022-12-14,Colusa,011,21464,3885,3882,1318,5200,22
2022-12-14,Contra Costa,013,1133247,262839,261280,21671,282951,1491
2022-12-14,Del Norte,015,27424,7608,7586,415,8001,56
2022-12-14,El Dorado,017,186661,33697,33598,4436,38034,235
2022-12-14,Fresno,019,978130,286246,283068,33289,316357,2905
2022-12-14,Glenn,021,27897,5704,5690,1954,7644,58
2022-12-14,Humboldt,023,135768,22783,22679,5516,28195,161
2022-12-14,Imperial,025,180216,68362,68094,18041,86135,963
2022-12-14,Inyo,027,18085,4664,4649,1181,5830,60
2022-12-14,Kern,029,883053,224580,223971,68205,292176,2444
2022-12-14,Kings,031,150075,61389,61254,4343,65597,466
2022-12-14,Lake,033,64148,13282,13201,1239,14440,149
2022-12-14,Lassen,035,31185,10149,10142,1031,11173,66
2022-12-14,Los Angeles,037,10098052,3402183,3390335,201462,3591797,34114
2022-12-14,Madera,039,155013,45295,45131,8616,53747,377
2022-12-14,Marin,041,260295,47403,47184,5515,52699,315
2022-12-14,Mariposa,043,17540,3262,3202,355,3557,32
2022-12-14,Mendocino,045,87422,16482,16396,4681,21077,136
2022-12-14,Merced,047,269075,74759,74307,12401,86708,880
2022-12-14,Modoc,049,8938,927,918,360,1278,11
2022-12-14,Mono,051,14174,3259,3251,280,3531,8
2022-12-14,Monterey,053,433212,96267,95970,22167,118137,776
2022-12-14,Napa,055,140530,33310,33212,1480,34692,162
2022-12-14,Nevada,057,99092,19752,19663,2152,21815,132
2022-12-14,Orange,059,3164182,689848,687587,70833,758420,7596
2022-12-14,Placer,061,380077,78738,78475,9968,88443,666
2022-12-14,Plumas,063,18699,3775,3769,452,4221,13
2022-12-14,Riverside,065,2383286,716757,714426,38796,753222,6694
2022-12-14,Sacramento,067,1510023,360577,359420,36225,395645,3395
2022-12-14,San Benito,069,59416,17133,17018,1052,18070,108
2022-12-14,San Bernardino,071,2135413,692981,690423,33171,723594,8136
2022-12-14,San Diego,073,3302833,955774,953029,76819,1029848,5608
2022-12-14,San Francisco,075,870044,188645,187665,12843,200508,1087
2022-12-14,San Joaquin,077,732212,204567,203845,16190,220035,2353
2022-12-14,San Luis Obispo,079,281455,64858,64540,7597,72137,533
2022-12-14,San Mateo,081,765935,176914,175963,10936,186899,748
2022-12-14,Santa Barbara,083,443738,109025,108635,7267,115902,743
2022-12-14,Santa Clara,085,1922200,457914,456121,20662,476783,2566
2022-12-14,Santa Cruz,087,273765,66564,66157,3670,69827,275
2022-12-14,Shasta,089,179085,35922,35797,8087,43884,599
2022-12-14,Sierra,091,2930,310,309,61,370,5
2022-12-14,Siskiyou,093,43540,5333,5325,3402,8727,94
2022-12-14,Solano,095,438530,109707,109297,8270,117567,472
2022-12-14,Sonoma,097,501317,110548,110159,5526,115685,533
2022-12-14,Stanislaus,099,539301,141863,141472,22325,163797,1796
2022-12-14,Sutter,101,95872,25076,25020,2506,27526,235
2022-12-14,Tehama,103,63373,14180,14104,3318,17422,218
2022-12-14,Trinity,105,12862,1449,1434,469,1903,23
2022-12-14,Tulare,107,460477,124989,124442,38422,162864,1546
2022-12-14,Tuolumne,109,53932,16311,16161,964,17125,209
2022-12-14,Ventura,111,848112,215407,214659,16999,231658,1597
2022-12-14,Yolo,113,214977,48946,48765,4646,53411,416
2022-12-14,Yuba,115,75493,19521,19482,1795,21277,132
2022-12-13,Alameda,001,1643700,364826,363758,21320,385078,2082
2022-12-13,Alpine,003,1148,139,139,2,141,0
2022-12-13,Amador,005,37829,10260,10236,955,11191,96
2022-12-13,Butte,007,227075,40874,40800,9717,50517,471
2022-12-13,Calaveras,009,45235,8791,8758,608,9366,135
2022-12-13,Colusa,011,21464,3882,3882,1318,5200,22
2022-12-13,Contra Costa,013,1133247,262579,261280,21649,282929,1491
2022-12-13,Del Norte,015,27424,7603,7586,415,8001,56
2022-12-13,El Dorado,017,186661,33665,33598,4432,38030,235
2022-12-13,Fresno,019,978130,286074,283068,33259,316327,2905
2022-12-13,Glenn,021,27897,5702,5690,1953,7643,58
2022-12-13,Humboldt,023,135768,22760,22679,5510,28189,161
2022-12-13,Imperial,025,180216,68318,68094,17992,86086,963
2022-12-13,Inyo,027,18085,4662,4649,1177,5826,60
2022-12-13,Kern,029,883053,224454,223971,68094,292065,2444
2022-12-13,Kings,031,150075,61348,61254,4336,65590,466
2022-12-13,Lake,033,64148,13269,13201,1238,14439,149
2022-12-13,Lassen,035,31185,10149,10142,1031,11173,66
2022-12-13,Los Angeles,037,10098052,3399632,3390335,201021,3591356,34114
2022-12-13,Madera,039,155013,45265,45131,8602,53733,377
2022-12-13,Marin,041,260295,47363,47184,5512,52696,315
2022-12-13,Mariposa,043,17540,3257,3202,355,3557,32
2022-12-13,Mendocino,045,87422,16477,16396,4672,21068,136
2022-12-13,Merced,047,269075,74715,74307,12395,86702,880
2022-12-13,Modoc,049,8938,925,918,358,1276,11
2022-12-13,Mono,051,14174,3258,3251,280,3531,8
2022-12-13,Monterey,053,433212,96222,95970,22148,118118,776
2022-12-13,Napa,055,140530,33292,33212,1480,34692,162
2022-12-13,Nevada,057,99092,19744,19663,2138,21801,132
2022-12-13,Orange,059,3164182,689313,687587,70707,758294,7596
2022-12-13,Placer,061,380077,78665,78475,9959,88434,666
2022-12-13,Plumas,063,18699,3772,3769,452,4221,13
2022-12-13,Riverside,065,2383286,716246,714426,38725,753151,6694
2022-12-13,Sacramento,067,1510023,360271,359420,36178,395598,3395
2022-12-13,San Benito,069,59416,17116,17018,1050,18068,108
2022-12-13,San Bernardino,071,2135413,692468,690423,33126,723549,8136
2022-12-13,San Diego,073,3302833,955031,953029,76690,1029719,5608
2022-12-13,San Francisco,075,870044,188452,187665,12835,200500,1087
2022-12-13,San Joaquin,077,732212,204416,203845,16157,220002,2353
2022-12-13,San Luis Obispo,079,281455,64808,64540,7582,72122,533
2022-12-13,San Mateo,081,765935,176783,175963,10925,186888,748
2022-12-13,Santa Barbara,083,443738,108946,108635,7259,115894,743
2022-12-13,Santa Clara,085,1922200,457476,456121,20632,476753,2566
2022-12-13,Santa Cruz,087,273765,66528,66157,3667,69824,275
2022-12-13,Shasta,089,179085,35906,35797,8075,43872,599
2022-12-13,Sierra,091,2930,310,309,61,370,5
2022-12-13,Siskiyou,093,43540,5333,5325,3399,8724,94
2022-12-13,Solano,095,438530,109607,109297,8264,117561,472
2022-12-13,Sonoma,097,501317,110485,110159,5519,115678,533
2022-12-13,Stanislaus,099,539301,141796,141472,22306,163778,1796
2022-12-13,Sutter,101,95872,25061,25020,2505,27525,235
2022-12-13,Tehama,103,63373,14167,14104,3314,17418,218
2022-12-13,Trinity,105,12862,1449,1434,466,1900,23
2022-12-13,Tulare,107,460477,124929,124442,38372,162814,1546
2022-12-13,Tuolumne,109,53932,16299,16161,963,17124,209
2022-12-13,Ventura,111,848112,215272,214659,16965,231624,1597
2022-12-13,Yolo,113,214977,48923,48765,4639,53404,416
2022-12-13,Yuba,115,75493,19513,19482,1793,21275,132
2022-12-12,Alameda,001,1643700,364430,360943,21274,382217,2081
2022-12-12,Alpine,003,1148,139,139,2,141,0
2022-12-12,Amador,005,37829,10252,10196,953,11149,96
2022-12-12,Butte,007,227075,40850,40598,9706,50304,470
2022-12-12,Calaveras,009,45235,8787,8727,606,9333,135
2022-12-12,Colusa,011,21464,3881,3869,1318,5187,22
2022-12-12,Contra Costa,013,1133247,262310,259434,21625,281059,1487
2022-12-12,Del Norte,015,27424,7600,7563,414,7977,56
2022-12-12,El Dorado,017,186661,33639,33447,4428,37875,235
2022-12-12,Fresno,019,978130,285860,281598,33210,314808,2899
2022-12-12,Glenn,021,27897,5694,5668,1953,7621,58
2022-12-12,Humboldt,023,135768,22748,22566,5503,28069,161
2022-12-12,Imperial,025,180216,68262,67632,17949,85581,962
2022-12-12,Inyo,027,18085,4660,4627,1170,5797,60
2022-12-12,Kern,029,883053,224288,222985,67990,290975,2437
2022-12-12,Kings,031,150075,61301,60965,4333,65298,464
2022-12-12,Lake,033,64148,13261,13140,1237,14377,149
2022-12-12,Lassen,035,31185,10149,10128,1030,11158,66
2022-12-12,Los Angeles,037,10098052,3396880,3370904,200593,3571497,34009
2022-12-12,Madera,039,155013,45233,44902,8595,53497,379
2022-12-12,Marin,041,260295,47322,46842,5506,52348,315
2022-12-12,Mariposa,043,17540,3250,3190,354,3544,32
2022-12-12,Mendocino,045,87422,16465,16350,4670,21020,136
2022-12-12,Merced,047,269075,74665,73999,12381,86380,877
2022-12-12,Modoc,049,8938,919,908,354,1262,11
2022-12-12,Mono,051,14174,3258,3238,280,3518,8
2022-12-12,Monterey,053,433212,96189,95709,22123,117832,776
2022-12-12,Napa,055,140530,33261,33043,1479,34522,164
2022-12-12,Nevada,057,99092,19728,19565,2133,21698,132
2022-12-12,Orange,059,3164182,688744,684112,70558,754670,7576
2022-12-12,Placer,061,380077,78634,78117,9947,88064,665
2022-12-12,Plumas,063,18699,3772,3762,452,4214,13
2022-12-12,Riverside,065,2383286,715745,710833,38634,749467,6697
2022-12-12,Sacramento,067,1510023,359983,357413,36126,393539,3382
2022-12-12,San Benito,069,59416,17086,16829,1046,17875,108
2022-12-12,San Bernardino,071,2135413,691898,686731,33066,719797,8135
2022-12-12,San Diego,073,3302833,954171,948180,76552,1024732,5584
2022-12-12,San Francisco,075,870044,188254,186203,12826,199029,1081
2022-12-12,San Joaquin,077,732212,204307,202515,16130,218645,2354
2022-12-12,San Luis Obispo,079,281455,64774,64350,7566,71916,533
2022-12-12,San Mateo,081,765935,176625,174791,10915,185706,749
2022-12-12,Santa Barbara,083,443738,108888,108151,7250,115401,739
2022-12-12,Santa Clara,085,1922200,456949,448654,20596,469250,2565
2022-12-12,Santa Cruz,087,273765,66441,65656,3665,69321,275
2022-12-12,Shasta,089,179085,35888,35666,8064,43730,598
2022-12-12,Sierra,091,2930,310,308,61,369,5
2022-12-12,Siskiyou,093,43540,5328,5442,3396,8838,95
2022-12-12,Solano,095,438530,109491,108649,8254,116903,473
2022-12-12,Sonoma,097,501317,110376,109622,5510,115132,531
2022-12-12,Stanislaus,099,539301,141719,140827,22295,163122,1785
2022-12-12,Sutter,101,95872,25045,24906,2505,27411,234
2022-12-12,Tehama,103,63373,14158,14004,3308,17312,218
2022-12-12,Trinity,105,12862,1447,1431,465,1896,23
2022-12-12,Tulare,107,460477,124855,123976,38323,162299,1546
2022-12-12,Tuolumne,109,53932,16285,16054,963,17017,208
2022-12-12,Ventura,111,848112,215130,213720,16942,230662,1598
2022-12-12,Yolo,113,214977,48901,48547,4623,53170,416
2022-12-12,Yuba,115,75493,19501,19399,1788,21187,132
2022-12-11,Alameda,001,1643700,364009,360943,21232,382175,2081
2022-12-11,Alpine,003,1148,139,139,2,141,0
2022-12-11,Amador,005,37829,10250,10196,952,11148,96
2022-12-11,Butte,007,227075,40822,40598,9700,50298,470
2022-12-11,Calaveras,009,45235,8777,8727,603,9330,135
2022-12-11,Colusa,011,21464,3880,3869,1318,5187,22
2022-12-11,Contra Costa,013,1133247,261966,259434,21592,281026,1487
2022-12-11,Del Norte,015,27424,7594,7563,413,7976,56
2022-12-11,El Dorado,017,186661,33617,33447,4425,37872,235
2022-12-11,Fresno,019,978130,285610,281598,33156,314754,2899
2022-12-11,Glenn,021,27897,5692,5668,1948,7616,58
2022-12-11,Humboldt,023,135768,22736,22566,5488,28054,161
2022-12-11,Imperial,025,180216,68191,67632,17853,85485,962
2022-12-11,Inyo,027,18085,4659,4627,1164,5791,60
2022-12-11,Kern,029,883053,224075,222985,67882,290867,2437
2022-12-11,Kings,031,150075,61269,60965,4327,65292,464
2022-12-11,Lake,033,64148,13254,13140,1237,14377,149
2022-12-11,Lassen,035,31185,10146,10128,1028,11156,66
2022-12-11,Los Angeles,037,10098052,3393693,3370904,200035,3570939,34009
2022-12-11,Madera,039,155013,45191,44902,8584,53486,379
2022-12-11,Marin,041,260295,47262,46842,5502,52344,315
2022-12-11,Mariposa,043,17540,3249,3190,353,3543,32
2022-12-11,Mendocino,045,87422,16454,16350,4661,21011,136
2022-12-11,Merced,047,269075,74606,73999,12354,86353,877
2022-12-11,Modoc,049,8938,919,908,354,1262,11
2022-12-11,Mono,051,14174,3257,3238,279,3517,8
2022-12-11,Monterey,053,433212,96129,95709,22105,117814,776
2022-12-11,Napa,055,140530,33221,33043,1473,34516,164
2022-12-11,Nevada,057,99092,19712,19565,2125,21690,132
2022-12-11,Orange,059,3164182,688097,684112,70378,754490,7576
2022-12-11,Placer,061,380077,78579,78117,9935,88052,665
2022-12-11,Plumas,063,18699,3770,3762,452,4214,13
2022-12-11,Riverside,065,2383286,715192,710833,38507,749340,6697
2022-12-11,Sacramento,067,1510023,359643,357413,36059,393472,3382
2022-12-11,San Benito,069,59416,17076,16829,1046,17875,108
2022-12-11,San Bernardino,071,2135413,691262,686731,33005,719736,8135
2022-12-11,San Diego,073,3302833,953307,948180,76362,1024542,5584
2022-12-11,San Francisco,075,870044,187980,186203,12804,199007,1081
2022-12-11,San Joaquin,077,732212,204115,202515,16097,218612,2354
2022-12-11,San Luis Obispo,079,281455,64717,64350,7545,71895,533
2022-12-11,San Mateo,081,765935,176429,174791,10901,185692,749
2022-12-11,Santa Barbara,083,443738,108777,108151,7224,115375,739
2022-12-11,Santa Clara,085,1922200,456328,448654,20545,469199,2565
2022-12-11,Santa Cruz,087,273765,66323,65656,3661,69317,275
2022-12-11,Shasta,089,179085,35871,35666,8043,43709,598
2022-12-11,Sierra,091,2930,310,308,61,369,5
2022-12-11,Siskiyou,093,43540,5324,5442,3393,8835,95
2022-12-11,Solano,095,438530,109363,108649,8248,116897,473
2022-12-11,Sonoma,097,501317,110247,109622,5500,115122,531
2022-12-11,Stanislaus,099,539301,141610,140827,22272,163099,1785
2022-12-11,Sutter,101,95872,25028,24906,2504,27410,234
2022-12-11,Tehama,103,63373,14144,14004,3300,17304,218
2022-12-11,Trinity,105,12862,1446,1431,464,1895,23
2022-12-11,Tulare,107,460477,124754,123976,38276,162252,1546
2022-12-11,Tuolumne,109,53932,16270,16054,960,17014,208
2022-12-11,Ventura,111,848112,214966,213720,16901,230621,1598
2022-12-11,Yolo,113,214977,48876,48547,4613,53160,416
2022-12-11,Yuba,115,75493,19483,19399,1784,21183,132
2022-12-10,Alameda,001,1643700,363768,360943,21203,382146,2081
2022-12-10,Alpine,003,1148,139,139,2,141,0
2022-12-10,Amador,005,37829,10246,10196,952,11148,96
2022-12-10,Butte,007,227075,40808,40598,9692,50290,470
2022-12-10,Calaveras,009,45235,8772,8727,601,9328,135
2022-12-10,Colusa,011,21464,3879,3869,1318,5187,22
2022-12-10,Contra Costa,013,1133247,261799,259434,21584,281018,1487
2022-12-10,Del Norte,015,27424,7589,7563,413,7976,56
2022-12-10,El Dorado,017,186661,33602,33447,4425,37872,235
2022-12-10,Fresno,019,978130,285498,281598,33145,314743,2899
2022-12-10,Glenn,021,27897,5691,5668,1947,7615,58
2022-12-10,Humboldt,023,135768,22720,22566,5480,28046,161
2022-12-10,Imperial,025,180216,68171,67632,17849,85481,962
2022-12-10,Inyo,027,18085,4655,4627,1160,5787,60
2022-12-10,Kern,029,883053,223983,222985,67812,290797,2437
2022-12-10,Kings,031,150075,61258,60965,4327,65292,464
2022-12-10,Lake,033,64148,13249,13140,1237,14377,149
2022-12-10,Lassen,035,31185,10145,10128,1028,11156,66
2022-12-10,Los Angeles,037,10098052,3392256,3370904,199779,3570683,34009
2022-12-10,Madera,039,155013,45178,44902,8581,53483,379
2022-12-10,Marin,041,260295,47231,46842,5498,52340,315
2022-12-10,Mariposa,043,17540,3249,3190,353,3543,32
2022-12-10,Mendocino,045,87422,16449,16350,4660,21010,136
2022-12-10,Merced,047,269075,74583,73999,12347,86346,877
2022-12-10,Modoc,049,8938,919,908,354,1262,11
2022-12-10,Mono,051,14174,3256,3238,279,3517,8
2022-12-10,Monterey,053,433212,96097,95709,22091,117800,776
2022-12-10,Napa,055,140530,33208,33043,1473,34516,164
2022-12-10,Nevada,057,99092,19706,19565,2123,21688,132
2022-12-10,Orange,059,3164182,687819,684112,70264,754376,7576
2022-12-10,Placer,061,380077,78537,78117,9929,88046,665
2022-12-10,Plumas,063,18699,3768,3762,452,4214,13
2022-12-10,Riverside,065,2383286,714875,710833,38450,749283,6697
2022-12-10,Sacramento,067,1510023,359498,357413,36044,393457,3382
2022-12-10,San Benito,069,59416,17058,16829,1044,17873,108
2022-12-10,San Bernardino,071,2135413,690956,686731,32963,719694,8135
2022-12-10,San Diego,073,3302833,952954,948180,76297,1024477,5584
2022-12-10,San Francisco,075,870044,187834,186203,12801,199004,1081
2022-12-10,San Joaquin,077,732212,204029,202515,16077,218592,2354
2022-12-10,San Luis Obispo,079,281455,64697,64350,7539,71889,533
2022-12-10,San Mateo,081,765935,176321,174791,10893,185684,749
2022-12-10,Santa Barbara,083,443738,108727,108151,7214,115365,739
2022-12-10,Santa Clara,085,1922200,456035,448654,20525,469179,2565
2022-12-10,Santa Cruz,087,273765,66289,65656,3657,69313,275
2022-12-10,Shasta,089,179085,35861,35666,8040,43706,598
2022-12-10,Sierra,091,2930,310,308,61,369,5
2022-12-10,Siskiyou,093,43540,5323,5442,3393,8835,95
2022-12-10,Solano,095,438530,109338,108649,8243,116892,473
2022-12-10,Sonoma,097,501317,110205,109622,5500,115122,531
2022-12-10,Stanislaus,099,539301,141553,140827,22258,163085,1785
2022-12-10,Sutter,101,95872,25018,24906,2504,27410,234
2022-12-10,Tehama,103,63373,14139,14004,3299,17303,218
2022-12-10,Trinity,105,12862,1445,1431,464,1895,23
2022-12-10,Tulare,107,460477,124709,123976,38252,162228,1546
2022-12-10,Tuolumne,109,53932,16231,16054,959,17013,208
2022-12-10,Ventura,111,848112,214884,213720,16881,230601,1598
2022-12-10,Yolo,113,214977,48853,48547,4605,53152,416
2022-12-10,Yuba,115,75493,19476,19399,1779,21178,132
2022-12-09,Alameda,001,1643700,363490,360943,21174,382117,2081
2022-12-09,Alpine,003,1148,139,139,2,141,0
2022-12-09,Amador,005,37829,10242,10196,951,11147,96
2022-12-09,Butte,007,227075,40793,40598,9682,50280,470
2022-12-09,Calaveras,009,45235,8767,8727,599,9326,135
2022-12-09,Colusa,011,21464,3875,3869,1318,5187,22
2022-12-09,Contra Costa,013,1133247,261648,259434,21572,281006,1487
2022-12-09,Del Norte,015,27424,7586,7563,413,7976,56
2022-12-09,El Dorado,017,186661,33588,33447,4423,37870,235
2022-12-09,Fresno,019,978130,285354,281598,33101,314699,2899
2022-12-09,Glenn,021,27897,5690,5668,1946,7614,58
2022-12-09,Humboldt,023,135768,22711,22566,5476,28042,161
2022-12-09,Imperial,025,180216,68137,67632,17844,85476,962
2022-12-09,Inyo,027,18085,4654,4627,1158,5785,60
2022-12-09,Kern,029,883053,223886,222985,67756,290741,2437
2022-12-09,Kings,031,150075,61234,60965,4327,65292,464
2022-12-09,Lake,033,64148,13244,13140,1237,14377,149
2022-12-09,Lassen,035,31185,10144,10128,1028,11156,66
2022-12-09,Los Angeles,037,10098052,3390552,3370904,199458,3570362,34009
2022-12-09,Madera,039,155013,45156,44902,8573,53475,379
2022-12-09,Marin,041,260295,47209,46842,5492,52334,315
2022-12-09,Mariposa,043,17540,3248,3190,353,3543,32
2022-12-09,Mendocino,045,87422,16442,16350,4660,21010,136
2022-12-09,Merced,047,269075,74548,73999,12342,86341,877
2022-12-09,Modoc,049,8938,919,908,354,1262,11
2022-12-09,Mono,051,14174,3255,3238,279,3517,8
2022-12-09,Monterey,053,433212,96071,95709,22085,117794,776
2022-12-09,Napa,055,140530,33195,33043,1472,34515,164
2022-12-09,Nevada,057,99092,19699,19565,2120,21685,132
2022-12-09,Orange,059,3164182,687474,684112,70146,754258,7576
2022-12-09,Placer,061,380077,78512,78117,9924,88041,665
2022-12-09,Plumas,063,18699,3767,3762,452,4214,13
2022-12-09,Riverside,065,2383286,714566,710833,38387,749220,6697
2022-12-09,Sacramento,067,1510023,359295,357413,36028,393441,3382
2022-12-09,San Benito,069,59416,17049,16829,1043,17872,108
2022-12-09,San Bernardino,071,2135413,690634,686731,32924,719655,8135
2022-12-09,San Diego,073,3302833,952534,948180,76222,1024402,5584
2022-12-09,San Francisco,075,870044,187720,186203,12787,198990,1081
2022-12-09,San Joaquin,077,732212,203941,202515,16066,218581,2354
2022-12-09,San Luis Obispo,079,281455,64682,64350,7536,71886,533
2022-12-09,San Mateo,081,765935,176207,174791,10884,185675,749
2022-12-09,Santa Barbara,083,443738,108683,108151,7212,115363,739
2022-12-09,Santa Clara,085,1922200,455712,448654,20490,469144,2565
2022-12-09,Santa Cruz,087,273765,66217,65656,3657,69313,275
2022-12-09,Shasta,089,179085,35852,35666,8034,43700,598
2022-12-09,Sierra,091,2930,310,308,61,369,5
2022-12-09,Siskiyou,093,43540,5322,5442,3392,8834,95
2022-12-09,Solano,095,438530,109275,108649,8237,116886,473
2022-12-09,Sonoma,097,501317,110151,109622,5497,115119,531
2022-12-09,Stanislaus,099,539301,141479,140827,22245,163072,1785
2022-12-09,Sutter,101,95872,25008,24906,2504,27410,234
2022-12-09,Tehama,103,63373,14132,14004,3298,17302,218
2022-12-09,Trinity,105,12862,1445,1431,464,1895,23
2022-12-09,Tulare,107,460477,124665,123976,38217,162193,1546
2022-12-09,Tuolumne,109,53932,16215,16054,958,17012,208
2022-12-09,Ventura,111,848112,214797,213720,16862,230582,1598
2022-12-09,Yolo,113,214977,48839,48547,4597,53144,416
2022-12-09,Yuba,115,75493,19469,19399,1778,21177,132
2022-12-08,Alameda,001,1643700,363082,360943,21127,382070,2081
2022-12-08,Alpine,003,1148,139,139,2,141,0
2022-12-08,Amador,005,37829,10236,10196,951,11147,96
2022-12-08,Butte,007,227075,40766,40598,9663,50261,470
2022-12-08,Calaveras,009,45235,8763,8727,598,9325,135
2022-12-08,Colusa,011,21464,3871,3869,1318,5187,22
2022-12-08,Contra Costa,013,1133247,261421,259434,21555,280989,1487
2022-12-08,Del Norte,015,27424,7585,7563,413,7976,56
2022-12-08,El Dorado,017,186661,33563,33447,4422,37869,235
2022-12-08,Fresno,019,978130,285149,281598,33057,314655,2899
2022-12-08,Glenn,021,27897,5684,5668,1943,7611,58
2022-12-08,Humboldt,023,135768,22698,22566,5468,28034,161
2022-12-08,Imperial,025,180216,68063,67632,17807,85439,962
2022-12-08,Inyo,027,18085,4648,4627,1157,5784,60
2022-12-08,Kern,029,883053,223770,222985,67684,290669,2437
2022-12-08,Kings,031,150075,61195,60965,4326,65291,464
2022-12-08,Lake,033,64148,13230,13140,1237,14377,149
2022-12-08,Lassen,035,31185,10142,10128,1028,11156,66
2022-12-08,Los Angeles,037,10098052,3388061,3370904,199035,3569939,34009
2022-12-08,Madera,039,155013,45135,44902,8570,53472,379
2022-12-08,Marin,041,260295,47156,46842,5483,52325,315
2022-12-08,Mariposa,043,17540,3241,3190,353,3543,32
2022-12-08,Mendocino,045,87422,16436,16350,4659,21009,136
2022-12-08,Merced,047,269075,74523,73999,12330,86329,877
2022-12-08,Modoc,049,8938,919,908,354,1262,11
2022-12-08,Mono,051,14174,3254,3238,279,3517,8
2022-12-08,Monterey,053,433212,96043,95709,22060,117769,776
2022-12-08,Napa,055,140530,33162,33043,1471,34514,164
2022-12-08,Nevada,057,99092,19680,19565,2118,21683,132
2022-12-08,Orange,059,3164182,687019,684112,69997,754109,7576
2022-12-08,Placer,061,380077,78460,78117,9918,88035,665
2022-12-08,Plumas,063,18699,3767,3762,452,4214,13
2022-12-08,Riverside,065,2383286,714096,710833,38308,749141,6697
2022-12-08,Sacramento,067,1510023,358992,357413,35967,393380,3382
2022-12-08,San Benito,069,59416,17040,16829,1043,17872,108
2022-12-08,San Bernardino,071,2135413,690097,686731,32872,719603,8135
2022-12-08,San Diego,073,3302833,951911,948180,76086,1024266,5584
2022-12-08,San Francisco,075,870044,187513,186203,12764,198967,1081
2022-12-08,San Joaquin,077,732212,203810,202515,16044,218559,2354
2022-12-08,San Luis Obispo,079,281455,64650,64350,7521,71871,533
2022-12-08,San Mateo,081,765935,176047,174791,10877,185668,749
2022-12-08,Santa Barbara,083,443738,108611,108151,7209,115360,739
2022-12-08,Santa Clara,085,1922200,455224,448654,20451,469105,2565
2022-12-08,Santa Cruz,087,273765,66189,65656,3654,69310,275
2022-12-08,Shasta,089,179085,35839,35666,8030,43696,598
2022-12-08,Sierra,091,2930,310,308,61,369,5
2022-12-08,Siskiyou,093,43540,5319,5442,3391,8833,95
2022-12-08,Solano,095,438530,109169,108649,8233,116882,473
2022-12-08,Sonoma,097,501317,110070,109622,5493,115115,531
2022-12-08,Stanislaus,099,539301,141397,140827,22219,163046,1785
2022-12-08,Sutter,101,95872,24985,24906,2501,27407,234
2022-12-08,Tehama,103,63373,14120,14004,3295,17299,218
2022-12-08,Trinity,105,12862,1444,1431,462,1893,23
2022-12-08,Tulare,107,460477,124623,123976,38165,162141,1546
2022-12-08,Tuolumne,109,53932,16193,16054,957,17011,208
2022-12-08,Ventura,111,848112,214674,213720,16825,230545,1598
2022-12-08,Yolo,113,214977,48797,48547,4592,53139,416
2022-12-08,Yuba,115,75493,19458,19399,1775,21174,132
2022-12-07,Alameda,001,1643700,362709,360943,21080,382023,2081
2022-12-07,Alpine,003,1148,139,139,2,141,0
2022-12-07,Amador,005,37829,10233,10196,951,11147,96
2022-12-07,Butte,007,227075,40734,40598,9648,50246,470
2022-12-07,Calaveras,009,45235,8758,8727,597,9324,135
2022-12-07,Colusa,011,21464,3871,3869,1318,5187,22
2022-12-07,Contra Costa,013,1133247,261192,259434,21525,280959,1487
2022-12-07,Del Norte,015,27424,7583,7563,413,7976,56
2022-12-07,El Dorado,017,186661,33538,33447,4418,37865,235
2022-12-07,Fresno,019,978130,284887,281598,33011,314609,2899
2022-12-07,Glenn,021,27897,5683,5668,1943,7611,58
2022-12-07,Humboldt,023,135768,22685,22566,5453,28019,161
2022-12-07,Imperial,025,180216,67993,67632,17738,85370,962
2022-12-07,Inyo,027,18085,4644,4627,1132,5759,60
2022-12-07,Kern,029,883053,223648,222985,67583,290568,2437
2022-12-07,Kings,031,150075,61152,60965,4322,65287,464
2022-12-07,Lake,033,64148,13222,13140,1237,14377,149
2022-12-07,Lassen,035,31185,10141,10128,1028,11156,66
2022-12-07,Los Angeles,037,10098052,3385410,3370904,198544,3569448,34009
2022-12-07,Madera,039,155013,45089,44902,8566,53468,379
2022-12-07,Marin,041,260295,47112,46842,5477,52319,315
2022-12-07,Mariposa,043,17540,3238,3190,353,3543,32
2022-12-07,Mendocino,045,87422,16432,16350,4654,21004,136
2022-12-07,Merced,047,269075,74480,73999,12297,86296,877
2022-12-07,Modoc,049,8938,918,908,354,1262,11
2022-12-07,Mono,051,14174,3252,3238,279,3517,8
2022-12-07,Monterey,053,433212,96004,95709,22036,117745,776
2022-12-07,Napa,055,140530,33144,33043,1467,34510,164
2022-12-07,Nevada,057,99092,19663,19565,2109,21674,132
2022-12-07,Orange,059,3164182,686504,684112,69841,753953,7576
2022-12-07,Placer,061,380077,78415,78117,9914,88031,665
2022-12-07,Plumas,063,18699,3766,3762,452,4214,13
2022-12-07,Riverside,065,2383286,713547,710833,38232,749065,6697
2022-12-07,Sacramento,067,1510023,358747,357413,35913,393326,3382
2022-12-07,San Benito,069,59416,17018,16829,1039,17868,108
2022-12-07,San Bernardino,071,2135413,689570,686731,32795,719526,8135
2022-12-07,San Diego,073,3302833,951126,948180,75944,1024124,5584
2022-12-07,San Francisco,075,870044,187311,186203,12751,198954,1081
2022-12-07,San Joaquin,077,732212,203649,202515,16014,218529,2354
2022-12-07,San Luis Obispo,079,281455,64624,64350,7501,71851,533
2022-12-07,San Mateo,081,765935,175887,174791,10867,185658,749
2022-12-07,Santa Barbara,083,443738,108529,108151,7201,115352,739
2022-12-07,Santa Clara,085,1922200,454785,448654,20413,469067,2565
2022-12-07,Santa Cruz,087,273765,66096,65656,3644,69300,275
2022-12-07,Shasta,089,179085,35819,35666,8019,43685,598
2022-12-07,Sierra,091,2930,310,308,61,369,5
2022-12-07,Siskiyou,093,43540,5317,5442,3391,8833,95
2022-12-07,Solano,095,438530,109074,108649,8227,116876,473
2022-12-07,Sonoma,097,501317,109996,109622,5490,115112,531
2022-12-07,Stanislaus,099,539301,141335,140827,22198,163025,1785
2022-12-07,Sutter,101,95872,24970,24906,2501,27407,234
2022-12-07,Tehama,103,63373,14111,14004,3292,17296,218
2022-12-07,Trinity,105,12862,1444,1431,461,1892,23
2022-12-07,Tulare,107,460477,124570,123976,38130,162106,1546
2022-12-07,Tuolumne,109,53932,16182,16054,957,17011,208
2022-12-07,Ventura,111,848112,214552,213720,16799,230519,1598
2022-12-07,Yolo,113,214977,48766,48547,4590,53137,416
2022-12-07,Yuba,115,75493,19452,19399,1773,21172,132
2022-12-06,Alameda,001,1643700,362269,360943,21048,381991,2081
2022-12-06,Alpine,003,1148,139,139,2,141,0
2022-12-06,Amador,005,37829,10225,10196,950,11146,96
2022-12-06,Butte,007,227075,40705,40598,9637,50235,470
2022-12-06,Calaveras,009,45235,8752,8727,595,9322,135
2022-12-06,Colusa,011,21464,3870,3869,1318,5187,22
2022-12-06,Contra Costa,013,1133247,260886,259434,21495,280929,1487
2022-12-06,Del Norte,015,27424,7580,7563,413,7976,56
2022-12-06,El Dorado,017,186661,33511,33447,4416,37863,235
2022-12-06,Fresno,019,978130,284664,281598,32961,314559,2899
2022-12-06,Glenn,021,27897,5680,5668,1938,7606,58
2022-12-06,Humboldt,023,135768,22665,22566,5443,28009,161
2022-12-06,Imperial,025,180216,67914,67632,17673,85305,962
2022-12-06,Inyo,027,18085,4641,4627,1128,5755,60
2022-12-06,Kern,029,883053,223544,222985,67480,290465,2437
2022-12-06,Kings,031,150075,61109,60965,4317,65282,464
2022-12-06,Lake,033,64148,13215,13140,1237,14377,149
2022-12-06,Lassen,035,31185,10139,10128,1027,11155,66
2022-12-06,Los Angeles,037,10098052,3382538,3370904,197979,3568883,34009
2022-12-06,Madera,039,155013,45065,44902,8538,53440,379
2022-12-06,Marin,041,260295,47066,46842,5471,52313,315
2022-12-06,Mariposa,043,17540,3238,3190,353,3543,32
2022-12-06,Mendocino,045,87422,16424,16350,4652,21002,136
2022-12-06,Merced,047,269075,74435,73999,12276,86275,877
2022-12-06,Modoc,049,8938,915,908,353,1261,11
2022-12-06,Mono,051,14174,3251,3238,279,3517,8
2022-12-06,Monterey,053,433212,95971,95709,22016,117725,776
2022-12-06,Napa,055,140530,33121,33043,1466,34509,164
2022-12-06,Nevada,057,99092,19648,19565,2100,21665,132
2022-12-06,Orange,059,3164182,685967,684112,69667,753779,7576
2022-12-06,Placer,061,380077,78352,78117,9903,88020,665
2022-12-06,Plumas,063,18699,3766,3762,452,4214,13
2022-12-06,Riverside,065,2383286,713043,710833,38121,748954,6697
2022-12-06,Sacramento,067,1510023,358484,357413,35878,393291,3382
2022-12-06,San Benito,069,59416,16999,16829,1035,17864,108
2022-12-06,San Bernardino,071,2135413,688996,686731,32734,719465,8135
2022-12-06,San Diego,073,3302833,950309,948180,75800,1023980,5584
2022-12-06,San Francisco,075,870044,187086,186203,12741,198944,1081
2022-12-06,San Joaquin,077,732212,203485,202515,15990,218505,2354
2022-12-06,San Luis Obispo,079,281455,64587,64350,7471,71821,533
2022-12-06,San Mateo,081,765935,175696,174791,10843,185634,749
2022-12-06,Santa Barbara,083,443738,108460,108151,7184,115335,739
2022-12-06,Santa Clara,085,1922200,454281,448654,20364,469018,2565
2022-12-06,Santa Cruz,087,273765,65989,65656,3642,69298,275
2022-12-06,Shasta,089,179085,35802,35666,8008,43674,598
2022-12-06,Sierra,091,2930,308,308,61,369,5
2022-12-06,Siskiyou,093,43540,5314,5442,3388,8830,95
2022-12-06,Solano,095,438530,108964,108649,8213,116862,473
2022-12-06,Sonoma,097,501317,109906,109622,5487,115109,531
2022-12-06,Stanislaus,099,539301,141238,140827,22167,162994,1785
2022-12-06,Sutter,101,95872,24955,24906,2498,27404,234
2022-12-06,Tehama,103,63373,14094,14004,3283,17287,218
2022-12-06,Trinity,105,12862,1444,1431,460,1891,23
2022-12-06,Tulare,107,460477,124510,123976,38078,162054,1546
2022-12-06,Tuolumne,109,53932,16173,16054,956,17010,208
2022-12-06,Ventura,111,848112,214385,213720,16766,230486,1598
2022-12-06,Yolo,113,214977,48724,48547,4586,53133,416
2022-12-06,Yuba,115,75493,19438,19399,1772,21171,132
2022-12-05,Alameda,001,1643700,361824,357689,21011,378700,2063
2022-12-05,Alpine,003,1148,139,139,2,141,0
2022-12-05,Amador,005,37829,10220,10150,950,11100,96
2022-12-05,Butte,007,227075,40667,40335,9622,49957,465
2022-12-05,Calaveras,009,45235,8746,8676,594,9270,135
2022-12-05,Colusa,011,21464,3869,3849,1318,5167,22
2022-12-05,Contra Costa,013,1133247,260619,257263,21476,278739,1485
2022-12-05,Del Norte,015,27424,7573,7519,412,7931,56
2022-12-05,El Dorado,017,186661,33493,33200,4412,37612,235
2022-12-05,Fresno,019,978130,284387,279787,32898,312685,2898
2022-12-05,Glenn,021,27897,5677,5647,1938,7585,58
2022-12-05,Humboldt,023,135768,22651,22436,5435,27871,160
2022-12-05,Imperial,025,180216,67811,67001,17605,84606,960
2022-12-05,Inyo,027,18085,4638,4590,1127,5717,60
2022-12-05,Kern,029,883053,223345,222087,67394,289481,2431
2022-12-05,Kings,031,150075,61045,60636,4309,64945,464
2022-12-05,Lake,033,64148,13205,13078,1237,14315,149
2022-12-05,Lassen,035,31185,10134,10110,1027,11137,65
2022-12-05,Los Angeles,037,10098052,3379460,3346956,197430,3544386,33937
2022-12-05,Madera,039,155013,45021,44650,8535,53185,377
2022-12-05,Marin,041,260295,47008,46509,5460,51969,314
2022-12-05,Mariposa,043,17540,3232,3175,353,3528,32
2022-12-05,Mendocino,045,87422,16412,16294,4646,20940,136
2022-12-05,Merced,047,269075,74385,73547,12255,85802,876
2022-12-05,Modoc,049,8938,914,895,353,1248,11
2022-12-05,Mono,051,14174,3249,3237,279,3516,8
2022-12-05,Monterey,053,433212,95926,95364,21998,117362,775
2022-12-05,Napa,055,140530,33098,32859,1463,34322,161
2022-12-05,Nevada,057,99092,19638,19398,2097,21495,132
2022-12-05,Orange,059,3164182,685336,679165,69470,748635,7567
2022-12-05,Placer,061,380077,78304,77618,9896,87514,665
2022-12-05,Plumas,063,18699,3765,3738,451,4189,13
2022-12-05,Riverside,065,2383286,712447,706396,38013,744409,6693
2022-12-05,Sacramento,067,1510023,358174,354844,35823,390667,3377
2022-12-05,San Benito,069,59416,16962,16555,1031,17586,108
2022-12-05,San Bernardino,071,2135413,688359,681872,32671,714543,8133
2022-12-05,San Diego,073,3302833,949450,942451,75654,1018105,5569
2022-12-05,San Francisco,075,870044,186840,184552,12725,197277,1078
2022-12-05,San Joaquin,077,732212,203310,201175,15964,217139,2347
2022-12-05,San Luis Obispo,079,281455,64544,64105,7457,71562,531
2022-12-05,San Mateo,081,765935,175479,173283,10833,184116,748
2022-12-05,Santa Barbara,083,443738,108376,107527,7169,114696,738
2022-12-05,Santa Clara,085,1922200,453730,444150,20314,464464,2560
2022-12-05,Santa Cruz,087,273765,65865,65044,3637,68681,275
2022-12-05,Shasta,089,179085,35784,35519,7998,43517,598
2022-12-05,Sierra,091,2930,308,308,61,369,5
2022-12-05,Siskiyou,093,43540,5313,5406,3386,8792,95
2022-12-05,Solano,095,438530,108863,107925,8200,116125,470
2022-12-05,Sonoma,097,501317,109812,109040,5481,114521,530
2022-12-05,Stanislaus,099,539301,141125,140127,22150,162277,1785
2022-12-05,Sutter,101,95872,24931,24800,2495,27295,234
2022-12-05,Tehama,103,63373,14078,13904,3279,17183,216
2022-12-05,Trinity,105,12862,1444,1428,459,1887,22
2022-12-05,Tulare,107,460477,124418,123368,38022,161390,1546
2022-12-05,Tuolumne,109,53932,16154,15945,955,16900,207
2022-12-05,Ventura,111,848112,214218,212363,16737,229100,1591
2022-12-05,Yolo,113,214977,48689,48329,4583,52912,409
2022-12-05,Yuba,115,75493,19426,19307,1772,21079,132
2022-12-04,Alameda,001,1643700,361279,357689,20953,378642,2063
2022-12-04,Alpine,003,1148,139,139,2,141,0
2022-12-04,Amador,005,37829,10216,10150,950,11100,96
2022-12-04,Butte,007,227075,40606,40335,9606,49941,465
2022-12-04,Calaveras,009,45235,8735,8676,592,9268,135
2022-12-04,Colusa,011,21464,3867,3849,1318,5167,22
2022-12-04,Contra Costa,013,1133247,260264,257263,21439,278702,1485
2022-12-04,Del Norte,015,27424,7569,7519,412,7931,56
2022-12-04,El Dorado,017,186661,33471,33200,4404,37604,235
2022-12-04,Fresno,019,978130,284085,279787,32831,312618,2898
2022-12-04,Glenn,021,27897,5672,5647,1935,7582,58
2022-12-04,Humboldt,023,135768,22623,22436,5425,27861,160
2022-12-04,Imperial,025,180216,67728,67001,17499,84500,960
2022-12-04,Inyo,027,18085,4636,4590,1125,5715,60
2022-12-04,Kern,029,883053,223206,222087,67272,289359,2431
2022-12-04,Kings,031,150075,60988,60636,4294,64930,464
2022-12-04,Lake,033,64148,13191,13078,1236,14314,149
2022-12-04,Lassen,035,31185,10131,10110,1025,11135,65
2022-12-04,Los Angeles,037,10098052,3375631,3346956,196767,3543723,33937
2022-12-04,Madera,039,155013,44993,44650,8525,53175,377
2022-12-04,Marin,041,260295,46941,46509,5451,51960,314
2022-12-04,Mariposa,043,17540,3229,3175,353,3528,32
2022-12-04,Mendocino,045,87422,16404,16294,4642,20936,136
2022-12-04,Merced,047,269075,74336,73547,12216,85763,876
2022-12-04,Modoc,049,8938,912,895,353,1248,11
2022-12-04,Mono,051,14174,3248,3237,279,3516,8
2022-12-04,Monterey,053,433212,95884,95364,21975,117339,775
2022-12-04,Napa,055,140530,33075,32859,1454,34313,161
2022-12-04,Nevada,057,99092,19613,19398,2085,21483,132
2022-12-04,Orange,059,3164182,684649,679165,69218,748383,7567
2022-12-04,Placer,061,380077,78231,77618,9883,87501,665
2022-12-04,Plumas,063,18699,3762,3738,449,4187,13
2022-12-04,Riverside,065,2383286,711756,706396,37888,744284,6693
2022-12-04,Sacramento,067,1510023,357821,354844,35750,390594,3377
2022-12-04,San Benito,069,59416,16946,16555,1031,17586,108
2022-12-04,San Bernardino,071,2135413,687565,681872,32597,714469,8133
2022-12-04,San Diego,073,3302833,948388,942451,75495,1017946,5569
2022-12-04,San Francisco,075,870044,186540,184552,12689,197241,1078
2022-12-04,San Joaquin,077,732212,203125,201175,15928,217103,2347
2022-12-04,San Luis Obispo,079,281455,64502,64105,7443,71548,531
2022-12-04,San Mateo,081,765935,175272,173283,10818,184101,748
2022-12-04,Santa Barbara,083,443738,108277,107527,7160,114687,738
2022-12-04,Santa Clara,085,1922200,453086,444150,20256,464406,2560
2022-12-04,Santa Cruz,087,273765,65801,65044,3627,68671,275
2022-12-04,Shasta,089,179085,35764,35519,7974,43493,598
2022-12-04,Sierra,091,2930,308,308,61,369,5
2022-12-04,Siskiyou,093,43540,5308,5406,3385,8791,95
2022-12-04,Solano,095,438530,108721,107925,8194,116119,470
2022-12-04,Sonoma,097,501317,109711,109040,5474,114514,530
2022-12-04,Stanislaus,099,539301,141005,140127,22129,162256,1785
2022-12-04,Sutter,101,95872,24911,24800,2484,27284,234
2022-12-04,Tehama,103,63373,14063,13904,3278,17182,216
2022-12-04,Trinity,105,12862,1444,1428,459,1887,22
2022-12-04,Tulare,107,460477,124309,123368,37961,161329,1546
2022-12-04,Tuolumne,109,53932,16131,15945,954,16899,207
2022-12-04,Ventura,111,848112,214048,212363,16694,229057,1591
2022-12-04,Yolo,113,214977,48644,48329,4575,52904,409
2022-12-04,Yuba,115,75493,19416,19307,1770,21077,132
2022-12-03,Alameda,001,1643700,361039,357689,20918,378607,2063
2022-12-03,Alpine,003,1148,139,139,2,141,0
2022-12-03,Amador,005,37829,10209,10150,950,11100,96
2022-12-03,Butte,007,227075,40590,40335,9596,49931,465
2022-12-03,Calaveras,009,45235,8732,8676,592,9268,135
2022-12-03,Colusa,011,21464,3866,3849,1318,5167,22
2022-12-03,Contra Costa,013,1133247,260090,257263,21422,278685,1485
2022-12-03,Del Norte,015,27424,7565,7519,411,7930,56
2022-12-03,El Dorado,017,186661,33455,33200,4402,37602,235
2022-12-03,Fresno,019,978130,283958,279787,32812,312599,2898
2022-12-03,Glenn,021,27897,5670,5647,1935,7582,58
2022-12-03,Humboldt,023,135768,22601,22436,5413,27849,160
2022-12-03,Imperial,025,180216,67691,67001,17480,84481,960
2022-12-03,Inyo,027,18085,4635,4590,1124,5714,60
2022-12-03,Kern,029,883053,223154,222087,67203,289290,2431
2022-12-03,Kings,031,150075,60968,60636,4292,64928,464
2022-12-03,Lake,033,64148,13186,13078,1235,14313,149
2022-12-03,Lassen,035,31185,10129,10110,1025,11135,65
2022-12-03,Los Angeles,037,10098052,3373750,3346956,196415,3543371,33937
2022-12-03,Madera,039,155013,44973,44650,8522,53172,377
2022-12-03,Marin,041,260295,46900,46509,5446,51955,314
2022-12-03,Mariposa,043,17540,3227,3175,353,3528,32
2022-12-03,Mendocino,045,87422,16398,16294,4641,20935,136
2022-12-03,Merced,047,269075,74297,73547,12204,85751,876
2022-12-03,Modoc,049,8938,910,895,352,1247,11
2022-12-03,Mono,051,14174,3246,3237,279,3516,8
2022-12-03,Monterey,053,433212,95863,95364,21958,117322,775
2022-12-03,Napa,055,140530,33067,32859,1454,34313,161
2022-12-03,Nevada,057,99092,19606,19398,2083,21481,132
2022-12-03,Orange,059,3164182,684306,679165,69059,748224,7567
2022-12-03,Placer,061,380077,78183,77618,9882,87500,665
2022-12-03,Plumas,063,18699,3760,3738,448,4186,13
2022-12-03,Riverside,065,2383286,711366,706396,37827,744223,6693
2022-12-03,Sacramento,067,1510023,357640,354844,35729,390573,3377
2022-12-03,San Benito,069,59416,16925,16555,1028,17583,108
2022-12-03,San Bernardino,071,2135413,687205,681872,32550,714422,8133
2022-12-03,San Diego,073,3302833,947889,942451,75433,1017884,5569
2022-12-03,San Francisco,075,870044,186400,184552,12682,197234,1078
2022-12-03,San Joaquin,077,732212,203013,201175,15905,217080,2347
2022-12-03,San Luis Obispo,079,281455,64489,64105,7438,71543,531
2022-12-03,San Mateo,081,765935,175148,173283,10809,184092,748
2022-12-03,Santa Barbara,083,443738,108237,107527,7154,114681,738
2022-12-03,Santa Clara,085,1922200,452734,444150,20219,464369,2560
2022-12-03,Santa Cruz,087,273765,65759,65044,3616,68660,275
2022-12-03,Shasta,089,179085,35754,35519,7971,43490,598
2022-12-03,Sierra,091,2930,308,308,61,369,5
2022-12-03,Siskiyou,093,43540,5307,5406,3385,8791,95
2022-12-03,Solano,095,438530,108692,107925,8186,116111,470
2022-12-03,Sonoma,097,501317,109665,109040,5472,114512,530
2022-12-03,Stanislaus,099,539301,140939,140127,22113,162240,1785
2022-12-03,Sutter,101,95872,24895,24800,2484,27284,234
2022-12-03,Tehama,103,63373,14059,13904,3275,17179,216
2022-12-03,Trinity,105,12862,1444,1428,459,1887,22
2022-12-03,Tulare,107,460477,124247,123368,37927,161295,1546
2022-12-03,Tuolumne,109,53932,16115,15945,951,16896,207
2022-12-03,Ventura,111,848112,213953,212363,16674,229037,1591
2022-12-03,Yolo,113,214977,48617,48329,4573,52902,409
2022-12-03,Yuba,115,75493,19411,19307,1769,21076,132
2022-12-02,Alameda,001,1643700,360770,357689,20893,378582,2063
2022-12-02,Alpine,003,1148,139,139,2,141,0
2022-12-02,Amador,005,37829,10203,10150,950,11100,96
2022-12-02,Butte,007,227075,40575,40335,9582,49917,465
2022-12-02,Calaveras,009,45235,8728,8676,592,9268,135
2022-12-02,Colusa,011,21464,3866,3849,1318,5167,22
2022-12-02,Contra Costa,013,1133247,259934,257263,21415,278678,1485
2022-12-02,Del Norte,015,27424,7561,7519,411,7930,56
2022-12-02,El Dorado,017,186661,33439,33200,4402,37602,235
2022-12-02,Fresno,019,978130,283799,279787,32786,312573,2898
2022-12-02,Glenn,021,27897,5669,5647,1934,7581,58
2022-12-02,Humboldt,023,135768,22589,22436,5409,27845,160
2022-12-02,Imperial,025,180216,67648,67001,17462,84463,960
2022-12-02,Inyo,027,18085,4632,4590,1122,5712,60
2022-12-02,Kern,029,883053,223064,222087,67155,289242,2431
2022-12-02,Kings,031,150075,60950,60636,4290,64926,464
2022-12-02,Lake,033,64148,13180,13078,1234,14312,149
2022-12-02,Lassen,035,31185,10128,10110,1024,11134,65
2022-12-02,Los Angeles,037,10098052,3371704,3346956,196007,3542963,33937
2022-12-02,Madera,039,155013,44949,44650,8521,53171,377
2022-12-02,Marin,041,260295,46863,46509,5443,51952,314
2022-12-02,Mariposa,043,17540,3225,3175,352,3527,32
2022-12-02,Mendocino,045,87422,16393,16294,4641,20935,136
2022-12-02,Merced,047,269075,74267,73547,12198,85745,876
2022-12-02,Modoc,049,8938,909,895,351,1246,11
2022-12-02,Mono,051,14174,3246,3237,278,3515,8
2022-12-02,Monterey,053,433212,95831,95364,21941,117305,775
2022-12-02,Napa,055,140530,33053,32859,1450,34309,161
2022-12-02,Nevada,057,99092,19600,19398,2078,21476,132
2022-12-02,Orange,059,3164182,683938,679165,68880,748045,7567
2022-12-02,Placer,061,380077,78156,77618,9874,87492,665
2022-12-02,Plumas,063,18699,3760,3738,448,4186,13
2022-12-02,Riverside,065,2383286,710925,706396,37762,744158,6693
2022-12-02,Sacramento,067,1510023,357415,354844,35697,390541,3377
2022-12-02,San Benito,069,59416,16902,16555,1025,17580,108
2022-12-02,San Bernardino,071,2135413,686836,681872,32518,714390,8133
2022-12-02,San Diego,073,3302833,947383,942451,75362,1017813,5569
2022-12-02,San Francisco,075,870044,186277,184552,12668,197220,1078
2022-12-02,San Joaquin,077,732212,202915,201175,15888,217063,2347
2022-12-02,San Luis Obispo,079,281455,64468,64105,7428,71533,531
2022-12-02,San Mateo,081,765935,175024,173283,10799,184082,748
2022-12-02,Santa Barbara,083,443738,108182,107527,7152,114679,738
2022-12-02,Santa Clara,085,1922200,452412,444150,20195,464345,2560
2022-12-02,Santa Cruz,087,273765,65704,65044,3613,68657,275
2022-12-02,Shasta,089,179085,35737,35519,7969,43488,598
2022-12-02,Sierra,091,2930,308,308,61,369,5
2022-12-02,Siskiyou,093,43540,5305,5406,3385,8791,95
2022-12-02,Solano,095,438530,108622,107925,8179,116104,470
2022-12-02,Sonoma,097,501317,109617,109040,5465,114505,530
2022-12-02,Stanislaus,099,539301,140876,140127,22106,162233,1785
2022-12-02,Sutter,101,95872,24886,24800,2484,27284,234
2022-12-02,Tehama,103,63373,14054,13904,3271,17175,216
2022-12-02,Trinity,105,12862,1444,1428,458,1886,22
2022-12-02,Tulare,107,460477,124201,123368,37884,161252,1546
2022-12-02,Tuolumne,109,53932,16103,15945,949,16894,207
2022-12-02,Ventura,111,848112,213849,212363,16648,229011,1591
2022-12-02,Yolo,113,214977,48605,48329,4572,52901,409
2022-12-02,Yuba,115,75493,19400,19307,1769,21076,132
2022-12-01,Alameda,001,1643700,360364,357689,20844,378533,2063
2022-12-01,Alpine,003,1148,139,139,2,141,0
2022-12-01,Amador,005,37829,10197,10150,950,11100,96
2022-12-01,Butte,007,227075,40547,40335,9566,49901,465
2022-12-01,Calaveras,009,45235,8721,8676,589,9265,135
2022-12-01,Colusa,011,21464,3866,3849,1315,5164,22
2022-12-01,Contra Costa,013,1133247,259698,257263,21395,278658,1485
2022-12-01,Del Norte,015,27424,7560,7519,411,7930,56
2022-12-01,El Dorado,017,186661,33412,33200,4395,37595,235
2022-12-01,Fresno,019,978130,283618,279787,32741,312528,2898
2022-12-01,Glenn,021,27897,5661,5647,1931,7578,58
2022-12-01,Humboldt,023,135768,22577,22436,5404,27840,160
2022-12-01,Imperial,025,180216,67575,67001,17362,84363,960
2022-12-01,Inyo,027,18085,4626,4590,1118,5708,60
2022-12-01,Kern,029,883053,222920,222087,67070,289157,2431
2022-12-01,Kings,031,150075,60910,60636,4287,64923,464
2022-12-01,Lake,033,64148,13174,13078,1234,14312,149
2022-12-01,Lassen,035,31185,10126,10110,1024,11134,65
2022-12-01,Los Angeles,037,10098052,3368836,3346956,195512,3542468,33937
2022-12-01,Madera,039,155013,44916,44650,8508,53158,377
2022-12-01,Marin,041,260295,46823,46509,5430,51939,314
2022-12-01,Mariposa,043,17540,3221,3175,352,3527,32
2022-12-01,Mendocino,045,87422,16388,16294,4641,20935,136
2022-12-01,Merced,047,269075,74220,73547,12183,85730,876
2022-12-01,Modoc,049,8938,906,895,350,1245,11
2022-12-01,Mono,051,14174,3243,3237,277,3514,8
2022-12-01,Monterey,053,433212,95795,95364,21928,117292,775
2022-12-01,Napa,055,140530,33024,32859,1449,34308,161
2022-12-01,Nevada,057,99092,19583,19398,2075,21473,132
2022-12-01,Orange,059,3164182,683359,679165,68682,747847,7567
2022-12-01,Placer,061,380077,78100,77618,9865,87483,665
2022-12-01,Plumas,063,18699,3753,3738,448,4186,13
2022-12-01,Riverside,065,2383286,710397,706396,37661,744057,6693
2022-12-01,Sacramento,067,1510023,357107,354844,35643,390487,3377
2022-12-01,San Benito,069,59416,16871,16555,1022,17577,108
2022-12-01,San Bernardino,071,2135413,686273,681872,32440,714312,8133
2022-12-01,San Diego,073,3302833,946576,942451,75227,1017678,5569
2022-12-01,San Francisco,075,870044,186067,184552,12640,197192,1078
2022-12-01,San Joaquin,077,732212,202762,201175,15864,217039,2347
2022-12-01,San Luis Obispo,079,281455,64446,64105,7414,71519,531
2022-12-01,San Mateo,081,765935,174858,173283,10791,184074,748
2022-12-01,Santa Barbara,083,443738,108116,107527,7145,114672,738
2022-12-01,Santa Clara,085,1922200,451912,444150,20152,464302,2560
2022-12-01,Santa Cruz,087,273765,65636,65044,3608,68652,275
2022-12-01,Shasta,089,179085,35718,35519,7960,43479,598
2022-12-01,Sierra,091,2930,308,308,61,369,5
2022-12-01,Siskiyou,093,43540,5303,5406,3384,8790,95
2022-12-01,Solano,095,438530,108545,107925,8174,116099,470
2022-12-01,Sonoma,097,501317,109550,109040,5452,114492,530
2022-12-01,Stanislaus,099,539301,140792,140127,22096,162223,1785
2022-12-01,Sutter,101,95872,24876,24800,2483,27283,234
2022-12-01,Tehama,103,63373,14037,13904,3266,17170,216
2022-12-01,Trinity,105,12862,1444,1428,457,1885,22
2022-12-01,Tulare,107,460477,124140,123368,37828,161196,1546
2022-12-01,Tuolumne,109,53932,16088,15945,949,16894,207
2022-12-01,Ventura,111,848112,213702,212363,16617,228980,1591
2022-12-01,Yolo,113,214977,48571,48329,4567,52896,409
2022-12-01,Yuba,115,75493,19381,19307,1769,21076,132
2022-11-30,Alameda,001,1643700,359941,357689,20804,378493,2063
2022-11-30,Alpine,003,1148,139,139,2,141,0
2022-11-30,Amador,005,37829,10191,10150,950,11100,96
2022-11-30,Butte,007,227075,40511,40335,9540,49875,465
2022-11-30,Calaveras,009,45235,8715,8676,588,9264,135
2022-11-30,Colusa,011,21464,3863,3849,1314,5163,22
2022-11-30,Contra Costa,013,1133247,259447,257263,21376,278639,1485
2022-11-30,Del Norte,015,27424,7556,7519,410,7929,56
2022-11-30,El Dorado,017,186661,33385,33200,4392,37592,235
2022-11-30,Fresno,019,978130,283360,279787,32700,312487,2898
2022-11-30,Glenn,021,27897,5659,5647,1925,7572,58
2022-11-30,Humboldt,023,135768,22563,22436,5393,27829,160
2022-11-30,Imperial,025,180216,67462,67001,17271,84272,960
2022-11-30,Inyo,027,18085,4625,4590,1115,5705,60
2022-11-30,Kern,029,883053,222824,222087,66995,289082,2431
2022-11-30,Kings,031,150075,60852,60636,4276,64912,464
2022-11-30,Lake,033,64148,13162,13078,1234,14312,149
2022-11-30,Lassen,035,31185,10124,10110,1024,11134,65
2022-11-30,Los Angeles,037,10098052,3365385,3346956,194938,3541894,33937
2022-11-30,Madera,039,155013,44889,44650,8503,53153,377
2022-11-30,Marin,041,260295,46785,46509,5424,51933,314
2022-11-30,Mariposa,043,17540,3217,3175,351,3526,32
2022-11-30,Mendocino,045,87422,16381,16294,4636,20930,136
2022-11-30,Merced,047,269075,74158,73547,12160,85707,876
2022-11-30,Modoc,049,8938,906,895,349,1244,11
2022-11-30,Mono,051,14174,3241,3237,277,3514,8
2022-11-30,Monterey,053,433212,95747,95364,21910,117274,775
2022-11-30,Napa,055,140530,32992,32859,1449,34308,161
2022-11-30,Nevada,057,99092,19572,19398,2070,21468,132
2022-11-30,Orange,059,3164182,682730,679165,68461,747626,7567
2022-11-30,Placer,061,380077,78032,77618,9856,87474,665
2022-11-30,Plumas,063,18699,3751,3738,448,4186,13
2022-11-30,Riverside,065,2383286,709737,706396,37558,743954,6693
2022-11-30,Sacramento,067,1510023,356819,354844,35608,390452,3377
2022-11-30,San Benito,069,59416,16831,16555,1020,17575,108
2022-11-30,San Bernardino,071,2135413,685667,681872,32359,714231,8133
2022-11-30,San Diego,073,3302833,945727,942451,75099,1017550,5569
2022-11-30,San Francisco,075,870044,185841,184552,12623,197175,1078
2022-11-30,San Joaquin,077,732212,202584,201175,15813,216988,2347
2022-11-30,San Luis Obispo,079,281455,64411,64105,7398,71503,531
2022-11-30,San Mateo,081,765935,174674,173283,10773,184056,748
2022-11-30,Santa Barbara,083,443738,108037,107527,7129,114656,738
2022-11-30,Santa Clara,085,1922200,451396,444150,20111,464261,2560
2022-11-30,Santa Cruz,087,273765,65572,65044,3603,68647,275
2022-11-30,Shasta,089,179085,35700,35519,7951,43470,598
2022-11-30,Sierra,091,2930,308,308,61,369,5
2022-11-30,Siskiyou,093,43540,5300,5406,3383,8789,95
2022-11-30,Solano,095,438530,108456,107925,8168,116093,470
2022-11-30,Sonoma,097,501317,109478,109040,5446,114486,530
2022-11-30,Stanislaus,099,539301,140685,140127,22081,162208,1785
2022-11-30,Sutter,101,95872,24858,24800,2480,27280,234
2022-11-30,Tehama,103,63373,14018,13904,3261,17165,216
2022-11-30,Trinity,105,12862,1443,1428,456,1884,22
2022-11-30,Tulare,107,460477,124057,123368,37776,161144,1546
2022-11-30,Tuolumne,109,53932,16072,15945,947,16892,207
2022-11-30,Ventura,111,848112,213511,212363,16574,228937,1591
2022-11-30,Yolo,113,214977,48544,48329,4561,52890,409
2022-11-30,Yuba,115,75493,19369,19307,1769,21076,132
2022-11-29,Alameda,001,1643700,359516,357689,20747,378436,2063
2022-11-29,Alpine,003,1148,139,139,1,140,0
2022-11-29,Amador,005,37829,10187,10150,950,11100,96
2022-11-29,Butte,007,227075,40468,40335,9521,49856,465
2022-11-29,Calaveras,009,45235,8708,8676,588,9264,135
2022-11-29,Colusa,011,21464,3862,3849,1310,5159,22
2022-11-29,Contra Costa,013,1133247,259187,257263,21354,278617,1485
2022-11-29,Del Norte,015,27424,7548,7519,410,7929,56
2022-11-29,El Dorado,017,186661,33344,33200,4389,37589,235
2022-11-29,Fresno,019,978130,283135,279787,32649,312436,2898
2022-11-29,Glenn,021,27897,5657,5647,1924,7571,58
2022-11-29,Humboldt,023,135768,22547,22436,5376,27812,160
2022-11-29,Imperial,025,180216,67368,67001,17189,84190,960
2022-11-29,Inyo,027,18085,4619,4590,1110,5700,60
2022-11-29,Kern,029,883053,222705,222087,66894,288981,2431
2022-11-29,Kings,031,150075,60813,60636,4273,64909,464
2022-11-29,Lake,033,64148,13154,13078,1234,14312,149
2022-11-29,Lassen,035,31185,10121,10110,1023,11133,65
2022-11-29,Los Angeles,037,10098052,3361432,3346956,194350,3541306,33937
2022-11-29,Madera,039,155013,44847,44650,8478,53128,377
2022-11-29,Marin,041,260295,46740,46509,5420,51929,314
2022-11-29,Mariposa,043,17540,3215,3175,350,3525,32
2022-11-29,Mendocino,045,87422,16372,16294,4632,20926,136
2022-11-29,Merced,047,269075,74105,73547,12133,85680,876
2022-11-29,Modoc,049,8938,904,895,349,1244,11
2022-11-29,Mono,051,14174,3240,3237,277,3514,8
2022-11-29,Monterey,053,433212,95706,95364,21885,117249,775
2022-11-29,Napa,055,140530,32967,32859,1449,34308,161
2022-11-29,Nevada,057,99092,19551,19398,2064,21462,132
2022-11-29,Orange,059,3164182,681987,679165,68225,747390,7567
2022-11-29,Placer,061,380077,77961,77618,9846,87464,665
2022-11-29,Plumas,063,18699,3745,3738,447,4185,13
2022-11-29,Riverside,065,2383286,709144,706396,37447,743843,6693
2022-11-29,Sacramento,067,1510023,356433,354844,35560,390404,3377
2022-11-29,San Benito,069,59416,16789,16555,1016,17571,108
2022-11-29,San Bernardino,071,2135413,685036,681872,32282,714154,8133
2022-11-29,San Diego,073,3302833,944825,942451,74920,1017371,5569
2022-11-29,San Francisco,075,870044,185611,184552,12607,197159,1078
2022-11-29,San Joaquin,077,732212,202382,201175,15774,216949,2347
2022-11-29,San Luis Obispo,079,281455,64371,64105,7386,71491,531
2022-11-29,San Mateo,081,765935,174490,173283,10762,184045,748
2022-11-29,Santa Barbara,083,443738,107953,107527,7119,114646,738
2022-11-29,Santa Clara,085,1922200,450858,444150,20057,464207,2560
2022-11-29,Santa Cruz,087,273765,65488,65044,3600,68644,275
2022-11-29,Shasta,089,179085,35680,35519,7936,43455,598
2022-11-29,Sierra,091,2930,308,308,61,369,5
2022-11-29,Siskiyou,093,43540,5296,5406,3382,8788,95
2022-11-29,Solano,095,438530,108349,107925,8161,116086,470
2022-11-29,Sonoma,097,501317,109398,109040,5436,114476,530
2022-11-29,Stanislaus,099,539301,140599,140127,22056,162183,1785
2022-11-29,Sutter,101,95872,24850,24800,2479,27279,234
2022-11-29,Tehama,103,63373,14003,13904,3252,17156,216
2022-11-29,Trinity,105,12862,1441,1428,456,1884,22
2022-11-29,Tulare,107,460477,123970,123368,37735,161103,1546
2022-11-29,Tuolumne,109,53932,16057,15945,945,16890,207
2022-11-29,Ventura,111,848112,213328,212363,16531,228894,1591
2022-11-29,Yolo,113,214977,48509,48329,4552,52881,409
2022-11-29,Yuba,115,75493,19358,19307,1768,21075,132
2022-11-28,Alameda,001,1643700,359064,356253,20715,376968,2059
2022-11-28,Alpine,003,1148,139,138,1,139,0
2022-11-28,Amador,005,37829,10179,10132,950,11082,95
2022-11-28,Butte,007,227075,40429,40206,9498,49704,465
2022-11-28,Calaveras,009,45235,8699,8651,588,9239,135
2022-11-28,Colusa,011,21464,3857,3840,1309,5149,22
2022-11-28,Contra Costa,013,1133247,258890,256191,21320,277511,1483
2022-11-28,Del Norte,015,27424,7543,7502,409,7911,56
2022-11-28,El Dorado,017,186661,33312,33057,4386,37443,233
2022-11-28,Fresno,019,978130,282864,278793,32588,311381,2893
2022-11-28,Glenn,021,27897,5653,5625,1923,7548,58
2022-11-28,Humboldt,023,135768,22530,22351,5356,27707,160
2022-11-28,Imperial,025,180216,67224,66747,17095,83842,960
2022-11-28,Inyo,027,18085,4612,4557,1105,5662,60
2022-11-28,Kern,029,883053,222550,221639,66798,288437,2430
2022-11-28,Kings,031,150075,60750,60457,4261,64718,463
2022-11-28,Lake,033,64148,13141,13042,1231,14273,149
2022-11-28,Lassen,035,31185,10120,10091,1021,11112,65
2022-11-28,Los Angeles,037,10098052,3357138,3332327,193783,3526110,33882
2022-11-28,Madera,039,155013,44816,44503,8468,52971,377
2022-11-28,Marin,041,260295,46698,46293,5412,51705,314
2022-11-28,Mariposa,043,17540,3213,3156,349,3505,32
2022-11-28,Mendocino,045,87422,16365,16255,4619,20874,136
2022-11-28,Merced,047,269075,74044,73259,12108,85367,876
2022-11-28,Modoc,049,8938,902,895,346,1241,11
2022-11-28,Mono,051,14174,3240,3233,276,3509,8
2022-11-28,Monterey,053,433212,95655,95169,21850,117019,775
2022-11-28,Napa,055,140530,32938,32736,1447,34183,161
2022-11-28,Nevada,057,99092,19524,19310,2060,21370,132
2022-11-28,Orange,059,3164182,681160,676959,67953,744912,7565
2022-11-28,Placer,061,380077,77913,77331,9838,87169,665
2022-11-28,Plumas,063,18699,3743,3737,447,4184,13
2022-11-28,Riverside,065,2383286,708492,704180,37338,741518,6692
2022-11-28,Sacramento,067,1510023,356047,353538,35501,389039,3374
2022-11-28,San Benito,069,59416,16743,16474,1004,17478,108
2022-11-28,San Bernardino,071,2135413,684344,679620,32189,711809,8133
2022-11-28,San Diego,073,3302833,943776,938583,74784,1013367,5562
2022-11-28,San Francisco,075,870044,185357,183671,12590,196261,1076
2022-11-28,San Joaquin,077,732212,202195,200474,15728,216202,2344
2022-11-28,San Luis Obispo,079,281455,64338,63962,7378,71340,530
2022-11-28,San Mateo,081,765935,174254,172573,10749,183322,748
2022-11-28,Santa Barbara,083,443738,107855,107184,7106,114290,735
2022-11-28,Santa Clara,085,1922200,450271,442182,20000,462182,2558
2022-11-28,Santa Cruz,087,273765,65394,64814,3597,68411,275
2022-11-28,Shasta,089,179085,35652,35452,7923,43375,596
2022-11-28,Sierra,091,2930,308,308,61,369,5
2022-11-28,Siskiyou,093,43540,5291,5385,3381,8766,95
2022-11-28,Solano,095,438530,108236,107446,8152,115598,469
2022-11-28,Sonoma,097,501317,109313,108690,5427,114117,530
2022-11-28,Stanislaus,099,539301,140484,139741,22019,161760,1785
2022-11-28,Sutter,101,95872,24835,24730,2479,27209,234
2022-11-28,Tehama,103,63373,13985,13857,3251,17108,216
2022-11-28,Trinity,105,12862,1441,1425,456,1881,21
2022-11-28,Tulare,107,460477,123894,123029,37681,160710,1545
2022-11-28,Tuolumne,109,53932,16047,15885,941,16826,206
2022-11-28,Ventura,111,848112,213119,211680,16480,228160,1591
2022-11-28,Yolo,113,214977,48476,48228,4539,52767,408
2022-11-28,Yuba,115,75493,19344,19233,1768,21001,132
2022-11-27,Alameda,001,1643700,358484,356253,20636,376889,2059
2022-11-27,Alpine,003,1148,139,138,1,139,0
2022-11-27,Amador,005,37829,10174,10132,949,11081,95
2022-11-27,Butte,007,227075,40384,40206,9478,49684,465
2022-11-27,Calaveras,009,45235,8693,8651,587,9238,135
2022-11-27,Colusa,011,21464,3854,3840,1307,5147,22
2022-11-27,Contra Costa,013,1133247,258537,256191,21272,277463,1483
2022-11-27,Del Norte,015,27424,7535,7502,406,7908,56
2022-11-27,El Dorado,017,186661,33268,33057,4380,37437,233
2022-11-27,Fresno,019,978130,282526,278793,32537,311330,2893
2022-11-27,Glenn,021,27897,5652,5625,1921,7546,58
2022-11-27,Humboldt,023,135768,22513,22351,5335,27686,160
2022-11-27,Imperial,025,180216,67134,66747,17024,83771,960
2022-11-27,Inyo,027,18085,4604,4557,1102,5659,60
2022-11-27,Kern,029,883053,222393,221639,66664,288303,2430
2022-11-27,Kings,031,150075,60676,60457,4249,64706,463
2022-11-27,Lake,033,64148,13127,13042,1229,14271,149
2022-11-27,Lassen,035,31185,10113,10091,1021,11112,65
2022-11-27,Los Angeles,037,10098052,3352047,3332327,193116,3525443,33882
2022-11-27,Madera,039,155013,44767,44503,8450,52953,377
2022-11-27,Marin,041,260295,46639,46293,5398,51691,314
2022-11-27,Mariposa,043,17540,3209,3156,349,3505,32
2022-11-27,Mendocino,045,87422,16351,16255,4607,20862,136
2022-11-27,Merced,047,269075,73931,73259,12082,85341,876
2022-11-27,Modoc,049,8938,900,895,346,1241,11
2022-11-27,Mono,051,14174,3240,3233,275,3508,8
2022-11-27,Monterey,053,433212,95593,95169,21828,116997,775
2022-11-27,Napa,055,140530,32902,32736,1445,34181,161
2022-11-27,Nevada,057,99092,19494,19310,2049,21359,132
2022-11-27,Orange,059,3164182,680329,676959,67673,744632,7565
2022-11-27,Placer,061,380077,77820,77331,9819,87150,665
2022-11-27,Plumas,063,18699,3741,3737,446,4183,13
2022-11-27,Riverside,065,2383286,707646,704180,37198,741378,6692
2022-11-27,Sacramento,067,1510023,355596,353538,35417,388955,3374
2022-11-27,San Benito,069,59416,16701,16474,1001,17475,108
2022-11-27,San Bernardino,071,2135413,683440,679620,32082,711702,8133
2022-11-27,San Diego,073,3302833,942533,938583,74599,1013182,5562
2022-11-27,San Francisco,075,870044,185052,183671,12559,196230,1076
2022-11-27,San Joaquin,077,732212,201929,200474,15652,216126,2344
2022-11-27,San Luis Obispo,079,281455,64265,63962,7357,71319,530
2022-11-27,San Mateo,081,765935,173942,172573,10727,183300,748
2022-11-27,Santa Barbara,083,443738,107747,107184,7079,114263,735
2022-11-27,Santa Clara,085,1922200,449590,442182,19949,462131,2558
2022-11-27,Santa Cruz,087,273765,65246,64814,3592,68406,275
2022-11-27,Shasta,089,179085,35631,35452,7908,43360,596
2022-11-27,Sierra,091,2930,308,308,61,369,5
2022-11-27,Siskiyou,093,43540,5286,5385,3379,8764,95
2022-11-27,Solano,095,438530,108095,107446,8137,115583,469
2022-11-27,Sonoma,097,501317,109208,108690,5424,114114,530
2022-11-27,Stanislaus,099,539301,140372,139741,21994,161735,1785
2022-11-27,Sutter,101,95872,24816,24730,2478,27208,234
2022-11-27,Tehama,103,63373,13964,13857,3233,17090,216
2022-11-27,Trinity,105,12862,1440,1425,456,1881,21
2022-11-27,Tulare,107,460477,123743,123029,37604,160633,1545
2022-11-27,Tuolumne,109,53932,16040,15885,939,16824,206
2022-11-27,Ventura,111,848112,212882,211680,16431,228111,1591
2022-11-27,Yolo,113,214977,48436,48228,4537,52765,408
2022-11-27,Yuba,115,75493,19324,19233,1765,20998,132
2022-11-26,Alameda,001,1643700,358213,356253,20612,376865,2059
2022-11-26,Alpine,003,1148,139,138,1,139,0
2022-11-26,Amador,005,37829,10169,10132,948,11080,95
2022-11-26,Butte,007,227075,40360,40206,9466,49672,465
2022-11-26,Calaveras,009,45235,8690,8651,587,9238,135
2022-11-26,Colusa,011,21464,3851,3840,1306,5146,22
2022-11-26,Contra Costa,013,1133247,258319,256191,21259,277450,1483
2022-11-26,Del Norte,015,27424,7525,7502,405,7907,56
2022-11-26,El Dorado,017,186661,33248,33057,4380,37437,233
2022-11-26,Fresno,019,978130,282361,278793,32510,311303,2893
2022-11-26,Glenn,021,27897,5648,5625,1915,7540,58
2022-11-26,Humboldt,023,135768,22500,22351,5327,27678,160
2022-11-26,Imperial,025,180216,67092,66747,17008,83755,960
2022-11-26,Inyo,027,18085,4597,4557,1100,5657,60
2022-11-26,Kern,029,883053,222305,221639,66603,288242,2430
2022-11-26,Kings,031,150075,60650,60457,4248,64705,463
2022-11-26,Lake,033,64148,13119,13042,1228,14270,149
2022-11-26,Lassen,035,31185,10112,10091,1021,11112,65
2022-11-26,Los Angeles,037,10098052,3349583,3332327,192761,3525088,33882
2022-11-26,Madera,039,155013,44746,44503,8441,52944,377
2022-11-26,Marin,041,260295,46599,46293,5392,51685,314
2022-11-26,Mariposa,043,17540,3209,3156,349,3505,32
2022-11-26,Mendocino,045,87422,16345,16255,4607,20862,136
2022-11-26,Merced,047,269075,73891,73259,12074,85333,876
2022-11-26,Modoc,049,8938,900,895,346,1241,11
2022-11-26,Mono,051,14174,3239,3233,274,3507,8
2022-11-26,Monterey,053,433212,95552,95169,21810,116979,775
2022-11-26,Napa,055,140530,32890,32736,1445,34181,161
2022-11-26,Nevada,057,99092,19487,19310,2042,21352,132
2022-11-26,Orange,059,3164182,679907,676959,67535,744494,7565
2022-11-26,Placer,061,380077,77760,77331,9812,87143,665
2022-11-26,Plumas,063,18699,3741,3737,446,4183,13
2022-11-26,Riverside,065,2383286,707201,704180,37127,741307,6692
2022-11-26,Sacramento,067,1510023,355394,353538,35396,388934,3374
2022-11-26,San Benito,069,59416,16679,16474,1001,17475,108
2022-11-26,San Bernardino,071,2135413,683042,679620,32031,711651,8133
2022-11-26,San Diego,073,3302833,942081,938583,74507,1013090,5562
2022-11-26,San Francisco,075,870044,184897,183671,12550,196221,1076
2022-11-26,San Joaquin,077,732212,201799,200474,15617,216091,2344
2022-11-26,San Luis Obispo,079,281455,64248,63962,7354,71316,530
2022-11-26,San Mateo,081,765935,173799,172573,10717,183290,748
2022-11-26,Santa Barbara,083,443738,107658,107184,7070,114254,735
2022-11-26,Santa Clara,085,1922200,449095,442182,19913,462095,2558
2022-11-26,Santa Cruz,087,273765,65198,64814,3590,68404,275
2022-11-26,Shasta,089,179085,35617,35452,7903,43355,596
2022-11-26,Sierra,091,2930,308,308,61,369,5
2022-11-26,Siskiyou,093,43540,5279,5385,3379,8764,95
2022-11-26,Solano,095,438530,108047,107446,8131,115577,469
2022-11-26,Sonoma,097,501317,109155,108690,5420,114110,530
2022-11-26,Stanislaus,099,539301,140305,139741,21976,161717,1785
2022-11-26,Sutter,101,95872,24810,24730,2477,27207,234
2022-11-26,Tehama,103,63373,13958,13857,3226,17083,216
2022-11-26,Trinity,105,12862,1440,1425,456,1881,21
2022-11-26,Tulare,107,460477,123693,123029,37546,160575,1545
2022-11-26,Tuolumne,109,53932,16028,15885,938,16823,206
2022-11-26,Ventura,111,848112,212742,211680,16408,228088,1591
2022-11-26,Yolo,113,214977,48416,48228,4532,52760,408
2022-11-26,Yuba,115,75493,19317,19233,1765,20998,132
2022-11-25,Alameda,001,1643700,357946,356253,20587,376840,2059
2022-11-25,Alpine,003,1148,139,138,1,139,0
2022-11-25,Amador,005,37829,10162,10132,947,11079,95
2022-11-25,Butte,007,227075,40343,40206,9452,49658,465
2022-11-25,Calaveras,009,45235,8687,8651,587,9238,135
2022-11-25,Colusa,011,21464,3849,3840,1306,5146,22
2022-11-25,Contra Costa,013,1133247,258153,256191,21245,277436,1483
2022-11-25,Del Norte,015,27424,7524,7502,405,7907,56
2022-11-25,El Dorado,017,186661,33222,33057,4376,37433,233
2022-11-25,Fresno,019,978130,282190,278793,32478,311271,2893
2022-11-25,Glenn,021,27897,5647,5625,1913,7538,58
2022-11-25,Humboldt,023,135768,22487,22351,5324,27675,160
2022-11-25,Imperial,025,180216,67055,66747,16976,83723,960
2022-11-25,Inyo,027,18085,4593,4557,1094,5651,60
2022-11-25,Kern,029,883053,222241,221639,66556,288195,2430
2022-11-25,Kings,031,150075,60627,60457,4247,64704,463
2022-11-25,Lake,033,64148,13117,13042,1228,14270,149
2022-11-25,Lassen,035,31185,10112,10091,1020,11111,65
2022-11-25,Los Angeles,037,10098052,3347278,3332327,192360,3524687,33882
2022-11-25,Madera,039,155013,44720,44503,8433,52936,377
2022-11-25,Marin,041,260295,46558,46293,5390,51683,314
2022-11-25,Mariposa,043,17540,3206,3156,348,3504,32
2022-11-25,Mendocino,045,87422,16337,16255,4604,20859,136
2022-11-25,Merced,047,269075,73855,73259,12069,85328,876
2022-11-25,Modoc,049,8938,899,895,346,1241,11
2022-11-25,Mono,051,14174,3239,3233,274,3507,8
2022-11-25,Monterey,053,433212,95505,95169,21785,116954,775
2022-11-25,Napa,055,140530,32877,32736,1445,34181,161
2022-11-25,Nevada,057,99092,19472,19310,2038,21348,132
2022-11-25,Orange,059,3164182,679507,676959,67419,744378,7565
2022-11-25,Placer,061,380077,77719,77331,9806,87137,665
2022-11-25,Plumas,063,18699,3741,3737,446,4183,13
2022-11-25,Riverside,065,2383286,706823,704180,37045,741225,6692
2022-11-25,Sacramento,067,1510023,355180,353538,35365,388903,3374
2022-11-25,San Benito,069,59416,16654,16474,1001,17475,108
2022-11-25,San Bernardino,071,2135413,682638,679620,31994,711614,8133
2022-11-25,San Diego,073,3302833,941595,938583,74447,1013030,5562
2022-11-25,San Francisco,075,870044,184750,183671,12522,196193,1076
2022-11-25,San Joaquin,077,732212,201686,200474,15598,216072,2344
2022-11-25,San Luis Obispo,079,281455,64233,63962,7346,71308,530
2022-11-25,San Mateo,081,765935,173620,172573,10708,183281,748
2022-11-25,Santa Barbara,083,443738,107595,107184,7068,114252,735
2022-11-25,Santa Clara,085,1922200,448674,442182,19878,462060,2558
2022-11-25,Santa Cruz,087,273765,65161,64814,3589,68403,275
2022-11-25,Shasta,089,179085,35610,35452,7898,43350,596
2022-11-25,Sierra,091,2930,308,308,61,369,5
2022-11-25,Siskiyou,093,43540,5276,5385,3379,8764,95
2022-11-25,Solano,095,438530,107966,107446,8123,115569,469
2022-11-25,Sonoma,097,501317,109102,108690,5420,114110,530
2022-11-25,Stanislaus,099,539301,140231,139741,21965,161706,1785
2022-11-25,Sutter,101,95872,24799,24730,2477,27207,234
2022-11-25,Tehama,103,63373,13949,13857,3221,17078,216
2022-11-25,Trinity,105,12862,1440,1425,455,1880,21
2022-11-25,Tulare,107,460477,123634,123029,37509,160538,1545
2022-11-25,Tuolumne,109,53932,16018,15885,937,16822,206
2022-11-25,Ventura,111,848112,212611,211680,16383,228063,1591
2022-11-25,Yolo,113,214977,48397,48228,4525,52753,408
2022-11-25,Yuba,115,75493,19306,19233,1764,20997,132
2022-11-24,Alameda,001,1643700,357638,356253,20562,376815,2059
2022-11-24,Alpine,003,1148,139,138,1,139,0
2022-11-24,Amador,005,37829,10159,10132,947,11079,95
2022-11-24,Butte,007,227075,40304,40206,9437,49643,465
2022-11-24,Calaveras,009,45235,8680,8651,587,9238,135
2022-11-24,Colusa,011,21464,3846,3840,1306,5146,22
2022-11-24,Contra Costa,013,1133247,257976,256191,21236,277427,1483
2022-11-24,Del Norte,015,27424,7523,7502,405,7907,56
2022-11-24,El Dorado,017,186661,33190,33057,4375,37432,233
2022-11-24,Fresno,019,978130,282002,278793,32430,311223,2893
2022-11-24,Glenn,021,27897,5643,5625,1911,7536,58
2022-11-24,Humboldt,023,135768,22473,22351,5319,27670,160
2022-11-24,Imperial,025,180216,66993,66747,16965,83712,960
2022-11-24,Inyo,027,18085,4589,4557,1093,5650,60
2022-11-24,Kern,029,883053,222173,221639,66490,288129,2430
2022-11-24,Kings,031,150075,60593,60457,4243,64700,463
2022-11-24,Lake,033,64148,13110,13042,1228,14270,149
2022-11-24,Lassen,035,31185,10108,10091,1020,11111,65
2022-11-24,Los Angeles,037,10098052,3344681,3332327,191912,3524239,33882
2022-11-24,Madera,039,155013,44698,44503,8425,52928,377
2022-11-24,Marin,041,260295,46513,46293,5389,51682,314
2022-11-24,Mariposa,043,17540,3202,3156,348,3504,32
2022-11-24,Mendocino,045,87422,16331,16255,4601,20856,136
2022-11-24,Merced,047,269075,73796,73259,12064,85323,876
2022-11-24,Modoc,049,8938,899,895,346,1241,11
2022-11-24,Mono,051,14174,3237,3233,274,3507,8
2022-11-24,Monterey,053,433212,95465,95169,21770,116939,775
2022-11-24,Napa,055,140530,32857,32736,1445,34181,161
2022-11-24,Nevada,057,99092,19457,19310,2034,21344,132
2022-11-24,Orange,059,3164182,679079,676959,67252,744211,7565
2022-11-24,Placer,061,380077,77678,77331,9795,87126,665
2022-11-24,Plumas,063,18699,3740,3737,446,4183,13
2022-11-24,Riverside,065,2383286,706354,704180,36959,741139,6692
2022-11-24,Sacramento,067,1510023,354924,353538,35346,388884,3374
2022-11-24,San Benito,069,59416,16644,16474,1000,17474,108
2022-11-24,San Bernardino,071,2135413,682150,679620,31942,711562,8133
2022-11-24,San Diego,073,3302833,941005,938583,74366,1012949,5562
2022-11-24,San Francisco,075,870044,184590,183671,12505,196176,1076
2022-11-24,San Joaquin,077,732212,201529,200474,15565,216039,2344
2022-11-24,San Luis Obispo,079,281455,64213,63962,7341,71303,530
2022-11-24,San Mateo,081,765935,173484,172573,10702,183275,748
2022-11-24,Santa Barbara,083,443738,107550,107184,7066,114250,735
2022-11-24,Santa Clara,085,1922200,448342,442182,19862,462044,2558
2022-11-24,Santa Cruz,087,273765,65131,64814,3588,68402,275
2022-11-24,Shasta,089,179085,35597,35452,7892,43344,596
2022-11-24,Sierra,091,2930,308,308,61,369,5
2022-11-24,Siskiyou,093,43540,5276,5385,3379,8764,95
2022-11-24,Solano,095,438530,107848,107446,8122,115568,469
2022-11-24,Sonoma,097,501317,109039,108690,5418,114108,530
2022-11-24,Stanislaus,099,539301,140150,139741,21953,161694,1785
2022-11-24,Sutter,101,95872,24787,24730,2477,27207,234
2022-11-24,Tehama,103,63373,13938,13857,3218,17075,216
2022-11-24,Trinity,105,12862,1440,1425,454,1879,21
2022-11-24,Tulare,107,460477,123581,123029,37476,160505,1545
2022-11-24,Tuolumne,109,53932,16004,15885,935,16820,206
2022-11-24,Ventura,111,848112,212469,211680,16345,228025,1591
2022-11-24,Yolo,113,214977,48377,48228,4523,52751,408
2022-11-24,Yuba,115,75493,19289,19233,1764,20997,132
2022-11-23,Alameda,001,1643700,357490,356253,20553,376806,2059
2022-11-23,Alpine,003,1148,139,138,1,139,0
2022-11-23,Amador,005,37829,10156,10132,947,11079,95
2022-11-23,Butte,007,227075,40288,40206,9426,49632,465
2022-11-23,Calaveras,009,45235,8674,8651,587,9238,135
2022-11-23,Colusa,011,21464,3846,3840,1306,5146,22
2022-11-23,Contra Costa,013,1133247,257866,256191,21232,277423,1483
2022-11-23,Del Norte,015,27424,7522,7502,405,7907,56
2022-11-23,El Dorado,017,186661,33180,33057,4374,37431,233
2022-11-23,Fresno,019,978130,281914,278793,32408,311201,2893
2022-11-23,Glenn,021,27897,5642,5625,1910,7535,58
2022-11-23,Humboldt,023,135768,22467,22351,5317,27668,160
2022-11-23,Imperial,025,180216,66951,66747,16959,83706,960
2022-11-23,Inyo,027,18085,4588,4557,1092,5649,60
2022-11-23,Kern,029,883053,222131,221639,66479,288118,2430
2022-11-23,Kings,031,150075,60581,60457,4242,64699,463
2022-11-23,Lake,033,64148,13104,13042,1228,14270,149
2022-11-23,Lassen,035,31185,10104,10091,1020,11111,65
2022-11-23,Los Angeles,037,10098052,3343629,3332327,191706,3524033,33882
2022-11-23,Madera,039,155013,44697,44503,8422,52925,377
2022-11-23,Marin,041,260295,46488,46293,5387,51680,314
2022-11-23,Mariposa,043,17540,3202,3156,348,3504,32
2022-11-23,Mendocino,045,87422,16330,16255,4598,20853,136
2022-11-23,Merced,047,269075,73775,73259,12060,85319,876
2022-11-23,Modoc,049,8938,899,895,346,1241,11
2022-11-23,Mono,051,14174,3237,3233,274,3507,8
2022-11-23,Monterey,053,433212,95444,95169,21764,116933,775
2022-11-23,Napa,055,140530,32846,32736,1445,34181,161
2022-11-23,Nevada,057,99092,19450,19310,2033,21343,132
2022-11-23,Orange,059,3164182,678943,676959,67191,744150,7565
2022-11-23,Placer,061,380077,77640,77331,9791,87122,665
2022-11-23,Plumas,063,18699,3739,3737,446,4183,13
2022-11-23,Riverside,065,2383286,706170,704180,36930,741110,6692
2022-11-23,Sacramento,067,1510023,354805,353538,35335,388873,3374
2022-11-23,San Benito,069,59416,16641,16474,1000,17474,108
2022-11-23,San Bernardino,071,2135413,681956,679620,31923,711543,8133
2022-11-23,San Diego,073,3302833,940797,938583,74329,1012912,5562
2022-11-23,San Francisco,075,870044,184515,183671,12502,196173,1076
2022-11-23,San Joaquin,077,732212,201463,200474,15545,216019,2344
2022-11-23,San Luis Obispo,079,281455,64207,63962,7341,71303,530
2022-11-23,San Mateo,081,765935,173431,172573,10697,183270,748
2022-11-23,Santa Barbara,083,443738,107516,107184,7064,114248,735
2022-11-23,Santa Clara,085,1922200,448167,442182,19845,462027,2558
2022-11-23,Santa Cruz,087,273765,65113,64814,3588,68402,275
2022-11-23,Shasta,089,179085,35591,35452,7890,43342,596
2022-11-23,Sierra,091,2930,308,308,61,369,5
2022-11-23,Siskiyou,093,43540,5273,5385,3379,8764,95
2022-11-23,Solano,095,438530,107833,107446,8120,115566,469
2022-11-23,Sonoma,097,501317,109008,108690,5418,114108,530
2022-11-23,Stanislaus,099,539301,140111,139741,21949,161690,1785
2022-11-23,Sutter,101,95872,24783,24730,2477,27207,234
2022-11-23,Tehama,103,63373,13933,13857,3217,17074,216
2022-11-23,Trinity,105,12862,1440,1425,454,1879,21
2022-11-23,Tulare,107,460477,123532,123029,37456,160485,1545
2022-11-23,Tuolumne,109,53932,15991,15885,935,16820,206
2022-11-23,Ventura,111,848112,212402,211680,16337,228017,1591
2022-11-23,Yolo,113,214977,48359,48228,4522,52750,408
2022-11-23,Yuba,115,75493,19282,19233,1763,20996,132
2022-11-22,Alameda,001,1643700,357123,356253,20512,376765,2059
2022-11-22,Alpine,003,1148,139,138,1,139,0
2022-11-22,Amador,005,37829,10152,10132,947,11079,95
2022-11-22,Butte,007,227075,40260,40206,9417,49623,465
2022-11-22,Calaveras,009,45235,8672,8651,586,9237,135
2022-11-22,Colusa,011,21464,3845,3840,1306,5146,22
2022-11-22,Contra Costa,013,1133247,257632,256191,21211,277402,1483
2022-11-22,Del Norte,015,27424,7517,7502,405,7907,56
2022-11-22,El Dorado,017,186661,33153,33057,4369,37426,233
2022-11-22,Fresno,019,978130,281724,278793,32368,311161,2893
2022-11-22,Glenn,021,27897,5639,5625,1905,7530,58
2022-11-22,Humboldt,023,135768,22443,22351,5306,27657,160
2022-11-22,Imperial,025,180216,66899,66747,16864,83611,960
2022-11-22,Inyo,027,18085,4584,4557,1090,5647,60
2022-11-22,Kern,029,883053,222066,221639,66429,288068,2430
2022-11-22,Kings,031,150075,60539,60457,4240,64697,463
2022-11-22,Lake,033,64148,13101,13042,1226,14268,149
2022-11-22,Lassen,035,31185,10097,10091,1019,11110,65
2022-11-22,Los Angeles,037,10098052,3340936,3332327,191248,3523575,33882
2022-11-22,Madera,039,155013,44672,44503,8411,52914,377
2022-11-22,Marin,041,260295,46446,46293,5385,51678,314
2022-11-22,Mariposa,043,17540,3197,3156,348,3504,32
2022-11-22,Mendocino,045,87422,16324,16255,4594,20849,136
2022-11-22,Merced,047,269075,73735,73259,12053,85312,876
2022-11-22,Modoc,049,8938,899,895,343,1238,11
2022-11-22,Mono,051,14174,3236,3233,274,3507,8
2022-11-22,Monterey,053,433212,95412,95169,21746,116915,775
2022-11-22,Napa,055,140530,32818,32736,1442,34178,161
2022-11-22,Nevada,057,99092,19429,19310,2022,21332,132
2022-11-22,Orange,059,3164182,678534,676959,67024,743983,7565
2022-11-22,Placer,061,380077,77581,77331,9783,87114,665
2022-11-22,Plumas,063,18699,3737,3737,446,4183,13
2022-11-22,Riverside,065,2383286,705748,704180,36851,741031,6692
2022-11-22,Sacramento,067,1510023,354557,353538,35308,388846,3374
2022-11-22,San Benito,069,59416,16625,16474,998,17472,108
2022-11-22,San Bernardino,071,2135413,681552,679620,31887,711507,8133
2022-11-22,San Diego,073,3302833,940295,938583,74226,1012809,5562
2022-11-22,San Francisco,075,870044,184370,183671,12489,196160,1076
2022-11-22,San Joaquin,077,732212,201334,200474,15513,215987,2344
2022-11-22,San Luis Obispo,079,281455,64186,63962,7328,71290,530
2022-11-22,San Mateo,081,765935,173295,172573,10687,183260,748
2022-11-22,Santa Barbara,083,443738,107464,107184,7050,114234,735
2022-11-22,Santa Clara,085,1922200,447776,442182,19817,461999,2558
2022-11-22,Santa Cruz,087,273765,65068,64814,3586,68400,275
2022-11-22,Shasta,089,179085,35573,35452,7884,43336,596
2022-11-22,Sierra,091,2930,308,308,61,369,5
2022-11-22,Siskiyou,093,43540,5269,5385,3379,8764,95
2022-11-22,Solano,095,438530,107749,107446,8118,115564,469
2022-11-22,Sonoma,097,501317,108942,108690,5409,114099,530
2022-11-22,Stanislaus,099,539301,140039,139741,21937,161678,1785
2022-11-22,Sutter,101,95872,24769,24730,2476,27206,234
2022-11-22,Tehama,103,63373,13923,13857,3216,17073,216
2022-11-22,Trinity,105,12862,1439,1425,453,1878,21
2022-11-22,Tulare,107,460477,123457,123029,37412,160441,1545
2022-11-22,Tuolumne,109,53932,15980,15885,934,16819,206
2022-11-22,Ventura,111,848112,212297,211680,16316,227996,1591
2022-11-22,Yolo,113,214977,48334,48228,4516,52744,408
2022-11-22,Yuba,115,75493,19272,19233,1763,20996,132
2022-11-21,Alameda,001,1643700,356847,354457,20487,374944,2054
2022-11-21,Alpine,003,1148,139,136,1,137,0
2022-11-21,Amador,005,37829,10147,10108,946,11054,95
2022-11-21,Butte,007,227075,40226,40058,9409,49467,461
2022-11-21,Calaveras,009,45235,8667,8612,585,9197,135
2022-11-21,Colusa,011,21464,3843,3828,1306,5134,22
2022-11-21,Contra Costa,013,1133247,257456,254944,21200,276144,1479
2022-11-21,Del Norte,015,27424,7515,7492,405,7897,56
2022-11-21,El Dorado,017,186661,33126,32903,4363,37266,233
2022-11-21,Fresno,019,978130,281552,277735,32325,310060,2888
2022-11-21,Glenn,021,27897,5636,5591,1902,7493,50
2022-11-21,Humboldt,023,135768,22425,22254,5295,27549,160
2022-11-21,Imperial,025,180216,66846,66473,16805,83278,960
2022-11-21,Inyo,027,18085,4578,4530,1086,5616,60
2022-11-21,Kern,029,883053,221967,221145,66379,287524,2430
2022-11-21,Kings,031,150075,60506,60156,4238,64394,462
2022-11-21,Lake,033,64148,13092,12978,1225,14203,149
2022-11-21,Lassen,035,31185,10093,10043,1018,11061,65
2022-11-21,Los Angeles,037,10098052,3338331,3320411,190778,3511189,33830
2022-11-21,Madera,039,155013,44654,44373,8409,52782,375
2022-11-21,Marin,041,260295,46400,46115,5384,51499,314
2022-11-21,Mariposa,043,17540,3190,3138,348,3486,32
2022-11-21,Mendocino,045,87422,16316,16205,4593,20798,136
2022-11-21,Merced,047,269075,73694,73022,12051,85073,875
2022-11-21,Modoc,049,8938,897,889,342,1231,11
2022-11-21,Mono,051,14174,3236,3226,273,3499,8
2022-11-21,Monterey,053,433212,95374,94949,21721,116670,773
2022-11-21,Napa,055,140530,32797,32610,1441,34051,161
2022-11-21,Nevada,057,99092,19407,19238,2015,21253,132
2022-11-21,Orange,059,3164182,678065,674980,66827,741807,7553
2022-11-21,Placer,061,380077,77525,76976,9776,86752,662
2022-11-21,Plumas,063,18699,3737,3729,446,4175,13
2022-11-21,Riverside,065,2383286,705302,702343,36770,739113,6686
2022-11-21,Sacramento,067,1510023,354258,352117,35262,387379,3362
2022-11-21,San Benito,069,59416,16613,16410,997,17407,108
2022-11-21,San Bernardino,071,2135413,681048,677641,31830,709471,8131
2022-11-21,San Diego,073,3302833,939696,935811,74103,1009914,5557
2022-11-21,San Francisco,075,870044,184198,182855,12480,195335,1074
2022-11-21,San Joaquin,077,732212,201205,199682,15479,215161,2341
2022-11-21,San Luis Obispo,079,281455,64159,63812,7321,71133,530
2022-11-21,San Mateo,081,765935,173171,171862,10681,182543,748
2022-11-21,Santa Barbara,083,443738,107389,106885,7047,113932,733
2022-11-21,Santa Clara,085,1922200,447368,440104,19797,459901,2541
2022-11-21,Santa Cruz,087,273765,65023,64515,3579,68094,276
2022-11-21,Shasta,089,179085,35555,35346,7876,43222,595
2022-11-21,Sierra,091,2930,308,308,60,368,5
2022-11-21,Siskiyou,093,43540,5264,5364,3379,8743,95
2022-11-21,Solano,095,438530,107648,106903,8112,115015,469
2022-11-21,Sonoma,097,501317,108860,108386,5405,113791,527
2022-11-21,Stanislaus,099,539301,139962,139293,21922,161215,1785
2022-11-21,Sutter,101,95872,24753,24642,2476,27118,234
2022-11-21,Tehama,103,63373,13915,13784,3213,16997,216
2022-11-21,Trinity,105,12862,1438,1422,450,1872,20
2022-11-21,Tulare,107,460477,123384,122707,37375,160082,1545
2022-11-21,Tuolumne,109,53932,15975,15805,934,16739,209
2022-11-21,Ventura,111,848112,212157,210938,16287,227225,1586
2022-11-21,Yolo,113,214977,48305,48092,4512,52604,355
2022-11-21,Yuba,115,75493,19252,19157,1762,20919,132
2022-11-20,Alameda,001,1643700,356502,354457,20451,374908,2054
2022-11-20,Alpine,003,1148,139,136,1,137,0
2022-11-20,Amador,005,37829,10144,10108,945,11053,95
2022-11-20,Butte,007,227075,40195,40058,9391,49449,461
2022-11-20,Calaveras,009,45235,8659,8612,585,9197,135
2022-11-20,Colusa,011,21464,3841,3828,1306,5134,22
2022-11-20,Contra Costa,013,1133247,257255,254944,21184,276128,1479
2022-11-20,Del Norte,015,27424,7509,7492,405,7897,56
2022-11-20,El Dorado,017,186661,33074,32903,4360,37263,233
2022-11-20,Fresno,019,978130,281340,277735,32277,310012,2888
2022-11-20,Glenn,021,27897,5631,5591,1901,7492,50
2022-11-20,Humboldt,023,135768,22405,22254,5291,27545,160
2022-11-20,Imperial,025,180216,66780,66473,16756,83229,960
2022-11-20,Inyo,027,18085,4571,4530,1085,5615,60
2022-11-20,Kern,029,883053,221866,221145,66324,287469,2430
2022-11-20,Kings,031,150075,60457,60156,4237,64393,462
2022-11-20,Lake,033,64148,13081,12978,1219,14197,149
2022-11-20,Lassen,035,31185,10092,10043,1016,11059,65
2022-11-20,Los Angeles,037,10098052,3335482,3320411,190302,3510713,33830
2022-11-20,Madera,039,155013,44636,44373,8404,52777,375
2022-11-20,Marin,041,260295,46371,46115,5380,51495,314
2022-11-20,Mariposa,043,17540,3186,3138,348,3486,32
2022-11-20,Mendocino,045,87422,16311,16205,4590,20795,136
2022-11-20,Merced,047,269075,73616,73022,12044,85066,875
2022-11-20,Modoc,049,8938,893,889,342,1231,11
2022-11-20,Mono,051,14174,3234,3226,273,3499,8
2022-11-20,Monterey,053,433212,95334,94949,21699,116648,773
2022-11-20,Napa,055,140530,32774,32610,1438,34048,161
2022-11-20,Nevada,057,99092,19376,19238,2007,21245,132
2022-11-20,Orange,059,3164182,677601,674980,66665,741645,7553
2022-11-20,Placer,061,380077,77464,76976,9773,86749,662
2022-11-20,Plumas,063,18699,3736,3729,446,4175,13
2022-11-20,Riverside,065,2383286,704886,702343,36689,739032,6686
2022-11-20,Sacramento,067,1510023,353965,352117,35232,387349,3362
2022-11-20,San Benito,069,59416,16594,16410,996,17406,108
2022-11-20,San Bernardino,071,2135413,680529,677641,31776,709417,8131
2022-11-20,San Diego,073,3302833,939019,935811,73996,1009807,5557
2022-11-20,San Francisco,075,870044,183990,182855,12459,195314,1074
2022-11-20,San Joaquin,077,732212,201080,199682,15457,215139,2341
2022-11-20,San Luis Obispo,079,281455,64126,63812,7317,71129,530
2022-11-20,San Mateo,081,765935,173026,171862,10665,182527,748
2022-11-20,Santa Barbara,083,443738,107325,106885,7036,113921,733
2022-11-20,Santa Clara,085,1922200,446976,440104,19768,459872,2541
2022-11-20,Santa Cruz,087,273765,64953,64515,3575,68090,276
2022-11-20,Shasta,089,179085,35536,35346,7864,43210,595
2022-11-20,Sierra,091,2930,308,308,60,368,5
2022-11-20,Siskiyou,093,43540,5262,5364,3378,8742,95
2022-11-20,Solano,095,438530,107537,106903,8103,115006,469
2022-11-20,Sonoma,097,501317,108798,108386,5403,113789,527
2022-11-20,Stanislaus,099,539301,139871,139293,21902,161195,1785
2022-11-20,Sutter,101,95872,24735,24642,2475,27117,234
2022-11-20,Tehama,103,63373,13904,13784,3213,16997,216
2022-11-20,Trinity,105,12862,1438,1422,447,1869,20
2022-11-20,Tulare,107,460477,123315,122707,37332,160039,1545
2022-11-20,Tuolumne,109,53932,15963,15805,933,16738,209
2022-11-20,Ventura,111,848112,212026,210938,16263,227201,1586
2022-11-20,Yolo,113,214977,48278,48092,4502,52594,355
2022-11-20,Yuba,115,75493,19247,19157,1762,20919,132
2022-11-19,Alameda,001,1643700,356325,354457,20430,374887,2054
2022-11-19,Alpine,003,1148,139,136,1,137,0
2022-11-19,Amador,005,37829,10141,10108,945,11053,95
2022-11-19,Butte,007,227075,40183,40058,9381,49439,461
2022-11-19,Calaveras,009,45235,8656,8612,583,9195,135
2022-11-19,Colusa,011,21464,3839,3828,1306,5134,22
2022-11-19,Contra Costa,013,1133247,257159,254944,21182,276126,1479
2022-11-19,Del Norte,015,27424,7508,7492,405,7897,56
2022-11-19,El Dorado,017,186661,33050,32903,4359,37262,233
2022-11-19,Fresno,019,978130,281235,277735,32258,309993,2888
2022-11-19,Glenn,021,27897,5631,5591,1901,7492,50
2022-11-19,Humboldt,023,135768,22390,22254,5285,27539,160
2022-11-19,Imperial,025,180216,66758,66473,16748,83221,960
2022-11-19,Inyo,027,18085,4569,4530,1081,5611,60
2022-11-19,Kern,029,883053,221830,221145,66302,287447,2430
2022-11-19,Kings,031,150075,60435,60156,4235,64391,462
2022-11-19,Lake,033,64148,13076,12978,1219,14197,149
2022-11-19,Lassen,035,31185,10091,10043,1016,11059,65
2022-11-19,Los Angeles,037,10098052,3333988,3320411,190062,3510473,33830
2022-11-19,Madera,039,155013,44621,44373,8403,52776,375
2022-11-19,Marin,041,260295,46348,46115,5380,51495,314
2022-11-19,Mariposa,043,17540,3186,3138,348,3486,32
2022-11-19,Mendocino,045,87422,16308,16205,4585,20790,136
2022-11-19,Merced,047,269075,73592,73022,12040,85062,875
2022-11-19,Modoc,049,8938,893,889,342,1231,11
2022-11-19,Mono,051,14174,3234,3226,273,3499,8
2022-11-19,Monterey,053,433212,95308,94949,21689,116638,773
2022-11-19,Napa,055,140530,32763,32610,1436,34046,161
2022-11-19,Nevada,057,99092,19366,19238,2004,21242,132
2022-11-19,Orange,059,3164182,677383,674980,66586,741566,7553
2022-11-19,Placer,061,380077,77413,76976,9767,86743,662
2022-11-19,Plumas,063,18699,3736,3729,446,4175,13
2022-11-19,Riverside,065,2383286,704655,702343,36635,738978,6686
2022-11-19,Sacramento,067,1510023,353846,352117,35222,387339,3362
2022-11-19,San Benito,069,59416,16581,16410,996,17406,108
2022-11-19,San Bernardino,071,2135413,680271,677641,31748,709389,8131
2022-11-19,San Diego,073,3302833,938780,935811,73958,1009769,5557
2022-11-19,San Francisco,075,870044,183895,182855,12455,195310,1074
2022-11-19,San Joaquin,077,732212,200990,199682,15429,215111,2341
2022-11-19,San Luis Obispo,079,281455,64111,63812,7313,71125,530
2022-11-19,San Mateo,081,765935,172948,171862,10659,182521,748
2022-11-19,Santa Barbara,083,443738,107288,106885,7031,113916,733
2022-11-19,Santa Clara,085,1922200,446763,440104,19752,459856,2541
2022-11-19,Santa Cruz,087,273765,64935,64515,3573,68088,276
2022-11-19,Shasta,089,179085,35527,35346,7857,43203,595
2022-11-19,Sierra,091,2930,308,308,60,368,5
2022-11-19,Siskiyou,093,43540,5255,5364,3378,8742,95
2022-11-19,Solano,095,438530,107506,106903,8098,115001,469
2022-11-19,Sonoma,097,501317,108773,108386,5402,113788,527
2022-11-19,Stanislaus,099,539301,139810,139293,21900,161193,1785
2022-11-19,Sutter,101,95872,24726,24642,2475,27117,234
2022-11-19,Tehama,103,63373,13897,13784,3212,16996,216
2022-11-19,Trinity,105,12862,1438,1422,447,1869,20
2022-11-19,Tulare,107,460477,123278,122707,37310,160017,1545
2022-11-19,Tuolumne,109,53932,15946,15805,932,16737,209
2022-11-19,Ventura,111,848112,211946,210938,16248,227186,1586
2022-11-19,Yolo,113,214977,48261,48092,4501,52593,355
2022-11-19,Yuba,115,75493,19241,19157,1762,20919,132
2022-11-18,Alameda,001,1643700,356140,354457,20413,374870,2054
2022-11-18,Alpine,003,1148,139,136,1,137,0
2022-11-18,Amador,005,37829,10135,10108,945,11053,95
2022-11-18,Butte,007,227075,40170,40058,9374,49432,461
2022-11-18,Calaveras,009,45235,8651,8612,583,9195,135
2022-11-18,Colusa,011,21464,3837,3828,1306,5134,22
2022-11-18,Contra Costa,013,1133247,257040,254944,21176,276120,1479
2022-11-18,Del Norte,015,27424,7506,7492,405,7897,56
2022-11-18,El Dorado,017,186661,33039,32903,4358,37261,233
2022-11-18,Fresno,019,978130,281122,277735,32239,309974,2888
2022-11-18,Glenn,021,27897,5630,5591,1901,7492,50
2022-11-18,Humboldt,023,135768,22377,22254,5281,27535,160
2022-11-18,Imperial,025,180216,66741,66473,16737,83210,960
2022-11-18,Inyo,027,18085,4567,4530,1076,5606,60
2022-11-18,Kern,029,883053,221798,221145,66252,287397,2430
2022-11-18,Kings,031,150075,60416,60156,4233,64389,462
2022-11-18,Lake,033,64148,13072,12978,1219,14197,149
2022-11-18,Lassen,035,31185,10091,10043,1016,11059,65
2022-11-18,Los Angeles,037,10098052,3332594,3320411,189811,3510222,33830
2022-11-18,Madera,039,155013,44599,44373,8397,52770,375
2022-11-18,Marin,041,260295,46327,46115,5376,51491,314
2022-11-18,Mariposa,043,17540,3179,3138,348,3486,32
2022-11-18,Mendocino,045,87422,16305,16205,4584,20789,136
2022-11-18,Merced,047,269075,73573,73022,12036,85058,875
2022-11-18,Modoc,049,8938,893,889,341,1230,11
2022-11-18,Mono,051,14174,3234,3226,272,3498,8
2022-11-18,Monterey,053,433212,95282,94949,21678,116627,773
2022-11-18,Napa,055,140530,32752,32610,1436,34046,161
2022-11-18,Nevada,057,99092,19359,19238,1995,21233,132
2022-11-18,Orange,059,3164182,677179,674980,66485,741465,7553
2022-11-18,Placer,061,380077,77379,76976,9760,86736,662
2022-11-18,Plumas,063,18699,3735,3729,445,4174,13
2022-11-18,Riverside,065,2383286,704440,702343,36590,738933,6686
2022-11-18,Sacramento,067,1510023,353688,352117,35204,387321,3362
2022-11-18,San Benito,069,59416,16578,16410,996,17406,108
2022-11-18,San Bernardino,071,2135413,680051,677641,31725,709366,8131
2022-11-18,San Diego,073,3302833,938452,935811,73919,1009730,5557
2022-11-18,San Francisco,075,870044,183792,182855,12433,195288,1074
2022-11-18,San Joaquin,077,732212,200913,199682,15414,215096,2341
2022-11-18,San Luis Obispo,079,281455,64095,63812,7310,71122,530
2022-11-18,San Mateo,081,765935,172889,171862,10650,182512,748
2022-11-18,Santa Barbara,083,443738,107260,106885,7027,113912,733
2022-11-18,Santa Clara,085,1922200,446532,440104,19736,459840,2541
2022-11-18,Santa Cruz,087,273765,64912,64515,3570,68085,276
2022-11-18,Shasta,089,179085,35518,35346,7853,43199,595
2022-11-18,Sierra,091,2930,308,308,60,368,5
2022-11-18,Siskiyou,093,43540,5253,5364,3378,8742,95
2022-11-18,Solano,095,438530,107450,106903,8096,114999,469
2022-11-18,Sonoma,097,501317,108738,108386,5400,113786,527
2022-11-18,Stanislaus,099,539301,139761,139293,21894,161187,1785
2022-11-18,Sutter,101,95872,24719,24642,2475,27117,234
2022-11-18,Tehama,103,63373,13893,13784,3211,16995,216
2022-11-18,Trinity,105,12862,1438,1422,446,1868,20
2022-11-18,Tulare,107,460477,123234,122707,37277,159984,1545
2022-11-18,Tuolumne,109,53932,15933,15805,932,16737,209
2022-11-18,Ventura,111,848112,211868,210938,16227,227165,1586
2022-11-18,Yolo,113,214977,48246,48092,4496,52588,355
2022-11-18,Yuba,115,75493,19230,19157,1762,20919,132
2022-11-17,Alameda,001,1643700,355882,354457,20383,374840,2054
2022-11-17,Alpine,003,1148,138,136,1,137,0
2022-11-17,Amador,005,37829,10132,10108,945,11053,95
2022-11-17,Butte,007,227075,40147,40058,9363,49421,461
2022-11-17,Calaveras,009,45235,8646,8612,581,9193,135
2022-11-17,Colusa,011,21464,3837,3828,1306,5134,22
2022-11-17,Contra Costa,013,1133247,256889,254944,21166,276110,1479
2022-11-17,Del Norte,015,27424,7502,7492,405,7897,56
2022-11-17,El Dorado,017,186661,33010,32903,4358,37261,233
2022-11-17,Fresno,019,978130,280958,277735,32213,309948,2888
2022-11-17,Glenn,021,27897,5624,5591,1897,7488,50
2022-11-17,Humboldt,023,135768,22370,22254,5277,27531,160
2022-11-17,Imperial,025,180216,66690,66473,16698,83171,960
2022-11-17,Inyo,027,18085,4560,4530,1074,5604,60
2022-11-17,Kern,029,883053,221722,221145,66215,287360,2430
2022-11-17,Kings,031,150075,60380,60156,4227,64383,462
2022-11-17,Lake,033,64148,13066,12978,1219,14197,149
2022-11-17,Lassen,035,31185,10084,10043,1013,11056,65
2022-11-17,Los Angeles,037,10098052,3330653,3320411,189523,3509934,33830
2022-11-17,Madera,039,155013,44543,44373,8393,52766,375
2022-11-17,Marin,041,260295,46300,46115,5372,51487,314
2022-11-17,Mariposa,043,17540,3174,3138,348,3486,32
2022-11-17,Mendocino,045,87422,16299,16205,4584,20789,136
2022-11-17,Merced,047,269075,73534,73022,12033,85055,875
2022-11-17,Modoc,049,8938,891,889,341,1230,11
2022-11-17,Mono,051,14174,3233,3226,272,3498,8
2022-11-17,Monterey,053,433212,95253,94949,21660,116609,773
2022-11-17,Napa,055,140530,32728,32610,1435,34045,161
2022-11-17,Nevada,057,99092,19347,19238,1991,21229,132
2022-11-17,Orange,059,3164182,676862,674980,66364,741344,7553
2022-11-17,Placer,061,380077,77334,76976,9754,86730,662
2022-11-17,Plumas,063,18699,3731,3729,445,4174,13
2022-11-17,Riverside,065,2383286,704140,702343,36541,738884,6686
2022-11-17,Sacramento,067,1510023,353469,352117,35172,387289,3362
2022-11-17,San Benito,069,59416,16570,16410,994,17404,108
2022-11-17,San Bernardino,071,2135413,679736,677641,31691,709332,8131
2022-11-17,San Diego,073,3302833,938045,935811,73868,1009679,5557
2022-11-17,San Francisco,075,870044,183664,182855,12414,195269,1074
2022-11-17,San Joaquin,077,732212,200793,199682,15374,215056,2341
2022-11-17,San Luis Obispo,079,281455,64074,63812,7307,71119,530
2022-11-17,San Mateo,081,765935,172789,171862,10648,182510,748
2022-11-17,Santa Barbara,083,443738,107220,106885,7024,113909,733
2022-11-17,Santa Clara,085,1922200,446193,440104,19711,459815,2541
2022-11-17,Santa Cruz,087,273765,64875,64515,3568,68083,276
2022-11-17,Shasta,089,179085,35506,35346,7844,43190,595
2022-11-17,Sierra,091,2930,308,308,60,368,5
2022-11-17,Siskiyou,093,43540,5250,5364,3378,8742,95
2022-11-17,Solano,095,438530,107384,106903,8093,114996,469
2022-11-17,Sonoma,097,501317,108688,108386,5399,113785,527
2022-11-17,Stanislaus,099,539301,139701,139293,21881,161174,1785
2022-11-17,Sutter,101,95872,24708,24642,2475,27117,234
2022-11-17,Tehama,103,63373,13879,13784,3209,16993,216
2022-11-17,Trinity,105,12862,1436,1422,443,1865,20
2022-11-17,Tulare,107,460477,123166,122707,37247,159954,1545
2022-11-17,Tuolumne,109,53932,15917,15805,932,16737,209
2022-11-17,Ventura,111,848112,211767,210938,16206,227144,1586
2022-11-17,Yolo,113,214977,48235,48092,4491,52583,355
2022-11-17,Yuba,115,75493,19215,19157,1760,20917,132
2022-11-16,Alameda,001,1643700,355652,354457,20360,374817,2054
2022-11-16,Alpine,003,1148,138,136,1,137,0
2022-11-16,Amador,005,37829,10125,10108,945,11053,95
2022-11-16,Butte,007,227075,40124,40058,9347,49405,461
2022-11-16,Calaveras,009,45235,8639,8612,580,9192,135
2022-11-16,Colusa,011,21464,3835,3828,1305,5133,22
2022-11-16,Contra Costa,013,1133247,256760,254944,21146,276090,1479
2022-11-16,Del Norte,015,27424,7502,7492,405,7897,56
2022-11-16,El Dorado,017,186661,32987,32903,4357,37260,233
2022-11-16,Fresno,019,978130,280801,277735,32189,309924,2888
2022-11-16,Glenn,021,27897,5621,5591,1896,7487,50
2022-11-16,Humboldt,023,135768,22353,22254,5271,27525,160
2022-11-16,Imperial,025,180216,66651,66473,16635,83108,960
2022-11-16,Inyo,027,18085,4555,4530,1067,5597,60
2022-11-16,Kern,029,883053,221641,221145,66167,287312,2430
2022-11-16,Kings,031,150075,60321,60156,4223,64379,462
2022-11-16,Lake,033,64148,13051,12978,1219,14197,149
2022-11-16,Lassen,035,31185,10080,10043,1011,11054,65
2022-11-16,Los Angeles,037,10098052,3328840,3320411,189213,3509624,33830
2022-11-16,Madera,039,155013,44523,44373,8387,52760,375
2022-11-16,Marin,041,260295,46274,46115,5367,51482,314
2022-11-16,Mariposa,043,17540,3174,3138,348,3486,32
2022-11-16,Mendocino,045,87422,16294,16205,4582,20787,136
2022-11-16,Merced,047,269075,73483,73022,12027,85049,875
2022-11-16,Modoc,049,8938,890,889,341,1230,11
2022-11-16,Mono,051,14174,3233,3226,272,3498,8
2022-11-16,Monterey,053,433212,95215,94949,21639,116588,773
2022-11-16,Napa,055,140530,32698,32610,1432,34042,161
2022-11-16,Nevada,057,99092,19336,19238,1988,21226,132
2022-11-16,Orange,059,3164182,676545,674980,66234,741214,7553
2022-11-16,Placer,061,380077,77275,76976,9752,86728,662
2022-11-16,Plumas,063,18699,3731,3729,445,4174,13
2022-11-16,Riverside,065,2383286,703820,702343,36478,738821,6686
2022-11-16,Sacramento,067,1510023,353224,352117,35143,387260,3362
2022-11-16,San Benito,069,59416,16561,16410,992,17402,108
2022-11-16,San Bernardino,071,2135413,679371,677641,31670,709311,8131
2022-11-16,San Diego,073,3302833,937578,935811,73815,1009626,5557
2022-11-16,San Francisco,075,870044,183533,182855,12403,195258,1074
2022-11-16,San Joaquin,077,732212,200671,199682,15362,215044,2341
2022-11-16,San Luis Obispo,079,281455,64051,63812,7302,71114,530
2022-11-16,San Mateo,081,765935,172685,171862,10642,182504,748
2022-11-16,Santa Barbara,083,443738,107170,106885,7014,113899,733
2022-11-16,Santa Clara,085,1922200,445856,440104,19692,459796,2541
2022-11-16,Santa Cruz,087,273765,64833,64515,3567,68082,276
2022-11-16,Shasta,089,179085,35497,35346,7837,43183,595
2022-11-16,Sierra,091,2930,308,308,60,368,5
2022-11-16,Siskiyou,093,43540,5247,5364,3377,8741,95
2022-11-16,Solano,095,438530,107316,106903,8087,114990,469
2022-11-16,Sonoma,097,501317,108637,108386,5397,113783,527
2022-11-16,Stanislaus,099,539301,139640,139293,21869,161162,1785
2022-11-16,Sutter,101,95872,24693,24642,2475,27117,234
2022-11-16,Tehama,103,63373,13868,13784,3195,16979,216
2022-11-16,Trinity,105,12862,1435,1422,442,1864,20
2022-11-16,Tulare,107,460477,123107,122707,37211,159918,1545
2022-11-16,Tuolumne,109,53932,15902,15805,932,16737,209
2022-11-16,Ventura,111,848112,211651,210938,16184,227122,1586
2022-11-16,Yolo,113,214977,48212,48092,4484,52576,355
2022-11-16,Yuba,115,75493,19201,19157,1760,20917,132
2022-11-15,Alameda,001,1643700,355418,354457,20349,374806,2054
2022-11-15,Alpine,003,1148,138,136,1,137,0
2022-11-15,Amador,005,37829,10119,10108,945,11053,95
2022-11-15,Butte,007,227075,40107,40058,9340,49398,461
2022-11-15,Calaveras,009,45235,8633,8612,580,9192,135
2022-11-15,Colusa,011,21464,3834,3828,1305,5133,22
2022-11-15,Contra Costa,013,1133247,256607,254944,21126,276070,1479
2022-11-15,Del Norte,015,27424,7500,7492,405,7897,56
2022-11-15,El Dorado,017,186661,32962,32903,4352,37255,233
2022-11-15,Fresno,019,978130,280632,277735,32152,309887,2888
2022-11-15,Glenn,021,27897,5617,5591,1895,7486,50
2022-11-15,Humboldt,023,135768,22338,22254,5264,27518,160
2022-11-15,Imperial,025,180216,66614,66473,16599,83072,960
2022-11-15,Inyo,027,18085,4551,4530,1063,5593,60
2022-11-15,Kern,029,883053,221558,221145,65799,286944,2430
2022-11-15,Kings,031,150075,60283,60156,4220,64376,462
2022-11-15,Lake,033,64148,13044,12978,1219,14197,149
2022-11-15,Lassen,035,31185,10073,10043,1010,11053,65
2022-11-15,Los Angeles,037,10098052,3326978,3320411,188944,3509355,33830
2022-11-15,Madera,039,155013,44503,44373,8384,52757,375
2022-11-15,Marin,041,260295,46251,46115,5364,51479,314
2022-11-15,Mariposa,043,17540,3171,3138,348,3486,32
2022-11-15,Mendocino,045,87422,16288,16205,4578,20783,136
2022-11-15,Merced,047,269075,73453,73022,12019,85041,875
2022-11-15,Modoc,049,8938,889,889,341,1230,11
2022-11-15,Mono,051,14174,3233,3226,272,3498,8
2022-11-15,Monterey,053,433212,95183,94949,21610,116559,773
2022-11-15,Napa,055,140530,32674,32610,1431,34041,161
2022-11-15,Nevada,057,99092,19323,19238,1982,21220,132
2022-11-15,Orange,059,3164182,676198,674980,66109,741089,7553
2022-11-15,Placer,061,380077,77227,76976,9746,86722,662
2022-11-15,Plumas,063,18699,3730,3729,445,4174,13
2022-11-15,Riverside,065,2383286,703499,702343,36427,738770,6686
2022-11-15,Sacramento,067,1510023,352980,352117,35109,387226,3362
2022-11-15,San Benito,069,59416,16558,16410,992,17402,108
2022-11-15,San Bernardino,071,2135413,679100,677641,31637,709278,8131
2022-11-15,San Diego,073,3302833,937111,935811,73760,1009571,5557
2022-11-15,San Francisco,075,870044,183407,182855,12390,195245,1074
2022-11-15,San Joaquin,077,732212,200554,199682,15346,215028,2341
2022-11-15,San Luis Obispo,079,281455,64018,63812,7297,71109,530
2022-11-15,San Mateo,081,765935,172574,171862,10637,182499,748
2022-11-15,Santa Barbara,083,443738,107127,106885,7009,113894,733
2022-11-15,Santa Clara,085,1922200,445536,440104,19677,459781,2541
2022-11-15,Santa Cruz,087,273765,64793,64515,3565,68080,276
2022-11-15,Shasta,089,179085,35485,35346,7823,43169,595
2022-11-15,Sierra,091,2930,308,308,60,368,5
2022-11-15,Siskiyou,093,43540,5243,5364,3377,8741,95
2022-11-15,Solano,095,438530,107230,106903,8080,114983,469
2022-11-15,Sonoma,097,501317,108594,108386,5391,113777,527
2022-11-15,Stanislaus,099,539301,139572,139293,21843,161136,1785
2022-11-15,Sutter,101,95872,24683,24642,2474,27116,234
2022-11-15,Tehama,103,63373,13855,13784,3190,16974,216
2022-11-15,Trinity,105,12862,1434,1422,442,1864,20
2022-11-15,Tulare,107,460477,123035,122707,37169,159876,1545
2022-11-15,Tuolumne,109,53932,15896,15805,932,16737,209
2022-11-15,Ventura,111,848112,211539,210938,16172,227110,1586
2022-11-15,Yolo,113,214977,48188,48092,4478,52570,355
2022-11-15,Yuba,115,75493,19191,19157,1758,20915,132
2022-11-14,Alameda,001,1643700,355143,352725,20321,373046,2050
2022-11-14,Alpine,003,1148,138,136,1,137,0
2022-11-14,Amador,005,37829,10119,10080,945,11025,95
2022-11-14,Butte,007,227075,40082,39935,9333,49268,461
2022-11-14,Calaveras,009,45235,8627,8590,580,9170,135
2022-11-14,Colusa,011,21464,3834,3822,1304,5126,22
2022-11-14,Contra Costa,013,1133247,256459,253870,21118,274988,1469
2022-11-14,Del Norte,015,27424,7499,7472,405,7877,56
2022-11-14,El Dorado,017,186661,32941,32713,4351,37064,232
2022-11-14,Fresno,019,978130,280486,276921,32122,309043,2887
2022-11-14,Glenn,021,27897,5615,5570,1894,7464,48
2022-11-14,Humboldt,023,135768,22320,22176,5254,27430,160
2022-11-14,Imperial,025,180216,66566,66182,16559,82741,960
2022-11-14,Inyo,027,18085,4549,4520,1058,5578,60
2022-11-14,Kern,029,883053,221485,220676,65745,286421,2430
2022-11-14,Kings,031,150075,60209,59955,4214,64169,461
2022-11-14,Lake,033,64148,13037,12931,1215,14146,149
2022-11-14,Lassen,035,31185,10059,10019,1009,11028,65
2022-11-14,Los Angeles,037,10098052,3325211,3311644,188633,3500277,33784
2022-11-14,Madera,039,155013,44486,44281,8381,52662,375
2022-11-14,Marin,041,260295,46221,45924,5362,51286,314
2022-11-14,Mariposa,043,17540,3171,3124,348,3472,32
2022-11-14,Mendocino,045,87422,16278,16164,4574,20738,136
2022-11-14,Merced,047,269075,73425,72817,12011,84828,870
2022-11-14,Modoc,049,8938,889,887,334,1221,11
2022-11-14,Mono,051,14174,3233,3218,272,3490,8
2022-11-14,Monterey,053,433212,95147,94708,21581,116289,772
2022-11-14,Napa,055,140530,32653,32510,1429,33939,162
2022-11-14,Nevada,057,99092,19314,19171,1977,21148,132
2022-11-14,Orange,059,3164182,675906,673328,65994,739322,7546
2022-11-14,Placer,061,380077,77166,76490,9739,86229,662
2022-11-14,Plumas,063,18699,3730,3723,445,4168,13
2022-11-14,Riverside,065,2383286,703160,700602,36367,736969,6660
2022-11-14,Sacramento,067,1510023,352736,350522,35077,385599,3358
2022-11-14,San Benito,069,59416,16549,16350,991,17341,108
2022-11-14,San Bernardino,071,2135413,678716,676086,31587,707673,8126
2022-11-14,San Diego,073,3302833,936523,933599,73702,1007301,5538
2022-11-14,San Francisco,075,870044,183260,181964,12380,194344,1072
2022-11-14,San Joaquin,077,732212,200440,199089,15331,214420,2340
2022-11-14,San Luis Obispo,079,281455,63989,63683,7294,70977,525
2022-11-14,San Mateo,081,765935,172435,171191,10627,181818,748
2022-11-14,Santa Barbara,083,443738,107068,106642,7008,113650,733
2022-11-14,Santa Clara,085,1922200,445207,438278,19649,457927,2535
2022-11-14,Santa Cruz,087,273765,64737,64221,3561,67782,274
2022-11-14,Shasta,089,179085,35464,35246,7810,43056,594
2022-11-14,Sierra,091,2930,308,309,60,369,5
2022-11-14,Siskiyou,093,43540,5240,5337,3376,8713,94
2022-11-14,Solano,095,438530,107160,106391,8073,114464,468
2022-11-14,Sonoma,097,501317,108537,108080,5385,113465,525
2022-11-14,Stanislaus,099,539301,139516,138963,21834,160797,1785
2022-11-14,Sutter,101,95872,24661,24537,2474,27011,235
2022-11-14,Tehama,103,63373,13843,13745,3187,16932,216
2022-11-14,Trinity,105,12862,1433,1414,440,1854,20
2022-11-14,Tulare,107,460477,122953,122447,37141,159588,1544
2022-11-14,Tuolumne,109,53932,15878,15727,932,16659,201
2022-11-14,Ventura,111,848112,211429,210439,16154,226593,1585
2022-11-14,Yolo,113,214977,48173,47953,4475,52428,354
2022-11-14,Yuba,115,75493,19182,19098,1758,20856,132
2022-11-13,Alameda,001,1643700,354829,352725,20297,373022,2050
2022-11-13,Alpine,003,1148,137,136,1,137,0
2022-11-13,Amador,005,37829,10116,10080,944,11024,95
2022-11-13,Butte,007,227075,40054,39935,9325,49260,461
2022-11-13,Calaveras,009,45235,8624,8590,577,9167,135
2022-11-13,Colusa,011,21464,3832,3822,1302,5124,22
2022-11-13,Contra Costa,013,1133247,256270,253870,21101,274971,1469
2022-11-13,Del Norte,015,27424,7496,7472,405,7877,56
2022-11-13,El Dorado,017,186661,32917,32713,4349,37062,232
2022-11-13,Fresno,019,978130,280304,276921,32090,309011,2887
2022-11-13,Glenn,021,27897,5607,5570,1894,7464,48
2022-11-13,Humboldt,023,135768,22304,22176,5246,27422,160
2022-11-13,Imperial,025,180216,66503,66182,16510,82692,960
2022-11-13,Inyo,027,18085,4544,4520,1057,5577,60
2022-11-13,Kern,029,883053,221373,220676,65665,286341,2430
2022-11-13,Kings,031,150075,60168,59955,4197,64152,461
2022-11-13,Lake,033,64148,13016,12931,1214,14145,149
2022-11-13,Lassen,035,31185,10043,10019,1009,11028,65
2022-11-13,Los Angeles,037,10098052,3323265,3311644,188352,3499996,33784
2022-11-13,Madera,039,155013,44469,44281,8368,52649,375
2022-11-13,Marin,041,260295,46188,45924,5361,51285,314
2022-11-13,Mariposa,043,17540,3168,3124,348,3472,32
2022-11-13,Mendocino,045,87422,16268,16164,4563,20727,136
2022-11-13,Merced,047,269075,73385,72817,12001,84818,870
2022-11-13,Modoc,049,8938,889,887,331,1218,11
2022-11-13,Mono,051,14174,3233,3218,272,3490,8
2022-11-13,Monterey,053,433212,95102,94708,21548,116256,772
2022-11-13,Napa,055,140530,32635,32510,1428,33938,162
2022-11-13,Nevada,057,99092,19292,19171,1964,21135,132
2022-11-13,Orange,059,3164182,675565,673328,65856,739184,7546
2022-11-13,Placer,061,380077,77100,76490,9736,86226,662
2022-11-13,Plumas,063,18699,3729,3723,445,4168,13
2022-11-13,Riverside,065,2383286,702773,700602,36303,736905,6660
2022-11-13,Sacramento,067,1510023,352486,350522,35026,385548,3358
2022-11-13,San Benito,069,59416,16540,16350,990,17340,108
2022-11-13,San Bernardino,071,2135413,678322,676086,31551,707637,8126
2022-11-13,San Diego,073,3302833,935947,933599,73641,1007240,5538
2022-11-13,San Francisco,075,870044,183121,181964,12368,194332,1072
2022-11-13,San Joaquin,077,732212,200294,199089,15315,214404,2340
2022-11-13,San Luis Obispo,079,281455,63968,63683,7293,70976,525
2022-11-13,San Mateo,081,765935,172305,171191,10622,181813,748
2022-11-13,Santa Barbara,083,443738,107006,106642,6997,113639,733
2022-11-13,Santa Clara,085,1922200,444836,438278,19628,457906,2535
2022-11-13,Santa Cruz,087,273765,64673,64221,3558,67779,274
2022-11-13,Shasta,089,179085,35443,35246,7799,43045,594
2022-11-13,Sierra,091,2930,308,309,60,369,5
2022-11-13,Siskiyou,093,43540,5233,5337,3374,8711,94
2022-11-13,Solano,095,438530,107063,106391,8070,114461,468
2022-11-13,Sonoma,097,501317,108483,108080,5381,113461,525
2022-11-13,Stanislaus,099,539301,139454,138963,21826,160789,1785
2022-11-13,Sutter,101,95872,24648,24537,2472,27009,235
2022-11-13,Tehama,103,63373,13826,13745,3183,16928,216
2022-11-13,Trinity,105,12862,1432,1414,438,1852,20
2022-11-13,Tulare,107,460477,122885,122447,37103,159550,1544
2022-11-13,Tuolumne,109,53932,15866,15727,932,16659,201
2022-11-13,Ventura,111,848112,211314,210439,16140,226579,1585
2022-11-13,Yolo,113,214977,48147,47953,4473,52426,354
2022-11-13,Yuba,115,75493,19168,19098,1756,20854,132
2022-11-12,Alameda,001,1643700,354684,352725,20283,373008,2050
2022-11-12,Alpine,003,1148,137,136,1,137,0
2022-11-12,Amador,005,37829,10115,10080,944,11024,95
2022-11-12,Butte,007,227075,40042,39935,9315,49250,461
2022-11-12,Calaveras,009,45235,8618,8590,576,9166,135
2022-11-12,Colusa,011,21464,3831,3822,1301,5123,22
2022-11-12,Contra Costa,013,1133247,256150,253870,21099,274969,1469
2022-11-12,Del Norte,015,27424,7495,7472,405,7877,56
2022-11-12,El Dorado,017,186661,32900,32713,4347,37060,232
2022-11-12,Fresno,019,978130,280238,276921,32080,309001,2887
2022-11-12,Glenn,021,27897,5603,5570,1894,7464,48
2022-11-12,Humboldt,023,135768,22293,22176,5239,27415,160
2022-11-12,Imperial,025,180216,66490,66182,16498,82680,960
2022-11-12,Inyo,027,18085,4542,4520,1057,5577,60
2022-11-12,Kern,029,883053,221334,220676,65640,286316,2430
2022-11-12,Kings,031,150075,60136,59955,4192,64147,461
2022-11-12,Lake,033,64148,13011,12931,1214,14145,149
2022-11-12,Lassen,035,31185,10038,10019,1009,11028,65
2022-11-12,Los Angeles,037,10098052,3322301,3311644,188185,3499829,33784
2022-11-12,Madera,039,155013,44459,44281,8368,52649,375
2022-11-12,Marin,041,260295,46171,45924,5360,51284,314
2022-11-12,Mariposa,043,17540,3167,3124,348,3472,32
2022-11-12,Mendocino,045,87422,16264,16164,4563,20727,136
2022-11-12,Merced,047,269075,73368,72817,11998,84815,870
2022-11-12,Modoc,049,8938,889,887,331,1218,11
2022-11-12,Mono,051,14174,3232,3218,272,3490,8
2022-11-12,Monterey,053,433212,95074,94708,21524,116232,772
2022-11-12,Napa,055,140530,32623,32510,1428,33938,162
2022-11-12,Nevada,057,99092,19283,19171,1963,21134,132
2022-11-12,Orange,059,3164182,675407,673328,65781,739109,7546
2022-11-12,Placer,061,380077,77054,76490,9732,86222,662
2022-11-12,Plumas,063,18699,3729,3723,445,4168,13
2022-11-12,Riverside,065,2383286,702594,700602,36265,736867,6660
2022-11-12,Sacramento,067,1510023,352378,350522,35013,385535,3358
2022-11-12,San Benito,069,59416,16536,16350,990,17340,108
2022-11-12,San Bernardino,071,2135413,678107,676086,31532,707618,8126
2022-11-12,San Diego,073,3302833,935708,933599,73608,1007207,5538
2022-11-12,San Francisco,075,870044,183057,181964,12359,194323,1072
2022-11-12,San Joaquin,077,732212,200235,199089,15307,214396,2340
2022-11-12,San Luis Obispo,079,281455,63954,63683,7290,70973,525
2022-11-12,San Mateo,081,765935,172240,171191,10613,181804,748
2022-11-12,Santa Barbara,083,443738,106985,106642,6994,113636,733
2022-11-12,Santa Clara,085,1922200,444635,438278,19612,457890,2535
2022-11-12,Santa Cruz,087,273765,64660,64221,3555,67776,274
2022-11-12,Shasta,089,179085,35430,35246,7795,43041,594
2022-11-12,Sierra,091,2930,308,309,60,369,5
2022-11-12,Siskiyou,093,43540,5228,5337,3373,8710,94
2022-11-12,Solano,095,438530,107030,106391,8064,114455,468
2022-11-12,Sonoma,097,501317,108461,108080,5377,113457,525
2022-11-12,Stanislaus,099,539301,139414,138963,21824,160787,1785
2022-11-12,Sutter,101,95872,24638,24537,2472,27009,235
2022-11-12,Tehama,103,63373,13820,13745,3176,16921,216
2022-11-12,Trinity,105,12862,1431,1414,437,1851,20
2022-11-12,Tulare,107,460477,122849,122447,37088,159535,1544
2022-11-12,Tuolumne,109,53932,15855,15727,932,16659,201
2022-11-12,Ventura,111,848112,211239,210439,16129,226568,1585
2022-11-12,Yolo,113,214977,48122,47953,4470,52423,354
2022-11-12,Yuba,115,75493,19161,19098,1754,20852,132
2022-11-11,Alameda,001,1643700,354539,352725,20271,372996,2050
2022-11-11,Alpine,003,1148,137,136,1,137,0
2022-11-11,Amador,005,37829,10107,10080,944,11024,95
2022-11-11,Butte,007,227075,40034,39935,9308,49243,461
2022-11-11,Calaveras,009,45235,8615,8590,576,9166,135
2022-11-11,Colusa,011,21464,3826,3822,1300,5122,22
2022-11-11,Contra Costa,013,1133247,256046,253870,21094,274964,1469
2022-11-11,Del Norte,015,27424,7490,7472,405,7877,56
2022-11-11,El Dorado,017,186661,32886,32713,4344,37057,232
2022-11-11,Fresno,019,978130,280160,276921,32067,308988,2887
2022-11-11,Glenn,021,27897,5601,5570,1894,7464,48
2022-11-11,Humboldt,023,135768,22280,22176,5236,27412,160
2022-11-11,Imperial,025,180216,66474,66182,16485,82667,960
2022-11-11,Inyo,027,18085,4541,4520,1054,5574,60
2022-11-11,Kern,029,883053,221294,220676,65598,286274,2430
2022-11-11,Kings,031,150075,60120,59955,4187,64142,461
2022-11-11,Lake,033,64148,13008,12931,1214,14145,149
2022-11-11,Lassen,035,31185,10036,10019,1009,11028,65
2022-11-11,Los Angeles,037,10098052,3321354,3311644,188018,3499662,33784
2022-11-11,Madera,039,155013,44442,44281,8362,52643,375
2022-11-11,Marin,041,260295,46145,45924,5359,51283,314
2022-11-11,Mariposa,043,17540,3165,3124,348,3472,32
2022-11-11,Mendocino,045,87422,16260,16164,4563,20727,136
2022-11-11,Merced,047,269075,73348,72817,11995,84812,870
2022-11-11,Modoc,049,8938,888,887,331,1218,11
2022-11-11,Mono,051,14174,3231,3218,272,3490,8
2022-11-11,Monterey,053,433212,95059,94708,21508,116216,772
2022-11-11,Napa,055,140530,32613,32510,1427,33937,162
2022-11-11,Nevada,057,99092,19275,19171,1963,21134,132
2022-11-11,Orange,059,3164182,675245,673328,65716,739044,7546
2022-11-11,Placer,061,380077,77029,76490,9729,86219,662
2022-11-11,Plumas,063,18699,3729,3723,445,4168,13
2022-11-11,Riverside,065,2383286,702432,700602,36239,736841,6660
2022-11-11,Sacramento,067,1510023,352258,350522,35003,385525,3358
2022-11-11,San Benito,069,59416,16533,16350,990,17340,108
2022-11-11,San Bernardino,071,2135413,677918,676086,31516,707602,8126
2022-11-11,San Diego,073,3302833,935430,933599,73587,1007186,5538
2022-11-11,San Francisco,075,870044,182985,181964,12346,194310,1072
2022-11-11,San Joaquin,077,732212,200168,199089,15298,214387,2340
2022-11-11,San Luis Obispo,079,281455,63945,63683,7289,70972,525
2022-11-11,San Mateo,081,765935,172173,171191,10610,181801,748
2022-11-11,Santa Barbara,083,443738,106974,106642,6992,113634,733
2022-11-11,Santa Clara,085,1922200,444461,438278,19606,457884,2535
2022-11-11,Santa Cruz,087,273765,64630,64221,3555,67776,274
2022-11-11,Shasta,089,179085,35420,35246,7791,43037,594
2022-11-11,Sierra,091,2930,308,309,60,369,5
2022-11-11,Siskiyou,093,43540,5226,5337,3373,8710,94
2022-11-11,Solano,095,438530,107002,106391,8061,114452,468
2022-11-11,Sonoma,097,501317,108429,108080,5375,113455,525
2022-11-11,Stanislaus,099,539301,139374,138963,21817,160780,1785
2022-11-11,Sutter,101,95872,24630,24537,2472,27009,235
2022-11-11,Tehama,103,63373,13812,13745,3174,16919,216
2022-11-11,Trinity,105,12862,1428,1414,437,1851,20
2022-11-11,Tulare,107,460477,122819,122447,37067,159514,1544
2022-11-11,Tuolumne,109,53932,15845,15727,932,16659,201
2022-11-11,Ventura,111,848112,211174,210439,16114,226553,1585
2022-11-11,Yolo,113,214977,48110,47953,4469,52422,354
2022-11-11,Yuba,115,75493,19154,19098,1754,20852,132
2022-11-10,Alameda,001,1643700,354350,352725,20260,372985,2050
2022-11-10,Alpine,003,1148,137,136,1,137,0
2022-11-10,Amador,005,37829,10107,10080,944,11024,95
2022-11-10,Butte,007,227075,40021,39935,9304,49239,461
2022-11-10,Calaveras,009,45235,8612,8590,574,9164,135
2022-11-10,Colusa,011,21464,3826,3822,1298,5120,22
2022-11-10,Contra Costa,013,1133247,255928,253870,21089,274959,1469
2022-11-10,Del Norte,015,27424,7490,7472,405,7877,56
2022-11-10,El Dorado,017,186661,32863,32713,4343,37056,232
2022-11-10,Fresno,019,978130,280047,276921,32055,308976,2887
2022-11-10,Glenn,021,27897,5599,5570,1894,7464,48
2022-11-10,Humboldt,023,135768,22274,22176,5232,27408,160
2022-11-10,Imperial,025,180216,66445,66182,16452,82634,960
2022-11-10,Inyo,027,18085,4540,4520,1052,5572,60
2022-11-10,Kern,029,883053,221242,220676,65547,286223,2430
2022-11-10,Kings,031,150075,60101,59955,4186,64141,461
2022-11-10,Lake,033,64148,13006,12931,1213,14144,149
2022-11-10,Lassen,035,31185,10033,10019,1009,11028,65
2022-11-10,Los Angeles,037,10098052,3320088,3311644,187860,3499504,33784
2022-11-10,Madera,039,155013,44428,44281,8356,52637,375
2022-11-10,Marin,041,260295,46123,45924,5359,51283,314
2022-11-10,Mariposa,043,17540,3165,3124,348,3472,32
2022-11-10,Mendocino,045,87422,16253,16164,4562,20726,136
2022-11-10,Merced,047,269075,73333,72817,11993,84810,870
2022-11-10,Modoc,049,8938,887,887,331,1218,11
2022-11-10,Mono,051,14174,3230,3218,272,3490,8
2022-11-10,Monterey,053,433212,95035,94708,21482,116190,772
2022-11-10,Napa,055,140530,32600,32510,1426,33936,162
2022-11-10,Nevada,057,99092,19265,19171,1961,21132,132
2022-11-10,Orange,059,3164182,675048,673328,65647,738975,7546
2022-11-10,Placer,061,380077,76988,76490,9723,86213,662
2022-11-10,Plumas,063,18699,3729,3723,445,4168,13
2022-11-10,Riverside,065,2383286,702260,700602,36198,736800,6660
2022-11-10,Sacramento,067,1510023,352094,350522,34986,385508,3358
2022-11-10,San Benito,069,59416,16532,16350,990,17340,108
2022-11-10,San Bernardino,071,2135413,677700,676086,31493,707579,8126
2022-11-10,San Diego,073,3302833,935170,933599,73552,1007151,5538
2022-11-10,San Francisco,075,870044,182880,181964,12337,194301,1072
2022-11-10,San Joaquin,077,732212,200090,199089,15287,214376,2340
2022-11-10,San Luis Obispo,079,281455,63930,63683,7287,70970,525
2022-11-10,San Mateo,081,765935,172088,171191,10605,181796,748
2022-11-10,Santa Barbara,083,443738,106956,106642,6986,113628,733
2022-11-10,Santa Clara,085,1922200,444219,438278,19584,457862,2535
2022-11-10,Santa Cruz,087,273765,64600,64221,3550,67771,274
2022-11-10,Shasta,089,179085,35408,35246,7787,43033,594
2022-11-10,Sierra,091,2930,308,309,60,369,5
2022-11-10,Siskiyou,093,43540,5223,5337,3372,8709,94
2022-11-10,Solano,095,438530,106940,106391,8058,114449,468
2022-11-10,Sonoma,097,501317,108395,108080,5374,113454,525
2022-11-10,Stanislaus,099,539301,139329,138963,21815,160778,1785
2022-11-10,Sutter,101,95872,24616,24537,2472,27009,235
2022-11-10,Tehama,103,63373,13811,13745,3171,16916,216
2022-11-10,Trinity,105,12862,1428,1414,437,1851,20
2022-11-10,Tulare,107,460477,122763,122447,37028,159475,1544
2022-11-10,Tuolumne,109,53932,15836,15727,931,16658,201
2022-11-10,Ventura,111,848112,211079,210439,16100,226539,1585
2022-11-10,Yolo,113,214977,48095,47953,4468,52421,354
2022-11-10,Yuba,115,75493,19149,19098,1753,20851,132
2022-11-09,Alameda,001,1643700,354126,352725,20234,372959,2050
2022-11-09,Alpine,003,1148,137,136,1,137,0
2022-11-09,Amador,005,37829,10105,10080,944,11024,95
2022-11-09,Butte,007,227075,39998,39935,9294,49229,461
2022-11-09,Calaveras,009,45235,8606,8590,572,9162,135
2022-11-09,Colusa,011,21464,3825,3822,1295,5117,22
2022-11-09,Contra Costa,013,1133247,255792,253870,21079,274949,1469
2022-11-09,Del Norte,015,27424,7489,7472,405,7877,56
2022-11-09,El Dorado,017,186661,32838,32713,4341,37054,232
2022-11-09,Fresno,019,978130,279940,276921,32042,308963,2887
2022-11-09,Glenn,021,27897,5598,5570,1894,7464,48
2022-11-09,Humboldt,023,135768,22263,22176,5227,27403,160
2022-11-09,Imperial,025,180216,66407,66182,16404,82586,960
2022-11-09,Inyo,027,18085,4539,4520,1048,5568,60
2022-11-09,Kern,029,883053,221175,220676,65487,286163,2430
2022-11-09,Kings,031,150075,60055,59955,4181,64136,461
2022-11-09,Lake,033,64148,13001,12931,1209,14140,149
2022-11-09,Lassen,035,31185,10030,10019,1009,11028,65
2022-11-09,Los Angeles,037,10098052,3318627,3311644,187677,3499321,33784
2022-11-09,Madera,039,155013,44415,44281,8353,52634,375
2022-11-09,Marin,041,260295,46102,45924,5355,51279,314
2022-11-09,Mariposa,043,17540,3163,3124,348,3472,32
2022-11-09,Mendocino,045,87422,16250,16164,4559,20723,136
2022-11-09,Merced,047,269075,73305,72817,11989,84806,870
2022-11-09,Modoc,049,8938,887,887,331,1218,11
2022-11-09,Mono,051,14174,3229,3218,271,3489,8
2022-11-09,Monterey,053,433212,95004,94708,21465,116173,772
2022-11-09,Napa,055,140530,32581,32510,1425,33935,162
2022-11-09,Nevada,057,99092,19261,19171,1955,21126,132
2022-11-09,Orange,059,3164182,674816,673328,65536,738864,7546
2022-11-09,Placer,061,380077,76943,76490,9717,86207,662
2022-11-09,Plumas,063,18699,3726,3723,445,4168,13
2022-11-09,Riverside,065,2383286,702022,700602,36174,736776,6660
2022-11-09,Sacramento,067,1510023,351926,350522,34947,385469,3358
2022-11-09,San Benito,069,59416,16524,16350,989,17339,108
2022-11-09,San Bernardino,071,2135413,677445,676086,31475,707561,8126
2022-11-09,San Diego,073,3302833,934849,933599,73496,1007095,5538
2022-11-09,San Francisco,075,870044,182782,181964,12332,194296,1072
2022-11-09,San Joaquin,077,732212,200004,199089,15275,214364,2340
2022-11-09,San Luis Obispo,079,281455,63909,63683,7284,70967,525
2022-11-09,San Mateo,081,765935,171985,171191,10603,181794,748
2022-11-09,Santa Barbara,083,443738,106933,106642,6983,113625,733
2022-11-09,Santa Clara,085,1922200,443983,438278,19570,457848,2535
2022-11-09,Santa Cruz,087,273765,64569,64221,3548,67769,274
2022-11-09,Shasta,089,179085,35398,35246,7778,43024,594
2022-11-09,Sierra,091,2930,308,309,60,369,5
2022-11-09,Siskiyou,093,43540,5222,5337,3371,8708,94
2022-11-09,Solano,095,438530,106881,106391,8052,114443,468
2022-11-09,Sonoma,097,501317,108348,108080,5369,113449,525
2022-11-09,Stanislaus,099,539301,139288,138963,21800,160763,1785
2022-11-09,Sutter,101,95872,24601,24537,2471,27008,235
2022-11-09,Tehama,103,63373,13804,13745,3168,16913,216
2022-11-09,Trinity,105,12862,1424,1414,434,1848,20
2022-11-09,Tulare,107,460477,122725,122447,37005,159452,1544
2022-11-09,Tuolumne,109,53932,15822,15727,931,16658,201
2022-11-09,Ventura,111,848112,211005,210439,16078,226517,1585
2022-11-09,Yolo,113,214977,48073,47953,4466,52419,354
2022-11-09,Yuba,115,75493,19140,19098,1747,20845,132
2022-11-08,Alameda,001,1643700,353921,352725,20208,372933,2050
2022-11-08,Alpine,003,1148,137,136,1,137,0
2022-11-08,Amador,005,37829,10103,10080,944,11024,95
2022-11-08,Butte,007,227075,39980,39935,9286,49221,461
2022-11-08,Calaveras,009,45235,8603,8590,572,9162,135
2022-11-08,Colusa,011,21464,3824,3822,1295,5117,22
2022-11-08,Contra Costa,013,1133247,255662,253870,21062,274932,1469
2022-11-08,Del Norte,015,27424,7485,7472,402,7874,56
2022-11-08,El Dorado,017,186661,32814,32713,4340,37053,232
2022-11-08,Fresno,019,978130,279839,276921,32025,308946,2887
2022-11-08,Glenn,021,27897,5597,5570,1894,7464,48
2022-11-08,Humboldt,023,135768,22255,22176,5220,27396,160
2022-11-08,Imperial,025,180216,66353,66182,16346,82528,960
2022-11-08,Inyo,027,18085,4539,4520,1045,5565,60
2022-11-08,Kern,029,883053,221096,220676,65433,286109,2430
2022-11-08,Kings,031,150075,60030,59955,4179,64134,461
2022-11-08,Lake,033,64148,12991,12931,1208,14139,149
2022-11-08,Lassen,035,31185,10028,10019,1008,11027,65
2022-11-08,Los Angeles,037,10098052,3317206,3311644,187475,3499119,33784
2022-11-08,Madera,039,155013,44399,44281,8349,52630,375
2022-11-08,Marin,041,260295,46073,45924,5348,51272,314
2022-11-08,Mariposa,043,17540,3158,3124,348,3472,32
2022-11-08,Mendocino,045,87422,16242,16164,4559,20723,136
2022-11-08,Merced,047,269075,73275,72817,11984,84801,870
2022-11-08,Modoc,049,8938,886,887,331,1218,11
2022-11-08,Mono,051,14174,3225,3218,269,3487,8
2022-11-08,Monterey,053,433212,94975,94708,21456,116164,772
2022-11-08,Napa,055,140530,32568,32510,1425,33935,162
2022-11-08,Nevada,057,99092,19255,19171,1952,21123,132
2022-11-08,Orange,059,3164182,674573,673328,65444,738772,7546
2022-11-08,Placer,061,380077,76899,76490,9712,86202,662
2022-11-08,Plumas,063,18699,3726,3723,445,4168,13
2022-11-08,Riverside,065,2383286,701781,700602,36136,736738,6660
2022-11-08,Sacramento,067,1510023,351734,350522,34907,385429,3358
2022-11-08,San Benito,069,59416,16515,16350,988,17338,108
2022-11-08,San Bernardino,071,2135413,677209,676086,31436,707522,8126
2022-11-08,San Diego,073,3302833,934436,933599,73456,1007055,5538
2022-11-08,San Francisco,075,870044,182659,181964,12318,194282,1072
2022-11-08,San Joaquin,077,732212,199918,199089,15265,214354,2340
2022-11-08,San Luis Obispo,079,281455,63890,63683,7281,70964,525
2022-11-08,San Mateo,081,765935,171889,171191,10600,181791,748
2022-11-08,Santa Barbara,083,443738,106897,106642,6980,113622,733
2022-11-08,Santa Clara,085,1922200,443722,438278,19552,457830,2535
2022-11-08,Santa Cruz,087,273765,64536,64221,3546,67767,274
2022-11-08,Shasta,089,179085,35377,35246,7762,43008,594
2022-11-08,Sierra,091,2930,308,309,60,369,5
2022-11-08,Siskiyou,093,43540,5221,5337,3367,8704,94
2022-11-08,Solano,095,438530,106806,106391,8045,114436,468
2022-11-08,Sonoma,097,501317,108309,108080,5368,113448,525
2022-11-08,Stanislaus,099,539301,139226,138963,21797,160760,1785
2022-11-08,Sutter,101,95872,24584,24537,2471,27008,235
2022-11-08,Tehama,103,63373,13799,13745,3167,16912,216
2022-11-08,Trinity,105,12862,1422,1414,433,1847,20
2022-11-08,Tulare,107,460477,122674,122447,36976,159423,1544
2022-11-08,Tuolumne,109,53932,15812,15727,931,16658,201
2022-11-08,Ventura,111,848112,210939,210439,16069,226508,1585
2022-11-08,Yolo,113,214977,48053,47953,4460,52413,354
2022-11-08,Yuba,115,75493,19130,19098,1746,20844,132
2022-11-07,Alameda,001,1643700,353682,351524,20187,371711,2044
2022-11-07,Alpine,003,1148,136,136,1,137,0
2022-11-07,Amador,005,37829,10099,10055,943,10998,95
2022-11-07,Butte,007,227075,39963,39852,9278,49130,462
2022-11-07,Calaveras,009,45235,8597,8576,572,9148,135
2022-11-07,Colusa,011,21464,3823,3820,1295,5115,22
2022-11-07,Contra Costa,013,1133247,255518,253122,21046,274168,1463
2022-11-07,Del Norte,015,27424,7482,7469,402,7871,56
2022-11-07,El Dorado,017,186661,32798,32622,4339,36961,231
2022-11-07,Fresno,019,978130,279721,276454,31999,308453,2885
2022-11-07,Glenn,021,27897,5595,5557,1892,7449,48
2022-11-07,Humboldt,023,135768,22239,22115,5206,27321,160
2022-11-07,Imperial,025,180216,66315,66024,16309,82333,960
2022-11-07,Inyo,027,18085,4538,4506,1043,5549,60
2022-11-07,Kern,029,883053,221041,220216,65366,285582,2426
2022-11-07,Kings,031,150075,60008,59856,4172,64028,459
2022-11-07,Lake,033,64148,12983,12898,1208,14106,148
2022-11-07,Lassen,035,31185,10024,10007,1008,11015,65
2022-11-07,Los Angeles,037,10098052,3315842,3304428,187230,3491658,33733
2022-11-07,Madera,039,155013,44391,44229,8342,52571,375
2022-11-07,Marin,041,260295,46046,45806,5348,51154,314
2022-11-07,Mariposa,043,17540,3153,3116,348,3464,32
2022-11-07,Mendocino,045,87422,16239,16130,4556,20686,137
2022-11-07,Merced,047,269075,73240,72727,11978,84705,870
2022-11-07,Modoc,049,8938,886,885,331,1216,11
2022-11-07,Mono,051,14174,3223,3216,269,3485,7
2022-11-07,Monterey,053,433212,94947,94541,21438,115979,770
2022-11-07,Napa,055,140530,32548,32484,1425,33909,161
2022-11-07,Nevada,057,99092,19249,19129,1951,21080,132
2022-11-07,Orange,059,3164182,674346,672253,65359,737612,7520
2022-11-07,Placer,061,380077,76856,76321,9705,86026,662
2022-11-07,Plumas,063,18699,3726,3720,445,4165,13
2022-11-07,Riverside,065,2383286,701519,699360,36101,735461,6660
2022-11-07,Sacramento,067,1510023,351557,349696,34872,384568,3350
2022-11-07,San Benito,069,59416,16507,16324,987,17311,108
2022-11-07,San Bernardino,071,2135413,676935,674939,31410,706349,8123
2022-11-07,San Diego,073,3302833,934070,931531,73412,1004943,5532
2022-11-07,San Francisco,075,870044,182552,180989,12305,193294,1067
2022-11-07,San Joaquin,077,732212,199835,198717,15251,213968,2336
2022-11-07,San Luis Obispo,079,281455,63869,63599,7279,70878,525
2022-11-07,San Mateo,081,765935,171798,170464,10596,181060,741
2022-11-07,Santa Barbara,083,443738,106876,106478,6976,113454,732
2022-11-07,Santa Clara,085,1922200,443474,436967,19533,456500,2533
2022-11-07,Santa Cruz,087,273765,64487,64070,3545,67615,274
2022-11-07,Shasta,089,179085,35363,35178,7747,42925,594
2022-11-07,Sierra,091,2930,308,308,60,368,5
2022-11-07,Siskiyou,093,43540,5213,5326,3365,8691,94
2022-11-07,Solano,095,438530,106723,106106,8038,114144,468
2022-11-07,Sonoma,097,501317,108271,107907,5367,113274,524
2022-11-07,Stanislaus,099,539301,139188,138715,21781,160496,1785
2022-11-07,Sutter,101,95872,24566,24470,2471,26941,233
2022-11-07,Tehama,103,63373,13794,13707,3162,16869,216
2022-11-07,Trinity,105,12862,1422,1413,433,1846,20
2022-11-07,Tulare,107,460477,122646,122246,36947,159193,1544
2022-11-07,Tuolumne,109,53932,15801,15672,931,16603,196
2022-11-07,Ventura,111,848112,210857,210085,16055,226140,1584
2022-11-07,Yolo,113,214977,48021,47786,4457,52243,353
2022-11-07,Yuba,115,75493,19122,19059,1744,20803,132
2022-11-06,Alameda,001,1643700,353453,351524,20166,371690,2044
2022-11-06,Alpine,003,1148,136,136,1,137,0
2022-11-06,Amador,005,37829,10094,10055,942,10997,95
2022-11-06,Butte,007,227075,39931,39852,9273,49125,462
2022-11-06,Calaveras,009,45235,8593,8576,572,9148,135
2022-11-06,Colusa,011,21464,3823,3820,1295,5115,22
2022-11-06,Contra Costa,013,1133247,255367,253122,21036,274158,1463
2022-11-06,Del Norte,015,27424,7479,7469,402,7871,56
2022-11-06,El Dorado,017,186661,32784,32622,4335,36957,231
2022-11-06,Fresno,019,978130,279589,276454,31975,308429,2885
2022-11-06,Glenn,021,27897,5578,5557,1885,7442,48
2022-11-06,Humboldt,023,135768,22229,22115,5197,27312,160
2022-11-06,Imperial,025,180216,66265,66024,16270,82294,960
2022-11-06,Inyo,027,18085,4536,4506,1041,5547,60
2022-11-06,Kern,029,883053,220939,220216,65308,285524,2426
2022-11-06,Kings,031,150075,59964,59856,4162,64018,459
2022-11-06,Lake,033,64148,12970,12898,1204,14102,148
2022-11-06,Lassen,035,31185,10023,10007,1007,11014,65
2022-11-06,Los Angeles,037,10098052,3314199,3304428,186986,3491414,33733
2022-11-06,Madera,039,155013,44380,44229,8335,52564,375
2022-11-06,Marin,041,260295,46016,45806,5346,51152,314
2022-11-06,Mariposa,043,17540,3152,3116,348,3464,32
2022-11-06,Mendocino,045,87422,16232,16130,4553,20683,137
2022-11-06,Merced,047,269075,73212,72727,11967,84694,870
2022-11-06,Modoc,049,8938,886,885,331,1216,11
2022-11-06,Mono,051,14174,3223,3216,267,3483,7
2022-11-06,Monterey,053,433212,94897,94541,21416,115957,770
2022-11-06,Napa,055,140530,32526,32484,1425,33909,161
2022-11-06,Nevada,057,99092,19234,19129,1937,21066,132
2022-11-06,Orange,059,3164182,674080,672253,65294,737547,7520
2022-11-06,Placer,061,380077,76805,76321,9700,86021,662
2022-11-06,Plumas,063,18699,3726,3720,445,4165,13
2022-11-06,Riverside,065,2383286,701210,699360,36063,735423,6660
2022-11-06,Sacramento,067,1510023,351342,349696,34822,384518,3350
2022-11-06,San Benito,069,59416,16499,16324,987,17311,108
2022-11-06,San Bernardino,071,2135413,676638,674939,31377,706316,8123
2022-11-06,San Diego,073,3302833,933562,931531,73352,1004883,5532
2022-11-06,San Francisco,075,870044,182416,180989,12292,193281,1067
2022-11-06,San Joaquin,077,732212,199746,198717,15240,213957,2336
2022-11-06,San Luis Obispo,079,281455,63850,63599,7276,70875,525
2022-11-06,San Mateo,081,765935,171697,170464,10589,181053,741
2022-11-06,Santa Barbara,083,443738,106820,106478,6966,113444,732
2022-11-06,Santa Clara,085,1922200,443189,436967,19506,456473,2533
2022-11-06,Santa Cruz,087,273765,64416,64070,3541,67611,274
2022-11-06,Shasta,089,179085,35341,35178,7727,42905,594
2022-11-06,Sierra,091,2930,308,308,60,368,5
2022-11-06,Siskiyou,093,43540,5213,5326,3364,8690,94
2022-11-06,Solano,095,438530,106627,106106,8032,114138,468
2022-11-06,Sonoma,097,501317,108207,107907,5365,113272,524
2022-11-06,Stanislaus,099,539301,139134,138715,21770,160485,1785
2022-11-06,Sutter,101,95872,24546,24470,2470,26940,233
2022-11-06,Tehama,103,63373,13788,13707,3147,16854,216
2022-11-06,Trinity,105,12862,1422,1413,433,1846,20
2022-11-06,Tulare,107,460477,122609,122246,36913,159159,1544
2022-11-06,Tuolumne,109,53932,15790,15672,931,16603,196
2022-11-06,Ventura,111,848112,210770,210085,16033,226118,1584
2022-11-06,Yolo,113,214977,48006,47786,4446,52232,353
2022-11-06,Yuba,115,75493,19114,19059,1743,20802,132
2022-11-05,Alameda,001,1643700,353309,351524,20157,371681,2044
2022-11-05,Alpine,003,1148,136,136,1,137,0
2022-11-05,Amador,005,37829,10092,10055,942,10997,95
2022-11-05,Butte,007,227075,39922,39852,9270,49122,462
2022-11-05,Calaveras,009,45235,8592,8576,572,9148,135
2022-11-05,Colusa,011,21464,3821,3820,1295,5115,22
2022-11-05,Contra Costa,013,1133247,255265,253122,21033,274155,1463
2022-11-05,Del Norte,015,27424,7479,7469,402,7871,56
2022-11-05,El Dorado,017,186661,32767,32622,4331,36953,231
2022-11-05,Fresno,019,978130,279533,276454,31965,308419,2885
2022-11-05,Glenn,021,27897,5576,5557,1884,7441,48
2022-11-05,Humboldt,023,135768,22219,22115,5195,27310,160
2022-11-05,Imperial,025,180216,66241,66024,16257,82281,960
2022-11-05,Inyo,027,18085,4535,4506,1041,5547,60
2022-11-05,Kern,029,883053,220892,220216,65282,285498,2426
2022-11-05,Kings,031,150075,59948,59856,4159,64015,459
2022-11-05,Lake,033,64148,12965,12898,1204,14102,148
2022-11-05,Lassen,035,31185,10023,10007,1007,11014,65
2022-11-05,Los Angeles,037,10098052,3313350,3304428,186843,3491271,33733
2022-11-05,Madera,039,155013,44374,44229,8333,52562,375
2022-11-05,Marin,041,260295,45999,45806,5346,51152,314
2022-11-05,Mariposa,043,17540,3151,3116,348,3464,32
2022-11-05,Mendocino,045,87422,16230,16130,4552,20682,137
2022-11-05,Merced,047,269075,73198,72727,11965,84692,870
2022-11-05,Modoc,049,8938,886,885,331,1216,11
2022-11-05,Mono,051,14174,3223,3216,266,3482,7
2022-11-05,Monterey,053,433212,94872,94541,21406,115947,770
2022-11-05,Napa,055,140530,32522,32484,1424,33908,161
2022-11-05,Nevada,057,99092,19229,19129,1933,21062,132
2022-11-05,Orange,059,3164182,673940,672253,65251,737504,7520
2022-11-05,Placer,061,380077,76764,76321,9696,86017,662
2022-11-05,Plumas,063,18699,3726,3720,444,4164,13
2022-11-05,Riverside,065,2383286,701028,699360,36039,735399,6660
2022-11-05,Sacramento,067,1510023,351226,349696,34805,384501,3350
2022-11-05,San Benito,069,59416,16491,16324,987,17311,108
2022-11-05,San Bernardino,071,2135413,676492,674939,31367,706306,8123
2022-11-05,San Diego,073,3302833,933367,931531,73335,1004866,5532
2022-11-05,San Francisco,075,870044,182334,180989,12287,193276,1067
2022-11-05,San Joaquin,077,732212,199693,198717,15233,213950,2336
2022-11-05,San Luis Obispo,079,281455,63841,63599,7276,70875,525
2022-11-05,San Mateo,081,765935,171639,170464,10585,181049,741
2022-11-05,Santa Barbara,083,443738,106799,106478,6964,113442,732
2022-11-05,Santa Clara,085,1922200,442995,436967,19491,456458,2533
2022-11-05,Santa Cruz,087,273765,64387,64070,3540,67610,274
2022-11-05,Shasta,089,179085,35332,35178,7718,42896,594
2022-11-05,Sierra,091,2930,308,308,60,368,5
2022-11-05,Siskiyou,093,43540,5212,5326,3362,8688,94
2022-11-05,Solano,095,438530,106598,106106,8030,114136,468
2022-11-05,Sonoma,097,501317,108187,107907,5360,113267,524
2022-11-05,Stanislaus,099,539301,139093,138715,21765,160480,1785
2022-11-05,Sutter,101,95872,24536,24470,2470,26940,233
2022-11-05,Tehama,103,63373,13784,13707,3145,16852,216
2022-11-05,Trinity,105,12862,1422,1413,433,1846,20
2022-11-05,Tulare,107,460477,122592,122246,36893,159139,1544
2022-11-05,Tuolumne,109,53932,15782,15672,931,16603,196
2022-11-05,Ventura,111,848112,210719,210085,16024,226109,1584
2022-11-05,Yolo,113,214977,47993,47786,4441,52227,353
2022-11-05,Yuba,115,75493,19109,19059,1742,20801,132
2022-11-04,Alameda,001,1643700,353166,351524,20137,371661,2044
2022-11-04,Alpine,003,1148,136,136,1,137,0
2022-11-04,Amador,005,37829,10089,10055,942,10997,95
2022-11-04,Butte,007,227075,39913,39852,9265,49117,462
2022-11-04,Calaveras,009,45235,8591,8576,572,9148,135
2022-11-04,Colusa,011,21464,3821,3820,1295,5115,22
2022-11-04,Contra Costa,013,1133247,255170,253122,21030,274152,1463
2022-11-04,Del Norte,015,27424,7479,7469,402,7871,56
2022-11-04,El Dorado,017,186661,32758,32622,4331,36953,231
2022-11-04,Fresno,019,978130,279479,276454,31956,308410,2885
2022-11-04,Glenn,021,27897,5575,5557,1883,7440,48
2022-11-04,Humboldt,023,135768,22212,22115,5193,27308,160
2022-11-04,Imperial,025,180216,66229,66024,16249,82273,960
2022-11-04,Inyo,027,18085,4532,4506,1040,5546,60
2022-11-04,Kern,029,883053,220853,220216,65249,285465,2426
2022-11-04,Kings,031,150075,59933,59856,4154,64010,459
2022-11-04,Lake,033,64148,12958,12898,1204,14102,148
2022-11-04,Lassen,035,31185,10022,10007,1007,11014,65
2022-11-04,Los Angeles,037,10098052,3312528,3304428,186694,3491122,33733
2022-11-04,Madera,039,155013,44367,44229,8332,52561,375
2022-11-04,Marin,041,260295,45983,45806,5345,51151,314
2022-11-04,Mariposa,043,17540,3149,3116,348,3464,32
2022-11-04,Mendocino,045,87422,16226,16130,4550,20680,137
2022-11-04,Merced,047,269075,73190,72727,11964,84691,870
2022-11-04,Modoc,049,8938,886,885,330,1215,11
2022-11-04,Mono,051,14174,3221,3216,266,3482,7
2022-11-04,Monterey,053,433212,94845,94541,21394,115935,770
2022-11-04,Napa,055,140530,32517,32484,1423,33907,161
2022-11-04,Nevada,057,99092,19223,19129,1924,21053,132
2022-11-04,Orange,059,3164182,673833,672253,65208,737461,7520
2022-11-04,Placer,061,380077,76746,76321,9694,86015,662
2022-11-04,Plumas,063,18699,3725,3720,443,4163,13
2022-11-04,Riverside,065,2383286,700855,699360,36007,735367,6660
2022-11-04,Sacramento,067,1510023,351117,349696,34792,384488,3350
2022-11-04,San Benito,069,59416,16487,16324,987,17311,108
2022-11-04,San Bernardino,071,2135413,676341,674939,31360,706299,8123
2022-11-04,San Diego,073,3302833,933162,931531,73323,1004854,5532
2022-11-04,San Francisco,075,870044,182266,180989,12281,193270,1067
2022-11-04,San Joaquin,077,732212,199642,198717,15228,213945,2336
2022-11-04,San Luis Obispo,079,281455,63829,63599,7274,70873,525
2022-11-04,San Mateo,081,765935,171567,170464,10582,181046,741
2022-11-04,Santa Barbara,083,443738,106778,106478,6962,113440,732
2022-11-04,Santa Clara,085,1922200,442800,436967,19480,456447,2533
2022-11-04,Santa Cruz,087,273765,64360,64070,3540,67610,274
2022-11-04,Shasta,089,179085,35326,35178,7709,42887,594
2022-11-04,Sierra,091,2930,308,308,60,368,5
2022-11-04,Siskiyou,093,43540,5208,5326,3362,8688,94
2022-11-04,Solano,095,438530,106542,106106,8027,114133,468
2022-11-04,Sonoma,097,501317,108164,107907,5359,113266,524
2022-11-04,Stanislaus,099,539301,139065,138715,21763,160478,1785
2022-11-04,Sutter,101,95872,24528,24470,2470,26940,233
2022-11-04,Tehama,103,63373,13779,13707,3134,16841,216
2022-11-04,Trinity,105,12862,1421,1413,433,1846,20
2022-11-04,Tulare,107,460477,122574,122246,36872,159118,1544
2022-11-04,Tuolumne,109,53932,15770,15672,931,16603,196
2022-11-04,Ventura,111,848112,210667,210085,16014,226099,1584
2022-11-04,Yolo,113,214977,47974,47786,4440,52226,353
2022-11-04,Yuba,115,75493,19106,19059,1742,20801,132
2022-11-03,Alameda,001,1643700,352981,351524,20114,371638,2044
2022-11-03,Alpine,003,1148,136,136,1,137,0
2022-11-03,Amador,005,37829,10084,10055,940,10995,95
2022-11-03,Butte,007,227075,39896,39852,9256,49108,462
2022-11-03,Calaveras,009,45235,8590,8576,572,9148,135
2022-11-03,Colusa,011,21464,3821,3820,1295,5115,22
2022-11-03,Contra Costa,013,1133247,255036,253122,21022,274144,1463
2022-11-03,Del Norte,015,27424,7479,7469,401,7870,56
2022-11-03,El Dorado,017,186661,32741,32622,4331,36953,231
2022-11-03,Fresno,019,978130,279404,276454,31936,308390,2885
2022-11-03,Glenn,021,27897,5572,5557,1882,7439,48
2022-11-03,Humboldt,023,135768,22197,22115,5185,27300,160
2022-11-03,Imperial,025,180216,66204,66024,16211,82235,960
2022-11-03,Inyo,027,18085,4530,4506,1039,5545,60
2022-11-03,Kern,029,883053,220806,220216,65203,285419,2426
2022-11-03,Kings,031,150075,59916,59856,4149,64005,459
2022-11-03,Lake,033,64148,12955,12898,1203,14101,148
2022-11-03,Lassen,035,31185,10019,10007,1006,11013,65
2022-11-03,Los Angeles,037,10098052,3311440,3304428,186490,3490918,33733
2022-11-03,Madera,039,155013,44355,44229,8330,52559,375
2022-11-03,Marin,041,260295,45957,45806,5345,51151,314
2022-11-03,Mariposa,043,17540,3146,3116,348,3464,32
2022-11-03,Mendocino,045,87422,16215,16130,4549,20679,137
2022-11-03,Merced,047,269075,73161,72727,11960,84687,870
2022-11-03,Modoc,049,8938,886,885,330,1215,11
2022-11-03,Mono,051,14174,3220,3216,266,3482,7
2022-11-03,Monterey,053,433212,94819,94541,21379,115920,770
2022-11-03,Napa,055,140530,32507,32484,1421,33905,161
2022-11-03,Nevada,057,99092,19213,19129,1922,21051,132
2022-11-03,Orange,059,3164182,673667,672253,65164,737417,7520
2022-11-03,Placer,061,380077,76711,76321,9690,86011,662
2022-11-03,Plumas,063,18699,3725,3720,443,4163,13
2022-11-03,Riverside,065,2383286,700649,699360,35970,735330,6660
2022-11-03,Sacramento,067,1510023,350955,349696,34758,384454,3350
2022-11-03,San Benito,069,59416,16483,16324,987,17311,108
2022-11-03,San Bernardino,071,2135413,676141,674939,31343,706282,8123
2022-11-03,San Diego,073,3302833,932907,931531,73295,1004826,5532
2022-11-03,San Francisco,075,870044,182160,180989,12276,193265,1067
2022-11-03,San Joaquin,077,732212,199579,198717,15213,213930,2336
2022-11-03,San Luis Obispo,079,281455,63811,63599,7272,70871,525
2022-11-03,San Mateo,081,765935,171470,170464,10581,181045,741
2022-11-03,Santa Barbara,083,443738,106754,106478,6958,113436,732
2022-11-03,Santa Clara,085,1922200,442560,436967,19463,456430,2533
2022-11-03,Santa Cruz,087,273765,64311,64070,3538,67608,274
2022-11-03,Shasta,089,179085,35311,35178,7695,42873,594
2022-11-03,Sierra,091,2930,308,308,60,368,5
2022-11-03,Siskiyou,093,43540,5205,5326,3360,8686,94
2022-11-03,Solano,095,438530,106495,106106,8020,114126,468
2022-11-03,Sonoma,097,501317,108134,107907,5359,113266,524
2022-11-03,Stanislaus,099,539301,139019,138715,21752,160467,1785
2022-11-03,Sutter,101,95872,24519,24470,2469,26939,233
2022-11-03,Tehama,103,63373,13771,13707,3130,16837,216
2022-11-03,Trinity,105,12862,1421,1413,432,1845,20
2022-11-03,Tulare,107,460477,122552,122246,36851,159097,1544
2022-11-03,Tuolumne,109,53932,15763,15672,930,16602,196
2022-11-03,Ventura,111,848112,210611,210085,16002,226087,1584
2022-11-03,Yolo,113,214977,47956,47786,4438,52224,353
2022-11-03,Yuba,115,75493,19099,19059,1742,20801,132
2022-11-02,Alameda,001,1643700,352799,351524,20091,371615,2044
2022-11-02,Alpine,003,1148,136,136,1,137,0
2022-11-02,Amador,005,37829,10074,10055,938,10993,95
2022-11-02,Butte,007,227075,39878,39852,9249,49101,462
2022-11-02,Calaveras,009,45235,8585,8576,572,9148,135
2022-11-02,Colusa,011,21464,3821,3820,1294,5114,22
2022-11-02,Contra Costa,013,1133247,254910,253122,21005,274127,1463
2022-11-02,Del Norte,015,27424,7479,7469,401,7870,56
2022-11-02,El Dorado,017,186661,32726,32622,4329,36951,231
2022-11-02,Fresno,019,978130,279318,276454,31917,308371,2885
2022-11-02,Glenn,021,27897,5568,5557,1880,7437,48
2022-11-02,Humboldt,023,135768,22185,22115,5183,27298,160
2022-11-02,Imperial,025,180216,66170,66024,16193,82217,960
2022-11-02,Inyo,027,18085,4527,4506,1039,5545,60
2022-11-02,Kern,029,883053,220761,220216,65159,285375,2426
2022-11-02,Kings,031,150075,59902,59856,4142,63998,459
2022-11-02,Lake,033,64148,12951,12898,1196,14094,148
2022-11-02,Lassen,035,31185,10017,10007,1005,11012,65
2022-11-02,Los Angeles,037,10098052,3310240,3304428,186298,3490726,33733
2022-11-02,Madera,039,155013,44339,44229,8327,52556,375
2022-11-02,Marin,041,260295,45941,45806,5344,51150,314
2022-11-02,Mariposa,043,17540,3145,3116,348,3464,32
2022-11-02,Mendocino,045,87422,16213,16130,4548,20678,137
2022-11-02,Merced,047,269075,73138,72727,11955,84682,870
2022-11-02,Modoc,049,8938,886,885,328,1213,11
2022-11-02,Mono,051,14174,3220,3216,266,3482,7
2022-11-02,Monterey,053,433212,94793,94541,21370,115911,770
2022-11-02,Napa,055,140530,32497,32484,1421,33905,161
2022-11-02,Nevada,057,99092,19206,19129,1917,21046,132
2022-11-02,Orange,059,3164182,673482,672253,65083,737336,7520
2022-11-02,Placer,061,380077,76674,76321,9683,86004,662
2022-11-02,Plumas,063,18699,3725,3720,443,4163,13
2022-11-02,Riverside,065,2383286,700477,699360,35948,735308,6660
2022-11-02,Sacramento,067,1510023,350782,349696,34724,384420,3350
2022-11-02,San Benito,069,59416,16477,16324,987,17311,108
2022-11-02,San Bernardino,071,2135413,675947,674939,31316,706255,8123
2022-11-02,San Diego,073,3302833,932575,931531,73261,1004792,5532
2022-11-02,San Francisco,075,870044,182054,180989,12272,193261,1067
2022-11-02,San Joaquin,077,732212,199501,198717,15201,213918,2336
2022-11-02,San Luis Obispo,079,281455,63787,63599,7265,70864,525
2022-11-02,San Mateo,081,765935,171409,170464,10573,181037,741
2022-11-02,Santa Barbara,083,443738,106723,106478,6952,113430,732
2022-11-02,Santa Clara,085,1922200,442347,436967,19450,456417,2533
2022-11-02,Santa Cruz,087,273765,64277,64070,3537,67607,274
2022-11-02,Shasta,089,179085,35300,35178,7681,42859,594
2022-11-02,Sierra,091,2930,308,308,60,368,5
2022-11-02,Siskiyou,093,43540,5204,5326,3353,8679,94
2022-11-02,Solano,095,438530,106444,106106,8014,114120,468
2022-11-02,Sonoma,097,501317,108098,107907,5357,113264,524
2022-11-02,Stanislaus,099,539301,138984,138715,21747,160462,1785
2022-11-02,Sutter,101,95872,24501,24470,2469,26939,233
2022-11-02,Tehama,103,63373,13765,13707,3125,16832,216
2022-11-02,Trinity,105,12862,1421,1413,429,1842,20
2022-11-02,Tulare,107,460477,122529,122246,36835,159081,1544
2022-11-02,Tuolumne,109,53932,15759,15672,930,16602,196
2022-11-02,Ventura,111,848112,210558,210085,15992,226077,1584
2022-11-02,Yolo,113,214977,47936,47786,4436,52222,353
2022-11-02,Yuba,115,75493,19091,19059,1741,20800,132
2022-11-01,Alameda,001,1643700,352604,351524,20072,371596,2044
2022-11-01,Alpine,003,1148,136,136,1,137,0
2022-11-01,Amador,005,37829,10068,10055,937,10992,95
2022-11-01,Butte,007,227075,39863,39852,9241,49093,462
2022-11-01,Calaveras,009,45235,8583,8576,572,9148,135
2022-11-01,Colusa,011,21464,3821,3820,1293,5113,22
2022-11-01,Contra Costa,013,1133247,254796,253122,20996,274118,1463
2022-11-01,Del Norte,015,27424,7479,7469,401,7870,56
2022-11-01,El Dorado,017,186661,32706,32622,4327,36949,231
2022-11-01,Fresno,019,978130,279238,276454,31904,308358,2885
2022-11-01,Glenn,021,27897,5567,5557,1878,7435,48
2022-11-01,Humboldt,023,135768,22172,22115,5177,27292,160
2022-11-01,Imperial,025,180216,66141,66024,16185,82209,960
2022-11-01,Inyo,027,18085,4524,4506,1038,5544,60
2022-11-01,Kern,029,883053,220685,220216,65106,285322,2426
2022-11-01,Kings,031,150075,59882,59856,4139,63995,459
2022-11-01,Lake,033,64148,12947,12898,1193,14091,148
2022-11-01,Lassen,035,31185,10015,10007,1004,11011,65
2022-11-01,Los Angeles,037,10098052,3309003,3304428,186078,3490506,33733
2022-11-01,Madera,039,155013,44326,44229,8317,52546,375
2022-11-01,Marin,041,260295,45921,45806,5342,51148,314
2022-11-01,Mariposa,043,17540,3142,3116,348,3464,32
2022-11-01,Mendocino,045,87422,16210,16130,4542,20672,137
2022-11-01,Merced,047,269075,73116,72727,11947,84674,870
2022-11-01,Modoc,049,8938,885,885,327,1212,11
2022-11-01,Mono,051,14174,3220,3216,265,3481,7
2022-11-01,Monterey,053,433212,94763,94541,21359,115900,770
2022-11-01,Napa,055,140530,32485,32484,1420,33904,161
2022-11-01,Nevada,057,99092,19192,19129,1914,21043,132
2022-11-01,Orange,059,3164182,673288,672253,64993,737246,7520
2022-11-01,Placer,061,380077,76646,76321,9673,85994,662
2022-11-01,Plumas,063,18699,3722,3720,443,4163,13
2022-11-01,Riverside,065,2383286,700256,699360,35915,735275,6660
2022-11-01,Sacramento,067,1510023,350625,349696,34696,384392,3350
2022-11-01,San Benito,069,59416,16470,16324,986,17310,108
2022-11-01,San Bernardino,071,2135413,675752,674939,31303,706242,8123
2022-11-01,San Diego,073,3302833,932247,931531,73230,1004761,5532
2022-11-01,San Francisco,075,870044,181947,180989,12262,193251,1067
2022-11-01,San Joaquin,077,732212,199426,198717,15196,213913,2336
2022-11-01,San Luis Obispo,079,281455,63764,63599,7262,70861,525
2022-11-01,San Mateo,081,765935,171334,170464,10570,181034,741
2022-11-01,Santa Barbara,083,443738,106689,106478,6946,113424,732
2022-11-01,Santa Clara,085,1922200,442105,436967,19438,456405,2533
2022-11-01,Santa Cruz,087,273765,64246,64070,3536,67606,274
2022-11-01,Shasta,089,179085,35290,35178,7664,42842,594
2022-11-01,Sierra,091,2930,308,308,60,368,5
2022-11-01,Siskiyou,093,43540,5202,5326,3351,8677,94
2022-11-01,Solano,095,438530,106396,106106,8010,114116,468
2022-11-01,Sonoma,097,501317,108061,107907,5353,113260,524
2022-11-01,Stanislaus,099,539301,138938,138715,21736,160451,1785
2022-11-01,Sutter,101,95872,24494,24470,2469,26939,233
2022-11-01,Tehama,103,63373,13757,13707,3120,16827,216
2022-11-01,Trinity,105,12862,1421,1413,429,1842,20
2022-11-01,Tulare,107,460477,122502,122246,36815,159061,1544
2022-11-01,Tuolumne,109,53932,15753,15672,930,16602,196
2022-11-01,Ventura,111,848112,210487,210085,15978,226063,1584
2022-11-01,Yolo,113,214977,47917,47786,4435,52221,353
2022-11-01,Yuba,115,75493,19084,19059,1741,20800,132
2022-10-31,Alameda,001,1643700,352381,350419,20047,370466,2040
2022-10-31,Alpine,003,1148,136,136,1,137,0
2022-10-31,Amador,005,37829,10067,10038,937,10975,94
2022-10-31,Butte,007,227075,39845,39707,9232,48939,457
2022-10-31,Calaveras,009,45235,8581,8561,572,9133,134
2022-10-31,Colusa,011,21464,3821,3813,1291,5104,22
2022-10-31,Contra Costa,013,1133247,254651,252398,20982,273380,1458
2022-10-31,Del Norte,015,27424,7478,7455,401,7856,56
2022-10-31,El Dorado,017,186661,32689,32513,4323,36836,231
2022-10-31,Fresno,019,978130,279128,275924,31886,307810,2885
2022-10-31,Glenn,021,27897,5566,5553,1877,7430,48
2022-10-31,Humboldt,023,135768,22160,22065,5173,27238,160
2022-10-31,Imperial,025,180216,66106,65903,16170,82073,959
2022-10-31,Inyo,027,18085,4519,4500,1038,5538,60
2022-10-31,Kern,029,883053,220587,219943,65056,284999,2425
2022-10-31,Kings,031,150075,59859,59742,4135,63877,459
2022-10-31,Lake,033,64148,12933,12868,1192,14060,148
2022-10-31,Lassen,035,31185,10014,9989,1004,10993,65
2022-10-31,Los Angeles,037,10098052,3307776,3298549,185847,3484396,33679
2022-10-31,Madera,039,155013,44313,44172,8317,52489,375
2022-10-31,Marin,041,260295,45897,45649,5339,50988,314
2022-10-31,Mariposa,043,17540,3139,3107,348,3455,31
2022-10-31,Mendocino,045,87422,16202,16104,4540,20644,153
2022-10-31,Merced,047,269075,73098,72606,11940,84546,870
2022-10-31,Modoc,049,8938,884,884,327,1211,11
2022-10-31,Mono,051,14174,3220,3215,264,3479,7
2022-10-31,Monterey,053,433212,94728,94425,21337,115762,769
2022-10-31,Napa,055,140530,32471,32448,1419,33867,160
2022-10-31,Nevada,057,99092,19189,19094,1914,21008,132
2022-10-31,Orange,059,3164182,673101,671141,64919,736060,7502
2022-10-31,Placer,061,380077,76627,76178,9667,85845,662
2022-10-31,Plumas,063,18699,3721,3705,443,4148,13
2022-10-31,Riverside,065,2383286,700027,698387,35887,734274,6659
2022-10-31,Sacramento,067,1510023,350474,348942,34670,383612,3346
2022-10-31,San Benito,069,59416,16464,16284,986,17270,108
2022-10-31,San Bernardino,071,2135413,675507,673959,31278,705237,8120
2022-10-31,San Diego,073,3302833,931914,929768,73198,1002966,5524
2022-10-31,San Francisco,075,870044,181837,180409,12258,192667,1066
2022-10-31,San Joaquin,077,732212,199350,198376,15182,213558,2335
2022-10-31,San Luis Obispo,079,281455,63739,63519,7254,70773,525
2022-10-31,San Mateo,081,765935,171235,169941,10566,180507,741
2022-10-31,Santa Barbara,083,443738,106651,106291,6943,113234,729
2022-10-31,Santa Clara,085,1922200,441843,435788,19424,455212,2528
2022-10-31,Santa Cruz,087,273765,64205,63885,3533,67418,274
2022-10-31,Shasta,089,179085,35268,35117,7657,42774,595
2022-10-31,Sierra,091,2930,308,308,60,368,5
2022-10-31,Siskiyou,093,43540,5198,5307,3349,8656,94
2022-10-31,Solano,095,438530,106340,105796,8005,113801,467
2022-10-31,Sonoma,097,501317,108021,107692,5349,113041,524
2022-10-31,Stanislaus,099,539301,138887,138423,21723,160146,1785
2022-10-31,Sutter,101,95872,24479,24425,2469,26894,233
2022-10-31,Tehama,103,63373,13747,13681,3119,16800,210
2022-10-31,Trinity,105,12862,1420,1398,429,1827,20
2022-10-31,Tulare,107,460477,122485,122140,36792,158932,1541
2022-10-31,Tuolumne,109,53932,15719,15658,928,16586,196
2022-10-31,Ventura,111,848112,210411,209746,15966,225712,1582
2022-10-31,Yolo,113,214977,47848,47703,4432,52135,349
2022-10-31,Yuba,115,75493,19076,19009,1741,20750,133
2022-10-30,Alameda,001,1643700,352171,350419,20023,370442,2040
2022-10-30,Alpine,003,1148,136,136,1,137,0
2022-10-30,Amador,005,37829,10062,10038,936,10974,94
2022-10-30,Butte,007,227075,39824,39707,9221,48928,457
2022-10-30,Calaveras,009,45235,8579,8561,572,9133,134
2022-10-30,Colusa,011,21464,3820,3813,1291,5104,22
2022-10-30,Contra Costa,013,1133247,254494,252398,20973,273371,1458
2022-10-30,Del Norte,015,27424,7475,7455,401,7856,56
2022-10-30,El Dorado,017,186661,32679,32513,4319,36832,231
2022-10-30,Fresno,019,978130,279040,275924,31870,307794,2885
2022-10-30,Glenn,021,27897,5558,5553,1877,7430,48
2022-10-30,Humboldt,023,135768,22154,22065,5166,27231,160
2022-10-30,Imperial,025,180216,66082,65903,16145,82048,959
2022-10-30,Inyo,027,18085,4519,4500,1037,5537,60
2022-10-30,Kern,029,883053,220516,219943,65006,284949,2425
2022-10-30,Kings,031,150075,59848,59742,4134,63876,459
2022-10-30,Lake,033,64148,12925,12868,1192,14060,148
2022-10-30,Lassen,035,31185,10009,9989,1004,10993,65
2022-10-30,Los Angeles,037,10098052,3306513,3298549,185604,3484153,33679
2022-10-30,Madera,039,155013,44304,44172,8311,52483,375
2022-10-30,Marin,041,260295,45878,45649,5338,50987,314
2022-10-30,Mariposa,043,17540,3139,3107,348,3455,31
2022-10-30,Mendocino,045,87422,16199,16104,4539,20643,153
2022-10-30,Merced,047,269075,73065,72606,11935,84541,870
2022-10-30,Modoc,049,8938,884,884,327,1211,11
2022-10-30,Mono,051,14174,3219,3215,264,3479,7
2022-10-30,Monterey,053,433212,94698,94425,21326,115751,769
2022-10-30,Napa,055,140530,32456,32448,1417,33865,160
2022-10-30,Nevada,057,99092,19182,19094,1909,21003,132
2022-10-30,Orange,059,3164182,672873,671141,64842,735983,7502
2022-10-30,Placer,061,380077,76607,76178,9664,85842,662
2022-10-30,Plumas,063,18699,3720,3705,443,4148,13
2022-10-30,Riverside,065,2383286,699808,698387,35854,734241,6659
2022-10-30,Sacramento,067,1510023,350344,348942,34635,383577,3346
2022-10-30,San Benito,069,59416,16458,16284,986,17270,108
2022-10-30,San Bernardino,071,2135413,675312,673959,31256,705215,8120
2022-10-30,San Diego,073,3302833,931557,929768,73140,1002908,5524
2022-10-30,San Francisco,075,870044,181712,180409,12248,192657,1066
2022-10-30,San Joaquin,077,732212,199281,198376,15159,213535,2335
2022-10-30,San Luis Obispo,079,281455,63726,63519,7250,70769,525
2022-10-30,San Mateo,081,765935,171146,169941,10561,180502,741
2022-10-30,Santa Barbara,083,443738,106625,106291,6938,113229,729
2022-10-30,Santa Clara,085,1922200,441611,435788,19416,455204,2528
2022-10-30,Santa Cruz,087,273765,64151,63885,3530,67415,274
2022-10-30,Shasta,089,179085,35255,35117,7652,42769,595
2022-10-30,Sierra,091,2930,308,308,60,368,5
2022-10-30,Siskiyou,093,43540,5196,5307,3348,8655,94
2022-10-30,Solano,095,438530,106280,105796,8002,113798,467
2022-10-30,Sonoma,097,501317,107984,107692,5345,113037,524
2022-10-30,Stanislaus,099,539301,138845,138423,21716,160139,1785
2022-10-30,Sutter,101,95872,24469,24425,2469,26894,233
2022-10-30,Tehama,103,63373,13738,13681,3115,16796,210
2022-10-30,Trinity,105,12862,1420,1398,428,1826,20
2022-10-30,Tulare,107,460477,122452,122140,36771,158911,1541
2022-10-30,Tuolumne,109,53932,15713,15658,927,16585,196
2022-10-30,Ventura,111,848112,210340,209746,15952,225698,1582
2022-10-30,Yolo,113,214977,47824,47703,4424,52127,349
2022-10-30,Yuba,115,75493,19068,19009,1740,20749,133
2022-10-29,Alameda,001,1643700,352061,350419,20012,370431,2040
2022-10-29,Alpine,003,1148,136,136,1,137,0
2022-10-29,Amador,005,37829,10060,10038,936,10974,94
2022-10-29,Butte,007,227075,39817,39707,9217,48924,457
2022-10-29,Calaveras,009,45235,8573,8561,572,9133,134
2022-10-29,Colusa,011,21464,3819,3813,1291,5104,22
2022-10-29,Contra Costa,013,1133247,254404,252398,20968,273366,1458
2022-10-29,Del Norte,015,27424,7475,7455,401,7856,56
2022-10-29,El Dorado,017,186661,32672,32513,4317,36830,231
2022-10-29,Fresno,019,978130,278991,275924,31860,307784,2885
2022-10-29,Glenn,021,27897,5557,5553,1877,7430,48
2022-10-29,Humboldt,023,135768,22148,22065,5165,27230,160
2022-10-29,Imperial,025,180216,66071,65903,16129,82032,959
2022-10-29,Inyo,027,18085,4519,4500,1036,5536,60
2022-10-29,Kern,029,883053,220485,219943,64981,284924,2425
2022-10-29,Kings,031,150075,59840,59742,4134,63876,459
2022-10-29,Lake,033,64148,12921,12868,1192,14060,148
2022-10-29,Lassen,035,31185,10009,9989,1004,10993,65
2022-10-29,Los Angeles,037,10098052,3305884,3298549,185490,3484039,33679
2022-10-29,Madera,039,155013,44299,44172,8311,52483,375
2022-10-29,Marin,041,260295,45859,45649,5337,50986,314
2022-10-29,Mariposa,043,17540,3139,3107,348,3455,31
2022-10-29,Mendocino,045,87422,16198,16104,4539,20643,153
2022-10-29,Merced,047,269075,73051,72606,11934,84540,870
2022-10-29,Modoc,049,8938,884,884,327,1211,11
2022-10-29,Mono,051,14174,3219,3215,264,3479,7
2022-10-29,Monterey,053,433212,94685,94425,21319,115744,769
2022-10-29,Napa,055,140530,32446,32448,1417,33865,160
2022-10-29,Nevada,057,99092,19176,19094,1908,21002,132
2022-10-29,Orange,059,3164182,672779,671141,64803,735944,7502
2022-10-29,Placer,061,380077,76592,76178,9661,85839,662
2022-10-29,Plumas,063,18699,3720,3705,443,4148,13
2022-10-29,Riverside,065,2383286,699694,698387,35834,734221,6659
2022-10-29,Sacramento,067,1510023,350276,348942,34620,383562,3346
2022-10-29,San Benito,069,59416,16454,16284,986,17270,108
2022-10-29,San Bernardino,071,2135413,675205,673959,31246,705205,8120
2022-10-29,San Diego,073,3302833,931401,929768,73128,1002896,5524
2022-10-29,San Francisco,075,870044,181645,180409,12246,192655,1066
2022-10-29,San Joaquin,077,732212,199247,198376,15150,213526,2335
2022-10-29,San Luis Obispo,079,281455,63723,63519,7248,70767,525
2022-10-29,San Mateo,081,765935,171091,169941,10560,180501,741
2022-10-29,Santa Barbara,083,443738,106606,106291,6935,113226,729
2022-10-29,Santa Clara,085,1922200,441475,435788,19407,455195,2528
2022-10-29,Santa Cruz,087,273765,64137,63885,3528,67413,274
2022-10-29,Shasta,089,179085,35248,35117,7649,42766,595
2022-10-29,Sierra,091,2930,308,308,60,368,5
2022-10-29,Siskiyou,093,43540,5195,5307,3346,8653,94
2022-10-29,Solano,095,438530,106247,105796,7998,113794,467
2022-10-29,Sonoma,097,501317,107966,107692,5343,113035,524
2022-10-29,Stanislaus,099,539301,138810,138423,21710,160133,1785
2022-10-29,Sutter,101,95872,24463,24425,2469,26894,233
2022-10-29,Tehama,103,63373,13735,13681,3111,16792,210
2022-10-29,Trinity,105,12862,1415,1398,426,1824,20
2022-10-29,Tulare,107,460477,122432,122140,36756,158896,1541
2022-10-29,Tuolumne,109,53932,15707,15658,927,16585,196
2022-10-29,Ventura,111,848112,210298,209746,15938,225684,1582
2022-10-29,Yolo,113,214977,47810,47703,4423,52126,349
2022-10-29,Yuba,115,75493,19064,19009,1740,20749,133
2022-10-28,Alameda,001,1643700,351971,350419,20007,370426,2040
2022-10-28,Alpine,003,1148,136,136,1,137,0
2022-10-28,Amador,005,37829,10055,10038,935,10973,94
2022-10-28,Butte,007,227075,39811,39707,9214,48921,457
2022-10-28,Calaveras,009,45235,8573,8561,572,9133,134
2022-10-28,Colusa,011,21464,3819,3813,1291,5104,22
2022-10-28,Contra Costa,013,1133247,254319,252398,20963,273361,1458
2022-10-28,Del Norte,015,27424,7474,7455,401,7856,56
2022-10-28,El Dorado,017,186661,32662,32513,4315,36828,231
2022-10-28,Fresno,019,978130,278942,275924,31853,307777,2885
2022-10-28,Glenn,021,27897,5556,5553,1875,7428,48
2022-10-28,Humboldt,023,135768,22143,22065,5164,27229,160
2022-10-28,Imperial,025,180216,66056,65903,16121,82024,959
2022-10-28,Inyo,027,18085,4516,4500,1036,5536,60
2022-10-28,Kern,029,883053,220458,219943,64972,284915,2425
2022-10-28,Kings,031,150075,59838,59742,4134,63876,459
2022-10-28,Lake,033,64148,12919,12868,1192,14060,148
2022-10-28,Lassen,035,31185,10009,9989,1004,10993,65
2022-10-28,Los Angeles,037,10098052,3305254,3298549,185364,3483913,33679
2022-10-28,Madera,039,155013,44291,44172,8308,52480,375
2022-10-28,Marin,041,260295,45847,45649,5337,50986,314
2022-10-28,Mariposa,043,17540,3136,3107,348,3455,31
2022-10-28,Mendocino,045,87422,16195,16104,4536,20640,153
2022-10-28,Merced,047,269075,73039,72606,11932,84538,870
2022-10-28,Modoc,049,8938,884,884,327,1211,11
2022-10-28,Mono,051,14174,3219,3215,264,3479,7
2022-10-28,Monterey,053,433212,94671,94425,21310,115735,769
2022-10-28,Napa,055,140530,32438,32448,1417,33865,160
2022-10-28,Nevada,057,99092,19173,19094,1907,21001,132
2022-10-28,Orange,059,3164182,672670,671141,64745,735886,7502
2022-10-28,Placer,061,380077,76580,76178,9659,85837,662
2022-10-28,Plumas,063,18699,3720,3705,443,4148,13
2022-10-28,Riverside,065,2383286,699578,698387,35821,734208,6659
2022-10-28,Sacramento,067,1510023,350176,348942,34612,383554,3346
2022-10-28,San Benito,069,59416,16450,16284,986,17270,108
2022-10-28,San Bernardino,071,2135413,675091,673959,31239,705198,8120
2022-10-28,San Diego,073,3302833,931217,929768,73114,1002882,5524
2022-10-28,San Francisco,075,870044,181588,180409,12241,192650,1066
2022-10-28,San Joaquin,077,732212,199219,198376,15146,213522,2335
2022-10-28,San Luis Obispo,079,281455,63718,63519,7247,70766,525
2022-10-28,San Mateo,081,765935,171034,169941,10557,180498,741
2022-10-28,Santa Barbara,083,443738,106592,106291,6935,113226,729
2022-10-28,Santa Clara,085,1922200,441329,435788,19397,455185,2528
2022-10-28,Santa Cruz,087,273765,64122,63885,3526,67411,274
2022-10-28,Shasta,089,179085,35242,35117,7644,42761,595
2022-10-28,Sierra,091,2930,308,308,60,368,5
2022-10-28,Siskiyou,093,43540,5191,5307,3344,8651,94
2022-10-28,Solano,095,438530,106220,105796,7997,113793,467
2022-10-28,Sonoma,097,501317,107945,107692,5343,113035,524
2022-10-28,Stanislaus,099,539301,138779,138423,21708,160131,1785
2022-10-28,Sutter,101,95872,24454,24425,2468,26893,233
2022-10-28,Tehama,103,63373,13732,13681,3110,16791,210
2022-10-28,Trinity,105,12862,1412,1398,425,1823,20
2022-10-28,Tulare,107,460477,122409,122140,36746,158886,1541
2022-10-28,Tuolumne,109,53932,15705,15658,927,16585,196
2022-10-28,Ventura,111,848112,210258,209746,15931,225677,1582
2022-10-28,Yolo,113,214977,47799,47703,4423,52126,349
2022-10-28,Yuba,115,75493,19058,19009,1739,20748,133
2022-10-27,Alameda,001,1643700,351836,350419,19993,370412,2040
2022-10-27,Alpine,003,1148,136,136,1,137,0
2022-10-27,Amador,005,37829,10054,10038,935,10973,94
2022-10-27,Butte,007,227075,39804,39707,9210,48917,457
2022-10-27,Calaveras,009,45235,8571,8561,571,9132,134
2022-10-27,Colusa,011,21464,3816,3813,1291,5104,22
2022-10-27,Contra Costa,013,1133247,254220,252398,20956,273354,1458
2022-10-27,Del Norte,015,27424,7469,7455,401,7856,56
2022-10-27,El Dorado,017,186661,32644,32513,4315,36828,231
2022-10-27,Fresno,019,978130,278876,275924,31848,307772,2885
2022-10-27,Glenn,021,27897,5553,5553,1875,7428,48
2022-10-27,Humboldt,023,135768,22134,22065,5164,27229,160
2022-10-27,Imperial,025,180216,66043,65903,16109,82012,959
2022-10-27,Inyo,027,18085,4514,4500,1036,5536,60
2022-10-27,Kern,029,883053,220395,219943,64940,284883,2425
2022-10-27,Kings,031,150075,59780,59742,4133,63875,459
2022-10-27,Lake,033,64148,12913,12868,1191,14059,148
2022-10-27,Lassen,035,31185,10007,9989,1003,10992,65
2022-10-27,Los Angeles,037,10098052,3304387,3298549,185213,3483762,33679
2022-10-27,Madera,039,155013,44281,44172,8305,52477,375
2022-10-27,Marin,041,260295,45829,45649,5337,50986,314
2022-10-27,Mariposa,043,17540,3135,3107,348,3455,31
2022-10-27,Mendocino,045,87422,16192,16104,4535,20639,153
2022-10-27,Merced,047,269075,73030,72606,11927,84533,870
2022-10-27,Modoc,049,8938,884,884,327,1211,11
2022-10-27,Mono,051,14174,3219,3215,264,3479,7
2022-10-27,Monterey,053,433212,94650,94425,21294,115719,769
2022-10-27,Napa,055,140530,32432,32448,1415,33863,160
2022-10-27,Nevada,057,99092,19167,19094,1904,20998,132
2022-10-27,Orange,059,3164182,672493,671141,64701,735842,7502
2022-10-27,Placer,061,380077,76567,76178,9654,85832,662
2022-10-27,Plumas,063,18699,3720,3705,443,4148,13
2022-10-27,Riverside,065,2383286,699446,698387,35797,734184,6659
2022-10-27,Sacramento,067,1510023,350043,348942,34593,383535,3346
2022-10-27,San Benito,069,59416,16449,16284,986,17270,108
2022-10-27,San Bernardino,071,2135413,674958,673959,31229,705188,8120
2022-10-27,San Diego,073,3302833,930973,929768,73083,1002851,5524
2022-10-27,San Francisco,075,870044,181498,180409,12231,192640,1066
2022-10-27,San Joaquin,077,732212,199186,198376,15137,213513,2335
2022-10-27,San Luis Obispo,079,281455,63705,63519,7245,70764,525
2022-10-27,San Mateo,081,765935,170946,169941,10554,180495,741
2022-10-27,Santa Barbara,083,443738,106562,106291,6934,113225,729
2022-10-27,Santa Clara,085,1922200,441157,435788,19387,455175,2528
2022-10-27,Santa Cruz,087,273765,64101,63885,3523,67408,274
2022-10-27,Shasta,089,179085,35233,35117,7637,42754,595
2022-10-27,Sierra,091,2930,308,308,60,368,5
2022-10-27,Siskiyou,093,43540,5187,5307,3343,8650,94
2022-10-27,Solano,095,438530,106181,105796,7995,113791,467
2022-10-27,Sonoma,097,501317,107916,107692,5343,113035,524
2022-10-27,Stanislaus,099,539301,138740,138423,21704,160127,1785
2022-10-27,Sutter,101,95872,24446,24425,2467,26892,233
2022-10-27,Tehama,103,63373,13731,13681,3110,16791,210
2022-10-27,Trinity,105,12862,1408,1398,422,1820,20
2022-10-27,Tulare,107,460477,122393,122140,36724,158864,1541
2022-10-27,Tuolumne,109,53932,15702,15658,927,16585,196
2022-10-27,Ventura,111,848112,210198,209746,15924,225670,1582
2022-10-27,Yolo,113,214977,47797,47703,4421,52124,349
2022-10-27,Yuba,115,75493,19053,19009,1738,20747,133
2022-10-26,Alameda,001,1643700,351666,350419,19977,370396,2040
2022-10-26,Alpine,003,1148,136,136,1,137,0
2022-10-26,Amador,005,37829,10053,10038,935,10973,94
2022-10-26,Butte,007,227075,39793,39707,9202,48909,457
2022-10-26,Calaveras,009,45235,8570,8561,570,9131,134
2022-10-26,Colusa,011,21464,3813,3813,1291,5104,22
2022-10-26,Contra Costa,013,1133247,254127,252398,20951,273349,1458
2022-10-26,Del Norte,015,27424,7468,7455,401,7856,56
2022-10-26,El Dorado,017,186661,32622,32513,4314,36827,231
2022-10-26,Fresno,019,978130,278824,275924,31828,307752,2885
2022-10-26,Glenn,021,27897,5553,5553,1874,7427,48
2022-10-26,Humboldt,023,135768,22129,22065,5157,27222,160
2022-10-26,Imperial,025,180216,66023,65903,16098,82001,959
2022-10-26,Inyo,027,18085,4513,4500,1034,5534,60
2022-10-26,Kern,029,883053,220357,219943,64912,284855,2425
2022-10-26,Kings,031,150075,59775,59742,4133,63875,459
2022-10-26,Lake,033,64148,12911,12868,1191,14059,148
2022-10-26,Lassen,035,31185,10002,9989,1002,10991,65
2022-10-26,Los Angeles,037,10098052,3303463,3298549,185068,3483617,33679
2022-10-26,Madera,039,155013,44273,44172,8303,52475,375
2022-10-26,Marin,041,260295,45816,45649,5335,50984,314
2022-10-26,Mariposa,043,17540,3134,3107,348,3455,31
2022-10-26,Mendocino,045,87422,16190,16104,4533,20637,153
2022-10-26,Merced,047,269075,73014,72606,11923,84529,870
2022-10-26,Modoc,049,8938,884,884,327,1211,11
2022-10-26,Mono,051,14174,3219,3215,264,3479,7
2022-10-26,Monterey,053,433212,94625,94425,21283,115708,769
2022-10-26,Napa,055,140530,32425,32448,1415,33863,160
2022-10-26,Nevada,057,99092,19164,19094,1896,20990,132
2022-10-26,Orange,059,3164182,672309,671141,64640,735781,7502
2022-10-26,Placer,061,380077,76545,76178,9649,85827,662
2022-10-26,Plumas,063,18699,3718,3705,443,4148,13
2022-10-26,Riverside,065,2383286,699301,698387,35773,734160,6659
2022-10-26,Sacramento,067,1510023,349971,348942,34573,383515,3346
2022-10-26,San Benito,069,59416,16444,16284,986,17270,108
2022-10-26,San Bernardino,071,2135413,674789,673959,31220,705179,8120
2022-10-26,San Diego,073,3302833,930687,929768,73041,1002809,5524
2022-10-26,San Francisco,075,870044,181421,180409,12227,192636,1066
2022-10-26,San Joaquin,077,732212,199134,198376,15125,213501,2335
2022-10-26,San Luis Obispo,079,281455,63690,63519,7243,70762,525
2022-10-26,San Mateo,081,765935,170858,169941,10549,180490,741
2022-10-26,Santa Barbara,083,443738,106528,106291,6929,113220,729
2022-10-26,Santa Clara,085,1922200,440982,435788,19368,455156,2528
2022-10-26,Santa Cruz,087,273765,64075,63885,3522,67407,274
2022-10-26,Shasta,089,179085,35225,35117,7632,42749,595
2022-10-26,Sierra,091,2930,308,308,60,368,5
2022-10-26,Siskiyou,093,43540,5185,5307,3342,8649,94
2022-10-26,Solano,095,438530,106124,105796,7994,113790,467
2022-10-26,Sonoma,097,501317,107890,107692,5338,113030,524
2022-10-26,Stanislaus,099,539301,138708,138423,21699,160122,1785
2022-10-26,Sutter,101,95872,24436,24425,2467,26892,233
2022-10-26,Tehama,103,63373,13726,13681,3110,16791,210
2022-10-26,Trinity,105,12862,1402,1398,420,1818,20
2022-10-26,Tulare,107,460477,122377,122140,36707,158847,1541
2022-10-26,Tuolumne,109,53932,15696,15658,927,16585,196
2022-10-26,Ventura,111,848112,210135,209746,15917,225663,1582
2022-10-26,Yolo,113,214977,47788,47703,4418,52121,349
2022-10-26,Yuba,115,75493,19046,19009,1738,20747,133
2022-10-25,Alameda,001,1643700,351515,350419,19959,370378,2040
2022-10-25,Alpine,003,1148,136,136,1,137,0
2022-10-25,Amador,005,37829,10051,10038,935,10973,94
2022-10-25,Butte,007,227075,39777,39707,9202,48909,457
2022-10-25,Calaveras,009,45235,8568,8561,570,9131,134
2022-10-25,Colusa,011,21464,3812,3813,1291,5104,22
2022-10-25,Contra Costa,013,1133247,254020,252398,20943,273341,1458
2022-10-25,Del Norte,015,27424,7467,7455,401,7856,56
2022-10-25,El Dorado,017,186661,32601,32513,4312,36825,231
2022-10-25,Fresno,019,978130,278768,275924,31813,307737,2885
2022-10-25,Glenn,021,27897,5551,5553,1874,7427,48
2022-10-25,Humboldt,023,135768,22122,22065,5154,27219,160
2022-10-25,Imperial,025,180216,66001,65903,16091,81994,959
2022-10-25,Inyo,027,18085,4513,4500,1033,5533,60
2022-10-25,Kern,029,883053,220307,219943,64871,284814,2425
2022-10-25,Kings,031,150075,59760,59742,4132,63874,459
2022-10-25,Lake,033,64148,12908,12868,1191,14059,148
2022-10-25,Lassen,035,31185,9995,9989,1002,10991,65
2022-10-25,Los Angeles,037,10098052,3302575,3298549,184924,3483473,33679
2022-10-25,Madera,039,155013,44264,44172,8299,52471,375
2022-10-25,Marin,041,260295,45789,45649,5333,50982,314
2022-10-25,Mariposa,043,17540,3133,3107,348,3455,31
2022-10-25,Mendocino,045,87422,16183,16104,4532,20636,153
2022-10-25,Merced,047,269075,72998,72606,11920,84526,870
2022-10-25,Modoc,049,8938,884,884,326,1210,11
2022-10-25,Mono,051,14174,3219,3215,263,3478,7
2022-10-25,Monterey,053,433212,94600,94425,21271,115696,769
2022-10-25,Napa,055,140530,32422,32448,1414,33862,160
2022-10-25,Nevada,057,99092,19160,19094,1893,20987,132
2022-10-25,Orange,059,3164182,672134,671141,64578,735719,7502
2022-10-25,Placer,061,380077,76510,76178,9645,85823,662
2022-10-25,Plumas,063,18699,3717,3705,443,4148,13
2022-10-25,Riverside,065,2383286,699132,698387,35760,734147,6659
2022-10-25,Sacramento,067,1510023,349863,348942,34535,383477,3346
2022-10-25,San Benito,069,59416,16437,16284,984,17268,108
2022-10-25,San Bernardino,071,2135413,674648,673959,31210,705169,8120
2022-10-25,San Diego,073,3302833,930417,929768,72984,1002752,5524
2022-10-25,San Francisco,075,870044,181332,180409,12216,192625,1066
2022-10-25,San Joaquin,077,732212,199076,198376,15118,213494,2335
2022-10-25,San Luis Obispo,079,281455,63670,63519,7240,70759,525
2022-10-25,San Mateo,081,765935,170787,169941,10547,180488,741
2022-10-25,Santa Barbara,083,443738,106493,106291,6923,113214,729
2022-10-25,Santa Clara,085,1922200,440789,435788,19358,455146,2528
2022-10-25,Santa Cruz,087,273765,64040,63885,3518,67403,274
2022-10-25,Shasta,089,179085,35219,35117,7626,42743,595
2022-10-25,Sierra,091,2930,308,308,60,368,5
2022-10-25,Siskiyou,093,43540,5183,5307,3338,8645,94
2022-10-25,Solano,095,438530,106079,105796,7988,113784,467
2022-10-25,Sonoma,097,501317,107848,107692,5337,113029,524
2022-10-25,Stanislaus,099,539301,138679,138423,21689,160112,1785
2022-10-25,Sutter,101,95872,24429,24425,2467,26892,233
2022-10-25,Tehama,103,63373,13723,13681,3109,16790,210
2022-10-25,Trinity,105,12862,1402,1398,416,1814,20
2022-10-25,Tulare,107,460477,122352,122140,36690,158830,1541
2022-10-25,Tuolumne,109,53932,15695,15658,927,16585,196
2022-10-25,Ventura,111,848112,210086,209746,15905,225651,1582
2022-10-25,Yolo,113,214977,47777,47703,4409,52112,349
2022-10-25,Yuba,115,75493,19039,19009,1738,20747,133
2022-10-24,Alameda,001,1643700,351357,349337,19949,369286,2031
2022-10-24,Alpine,003,1148,136,136,1,137,0
2022-10-24,Amador,005,37829,10049,10025,934,10959,94
2022-10-24,Butte,007,227075,39763,39607,9199,48806,456
2022-10-24,Calaveras,009,45235,8568,8541,569,9110,135
2022-10-24,Colusa,011,21464,3810,3807,1291,5098,22
2022-10-24,Contra Costa,013,1133247,253902,251722,20936,272658,1444
2022-10-24,Del Norte,015,27424,7462,7450,401,7851,56
2022-10-24,El Dorado,017,186661,32588,32443,4311,36754,232
2022-10-24,Fresno,019,978130,278705,275502,31791,307293,2893
2022-10-24,Glenn,021,27897,5550,5543,1874,7417,48
2022-10-24,Humboldt,023,135768,22116,21979,5147,27126,160
2022-10-24,Imperial,025,180216,65980,65801,16082,81883,961
2022-10-24,Inyo,027,18085,4512,4497,1030,5527,60
2022-10-24,Kern,029,883053,220257,219679,64838,284517,2424
2022-10-24,Kings,031,150075,59742,59632,4132,63764,460
2022-10-24,Lake,033,64148,12903,12847,1191,14038,148
2022-10-24,Lassen,035,31185,9995,9977,1002,10979,65
2022-10-24,Los Angeles,037,10098052,3301579,3289814,184753,3474567,33533
2022-10-24,Madera,039,155013,44259,44121,8298,52419,375
2022-10-24,Marin,041,260295,45760,45521,5333,50854,314
2022-10-24,Mariposa,043,17540,3131,3096,346,3442,31
2022-10-24,Mendocino,045,87422,16179,16059,4529,20588,136
2022-10-24,Merced,047,269075,72985,72442,11917,84359,869
2022-10-24,Modoc,049,8938,883,883,326,1209,11
2022-10-24,Mono,051,14174,3219,3212,262,3474,7
2022-10-24,Monterey,053,433212,94578,94275,21256,115531,768
2022-10-24,Napa,055,140530,32418,32395,1414,33809,160
2022-10-24,Nevada,057,99092,19152,19056,1883,20939,132
2022-10-24,Orange,059,3164182,671951,669923,64534,734457,7536
2022-10-24,Placer,061,380077,76479,76022,9642,85664,662
2022-10-24,Plumas,063,18699,3716,3691,442,4133,13
2022-10-24,Riverside,065,2383286,698998,697500,35735,733235,6569
2022-10-24,Sacramento,067,1510023,349744,348260,34508,382768,3337
2022-10-24,San Benito,069,59416,16431,16251,983,17234,107
2022-10-24,San Bernardino,071,2135413,674477,673189,31197,704386,8152
2022-10-24,San Diego,073,3302833,930142,928182,72931,1001113,5517
2022-10-24,San Francisco,075,870044,181226,179967,12213,192180,1056
2022-10-24,San Joaquin,077,732212,199020,198041,15096,213137,2336
2022-10-24,San Luis Obispo,079,281455,63658,63410,7239,70649,525
2022-10-24,San Mateo,081,765935,170726,169484,10543,180027,732
2022-10-24,Santa Barbara,083,443738,106470,106125,6922,113047,726
2022-10-24,Santa Clara,085,1922200,440586,434684,19346,454030,2523
2022-10-24,Santa Cruz,087,273765,64017,63592,3516,67108,275
2022-10-24,Shasta,089,179085,35204,35031,7615,42646,595
2022-10-24,Sierra,091,2930,308,305,60,365,5
2022-10-24,Siskiyou,093,43540,5181,5298,3338,8636,94
2022-10-24,Solano,095,438530,106031,105561,7987,113548,466
2022-10-24,Sonoma,097,501317,107817,107436,5337,112773,527
2022-10-24,Stanislaus,099,539301,138652,138223,21686,159909,1785
2022-10-24,Sutter,101,95872,24424,24393,2467,26860,233
2022-10-24,Tehama,103,63373,13721,13647,3108,16755,209
2022-10-24,Trinity,105,12862,1401,1396,415,1811,20
2022-10-24,Tulare,107,460477,122331,122035,36673,158708,1540
2022-10-24,Tuolumne,109,53932,15692,15626,927,16553,196
2022-10-24,Ventura,111,848112,210036,209427,15900,225327,1571
2022-10-24,Yolo,113,214977,47766,47611,4407,52018,346
2022-10-24,Yuba,115,75493,19030,18969,1738,20707,130
2022-10-23,Alameda,001,1643700,351164,349337,19930,369267,2031
2022-10-23,Alpine,003,1148,136,136,1,137,0
2022-10-23,Amador,005,37829,10048,10025,934,10959,94
2022-10-23,Butte,007,227075,39751,39607,9197,48804,456
2022-10-23,Calaveras,009,45235,8563,8541,569,9110,135
2022-10-23,Colusa,011,21464,3810,3807,1289,5096,22
2022-10-23,Contra Costa,013,1133247,253793,251722,20924,272646,1444
2022-10-23,Del Norte,015,27424,7461,7450,401,7851,56
2022-10-23,El Dorado,017,186661,32575,32443,4309,36752,232
2022-10-23,Fresno,019,978130,278641,275502,31777,307279,2893
2022-10-23,Glenn,021,27897,5548,5543,1872,7415,48
2022-10-23,Humboldt,023,135768,22108,21979,5140,27119,160
2022-10-23,Imperial,025,180216,65967,65801,16064,81865,961
2022-10-23,Inyo,027,18085,4510,4497,1030,5527,60
2022-10-23,Kern,029,883053,220205,219679,64766,284445,2424
2022-10-23,Kings,031,150075,59723,59632,4129,63761,460
2022-10-23,Lake,033,64148,12902,12847,1191,14038,148
2022-10-23,Lassen,035,31185,9992,9977,1001,10978,65
2022-10-23,Los Angeles,037,10098052,3300622,3289814,184556,3474370,33533
2022-10-23,Madera,039,155013,44247,44121,8296,52417,375
2022-10-23,Marin,041,260295,45745,45521,5331,50852,314
2022-10-23,Mariposa,043,17540,3128,3096,345,3441,31
2022-10-23,Mendocino,045,87422,16172,16059,4528,20587,136
2022-10-23,Merced,047,269075,72977,72442,11913,84355,869
2022-10-23,Modoc,049,8938,883,883,326,1209,11
2022-10-23,Mono,051,14174,3219,3212,261,3473,7
2022-10-23,Monterey,053,433212,94558,94275,21241,115516,768
2022-10-23,Napa,055,140530,32400,32395,1414,33809,160
2022-10-23,Nevada,057,99092,19140,19056,1881,20937,132
2022-10-23,Orange,059,3164182,671728,669923,64463,734386,7536
2022-10-23,Placer,061,380077,76449,76022,9638,85660,662
2022-10-23,Plumas,063,18699,3715,3691,441,4132,13
2022-10-23,Riverside,065,2383286,698818,697500,35716,733216,6569
2022-10-23,Sacramento,067,1510023,349597,348260,34484,382744,3337
2022-10-23,San Benito,069,59416,16424,16251,982,17233,107
2022-10-23,San Bernardino,071,2135413,674340,673189,31180,704369,8152
2022-10-23,San Diego,073,3302833,929792,928182,72889,1001071,5517
2022-10-23,San Francisco,075,870044,181118,179967,12205,192172,1056
2022-10-23,San Joaquin,077,732212,198958,198041,15084,213125,2336
2022-10-23,San Luis Obispo,079,281455,63644,63410,7231,70641,525
2022-10-23,San Mateo,081,765935,170637,169484,10540,180024,732
2022-10-23,Santa Barbara,083,443738,106430,106125,6919,113044,726
2022-10-23,Santa Clara,085,1922200,440367,434684,19323,454007,2523
2022-10-23,Santa Cruz,087,273765,63963,63592,3513,67105,275
2022-10-23,Shasta,089,179085,35191,35031,7604,42635,595
2022-10-23,Sierra,091,2930,308,305,60,365,5
2022-10-23,Siskiyou,093,43540,5179,5298,3335,8633,94
2022-10-23,Solano,095,438530,105980,105561,7983,113544,466
2022-10-23,Sonoma,097,501317,107758,107436,5333,112769,527
2022-10-23,Stanislaus,099,539301,138610,138223,21682,159905,1785
2022-10-23,Sutter,101,95872,24418,24393,2467,26860,233
2022-10-23,Tehama,103,63373,13715,13647,3108,16755,209
2022-10-23,Trinity,105,12862,1401,1396,412,1808,20
2022-10-23,Tulare,107,460477,122302,122035,36649,158684,1540
2022-10-23,Tuolumne,109,53932,15689,15626,926,16552,196
2022-10-23,Ventura,111,848112,209985,209427,15887,225314,1571
2022-10-23,Yolo,113,214977,47748,47611,4396,52007,346
2022-10-23,Yuba,115,75493,19024,18969,1737,20706,130
2022-10-22,Alameda,001,1643700,351064,349337,19924,369261,2031
2022-10-22,Alpine,003,1148,136,136,1,137,0
2022-10-22,Amador,005,37829,10046,10025,934,10959,94
2022-10-22,Butte,007,227075,39745,39607,9192,48799,456
2022-10-22,Calaveras,009,45235,8560,8541,569,9110,135
2022-10-22,Colusa,011,21464,3810,3807,1288,5095,22
2022-10-22,Contra Costa,013,1133247,253727,251722,20917,272639,1444
2022-10-22,Del Norte,015,27424,7460,7450,401,7851,56
2022-10-22,El Dorado,017,186661,32568,32443,4308,36751,232
2022-10-22,Fresno,019,978130,278603,275502,31773,307275,2893
2022-10-22,Glenn,021,27897,5547,5543,1872,7415,48
2022-10-22,Humboldt,023,135768,22103,21979,5138,27117,160
2022-10-22,Imperial,025,180216,65953,65801,16057,81858,961
2022-10-22,Inyo,027,18085,4509,4497,1028,5525,60
2022-10-22,Kern,029,883053,220186,219679,64736,284415,2424
2022-10-22,Kings,031,150075,59714,59632,4128,63760,460
2022-10-22,Lake,033,64148,12900,12847,1190,14037,148
2022-10-22,Lassen,035,31185,9992,9977,1000,10977,65
2022-10-22,Los Angeles,037,10098052,3300105,3289814,184467,3474281,33533
2022-10-22,Madera,039,155013,44239,44121,8295,52416,375
2022-10-22,Marin,041,260295,45725,45521,5327,50848,314
2022-10-22,Mariposa,043,17540,3128,3096,345,3441,31
2022-10-22,Mendocino,045,87422,16171,16059,4528,20587,136
2022-10-22,Merced,047,269075,72967,72442,11913,84355,869
2022-10-22,Modoc,049,8938,883,883,326,1209,11
2022-10-22,Mono,051,14174,3218,3212,261,3473,7
2022-10-22,Monterey,053,433212,94546,94275,21232,115507,768
2022-10-22,Napa,055,140530,32396,32395,1414,33809,160
2022-10-22,Nevada,057,99092,19136,19056,1881,20937,132
2022-10-22,Orange,059,3164182,671636,669923,64419,734342,7536
2022-10-22,Placer,061,380077,76428,76022,9633,85655,662
2022-10-22,Plumas,063,18699,3715,3691,441,4132,13
2022-10-22,Riverside,065,2383286,698723,697500,35698,733198,6569
2022-10-22,Sacramento,067,1510023,349521,348260,34472,382732,3337
2022-10-22,San Benito,069,59416,16416,16251,982,17233,107
2022-10-22,San Bernardino,071,2135413,674261,673189,31174,704363,8152
2022-10-22,San Diego,073,3302833,929661,928182,72866,1001048,5517
2022-10-22,San Francisco,075,870044,181067,179967,12202,192169,1056
2022-10-22,San Joaquin,077,732212,198934,198041,15077,213118,2336
2022-10-22,San Luis Obispo,079,281455,63640,63410,7230,70640,525
2022-10-22,San Mateo,081,765935,170582,169484,10536,180020,732
2022-10-22,Santa Barbara,083,443738,106417,106125,6916,113041,726
2022-10-22,Santa Clara,085,1922200,440234,434684,19313,453997,2523
2022-10-22,Santa Cruz,087,273765,63950,63592,3513,67105,275
2022-10-22,Shasta,089,179085,35186,35031,7600,42631,595
2022-10-22,Sierra,091,2930,308,305,60,365,5
2022-10-22,Siskiyou,093,43540,5175,5298,3335,8633,94
2022-10-22,Solano,095,438530,105959,105561,7983,113544,466
2022-10-22,Sonoma,097,501317,107745,107436,5332,112768,527
2022-10-22,Stanislaus,099,539301,138592,138223,21679,159902,1785
2022-10-22,Sutter,101,95872,24416,24393,2467,26860,233
2022-10-22,Tehama,103,63373,13711,13647,3106,16753,209
2022-10-22,Trinity,105,12862,1401,1396,412,1808,20
2022-10-22,Tulare,107,460477,122291,122035,36638,158673,1540
2022-10-22,Tuolumne,109,53932,15687,15626,926,16552,196
2022-10-22,Ventura,111,848112,209960,209427,15882,225309,1571
2022-10-22,Yolo,113,214977,47738,47611,4396,52007,346
2022-10-22,Yuba,115,75493,19017,18969,1736,20705,130
2022-10-21,Alameda,001,1643700,350984,349337,19916,369253,2031
2022-10-21,Alpine,003,1148,136,136,1,137,0
2022-10-21,Amador,005,37829,10045,10025,934,10959,94
2022-10-21,Butte,007,227075,39733,39607,9187,48794,456
2022-10-21,Calaveras,009,45235,8560,8541,569,9110,135
2022-10-21,Colusa,011,21464,3809,3807,1288,5095,22
2022-10-21,Contra Costa,013,1133247,253661,251722,20909,272631,1444
2022-10-21,Del Norte,015,27424,7460,7450,401,7851,56
2022-10-21,El Dorado,017,186661,32558,32443,4306,36749,232
2022-10-21,Fresno,019,978130,278567,275502,31768,307270,2893
2022-10-21,Glenn,021,27897,5547,5543,1871,7414,48
2022-10-21,Humboldt,023,135768,22095,21979,5135,27114,160
2022-10-21,Imperial,025,180216,65948,65801,16051,81852,961
2022-10-21,Inyo,027,18085,4509,4497,1028,5525,60
2022-10-21,Kern,029,883053,220165,219679,64716,284395,2424
2022-10-21,Kings,031,150075,59708,59632,4128,63760,460
2022-10-21,Lake,033,64148,12899,12847,1190,14037,148
2022-10-21,Lassen,035,31185,9990,9977,1000,10977,65
2022-10-21,Los Angeles,037,10098052,3299545,3289814,184344,3474158,33533
2022-10-21,Madera,039,155013,44232,44121,8292,52413,375
2022-10-21,Marin,041,260295,45705,45521,5325,50846,314
2022-10-21,Mariposa,043,17540,3127,3096,345,3441,31
2022-10-21,Mendocino,045,87422,16164,16059,4528,20587,136
2022-10-21,Merced,047,269075,72961,72442,11912,84354,869
2022-10-21,Modoc,049,8938,883,883,326,1209,11
2022-10-21,Mono,051,14174,3218,3212,261,3473,7
2022-10-21,Monterey,053,433212,94529,94275,21230,115505,768
2022-10-21,Napa,055,140530,32394,32395,1414,33809,160
2022-10-21,Nevada,057,99092,19132,19056,1880,20936,132
2022-10-21,Orange,059,3164182,671517,669923,64381,734304,7536
2022-10-21,Placer,061,380077,76407,76022,9628,85650,662
2022-10-21,Plumas,063,18699,3714,3691,441,4132,13
2022-10-21,Riverside,065,2383286,698633,697500,35685,733185,6569
2022-10-21,Sacramento,067,1510023,349449,348260,34465,382725,3337
2022-10-21,San Benito,069,59416,16414,16251,981,17232,107
2022-10-21,San Bernardino,071,2135413,674185,673189,31166,704355,8152
2022-10-21,San Diego,073,3302833,929510,928182,72844,1001026,5517
2022-10-21,San Francisco,075,870044,181028,179967,12198,192165,1056
2022-10-21,San Joaquin,077,732212,198907,198041,15073,213114,2336
2022-10-21,San Luis Obispo,079,281455,63632,63410,7230,70640,525
2022-10-21,San Mateo,081,765935,170539,169484,10533,180017,732
2022-10-21,Santa Barbara,083,443738,106403,106125,6916,113041,726
2022-10-21,Santa Clara,085,1922200,440102,434684,19304,453988,2523
2022-10-21,Santa Cruz,087,273765,63935,63592,3513,67105,275
2022-10-21,Shasta,089,179085,35179,35031,7593,42624,595
2022-10-21,Sierra,091,2930,308,305,60,365,5
2022-10-21,Siskiyou,093,43540,5175,5298,3335,8633,94
2022-10-21,Solano,095,438530,105936,105561,7982,113543,466
2022-10-21,Sonoma,097,501317,107721,107436,5330,112766,527
2022-10-21,Stanislaus,099,539301,138577,138223,21677,159900,1785
2022-10-21,Sutter,101,95872,24409,24393,2467,26860,233
2022-10-21,Tehama,103,63373,13707,13647,3106,16753,209
2022-10-21,Trinity,105,12862,1401,1396,411,1807,20
2022-10-21,Tulare,107,460477,122284,122035,36632,158667,1540
2022-10-21,Tuolumne,109,53932,15681,15626,926,16552,196
2022-10-21,Ventura,111,848112,209930,209427,15879,225306,1571
2022-10-21,Yolo,113,214977,47728,47611,4395,52006,346
2022-10-21,Yuba,115,75493,19007,18969,1736,20705,130
2022-10-20,Alameda,001,1643700,350848,349337,19911,369248,2031
2022-10-20,Alpine,003,1148,136,136,1,137,0
2022-10-20,Amador,005,37829,10040,10025,934,10959,94
2022-10-20,Butte,007,227075,39726,39607,9185,48792,456
2022-10-20,Calaveras,009,45235,8559,8541,568,9109,135
2022-10-20,Colusa,011,21464,3809,3807,1287,5094,22
2022-10-20,Contra Costa,013,1133247,253560,251722,20905,272627,1444
2022-10-20,Del Norte,015,27424,7460,7450,400,7850,56
2022-10-20,El Dorado,017,186661,32542,32443,4305,36748,232
2022-10-20,Fresno,019,978130,278516,275502,31760,307262,2893
2022-10-20,Glenn,021,27897,5547,5543,1871,7414,48
2022-10-20,Humboldt,023,135768,22089,21979,5129,27108,160
2022-10-20,Imperial,025,180216,65939,65801,16040,81841,961
2022-10-20,Inyo,027,18085,4504,4497,1025,5522,60
2022-10-20,Kern,029,883053,220127,219679,64670,284349,2424
2022-10-20,Kings,031,150075,59693,59632,4126,63758,460
2022-10-20,Lake,033,64148,12895,12847,1190,14037,148
2022-10-20,Lassen,035,31185,9987,9977,1000,10977,65
2022-10-20,Los Angeles,037,10098052,3298798,3289814,184220,3474034,33533
2022-10-20,Madera,039,155013,44220,44121,8292,52413,375
2022-10-20,Marin,041,260295,45688,45521,5324,50845,314
2022-10-20,Mariposa,043,17540,3126,3096,344,3440,31
2022-10-20,Mendocino,045,87422,16159,16059,4527,20586,136
2022-10-20,Merced,047,269075,72952,72442,11912,84354,869
2022-10-20,Modoc,049,8938,882,883,325,1208,11
2022-10-20,Mono,051,14174,3218,3212,261,3473,7
2022-10-20,Monterey,053,433212,94513,94275,21217,115492,768
2022-10-20,Napa,055,140530,32388,32395,1414,33809,160
2022-10-20,Nevada,057,99092,19130,19056,1874,20930,132
2022-10-20,Orange,059,3164182,671383,669923,64327,734250,7536
2022-10-20,Placer,061,380077,76376,76022,9624,85646,662
2022-10-20,Plumas,063,18699,3713,3691,441,4132,13
2022-10-20,Riverside,065,2383286,698506,697500,35666,733166,6569
2022-10-20,Sacramento,067,1510023,349310,348260,34445,382705,3337
2022-10-20,San Benito,069,59416,16411,16251,980,17231,107
2022-10-20,San Bernardino,071,2135413,674076,673189,31149,704338,8152
2022-10-20,San Diego,073,3302833,929315,928182,72803,1000985,5517
2022-10-20,San Francisco,075,870044,180967,179967,12192,192159,1056
2022-10-20,San Joaquin,077,732212,198874,198041,15065,213106,2336
2022-10-20,San Luis Obispo,079,281455,63622,63410,7225,70635,525
2022-10-20,San Mateo,081,765935,170468,169484,10531,180015,732
2022-10-20,Santa Barbara,083,443738,106381,106125,6914,113039,726
2022-10-20,Santa Clara,085,1922200,439954,434684,19289,453973,2523
2022-10-20,Santa Cruz,087,273765,63898,63592,3512,67104,275
2022-10-20,Shasta,089,179085,35169,35031,7578,42609,595
2022-10-20,Sierra,091,2930,308,305,60,365,5
2022-10-20,Siskiyou,093,43540,5173,5298,3335,8633,94
2022-10-20,Solano,095,438530,105900,105561,7979,113540,466
2022-10-20,Sonoma,097,501317,107687,107436,5330,112766,527
2022-10-20,Stanislaus,099,539301,138540,138223,21674,159897,1785
2022-10-20,Sutter,101,95872,24405,24393,2467,26860,233
2022-10-20,Tehama,103,63373,13701,13647,3102,16749,209
2022-10-20,Trinity,105,12862,1401,1396,411,1807,20
2022-10-20,Tulare,107,460477,122269,122035,36626,158661,1540
2022-10-20,Tuolumne,109,53932,15675,15626,926,16552,196
2022-10-20,Ventura,111,848112,209891,209427,15870,225297,1571
2022-10-20,Yolo,113,214977,47718,47611,4391,52002,346
2022-10-20,Yuba,115,75493,19001,18969,1736,20705,130
2022-10-19,Alameda,001,1643700,350712,349337,19900,369237,2031
2022-10-19,Alpine,003,1148,136,136,1,137,0
2022-10-19,Amador,005,37829,10038,10025,933,10958,94
2022-10-19,Butte,007,227075,39719,39607,9182,48789,456
2022-10-19,Calaveras,009,45235,8557,8541,568,9109,135
2022-10-19,Colusa,011,21464,3808,3807,1287,5094,22
2022-10-19,Contra Costa,013,1133247,253477,251722,20889,272611,1444
2022-10-19,Del Norte,015,27424,7460,7450,400,7850,56
2022-10-19,El Dorado,017,186661,32527,32443,4303,36746,232
2022-10-19,Fresno,019,978130,278452,275502,31745,307247,2893
2022-10-19,Glenn,021,27897,5544,5543,1871,7414,48
2022-10-19,Humboldt,023,135768,22073,21979,5119,27098,160
2022-10-19,Imperial,025,180216,65923,65801,16029,81830,961
2022-10-19,Inyo,027,18085,4504,4497,1023,5520,60
2022-10-19,Kern,029,883053,220079,219679,64629,284308,2424
2022-10-19,Kings,031,150075,59680,59632,4126,63758,460
2022-10-19,Lake,033,64148,12890,12847,1189,14036,148
2022-10-19,Lassen,035,31185,9984,9977,999,10976,65
2022-10-19,Los Angeles,037,10098052,3297972,3289814,184082,3473896,33533
2022-10-19,Madera,039,155013,44212,44121,8291,52412,375
2022-10-19,Marin,041,260295,45666,45521,5323,50844,314
2022-10-19,Mariposa,043,17540,3123,3096,344,3440,31
2022-10-19,Mendocino,045,87422,16154,16059,4525,20584,136
2022-10-19,Merced,047,269075,72934,72442,11909,84351,869
2022-10-19,Modoc,049,8938,882,883,325,1208,11
2022-10-19,Mono,051,14174,3217,3212,260,3472,7
2022-10-19,Monterey,053,433212,94499,94275,21210,115485,768
2022-10-19,Napa,055,140530,32381,32395,1413,33808,160
2022-10-19,Nevada,057,99092,19125,19056,1872,20928,132
2022-10-19,Orange,059,3164182,671174,669923,64268,734191,7536
2022-10-19,Placer,061,380077,76349,76022,9619,85641,662
2022-10-19,Plumas,063,18699,3710,3691,441,4132,13
2022-10-19,Riverside,065,2383286,698385,697500,35644,733144,6569
2022-10-19,Sacramento,067,1510023,349204,348260,34430,382690,3337
2022-10-19,San Benito,069,59416,16407,16251,980,17231,107
2022-10-19,San Bernardino,071,2135413,673943,673189,31143,704332,8152
2022-10-19,San Diego,073,3302833,929058,928182,72757,1000939,5517
2022-10-19,San Francisco,075,870044,180890,179967,12186,192153,1056
2022-10-19,San Joaquin,077,732212,198831,198041,15055,213096,2336
2022-10-19,San Luis Obispo,079,281455,63608,63410,7224,70634,525
2022-10-19,San Mateo,081,765935,170403,169484,10523,180007,732
2022-10-19,Santa Barbara,083,443738,106352,106125,6912,113037,726
2022-10-19,Santa Clara,085,1922200,439794,434684,19278,453962,2523
2022-10-19,Santa Cruz,087,273765,63849,63592,3511,67103,275
2022-10-19,Shasta,089,179085,35160,35031,7564,42595,595
2022-10-19,Sierra,091,2930,308,305,60,365,5
2022-10-19,Siskiyou,093,43540,5172,5298,3332,8630,94
2022-10-19,Solano,095,438530,105868,105561,7977,113538,466
2022-10-19,Sonoma,097,501317,107655,107436,5327,112763,527
2022-10-19,Stanislaus,099,539301,138507,138223,21671,159894,1785
2022-10-19,Sutter,101,95872,24402,24393,2467,26860,233
2022-10-19,Tehama,103,63373,13696,13647,3100,16747,209
2022-10-19,Trinity,105,12862,1400,1396,411,1807,20
2022-10-19,Tulare,107,460477,122258,122035,36606,158641,1540
2022-10-19,Tuolumne,109,53932,15671,15626,926,16552,196
2022-10-19,Ventura,111,848112,209848,209427,15857,225284,1571
2022-10-19,Yolo,113,214977,47708,47611,4383,51994,346
2022-10-19,Yuba,115,75493,18991,18969,1735,20704,130
2022-10-18,Alameda,001,1643700,350587,349337,19886,369223,2031
2022-10-18,Alpine,003,1148,136,136,1,137,0
2022-10-18,Amador,005,37829,10035,10025,931,10956,94
2022-10-18,Butte,007,227075,39710,39607,9182,48789,456
2022-10-18,Calaveras,009,45235,8552,8541,567,9108,135
2022-10-18,Colusa,011,21464,3807,3807,1285,5092,22
2022-10-18,Contra Costa,013,1133247,253387,251722,20885,272607,1444
2022-10-18,Del Norte,015,27424,7456,7450,400,7850,56
2022-10-18,El Dorado,017,186661,32510,32443,4298,36741,232
2022-10-18,Fresno,019,978130,278395,275502,31732,307234,2893
2022-10-18,Glenn,021,27897,5544,5543,1871,7414,48
2022-10-18,Humboldt,023,135768,22060,21979,5116,27095,160
2022-10-18,Imperial,025,180216,65902,65801,16013,81814,961
2022-10-18,Inyo,027,18085,4504,4497,1020,5517,60
2022-10-18,Kern,029,883053,220033,219679,64591,284270,2424
2022-10-18,Kings,031,150075,59664,59632,4124,63756,460
2022-10-18,Lake,033,64148,12884,12847,1189,14036,148
2022-10-18,Lassen,035,31185,9981,9977,999,10976,65
2022-10-18,Los Angeles,037,10098052,3297164,3289814,183948,3473762,33533
2022-10-18,Madera,039,155013,44203,44121,8289,52410,375
2022-10-18,Marin,041,260295,45640,45521,5321,50842,314
2022-10-18,Mariposa,043,17540,3121,3096,344,3440,31
2022-10-18,Mendocino,045,87422,16143,16059,4525,20584,136
2022-10-18,Merced,047,269075,72915,72442,11902,84344,869
2022-10-18,Modoc,049,8938,882,883,325,1208,11
2022-10-18,Mono,051,14174,3216,3212,260,3472,7
2022-10-18,Monterey,053,433212,94472,94275,21202,115477,768
2022-10-18,Napa,055,140530,32376,32395,1413,33808,160
2022-10-18,Nevada,057,99092,19119,19056,1872,20928,132
2022-10-18,Orange,059,3164182,670997,669923,64184,734107,7536
2022-10-18,Placer,061,380077,76318,76022,9616,85638,662
2022-10-18,Plumas,063,18699,3709,3691,441,4132,13
2022-10-18,Riverside,065,2383286,698237,697500,35627,733127,6569
2022-10-18,Sacramento,067,1510023,349082,348260,34412,382672,3337
2022-10-18,San Benito,069,59416,16402,16251,977,17228,107
2022-10-18,San Bernardino,071,2135413,673833,673189,31123,704312,8152
2022-10-18,San Diego,073,3302833,928760,928182,72709,1000891,5517
2022-10-18,San Francisco,075,870044,180808,179967,12184,192151,1056
2022-10-18,San Joaquin,077,732212,198795,198041,15042,213083,2336
2022-10-18,San Luis Obispo,079,281455,63584,63410,7222,70632,525
2022-10-18,San Mateo,081,765935,170326,169484,10519,180003,732
2022-10-18,Santa Barbara,083,443738,106326,106125,6909,113034,726
2022-10-18,Santa Clara,085,1922200,439619,434684,19259,453943,2523
2022-10-18,Santa Cruz,087,273765,63828,63592,3508,67100,275
2022-10-18,Shasta,089,179085,35153,35031,7560,42591,595
2022-10-18,Sierra,091,2930,308,305,60,365,5
2022-10-18,Siskiyou,093,43540,5172,5298,3330,8628,94
2022-10-18,Solano,095,438530,105832,105561,7972,113533,466
2022-10-18,Sonoma,097,501317,107611,107436,5320,112756,527
2022-10-18,Stanislaus,099,539301,138483,138223,21664,159887,1785
2022-10-18,Sutter,101,95872,24398,24393,2467,26860,233
2022-10-18,Tehama,103,63373,13689,13647,3097,16744,209
2022-10-18,Trinity,105,12862,1400,1396,408,1804,20
2022-10-18,Tulare,107,460477,122239,122035,36588,158623,1540
2022-10-18,Tuolumne,109,53932,15666,15626,926,16552,196
2022-10-18,Ventura,111,848112,209786,209427,15846,225273,1571
2022-10-18,Yolo,113,214977,47699,47611,4380,51991,346
2022-10-18,Yuba,115,75493,18984,18969,1735,20704,130
2022-10-17,Alameda,001,1643700,350435,348487,19881,368368,2027
2022-10-17,Alpine,003,1148,136,135,1,136,0
2022-10-17,Amador,005,37829,10031,10013,931,10944,93
2022-10-17,Butte,007,227075,39695,39567,9180,48747,456
2022-10-17,Calaveras,009,45235,8548,8523,567,9090,133
2022-10-17,Colusa,011,21464,3807,3805,1285,5090,22
2022-10-17,Contra Costa,013,1133247,253279,250897,20878,271775,1440
2022-10-17,Del Norte,015,27424,7456,7440,400,7840,56
2022-10-17,El Dorado,017,186661,32497,32373,4296,36669,231
2022-10-17,Fresno,019,978130,278328,275035,31709,306744,2873
2022-10-17,Glenn,021,27897,5541,5532,1871,7403,48
2022-10-17,Humboldt,023,135768,22047,21914,5104,27018,159
2022-10-17,Imperial,025,180216,65884,65691,15987,81678,958
2022-10-17,Inyo,027,18085,4504,4492,1019,5511,60
2022-10-17,Kern,029,883053,219988,219487,64553,284040,2420
2022-10-17,Kings,031,150075,59653,59560,4123,63683,459
2022-10-17,Lake,033,64148,12881,12815,1188,14003,146
2022-10-17,Lassen,035,31185,9979,9970,999,10969,65
2022-10-17,Los Angeles,037,10098052,3296267,3285385,183797,3469182,33525
2022-10-17,Madera,039,155013,44198,44078,8288,52366,375
2022-10-17,Marin,041,260295,45622,45378,5318,50696,315
2022-10-17,Mariposa,043,17540,3119,3091,344,3435,31
2022-10-17,Mendocino,045,87422,16137,16023,4524,20547,136
2022-10-17,Merced,047,269075,72897,72326,11901,84227,868
2022-10-17,Modoc,049,8938,882,882,325,1207,11
2022-10-17,Mono,051,14174,3216,3206,260,3466,7
2022-10-17,Monterey,053,433212,94448,94183,21196,115379,768
2022-10-17,Napa,055,140530,32367,32326,1412,33738,161
2022-10-17,Nevada,057,99092,19114,19023,1869,20892,132
2022-10-17,Orange,059,3164182,670824,668814,64122,732936,7473
2022-10-17,Placer,061,380077,76288,75902,9603,85505,660
2022-10-17,Plumas,063,18699,3704,3682,439,4121,13
2022-10-17,Riverside,065,2383286,698079,696402,35603,732005,6561
2022-10-17,Sacramento,067,1510023,348943,347495,34399,381894,3324
2022-10-17,San Benito,069,59416,16390,16223,976,17199,107
2022-10-17,San Bernardino,071,2135413,673699,672221,31103,703324,8148
2022-10-17,San Diego,073,3302833,928459,926574,72660,999234,5507
2022-10-17,San Francisco,075,870044,180726,179482,12181,191663,1048
2022-10-17,San Joaquin,077,732212,198748,197672,15035,212707,2322
2022-10-17,San Luis Obispo,079,281455,63569,63321,7221,70542,524
2022-10-17,San Mateo,081,765935,170262,168944,10519,179463,732
2022-10-17,Santa Barbara,083,443738,106306,105931,6906,112837,726
2022-10-17,Santa Clara,085,1922200,439402,433458,19248,452706,2513
2022-10-17,Santa Cruz,087,273765,63779,63316,3507,66823,273
2022-10-17,Shasta,089,179085,35131,34971,7554,42525,595
2022-10-17,Sierra,091,2930,306,305,60,365,5
2022-10-17,Siskiyou,093,43540,5169,5287,3327,8614,92
2022-10-17,Solano,095,438530,105794,105287,7969,113256,465
2022-10-17,Sonoma,097,501317,107571,107199,5316,112515,520
2022-10-17,Stanislaus,099,539301,138453,137994,21656,159650,1782
2022-10-17,Sutter,101,95872,24397,24357,2467,26824,233
2022-10-17,Tehama,103,63373,13685,13624,3096,16720,209
2022-10-17,Trinity,105,12862,1400,1396,408,1804,20
2022-10-17,Tulare,107,460477,122221,121902,36576,158478,1538
2022-10-17,Tuolumne,109,53932,15659,15586,925,16511,196
2022-10-17,Ventura,111,848112,209743,209051,15840,224891,1571
2022-10-17,Yolo,113,214977,47676,47498,4374,51872,343
2022-10-17,Yuba,115,75493,18978,18934,1735,20669,129
2022-10-16,Alameda,001,1643700,350268,348487,19864,368351,2027
2022-10-16,Alpine,003,1148,136,135,1,136,0
2022-10-16,Amador,005,37829,10029,10013,931,10944,93
2022-10-16,Butte,007,227075,39675,39567,9174,48741,456
2022-10-16,Calaveras,009,45235,8547,8523,566,9089,133
2022-10-16,Colusa,011,21464,3806,3805,1285,5090,22
2022-10-16,Contra Costa,013,1133247,253155,250897,20876,271773,1440
2022-10-16,Del Norte,015,27424,7455,7440,400,7840,56
2022-10-16,El Dorado,017,186661,32482,32373,4292,36665,231
2022-10-16,Fresno,019,978130,278240,275035,31691,306726,2873
2022-10-16,Glenn,021,27897,5540,5532,1871,7403,48
2022-10-16,Humboldt,023,135768,22028,21914,5090,27004,159
2022-10-16,Imperial,025,180216,65851,65691,15971,81662,958
2022-10-16,Inyo,027,18085,4503,4492,1016,5508,60
2022-10-16,Kern,029,883053,219941,219487,64507,283994,2420
2022-10-16,Kings,031,150075,59642,59560,4122,63682,459
2022-10-16,Lake,033,64148,12877,12815,1188,14003,146
2022-10-16,Lassen,035,31185,9978,9970,999,10969,65
2022-10-16,Los Angeles,037,10098052,3295347,3285385,183641,3469026,33525
2022-10-16,Madera,039,155013,44184,44078,8286,52364,375
2022-10-16,Marin,041,260295,45600,45378,5317,50695,315
2022-10-16,Mariposa,043,17540,3118,3091,344,3435,31
2022-10-16,Mendocino,045,87422,16128,16023,4522,20545,136
2022-10-16,Merced,047,269075,72877,72326,11900,84226,868
2022-10-16,Modoc,049,8938,882,882,325,1207,11
2022-10-16,Mono,051,14174,3215,3206,260,3466,7
2022-10-16,Monterey,053,433212,94420,94183,21185,115368,768
2022-10-16,Napa,055,140530,32358,32326,1412,33738,161
2022-10-16,Nevada,057,99092,19110,19023,1867,20890,132
2022-10-16,Orange,059,3164182,670625,668814,64068,732882,7473
2022-10-16,Placer,061,380077,76263,75902,9598,85500,660
2022-10-16,Plumas,063,18699,3700,3682,439,4121,13
2022-10-16,Riverside,065,2383286,697909,696402,35575,731977,6561
2022-10-16,Sacramento,067,1510023,348764,347495,34375,381870,3324
2022-10-16,San Benito,069,59416,16386,16223,975,17198,107
2022-10-16,San Bernardino,071,2135413,673536,672221,31096,703317,8148
2022-10-16,San Diego,073,3302833,928139,926574,72610,999184,5507
2022-10-16,San Francisco,075,870044,180618,179482,12171,191653,1048
2022-10-16,San Joaquin,077,732212,198672,197672,15028,212700,2322
2022-10-16,San Luis Obispo,079,281455,63544,63321,7218,70539,524
2022-10-16,San Mateo,081,765935,170160,168944,10517,179461,732
2022-10-16,Santa Barbara,083,443738,106277,105931,6904,112835,726
2022-10-16,Santa Clara,085,1922200,439209,433458,19234,452692,2513
2022-10-16,Santa Cruz,087,273765,63693,63316,3503,66819,273
2022-10-16,Shasta,089,179085,35115,34971,7545,42516,595
2022-10-16,Sierra,091,2930,306,305,60,365,5
2022-10-16,Siskiyou,093,43540,5166,5287,3327,8614,92
2022-10-16,Solano,095,438530,105747,105287,7968,113255,465
2022-10-16,Sonoma,097,501317,107520,107199,5310,112509,520
2022-10-16,Stanislaus,099,539301,138423,137994,21655,159649,1782
2022-10-16,Sutter,101,95872,24391,24357,2463,26820,233
2022-10-16,Tehama,103,63373,13680,13624,3095,16719,209
2022-10-16,Trinity,105,12862,1400,1396,408,1804,20
2022-10-16,Tulare,107,460477,122195,121902,36563,158465,1538
2022-10-16,Tuolumne,109,53932,15657,15586,925,16511,196
2022-10-16,Ventura,111,848112,209673,209051,15833,224884,1571
2022-10-16,Yolo,113,214977,47660,47498,4364,51862,343
2022-10-16,Yuba,115,75493,18973,18934,1735,20669,129
2022-10-15,Alameda,001,1643700,350170,348487,19852,368339,2027
2022-10-15,Alpine,003,1148,136,135,1,136,0
2022-10-15,Amador,005,37829,10027,10013,931,10944,93
2022-10-15,Butte,007,227075,39672,39567,9170,48737,456
2022-10-15,Calaveras,009,45235,8544,8523,566,9089,133
2022-10-15,Colusa,011,21464,3806,3805,1285,5090,22
2022-10-15,Contra Costa,013,1133247,253083,250897,20874,271771,1440
2022-10-15,Del Norte,015,27424,7455,7440,400,7840,56
2022-10-15,El Dorado,017,186661,32472,32373,4292,36665,231
2022-10-15,Fresno,019,978130,278213,275035,31689,306724,2873
2022-10-15,Glenn,021,27897,5539,5532,1871,7403,48
2022-10-15,Humboldt,023,135768,22020,21914,5082,26996,159
2022-10-15,Imperial,025,180216,65844,65691,15965,81656,958
2022-10-15,Inyo,027,18085,4503,4492,1016,5508,60
2022-10-15,Kern,029,883053,219915,219487,64472,283959,2420
2022-10-15,Kings,031,150075,59628,59560,4122,63682,459
2022-10-15,Lake,033,64148,12877,12815,1188,14003,146
2022-10-15,Lassen,035,31185,9977,9970,999,10969,65
2022-10-15,Los Angeles,037,10098052,3294876,3285385,183550,3468935,33525
2022-10-15,Madera,039,155013,44181,44078,8286,52364,375
2022-10-15,Marin,041,260295,45583,45378,5315,50693,315
2022-10-15,Mariposa,043,17540,3118,3091,344,3435,31
2022-10-15,Mendocino,045,87422,16121,16023,4522,20545,136
2022-10-15,Merced,047,269075,72864,72326,11899,84225,868
2022-10-15,Modoc,049,8938,882,882,324,1206,11
2022-10-15,Mono,051,14174,3214,3206,260,3466,7
2022-10-15,Monterey,053,433212,94402,94183,21175,115358,768
2022-10-15,Napa,055,140530,32355,32326,1412,33738,161
2022-10-15,Nevada,057,99092,19106,19023,1865,20888,132
2022-10-15,Orange,059,3164182,670519,668814,64033,732847,7473
2022-10-15,Placer,061,380077,76249,75902,9597,85499,660
2022-10-15,Plumas,063,18699,3699,3682,439,4121,13
2022-10-15,Riverside,065,2383286,697820,696402,35559,731961,6561
2022-10-15,Sacramento,067,1510023,348678,347495,34368,381863,3324
2022-10-15,San Benito,069,59416,16382,16223,974,17197,107
2022-10-15,San Bernardino,071,2135413,673470,672221,31089,703310,8148
2022-10-15,San Diego,073,3302833,928022,926574,72597,999171,5507
2022-10-15,San Francisco,075,870044,180566,179482,12170,191652,1048
2022-10-15,San Joaquin,077,732212,198635,197672,15026,212698,2322
2022-10-15,San Luis Obispo,079,281455,63536,63321,7215,70536,524
2022-10-15,San Mateo,081,765935,170108,168944,10511,179455,732
2022-10-15,Santa Barbara,083,443738,106251,105931,6902,112833,726
2022-10-15,Santa Clara,085,1922200,439102,433458,19228,452686,2513
2022-10-15,Santa Cruz,087,273765,63666,63316,3498,66814,273
2022-10-15,Shasta,089,179085,35108,34971,7543,42514,595
2022-10-15,Sierra,091,2930,306,305,60,365,5
2022-10-15,Siskiyou,093,43540,5165,5287,3325,8612,92
2022-10-15,Solano,095,438530,105730,105287,7962,113249,465
2022-10-15,Sonoma,097,501317,107494,107199,5310,112509,520
2022-10-15,Stanislaus,099,539301,138405,137994,21654,159648,1782
2022-10-15,Sutter,101,95872,24388,24357,2463,26820,233
2022-10-15,Tehama,103,63373,13678,13624,3095,16719,209
2022-10-15,Trinity,105,12862,1400,1396,408,1804,20
2022-10-15,Tulare,107,460477,122183,121902,36551,158453,1538
2022-10-15,Tuolumne,109,53932,15651,15586,925,16511,196
2022-10-15,Ventura,111,848112,209642,209051,15827,224878,1571
2022-10-15,Yolo,113,214977,47651,47498,4362,51860,343
2022-10-15,Yuba,115,75493,18971,18934,1734,20668,129
2022-10-14,Alameda,001,1643700,350095,348487,19841,368328,2027
2022-10-14,Alpine,003,1148,136,135,1,136,0
2022-10-14,Amador,005,37829,10027,10013,931,10944,93
2022-10-14,Butte,007,227075,39664,39567,9166,48733,456
2022-10-14,Calaveras,009,45235,8540,8523,566,9089,133
2022-10-14,Colusa,011,21464,3805,3805,1285,5090,22
2022-10-14,Contra Costa,013,1133247,253021,250897,20871,271768,1440
2022-10-14,Del Norte,015,27424,7455,7440,400,7840,56
2022-10-14,El Dorado,017,186661,32465,32373,4290,36663,231
2022-10-14,Fresno,019,978130,278180,275035,31685,306720,2873
2022-10-14,Glenn,021,27897,5538,5532,1869,7401,48
2022-10-14,Humboldt,023,135768,22018,21914,5078,26992,159
2022-10-14,Imperial,025,180216,65833,65691,15959,81650,958
2022-10-14,Inyo,027,18085,4503,4492,1014,5506,60
2022-10-14,Kern,029,883053,219896,219487,64448,283935,2420
2022-10-14,Kings,031,150075,59621,59560,4122,63682,459
2022-10-14,Lake,033,64148,12875,12815,1188,14003,146
2022-10-14,Lassen,035,31185,9977,9970,999,10969,65
2022-10-14,Los Angeles,037,10098052,3294373,3285385,183454,3468839,33525
2022-10-14,Madera,039,155013,44176,44078,8280,52358,375
2022-10-14,Marin,041,260295,45572,45378,5314,50692,315
2022-10-14,Mariposa,043,17540,3118,3091,344,3435,31
2022-10-14,Mendocino,045,87422,16115,16023,4521,20544,136
2022-10-14,Merced,047,269075,72851,72326,11898,84224,868
2022-10-14,Modoc,049,8938,882,882,324,1206,11
2022-10-14,Mono,051,14174,3214,3206,260,3466,7
2022-10-14,Monterey,053,433212,94382,94183,21171,115354,768
2022-10-14,Napa,055,140530,32347,32326,1412,33738,161
2022-10-14,Nevada,057,99092,19099,19023,1863,20886,132
2022-10-14,Orange,059,3164182,670415,668814,63999,732813,7473
2022-10-14,Placer,061,380077,76233,75902,9593,85495,660
2022-10-14,Plumas,063,18699,3698,3682,439,4121,13
2022-10-14,Riverside,065,2383286,697727,696402,35549,731951,6561
2022-10-14,Sacramento,067,1510023,348606,347495,34364,381859,3324
2022-10-14,San Benito,069,59416,16378,16223,974,17197,107
2022-10-14,San Bernardino,071,2135413,673396,672221,31076,703297,8148
2022-10-14,San Diego,073,3302833,927811,926574,72575,999149,5507
2022-10-14,San Francisco,075,870044,180517,179482,12166,191648,1048
2022-10-14,San Joaquin,077,732212,198602,197672,15022,212694,2322
2022-10-14,San Luis Obispo,079,281455,63526,63321,7213,70534,524
2022-10-14,San Mateo,081,765935,170058,168944,10511,179455,732
2022-10-14,Santa Barbara,083,443738,106236,105931,6902,112833,726
2022-10-14,Santa Clara,085,1922200,438965,433458,19220,452678,2513
2022-10-14,Santa Cruz,087,273765,63634,63316,3497,66813,273
2022-10-14,Shasta,089,179085,35103,34971,7543,42514,595
2022-10-14,Sierra,091,2930,306,305,60,365,5
2022-10-14,Siskiyou,093,43540,5164,5287,3325,8612,92
2022-10-14,Solano,095,438530,105698,105287,7960,113247,465
2022-10-14,Sonoma,097,501317,107474,107199,5309,112508,520
2022-10-14,Stanislaus,099,539301,138381,137994,21649,159643,1782
2022-10-14,Sutter,101,95872,24381,24357,2463,26820,233
2022-10-14,Tehama,103,63373,13674,13624,3094,16718,209
2022-10-14,Trinity,105,12862,1400,1396,408,1804,20
2022-10-14,Tulare,107,460477,122166,121902,36546,158448,1538
2022-10-14,Tuolumne,109,53932,15647,15586,925,16511,196
2022-10-14,Ventura,111,848112,209592,209051,15826,224877,1571
2022-10-14,Yolo,113,214977,47641,47498,4357,51855,343
2022-10-14,Yuba,115,75493,18965,18934,1734,20668,129
2022-10-13,Alameda,001,1643700,349955,348487,19825,368312,2027
2022-10-13,Alpine,003,1148,136,135,1,136,0
2022-10-13,Amador,005,37829,10025,10013,931,10944,93
2022-10-13,Butte,007,227075,39654,39567,9161,48728,456
2022-10-13,Calaveras,009,45235,8538,8523,566,9089,133
2022-10-13,Colusa,011,21464,3805,3805,1285,5090,22
2022-10-13,Contra Costa,013,1133247,252936,250897,20862,271759,1440
2022-10-13,Del Norte,015,27424,7453,7440,400,7840,56
2022-10-13,El Dorado,017,186661,32452,32373,4287,36660,231
2022-10-13,Fresno,019,978130,278137,275035,31677,306712,2873
2022-10-13,Glenn,021,27897,5538,5532,1869,7401,48
2022-10-13,Humboldt,023,135768,22007,21914,5071,26985,159
2022-10-13,Imperial,025,180216,65819,65691,15947,81638,958
2022-10-13,Inyo,027,18085,4502,4492,1014,5506,60
2022-10-13,Kern,029,883053,219864,219487,64410,283897,2420
2022-10-13,Kings,031,150075,59610,59560,4122,63682,459
2022-10-13,Lake,033,64148,12872,12815,1188,14003,146
2022-10-13,Lassen,035,31185,9976,9970,999,10969,65
2022-10-13,Los Angeles,037,10098052,3293637,3285385,183322,3468707,33525
2022-10-13,Madera,039,155013,44168,44078,8277,52355,375
2022-10-13,Marin,041,260295,45543,45378,5310,50688,315
2022-10-13,Mariposa,043,17540,3117,3091,344,3435,31
2022-10-13,Mendocino,045,87422,16109,16023,4521,20544,136
2022-10-13,Merced,047,269075,72835,72326,11894,84220,868
2022-10-13,Modoc,049,8938,882,882,324,1206,11
2022-10-13,Mono,051,14174,3213,3206,259,3465,7
2022-10-13,Monterey,053,433212,94368,94183,21160,115343,768
2022-10-13,Napa,055,140530,32333,32326,1411,33737,161
2022-10-13,Nevada,057,99092,19088,19023,1861,20884,132
2022-10-13,Orange,059,3164182,670264,668814,63950,732764,7473
2022-10-13,Placer,061,380077,76216,75902,9589,85491,660
2022-10-13,Plumas,063,18699,3696,3682,439,4121,13
2022-10-13,Riverside,065,2383286,697603,696402,35533,731935,6561
2022-10-13,Sacramento,067,1510023,348477,347495,34351,381846,3324
2022-10-13,San Benito,069,59416,16377,16223,974,17197,107
2022-10-13,San Bernardino,071,2135413,673300,672221,31070,703291,8148
2022-10-13,San Diego,073,3302833,927607,926574,72551,999125,5507
2022-10-13,San Francisco,075,870044,180425,179482,12163,191645,1048
2022-10-13,San Joaquin,077,732212,198558,197672,15015,212687,2322
2022-10-13,San Luis Obispo,079,281455,63518,63321,7203,70524,524
2022-10-13,San Mateo,081,765935,169965,168944,10510,179454,732
2022-10-13,Santa Barbara,083,443738,106214,105931,6898,112829,726
2022-10-13,Santa Clara,085,1922200,438820,433458,19216,452674,2513
2022-10-13,Santa Cruz,087,273765,63609,63316,3495,66811,273
2022-10-13,Shasta,089,179085,35091,34971,7538,42509,595
2022-10-13,Sierra,091,2930,306,305,60,365,5
2022-10-13,Siskiyou,093,43540,5161,5287,3322,8609,92
2022-10-13,Solano,095,438530,105660,105287,7954,113241,465
2022-10-13,Sonoma,097,501317,107437,107199,5309,112508,520
2022-10-13,Stanislaus,099,539301,138350,137994,21649,159643,1782
2022-10-13,Sutter,101,95872,24376,24357,2463,26820,233
2022-10-13,Tehama,103,63373,13671,13624,3093,16717,209
2022-10-13,Trinity,105,12862,1400,1396,407,1803,20
2022-10-13,Tulare,107,460477,122151,121902,36533,158435,1538
2022-10-13,Tuolumne,109,53932,15640,15586,925,16511,196
2022-10-13,Ventura,111,848112,209544,209051,15820,224871,1571
2022-10-13,Yolo,113,214977,47623,47498,4351,51849,343
2022-10-13,Yuba,115,75493,18959,18934,1734,20668,129
2022-10-12,Alameda,001,1643700,349831,348487,19810,368297,2027
2022-10-12,Alpine,003,1148,135,135,1,136,0
2022-10-12,Amador,005,37829,10023,10013,931,10944,93
2022-10-12,Butte,007,227075,39645,39567,9160,48727,456
2022-10-12,Calaveras,009,45235,8533,8523,566,9089,133
2022-10-12,Colusa,011,21464,3805,3805,1285,5090,22
2022-10-12,Contra Costa,013,1133247,252843,250897,20852,271749,1440
2022-10-12,Del Norte,015,27424,7453,7440,400,7840,56
2022-10-12,El Dorado,017,186661,32442,32373,4286,36659,231
2022-10-12,Fresno,019,978130,278093,275035,31668,306703,2873
2022-10-12,Glenn,021,27897,5537,5532,1869,7401,48
2022-10-12,Humboldt,023,135768,22002,21914,5067,26981,159
2022-10-12,Imperial,025,180216,65798,65691,15938,81629,958
2022-10-12,Inyo,027,18085,4501,4492,1013,5505,60
2022-10-12,Kern,029,883053,219825,219487,64376,283863,2420
2022-10-12,Kings,031,150075,59605,59560,4119,63679,459
2022-10-12,Lake,033,64148,12864,12815,1188,14003,146
2022-10-12,Lassen,035,31185,9973,9970,999,10969,65
2022-10-12,Los Angeles,037,10098052,3292885,3285385,183180,3468565,33525
2022-10-12,Madera,039,155013,44158,44078,8275,52353,375
2022-10-12,Marin,041,260295,45525,45378,5307,50685,315
2022-10-12,Mariposa,043,17540,3116,3091,344,3435,31
2022-10-12,Mendocino,045,87422,16107,16023,4519,20542,136
2022-10-12,Merced,047,269075,72812,72326,11890,84216,868
2022-10-12,Modoc,049,8938,882,882,324,1206,11
2022-10-12,Mono,051,14174,3212,3206,258,3464,7
2022-10-12,Monterey,053,433212,94350,94183,21150,115333,768
2022-10-12,Napa,055,140530,32322,32326,1411,33737,161
2022-10-12,Nevada,057,99092,19080,19023,1860,20883,132
2022-10-12,Orange,059,3164182,670098,668814,63902,732716,7473
2022-10-12,Placer,061,380077,76196,75902,9585,85487,660
2022-10-12,Plumas,063,18699,3694,3682,438,4120,13
2022-10-12,Riverside,065,2383286,697479,696402,35511,731913,6561
2022-10-12,Sacramento,067,1510023,348370,347495,34330,381825,3324
2022-10-12,San Benito,069,59416,16372,16223,972,17195,107
2022-10-12,San Bernardino,071,2135413,673171,672221,31059,703280,8148
2022-10-12,San Diego,073,3302833,927353,926574,72516,999090,5507
2022-10-12,San Francisco,075,870044,180345,179482,12162,191644,1048
2022-10-12,San Joaquin,077,732212,198500,197672,15010,212682,2322
2022-10-12,San Luis Obispo,079,281455,63505,63321,7199,70520,524
2022-10-12,San Mateo,081,765935,169885,168944,10508,179452,732
2022-10-12,Santa Barbara,083,443738,106198,105931,6897,112828,726
2022-10-12,Santa Clara,085,1922200,438636,433458,19207,452665,2513
2022-10-12,Santa Cruz,087,273765,63572,63316,3495,66811,273
2022-10-12,Shasta,089,179085,35077,34971,7531,42502,595
2022-10-12,Sierra,091,2930,306,305,60,365,5
2022-10-12,Siskiyou,093,43540,5161,5287,3319,8606,92
2022-10-12,Solano,095,438530,105617,105287,7952,113239,465
2022-10-12,Sonoma,097,501317,107406,107199,5308,112507,520
2022-10-12,Stanislaus,099,539301,138304,137994,21644,159638,1782
2022-10-12,Sutter,101,95872,24370,24357,2463,26820,233
2022-10-12,Tehama,103,63373,13669,13624,3092,16716,209
2022-10-12,Trinity,105,12862,1400,1396,405,1801,20
2022-10-12,Tulare,107,460477,122127,121902,36512,158414,1538
2022-10-12,Tuolumne,109,53932,15636,15586,925,16511,196
2022-10-12,Ventura,111,848112,209492,209051,15818,224869,1571
2022-10-12,Yolo,113,214977,47603,47498,4347,51845,343
2022-10-12,Yuba,115,75493,18952,18934,1732,20666,129
2022-10-11,Alameda,001,1643700,349667,348487,19802,368289,2027
2022-10-11,Alpine,003,1148,135,135,1,136,0
2022-10-11,Amador,005,37829,10019,10013,931,10944,93
2022-10-11,Butte,007,227075,39630,39567,9160,48727,456
2022-10-11,Calaveras,009,45235,8529,8523,565,9088,133
2022-10-11,Colusa,011,21464,3804,3805,1285,5090,22
2022-10-11,Contra Costa,013,1133247,252729,250897,20847,271744,1440
2022-10-11,Del Norte,015,27424,7448,7440,400,7840,56
2022-10-11,El Dorado,017,186661,32423,32373,4286,36659,231
2022-10-11,Fresno,019,978130,278039,275035,31655,306690,2873
2022-10-11,Glenn,021,27897,5536,5532,1868,7400,48
2022-10-11,Humboldt,023,135768,21996,21914,5057,26971,159
2022-10-11,Imperial,025,180216,65785,65691,15920,81611,958
2022-10-11,Inyo,027,18085,4499,4492,1012,5504,60
2022-10-11,Kern,029,883053,219800,219487,64351,283838,2420
2022-10-11,Kings,031,150075,59591,59560,4114,63674,459
2022-10-11,Lake,033,64148,12860,12815,1186,14001,146
2022-10-11,Lassen,035,31185,9972,9970,999,10969,65
2022-10-11,Los Angeles,037,10098052,3292066,3285385,183050,3468435,33525
2022-10-11,Madera,039,155013,44151,44078,8274,52352,375
2022-10-11,Marin,041,260295,45508,45378,5303,50681,315
2022-10-11,Mariposa,043,17540,3115,3091,344,3435,31
2022-10-11,Mendocino,045,87422,16102,16023,4517,20540,136
2022-10-11,Merced,047,269075,72786,72326,11889,84215,868
2022-10-11,Modoc,049,8938,881,882,324,1206,11
2022-10-11,Mono,051,14174,3212,3206,257,3463,7
2022-10-11,Monterey,053,433212,94340,94183,21142,115325,768
2022-10-11,Napa,055,140530,32318,32326,1410,33736,161
2022-10-11,Nevada,057,99092,19069,19023,1858,20881,132
2022-10-11,Orange,059,3164182,669926,668814,63859,732673,7473
2022-10-11,Placer,061,380077,76166,75902,9583,85485,660
2022-10-11,Plumas,063,18699,3694,3682,437,4119,13
2022-10-11,Riverside,065,2383286,697348,696402,35501,731903,6561
2022-10-11,Sacramento,067,1510023,348210,347495,34312,381807,3324
2022-10-11,San Benito,069,59416,16366,16223,971,17194,107
2022-10-11,San Bernardino,071,2135413,673035,672221,31050,703271,8148
2022-10-11,San Diego,073,3302833,927074,926574,72481,999055,5507
2022-10-11,San Francisco,075,870044,180251,179482,12161,191643,1048
2022-10-11,San Joaquin,077,732212,198455,197672,15005,212677,2322
2022-10-11,San Luis Obispo,079,281455,63483,63321,7187,70508,524
2022-10-11,San Mateo,081,765935,169809,168944,10504,179448,732
2022-10-11,Santa Barbara,083,443738,106169,105931,6895,112826,726
2022-10-11,Santa Clara,085,1922200,438462,433458,19198,452656,2513
2022-10-11,Santa Cruz,087,273765,63530,63316,3493,66809,273
2022-10-11,Shasta,089,179085,35065,34971,7521,42492,595
2022-10-11,Sierra,091,2930,306,305,60,365,5
2022-10-11,Siskiyou,093,43540,5160,5287,3317,8604,92
2022-10-11,Solano,095,438530,105577,105287,7950,113237,465
2022-10-11,Sonoma,097,501317,107363,107199,5304,112503,520
2022-10-11,Stanislaus,099,539301,138272,137994,21640,159634,1782
2022-10-11,Sutter,101,95872,24366,24357,2463,26820,233
2022-10-11,Tehama,103,63373,13668,13624,3089,16713,209
2022-10-11,Trinity,105,12862,1400,1396,404,1800,20
2022-10-11,Tulare,107,460477,122102,121902,36500,158402,1538
2022-10-11,Tuolumne,109,53932,15630,15586,925,16511,196
2022-10-11,Ventura,111,848112,209439,209051,15812,224863,1571
2022-10-11,Yolo,113,214977,47596,47498,4341,51839,343
2022-10-11,Yuba,115,75493,18940,18934,1732,20666,129
2022-10-10,Alameda,001,1643700,349520,347497,19791,367288,2023
2022-10-10,Alpine,003,1148,135,135,1,136,0
2022-10-10,Amador,005,37829,10016,9999,931,10930,93
2022-10-10,Butte,007,227075,39619,39453,9158,48611,454
2022-10-10,Calaveras,009,45235,8529,8511,564,9075,133
2022-10-10,Colusa,011,21464,3803,3794,1285,5079,22
2022-10-10,Contra Costa,013,1133247,252611,250136,20833,270969,1430
2022-10-10,Del Norte,015,27424,7445,7433,399,7832,56
2022-10-10,El Dorado,017,186661,32408,32320,4284,36604,231
2022-10-10,Fresno,019,978130,277981,274628,31644,306272,2865
2022-10-10,Glenn,021,27897,5535,5510,1868,7378,48
2022-10-10,Humboldt,023,135768,21977,21831,5053,26884,159
2022-10-10,Imperial,025,180216,65767,65532,15903,81435,958
2022-10-10,Inyo,027,18085,4498,4489,1010,5499,59
2022-10-10,Kern,029,883053,219758,219191,64311,283502,2418
2022-10-10,Kings,031,150075,59582,59489,4112,63601,458
2022-10-10,Lake,033,64148,12856,12795,1186,13981,147
2022-10-10,Lassen,035,31185,9972,9967,998,10965,65
2022-10-10,Los Angeles,037,10098052,3291193,3278961,182898,3461859,33467
2022-10-10,Madera,039,155013,44139,44029,8270,52299,374
2022-10-10,Marin,041,260295,45490,45190,5299,50489,313
2022-10-10,Mariposa,043,17540,3113,3088,344,3432,31
2022-10-10,Mendocino,045,87422,16089,15992,4514,20506,136
2022-10-10,Merced,047,269075,72768,72236,11883,84119,865
2022-10-10,Modoc,049,8938,881,876,324,1200,11
2022-10-10,Mono,051,14174,3210,3205,257,3462,7
2022-10-10,Monterey,053,433212,94323,94111,21139,115250,766
2022-10-10,Napa,055,140530,32307,32258,1410,33668,160
2022-10-10,Nevada,057,99092,19065,18989,1857,20846,132
2022-10-10,Orange,059,3164182,669740,667297,63805,731102,7452
2022-10-10,Placer,061,380077,76141,75768,9578,85346,660
2022-10-10,Plumas,063,18699,3693,3669,436,4105,13
2022-10-10,Riverside,065,2383286,697194,695315,35489,730804,6567
2022-10-10,Sacramento,067,1510023,348090,346748,34271,381019,3310
2022-10-10,San Benito,069,59416,16362,16188,971,17159,106
2022-10-10,San Bernardino,071,2135413,672881,670906,31040,701946,8116
2022-10-10,San Diego,073,3302833,926812,924672,72441,997113,5498
2022-10-10,San Francisco,075,870044,180163,178943,12157,191100,1045
2022-10-10,San Joaquin,077,732212,198395,197390,15000,212390,2319
2022-10-10,San Luis Obispo,079,281455,63460,63219,7182,70401,524
2022-10-10,San Mateo,081,765935,169722,168413,10501,178914,737
2022-10-10,Santa Barbara,083,443738,106124,105695,6894,112589,725
2022-10-10,Santa Clara,085,1922200,438260,432327,19179,451506,2506
2022-10-10,Santa Cruz,087,273765,63496,63099,3492,66591,273
2022-10-10,Shasta,089,179085,35049,34904,7515,42419,593
2022-10-10,Sierra,091,2930,306,305,60,365,5
2022-10-10,Siskiyou,093,43540,5157,5272,3316,8588,92
2022-10-10,Solano,095,438530,105531,105042,7944,112986,465
2022-10-10,Sonoma,097,501317,107327,106940,5300,112240,520
2022-10-10,Stanislaus,099,539301,138230,137838,21636,159474,1781
2022-10-10,Sutter,101,95872,24357,24326,2463,26789,232
2022-10-10,Tehama,103,63373,13664,13603,3089,16692,210
2022-10-10,Trinity,105,12862,1400,1394,400,1794,20
2022-10-10,Tulare,107,460477,122084,121787,36482,158269,1531
2022-10-10,Tuolumne,109,53932,15624,15558,925,16483,196
2022-10-10,Ventura,111,848112,209368,208632,15805,224437,1567
2022-10-10,Yolo,113,214977,47573,47422,4340,51762,341
2022-10-10,Yuba,115,75493,18934,18914,1732,20646,129
2022-10-09,Alameda,001,1643700,349368,347497,19769,367266,2023
2022-10-09,Alpine,003,1148,135,135,1,136,0
2022-10-09,Amador,005,37829,10014,9999,931,10930,93
2022-10-09,Butte,007,227075,39611,39453,9157,48610,454
2022-10-09,Calaveras,009,45235,8526,8511,564,9075,133
2022-10-09,Colusa,011,21464,3803,3794,1285,5079,22
2022-10-09,Contra Costa,013,1133247,252499,250136,20820,270956,1430
2022-10-09,Del Norte,015,27424,7444,7433,399,7832,56
2022-10-09,El Dorado,017,186661,32396,32320,4283,36603,231
2022-10-09,Fresno,019,978130,277890,274628,31633,306261,2865
2022-10-09,Glenn,021,27897,5532,5510,1867,7377,48
2022-10-09,Humboldt,023,135768,21964,21831,5047,26878,159
2022-10-09,Imperial,025,180216,65735,65532,15883,81415,958
2022-10-09,Inyo,027,18085,4498,4489,1008,5497,59
2022-10-09,Kern,029,883053,219723,219191,64246,283437,2418
2022-10-09,Kings,031,150075,59565,59489,4111,63600,458
2022-10-09,Lake,033,64148,12849,12795,1186,13981,147
2022-10-09,Lassen,035,31185,9972,9967,998,10965,65
2022-10-09,Los Angeles,037,10098052,3290210,3278961,182731,3461692,33467
2022-10-09,Madera,039,155013,44129,44029,8268,52297,374
2022-10-09,Marin,041,260295,45457,45190,5293,50483,313
2022-10-09,Mariposa,043,17540,3111,3088,344,3432,31
2022-10-09,Mendocino,045,87422,16083,15992,4514,20506,136
2022-10-09,Merced,047,269075,72750,72236,11878,84114,865
2022-10-09,Modoc,049,8938,881,876,324,1200,11
2022-10-09,Mono,051,14174,3210,3205,257,3462,7
2022-10-09,Monterey,053,433212,94307,94111,21129,115240,766
2022-10-09,Napa,055,140530,32293,32258,1409,33667,160
2022-10-09,Nevada,057,99092,19058,18989,1855,20844,132
2022-10-09,Orange,059,3164182,669520,667297,63731,731028,7452
2022-10-09,Placer,061,380077,76123,75768,9575,85343,660
2022-10-09,Plumas,063,18699,3691,3669,436,4105,13
2022-10-09,Riverside,065,2383286,696999,695315,35477,730792,6567
2022-10-09,Sacramento,067,1510023,347930,346748,34252,381000,3310
2022-10-09,San Benito,069,59416,16360,16188,971,17159,106
2022-10-09,San Bernardino,071,2135413,672726,670906,31031,701937,8116
2022-10-09,San Diego,073,3302833,926532,924672,72407,997079,5498
2022-10-09,San Francisco,075,870044,180066,178943,12154,191097,1045
2022-10-09,San Joaquin,077,732212,198316,197390,14995,212385,2319
2022-10-09,San Luis Obispo,079,281455,63453,63219,7175,70394,524
2022-10-09,San Mateo,081,765935,169615,168413,10498,178911,737
2022-10-09,Santa Barbara,083,443738,106090,105695,6890,112585,725
2022-10-09,Santa Clara,085,1922200,438049,432327,19164,451491,2506
2022-10-09,Santa Cruz,087,273765,63431,63099,3490,66589,273
2022-10-09,Shasta,089,179085,35025,34904,7508,42412,593
2022-10-09,Sierra,091,2930,306,305,60,365,5
2022-10-09,Siskiyou,093,43540,5157,5272,3315,8587,92
2022-10-09,Solano,095,438530,105476,105042,7942,112984,465
2022-10-09,Sonoma,097,501317,107280,106940,5299,112239,520
2022-10-09,Stanislaus,099,539301,138204,137838,21628,159466,1781
2022-10-09,Sutter,101,95872,24346,24326,2462,26788,232
2022-10-09,Tehama,103,63373,13662,13603,3089,16692,210
2022-10-09,Trinity,105,12862,1400,1394,400,1794,20
2022-10-09,Tulare,107,460477,122060,121787,36462,158249,1531
2022-10-09,Tuolumne,109,53932,15617,15558,925,16483,196
2022-10-09,Ventura,111,848112,209321,208632,15800,224432,1567
2022-10-09,Yolo,113,214977,47550,47422,4337,51759,341
2022-10-09,Yuba,115,75493,18931,18914,1732,20646,129
2022-10-08,Alameda,001,1643700,349281,347497,19762,367259,2023
2022-10-08,Alpine,003,1148,135,135,1,136,0
2022-10-08,Amador,005,37829,10013,9999,930,10929,93
2022-10-08,Butte,007,227075,39606,39453,9151,48604,454
2022-10-08,Calaveras,009,45235,8524,8511,564,9075,133
2022-10-08,Colusa,011,21464,3803,3794,1285,5079,22
2022-10-08,Contra Costa,013,1133247,252419,250136,20817,270953,1430
2022-10-08,Del Norte,015,27424,7444,7433,399,7832,56
2022-10-08,El Dorado,017,186661,32387,32320,4282,36602,231
2022-10-08,Fresno,019,978130,277860,274628,31630,306258,2865
2022-10-08,Glenn,021,27897,5531,5510,1867,7377,48
2022-10-08,Humboldt,023,135768,21953,21831,5041,26872,159
2022-10-08,Imperial,025,180216,65710,65532,15877,81409,958
2022-10-08,Inyo,027,18085,4498,4489,1006,5495,59
2022-10-08,Kern,029,883053,219688,219191,64225,283416,2418
2022-10-08,Kings,031,150075,59561,59489,4111,63600,458
2022-10-08,Lake,033,64148,12846,12795,1186,13981,147
2022-10-08,Lassen,035,31185,9972,9967,998,10965,65
2022-10-08,Los Angeles,037,10098052,3289651,3278961,182640,3461601,33467
2022-10-08,Madera,039,155013,44124,44029,8268,52297,374
2022-10-08,Marin,041,260295,45437,45190,5287,50477,313
2022-10-08,Mariposa,043,17540,3111,3088,344,3432,31
2022-10-08,Mendocino,045,87422,16082,15992,4511,20503,136
2022-10-08,Merced,047,269075,72740,72236,11877,84113,865
2022-10-08,Modoc,049,8938,879,876,324,1200,11
2022-10-08,Mono,051,14174,3210,3205,257,3462,7
2022-10-08,Monterey,053,433212,94297,94111,21127,115238,766
2022-10-08,Napa,055,140530,32286,32258,1409,33667,160
2022-10-08,Nevada,057,99092,19056,18989,1854,20843,132
2022-10-08,Orange,059,3164182,669405,667297,63687,730984,7452
2022-10-08,Placer,061,380077,76094,75768,9572,85340,660
2022-10-08,Plumas,063,18699,3690,3669,436,4105,13
2022-10-08,Riverside,065,2383286,696902,695315,35463,730778,6567
2022-10-08,Sacramento,067,1510023,347870,346748,34250,380998,3310
2022-10-08,San Benito,069,59416,16357,16188,971,17159,106
2022-10-08,San Bernardino,071,2135413,672649,670906,31023,701929,8116
2022-10-08,San Diego,073,3302833,926399,924672,72392,997064,5498
2022-10-08,San Francisco,075,870044,180018,178943,12150,191093,1045
2022-10-08,San Joaquin,077,732212,198281,197390,14990,212380,2319
2022-10-08,San Luis Obispo,079,281455,63447,63219,7174,70393,524
2022-10-08,San Mateo,081,765935,169565,168413,10495,178908,737
2022-10-08,Santa Barbara,083,443738,106066,105695,6888,112583,725
2022-10-08,Santa Clara,085,1922200,437933,432327,19153,451480,2506
2022-10-08,Santa Cruz,087,273765,63409,63099,3490,66589,273
2022-10-08,Shasta,089,179085,35019,34904,7503,42407,593
2022-10-08,Sierra,091,2930,306,305,60,365,5
2022-10-08,Siskiyou,093,43540,5157,5272,3314,8586,92
2022-10-08,Solano,095,438530,105456,105042,7936,112978,465
2022-10-08,Sonoma,097,501317,107250,106940,5299,112239,520
2022-10-08,Stanislaus,099,539301,138187,137838,21625,159463,1781
2022-10-08,Sutter,101,95872,24343,24326,2462,26788,232
2022-10-08,Tehama,103,63373,13661,13603,3088,16691,210
2022-10-08,Trinity,105,12862,1400,1394,400,1794,20
2022-10-08,Tulare,107,460477,122036,121787,36456,158243,1531
2022-10-08,Tuolumne,109,53932,15612,15558,925,16483,196
2022-10-08,Ventura,111,848112,209287,208632,15796,224428,1567
2022-10-08,Yolo,113,214977,47539,47422,4336,51758,341
2022-10-08,Yuba,115,75493,18928,18914,1732,20646,129
2022-10-07,Alameda,001,1643700,349164,347497,19759,367256,2023
2022-10-07,Alpine,003,1148,135,135,1,136,0
2022-10-07,Amador,005,37829,10011,9999,930,10929,93
2022-10-07,Butte,007,227075,39605,39453,9149,48602,454
2022-10-07,Calaveras,009,45235,8523,8511,564,9075,133
2022-10-07,Colusa,011,21464,3803,3794,1284,5078,22
2022-10-07,Contra Costa,013,1133247,252337,250136,20816,270952,1430
2022-10-07,Del Norte,015,27424,7444,7433,398,7831,56
2022-10-07,El Dorado,017,186661,32378,32320,4280,36600,231
2022-10-07,Fresno,019,978130,277830,274628,31627,306255,2865
2022-10-07,Glenn,021,27897,5530,5510,1866,7376,48
2022-10-07,Humboldt,023,135768,21946,21831,5034,26865,159
2022-10-07,Imperial,025,180216,65698,65532,15871,81403,958
2022-10-07,Inyo,027,18085,4496,4489,1004,5493,59
2022-10-07,Kern,029,883053,219658,219191,64198,283389,2418
2022-10-07,Kings,031,150075,59553,59489,4111,63600,458
2022-10-07,Lake,033,64148,12842,12795,1186,13981,147
2022-10-07,Lassen,035,31185,9972,9967,998,10965,65
2022-10-07,Los Angeles,037,10098052,3289043,3278961,182535,3461496,33467
2022-10-07,Madera,039,155013,44120,44029,8266,52295,374
2022-10-07,Marin,041,260295,45418,45190,5285,50475,313
2022-10-07,Mariposa,043,17540,3108,3088,344,3432,31
2022-10-07,Mendocino,045,87422,16078,15992,4510,20502,136
2022-10-07,Merced,047,269075,72733,72236,11875,84111,865
2022-10-07,Modoc,049,8938,879,876,324,1200,11
2022-10-07,Mono,051,14174,3209,3205,257,3462,7
2022-10-07,Monterey,053,433212,94282,94111,21123,115234,766
2022-10-07,Napa,055,140530,32278,32258,1409,33667,160
2022-10-07,Nevada,057,99092,19054,18989,1850,20839,132
2022-10-07,Orange,059,3164182,669286,667297,63652,730949,7452
2022-10-07,Placer,061,380077,76075,75768,9568,85336,660
2022-10-07,Plumas,063,18699,3687,3669,436,4105,13
2022-10-07,Riverside,065,2383286,696813,695315,35451,730766,6567
2022-10-07,Sacramento,067,1510023,347785,346748,34242,380990,3310
2022-10-07,San Benito,069,59416,16355,16188,971,17159,106
2022-10-07,San Bernardino,071,2135413,672567,670906,31018,701924,8116
2022-10-07,San Diego,073,3302833,926227,924672,72374,997046,5498
2022-10-07,San Francisco,075,870044,179957,178943,12143,191086,1045
2022-10-07,San Joaquin,077,732212,198247,197390,14989,212379,2319
2022-10-07,San Luis Obispo,079,281455,63435,63219,7173,70392,524
2022-10-07,San Mateo,081,765935,169495,168413,10494,178907,737
2022-10-07,Santa Barbara,083,443738,106041,105695,6887,112582,725
2022-10-07,Santa Clara,085,1922200,437803,432327,19146,451473,2506
2022-10-07,Santa Cruz,087,273765,63377,63099,3489,66588,273
2022-10-07,Shasta,089,179085,35013,34904,7500,42404,593
2022-10-07,Sierra,091,2930,306,305,60,365,5
2022-10-07,Siskiyou,093,43540,5156,5272,3313,8585,92
2022-10-07,Solano,095,438530,105427,105042,7932,112974,465
2022-10-07,Sonoma,097,501317,107223,106940,5298,112238,520
2022-10-07,Stanislaus,099,539301,138169,137838,21624,159462,1781
2022-10-07,Sutter,101,95872,24336,24326,2462,26788,232
2022-10-07,Tehama,103,63373,13661,13603,3086,16689,210
2022-10-07,Trinity,105,12862,1399,1394,400,1794,20
2022-10-07,Tulare,107,460477,122019,121787,36443,158230,1531
2022-10-07,Tuolumne,109,53932,15608,15558,925,16483,196
2022-10-07,Ventura,111,848112,209245,208632,15791,224423,1567
2022-10-07,Yolo,113,214977,47532,47422,4332,51754,341
2022-10-07,Yuba,115,75493,18928,18914,1732,20646,129
2022-10-06,Alameda,001,1643700,349026,347497,19748,367245,2023
2022-10-06,Alpine,003,1148,135,135,1,136,0
2022-10-06,Amador,005,37829,10009,9999,930,10929,93
2022-10-06,Butte,007,227075,39596,39453,9144,48597,454
2022-10-06,Calaveras,009,45235,8521,8511,563,9074,133
2022-10-06,Colusa,011,21464,3803,3794,1284,5078,22
2022-10-06,Contra Costa,013,1133247,252242,250136,20812,270948,1430
2022-10-06,Del Norte,015,27424,7442,7433,398,7831,56
2022-10-06,El Dorado,017,186661,32368,32320,4278,36598,231
2022-10-06,Fresno,019,978130,277782,274628,31621,306249,2865
2022-10-06,Glenn,021,27897,5529,5510,1865,7375,48
2022-10-06,Humboldt,023,135768,21934,21831,5026,26857,159
2022-10-06,Imperial,025,180216,65674,65532,15863,81395,958
2022-10-06,Inyo,027,18085,4496,4489,1003,5492,59
2022-10-06,Kern,029,883053,219627,219191,64172,283363,2418
2022-10-06,Kings,031,150075,59539,59489,4109,63598,458
2022-10-06,Lake,033,64148,12841,12795,1186,13981,147
2022-10-06,Lassen,035,31185,9972,9967,998,10965,65
2022-10-06,Los Angeles,037,10098052,3288203,3278961,182387,3461348,33467
2022-10-06,Madera,039,155013,44111,44029,8266,52295,374
2022-10-06,Marin,041,260295,45400,45190,5283,50473,313
2022-10-06,Mariposa,043,17540,3108,3088,344,3432,31
2022-10-06,Mendocino,045,87422,16076,15992,4509,20501,136
2022-10-06,Merced,047,269075,72721,72236,11874,84110,865
2022-10-06,Modoc,049,8938,878,876,324,1200,11
2022-10-06,Mono,051,14174,3209,3205,257,3462,7
2022-10-06,Monterey,053,433212,94273,94111,21114,115225,766
2022-10-06,Napa,055,140530,32271,32258,1409,33667,160
2022-10-06,Nevada,057,99092,19048,18989,1849,20838,132
2022-10-06,Orange,059,3164182,669092,667297,63599,730896,7452
2022-10-06,Placer,061,380077,76050,75768,9566,85334,660
2022-10-06,Plumas,063,18699,3685,3669,436,4105,13
2022-10-06,Riverside,065,2383286,696682,695315,35441,730756,6567
2022-10-06,Sacramento,067,1510023,347667,346748,34226,380974,3310
2022-10-06,San Benito,069,59416,16352,16188,970,17158,106
2022-10-06,San Bernardino,071,2135413,672431,670906,31007,701913,8116
2022-10-06,San Diego,073,3302833,925979,924672,72325,996997,5498
2022-10-06,San Francisco,075,870044,179878,178943,12141,191084,1045
2022-10-06,San Joaquin,077,732212,198197,197390,14982,212372,2319
2022-10-06,San Luis Obispo,079,281455,63417,63219,7169,70388,524
2022-10-06,San Mateo,081,765935,169428,168413,10492,178905,737
2022-10-06,Santa Barbara,083,443738,106016,105695,6885,112580,725
2022-10-06,Santa Clara,085,1922200,437638,432327,19138,451465,2506
2022-10-06,Santa Cruz,087,273765,63338,63099,3486,66585,273
2022-10-06,Shasta,089,179085,35002,34904,7494,42398,593
2022-10-06,Sierra,091,2930,306,305,60,365,5
2022-10-06,Siskiyou,093,43540,5154,5272,3313,8585,92
2022-10-06,Solano,095,438530,105396,105042,7928,112970,465
2022-10-06,Sonoma,097,501317,107198,106940,5297,112237,520
2022-10-06,Stanislaus,099,539301,138138,137838,21617,159455,1781
2022-10-06,Sutter,101,95872,24326,24326,2462,26788,232
2022-10-06,Tehama,103,63373,13655,13603,3085,16688,210
2022-10-06,Trinity,105,12862,1399,1394,398,1792,20
2022-10-06,Tulare,107,460477,122002,121787,36438,158225,1531
2022-10-06,Tuolumne,109,53932,15605,15558,924,16482,196
2022-10-06,Ventura,111,848112,209182,208632,15781,224413,1567
2022-10-06,Yolo,113,214977,47520,47422,4330,51752,341
2022-10-06,Yuba,115,75493,18927,18914,1732,20646,129
2022-10-05,Alameda,001,1643700,348866,347497,19741,367238,2023
2022-10-05,Alpine,003,1148,135,135,1,136,0
2022-10-05,Amador,005,37829,10007,9999,930,10929,93
2022-10-05,Butte,007,227075,39589,39453,9141,48594,454
2022-10-05,Calaveras,009,45235,8519,8511,563,9074,133
2022-10-05,Colusa,011,21464,3802,3794,1284,5078,22
2022-10-05,Contra Costa,013,1133247,252147,250136,20801,270937,1430
2022-10-05,Del Norte,015,27424,7439,7433,398,7831,56
2022-10-05,El Dorado,017,186661,32352,32320,4278,36598,231
2022-10-05,Fresno,019,978130,277711,274628,31615,306243,2865
2022-10-05,Glenn,021,27897,5529,5510,1864,7374,48
2022-10-05,Humboldt,023,135768,21920,21831,5021,26852,159
2022-10-05,Imperial,025,180216,65650,65532,15849,81381,958
2022-10-05,Inyo,027,18085,4496,4489,1000,5489,59
2022-10-05,Kern,029,883053,219580,219191,64129,283320,2418
2022-10-05,Kings,031,150075,59530,59489,4108,63597,458
2022-10-05,Lake,033,64148,12839,12795,1185,13980,147
2022-10-05,Lassen,035,31185,9972,9967,997,10964,65
2022-10-05,Los Angeles,037,10098052,3287372,3278961,182239,3461200,33467
2022-10-05,Madera,039,155013,44103,44029,8263,52292,374
2022-10-05,Marin,041,260295,45376,45190,5279,50469,313
2022-10-05,Mariposa,043,17540,3107,3088,344,3432,31
2022-10-05,Mendocino,045,87422,16074,15992,4504,20496,136
2022-10-05,Merced,047,269075,72709,72236,11871,84107,865
2022-10-05,Modoc,049,8938,878,876,324,1200,11
2022-10-05,Mono,051,14174,3209,3205,257,3462,7
2022-10-05,Monterey,053,433212,94259,94111,21109,115220,766
2022-10-05,Napa,055,140530,32262,32258,1409,33667,160
2022-10-05,Nevada,057,99092,19040,18989,1849,20838,132
2022-10-05,Orange,059,3164182,668913,667297,63543,730840,7452
2022-10-05,Placer,061,380077,76026,75768,9563,85331,660
2022-10-05,Plumas,063,18699,3682,3669,435,4104,13
2022-10-05,Riverside,065,2383286,696538,695315,35423,730738,6567
2022-10-05,Sacramento,067,1510023,347570,346748,34216,380964,3310
2022-10-05,San Benito,069,59416,16349,16188,970,17158,106
2022-10-05,San Bernardino,071,2135413,672271,670906,30997,701903,8116
2022-10-05,San Diego,073,3302833,925754,924672,72300,996972,5498
2022-10-05,San Francisco,075,870044,179779,178943,12135,191078,1045
2022-10-05,San Joaquin,077,732212,198152,197390,14972,212362,2319
2022-10-05,San Luis Obispo,079,281455,63412,63219,7164,70383,524
2022-10-05,San Mateo,081,765935,169350,168413,10491,178904,737
2022-10-05,Santa Barbara,083,443738,105988,105695,6882,112577,725
2022-10-05,Santa Clara,085,1922200,437460,432327,19131,451458,2506
2022-10-05,Santa Cruz,087,273765,63306,63099,3486,66585,273
2022-10-05,Shasta,089,179085,34995,34904,7487,42391,593
2022-10-05,Sierra,091,2930,306,305,60,365,5
2022-10-05,Siskiyou,093,43540,5149,5272,3311,8583,92
2022-10-05,Solano,095,438530,105361,105042,7924,112966,465
2022-10-05,Sonoma,097,501317,107163,106940,5297,112237,520
2022-10-05,Stanislaus,099,539301,138109,137838,21609,159447,1781
2022-10-05,Sutter,101,95872,24323,24326,2461,26787,232
2022-10-05,Tehama,103,63373,13651,13603,3084,16687,210
2022-10-05,Trinity,105,12862,1399,1394,398,1792,20
2022-10-05,Tulare,107,460477,121984,121787,36416,158203,1531
2022-10-05,Tuolumne,109,53932,15599,15558,924,16482,196
2022-10-05,Ventura,111,848112,209123,208632,15778,224410,1567
2022-10-05,Yolo,113,214977,47503,47422,4328,51750,341
2022-10-05,Yuba,115,75493,18922,18914,1729,20643,129
2022-10-04,Alameda,001,1643700,348725,347497,19727,367224,2023
2022-10-04,Alpine,003,1148,135,135,1,136,0
2022-10-04,Amador,005,37829,10005,9999,930,10929,93
2022-10-04,Butte,007,227075,39577,39453,9139,48592,454
2022-10-04,Calaveras,009,45235,8518,8511,561,9072,133
2022-10-04,Colusa,011,21464,3802,3794,1284,5078,22
2022-10-04,Contra Costa,013,1133247,252062,250136,20794,270930,1430
2022-10-04,Del Norte,015,27424,7437,7433,398,7831,56
2022-10-04,El Dorado,017,186661,32346,32320,4277,36597,231
2022-10-04,Fresno,019,978130,277648,274628,31609,306237,2865
2022-10-04,Glenn,021,27897,5528,5510,1864,7374,48
2022-10-04,Humboldt,023,135768,21907,21831,5020,26851,159
2022-10-04,Imperial,025,180216,65615,65532,15834,81366,958
2022-10-04,Inyo,027,18085,4495,4489,998,5487,59
2022-10-04,Kern,029,883053,219522,219191,64088,283279,2418
2022-10-04,Kings,031,150075,59515,59489,4107,63596,458
2022-10-04,Lake,033,64148,12834,12795,1185,13980,147
2022-10-04,Lassen,035,31185,9971,9967,996,10963,65
2022-10-04,Los Angeles,037,10098052,3286483,3278961,182074,3461035,33467
2022-10-04,Madera,039,155013,44089,44029,8261,52290,374
2022-10-04,Marin,041,260295,45345,45190,5279,50469,313
2022-10-04,Mariposa,043,17540,3107,3088,344,3432,31
2022-10-04,Mendocino,045,87422,16070,15992,4498,20490,136
2022-10-04,Merced,047,269075,72689,72236,11869,84105,865
2022-10-04,Modoc,049,8938,878,876,324,1200,11
2022-10-04,Mono,051,14174,3209,3205,256,3461,7
2022-10-04,Monterey,053,433212,94246,94111,21104,115215,766
2022-10-04,Napa,055,140530,32258,32258,1409,33667,160
2022-10-04,Nevada,057,99092,19037,18989,1849,20838,132
2022-10-04,Orange,059,3164182,668703,667297,63461,730758,7452
2022-10-04,Placer,061,380077,75993,75768,9559,85327,660
2022-10-04,Plumas,063,18699,3676,3669,434,4103,13
2022-10-04,Riverside,065,2383286,696380,695315,35406,730721,6567
2022-10-04,Sacramento,067,1510023,347451,346748,34188,380936,3310
2022-10-04,San Benito,069,59416,16337,16188,969,17157,106
2022-10-04,San Bernardino,071,2135413,672120,670906,30989,701895,8116
2022-10-04,San Diego,073,3302833,925421,924672,72250,996922,5498
2022-10-04,San Francisco,075,870044,179685,178943,12132,191075,1045
2022-10-04,San Joaquin,077,732212,198106,197390,14966,212356,2319
2022-10-04,San Luis Obispo,079,281455,63395,63219,7155,70374,524
2022-10-04,San Mateo,081,765935,169263,168413,10489,178902,737
2022-10-04,Santa Barbara,083,443738,105957,105695,6880,112575,725
2022-10-04,Santa Clara,085,1922200,437268,432327,19124,451451,2506
2022-10-04,Santa Cruz,087,273765,63270,63099,3484,66583,273
2022-10-04,Shasta,089,179085,34981,34904,7482,42386,593
2022-10-04,Sierra,091,2930,306,305,60,365,5
2022-10-04,Siskiyou,093,43540,5148,5272,3311,8583,92
2022-10-04,Solano,095,438530,105313,105042,7922,112964,465
2022-10-04,Sonoma,097,501317,107128,106940,5294,112234,520
2022-10-04,Stanislaus,099,539301,138082,137838,21607,159445,1781
2022-10-04,Sutter,101,95872,24313,24326,2460,26786,232
2022-10-04,Tehama,103,63373,13648,13603,3082,16685,210
2022-10-04,Trinity,105,12862,1399,1394,398,1792,20
2022-10-04,Tulare,107,460477,121959,121787,36406,158193,1531
2022-10-04,Tuolumne,109,53932,15598,15558,924,16482,196
2022-10-04,Ventura,111,848112,209056,208632,15773,224405,1567
2022-10-04,Yolo,113,214977,47487,47422,4325,51747,341
2022-10-04,Yuba,115,75493,18917,18914,1727,20641,129
2022-10-03,Alameda,001,1643700,348541,346369,19719,366088,2020
2022-10-03,Alpine,003,1148,135,134,1,135,0
2022-10-03,Amador,005,37829,10003,9987,930,10917,90
2022-10-03,Butte,007,227075,39562,39378,9135,48513,454
2022-10-03,Calaveras,009,45235,8517,8497,561,9058,133
2022-10-03,Colusa,011,21464,3802,3782,1283,5065,22
2022-10-03,Contra Costa,013,1133247,251945,249273,20789,270062,1426
2022-10-03,Del Norte,015,27424,7436,7421,398,7819,56
2022-10-03,El Dorado,017,186661,32338,32238,4275,36513,231
2022-10-03,Fresno,019,978130,277589,274028,31597,305625,2859
2022-10-03,Glenn,021,27897,5528,5509,1864,7373,48
2022-10-03,Humboldt,023,135768,21892,21744,5018,26762,157
2022-10-03,Imperial,025,180216,65596,65425,15819,81244,958
2022-10-03,Inyo,027,18085,4494,4483,995,5478,59
2022-10-03,Kern,029,883053,219468,218846,64037,282883,2417
2022-10-03,Kings,031,150075,59497,59394,4104,63498,459
2022-10-03,Lake,033,64148,12830,12761,1185,13946,147
2022-10-03,Lassen,035,31185,9969,9962,995,10957,65
2022-10-03,Los Angeles,037,10098052,3285455,3271661,181914,3453575,33336
2022-10-03,Madera,039,155013,44081,43953,8258,52211,374
2022-10-03,Marin,041,260295,45316,45002,5278,50280,310
2022-10-03,Mariposa,043,17540,3107,3079,343,3422,31
2022-10-03,Mendocino,045,87422,16063,15950,4492,20442,136
2022-10-03,Merced,047,269075,72675,72117,11866,83983,863
2022-10-03,Modoc,049,8938,876,873,324,1197,11
2022-10-03,Mono,051,14174,3209,3201,256,3457,7
2022-10-03,Monterey,053,433212,94231,93991,21089,115080,766
2022-10-03,Napa,055,140530,32243,32171,1409,33580,160
2022-10-03,Nevada,057,99092,19030,18923,1847,20770,132
2022-10-03,Orange,059,3164182,668482,665825,63392,729217,7435
2022-10-03,Placer,061,380077,75972,75573,9554,85127,661
2022-10-03,Plumas,063,18699,3675,3645,434,4079,13
2022-10-03,Riverside,065,2383286,696212,694250,35386,729636,6543
2022-10-03,Sacramento,067,1510023,347308,345905,34174,380079,3294
2022-10-03,San Benito,069,59416,16330,16152,969,17121,106
2022-10-03,San Bernardino,071,2135413,671942,668798,30970,699768,8106
2022-10-03,San Diego,073,3302833,925101,922323,72205,994528,5491
2022-10-03,San Francisco,075,870044,179574,178486,12125,190611,1043
2022-10-03,San Joaquin,077,732212,198042,197009,14961,211970,2319
2022-10-03,San Luis Obispo,079,281455,63379,63060,7149,70209,524
2022-10-03,San Mateo,081,765935,169182,167790,10487,178277,736
2022-10-03,Santa Barbara,083,443738,105916,105437,6878,112315,722
2022-10-03,Santa Clara,085,1922200,437049,430899,19111,450010,2494
2022-10-03,Santa Cruz,087,273765,63223,62866,3483,66349,273
2022-10-03,Shasta,089,179085,34974,34849,7477,42326,592
2022-10-03,Sierra,091,2930,306,304,60,364,5
2022-10-03,Siskiyou,093,43540,5148,5261,3308,8569,91
2022-10-03,Solano,095,438530,105255,104704,7920,112624,464
2022-10-03,Sonoma,097,501317,107086,106624,5288,111912,519
2022-10-03,Stanislaus,099,539301,138047,137589,21603,159192,1780
2022-10-03,Sutter,101,95872,24311,24265,2460,26725,232
2022-10-03,Tehama,103,63373,13645,13564,3082,16646,210
2022-10-03,Trinity,105,12862,1399,1392,397,1789,20
2022-10-03,Tulare,107,460477,121938,121589,36387,157976,1531
2022-10-03,Tuolumne,109,53932,15595,15516,924,16440,196
2022-10-03,Ventura,111,848112,208985,208124,15758,223882,1565
2022-10-03,Yolo,113,214977,47470,47279,4320,51599,341
2022-10-03,Yuba,115,75493,18913,18881,1722,20603,132
2022-10-02,Alameda,001,1643700,348337,346369,19707,366076,2020
2022-10-02,Alpine,003,1148,135,134,1,135,0
2022-10-02,Amador,005,37829,10003,9987,930,10917,90
2022-10-02,Butte,007,227075,39550,39378,9133,48511,454
2022-10-02,Calaveras,009,45235,8513,8497,560,9057,133
2022-10-02,Colusa,011,21464,3800,3782,1283,5065,22
2022-10-02,Contra Costa,013,1133247,251827,249273,20777,270050,1426
2022-10-02,Del Norte,015,27424,7433,7421,398,7819,56
2022-10-02,El Dorado,017,186661,32327,32238,4274,36512,231
2022-10-02,Fresno,019,978130,277513,274028,31584,305612,2859
2022-10-02,Glenn,021,27897,5525,5509,1864,7373,48
2022-10-02,Humboldt,023,135768,21875,21744,5009,26753,157
2022-10-02,Imperial,025,180216,65562,65425,15796,81221,958
2022-10-02,Inyo,027,18085,4494,4483,993,5476,59
2022-10-02,Kern,029,883053,219418,218846,63984,282830,2417
2022-10-02,Kings,031,150075,59482,59394,4103,63497,459
2022-10-02,Lake,033,64148,12824,12761,1185,13946,147
2022-10-02,Lassen,035,31185,9968,9962,993,10955,65
2022-10-02,Los Angeles,037,10098052,3284312,3271661,181753,3453414,33336
2022-10-02,Madera,039,155013,44073,43953,8255,52208,374
2022-10-02,Marin,041,260295,45283,45002,5273,50275,310
2022-10-02,Mariposa,043,17540,3107,3079,343,3422,31
2022-10-02,Mendocino,045,87422,16054,15950,4489,20439,136
2022-10-02,Merced,047,269075,72647,72117,11862,83979,863
2022-10-02,Modoc,049,8938,876,873,324,1197,11
2022-10-02,Mono,051,14174,3209,3201,256,3457,7
2022-10-02,Monterey,053,433212,94215,93991,21076,115067,766
2022-10-02,Napa,055,140530,32232,32171,1407,33578,160
2022-10-02,Nevada,057,99092,19024,18923,1847,20770,132
2022-10-02,Orange,059,3164182,668215,665825,63309,729134,7435
2022-10-02,Placer,061,380077,75945,75573,9551,85124,661
2022-10-02,Plumas,063,18699,3671,3645,433,4078,13
2022-10-02,Riverside,065,2383286,696020,694250,35367,729617,6543
2022-10-02,Sacramento,067,1510023,347133,345905,34141,380046,3294
2022-10-02,San Benito,069,59416,16325,16152,969,17121,106
2022-10-02,San Bernardino,071,2135413,671709,668798,30942,699740,8106
2022-10-02,San Diego,073,3302833,924731,922323,72156,994479,5491
2022-10-02,San Francisco,075,870044,179446,178486,12119,190605,1043
2022-10-02,San Joaquin,077,732212,197967,197009,14957,211966,2319
2022-10-02,San Luis Obispo,079,281455,63342,63060,7140,70200,524
2022-10-02,San Mateo,081,765935,169062,167790,10483,178273,736
2022-10-02,Santa Barbara,083,443738,105868,105437,6871,112308,722
2022-10-02,Santa Clara,085,1922200,436831,430899,19092,449991,2494
2022-10-02,Santa Cruz,087,273765,63183,62866,3476,66342,273
2022-10-02,Shasta,089,179085,34959,34849,7474,42323,592
2022-10-02,Sierra,091,2930,306,304,60,364,5
2022-10-02,Siskiyou,093,43540,5148,5261,3307,8568,91
2022-10-02,Solano,095,438530,105192,104704,7913,112617,464
2022-10-02,Sonoma,097,501317,107036,106624,5285,111909,519
2022-10-02,Stanislaus,099,539301,138013,137589,21599,159188,1780
2022-10-02,Sutter,101,95872,24301,24265,2460,26725,232
2022-10-02,Tehama,103,63373,13640,13564,3076,16640,210
2022-10-02,Trinity,105,12862,1399,1392,397,1789,20
2022-10-02,Tulare,107,460477,121912,121589,36368,157957,1531
2022-10-02,Tuolumne,109,53932,15590,15516,924,16440,196
2022-10-02,Ventura,111,848112,208905,208124,15739,223863,1565
2022-10-02,Yolo,113,214977,47458,47279,4315,51594,341
2022-10-02,Yuba,115,75493,18907,18881,1720,20601,132
2022-10-01,Alameda,001,1643700,348222,346369,19704,366073,2020
2022-10-01,Alpine,003,1148,135,134,1,135,0
2022-10-01,Amador,005,37829,10001,9987,930,10917,90
2022-10-01,Butte,007,227075,39539,39378,9126,48504,454
2022-10-01,Calaveras,009,45235,8513,8497,559,9056,133
2022-10-01,Colusa,011,21464,3800,3782,1281,5063,22
2022-10-01,Contra Costa,013,1133247,251753,249273,20774,270047,1426
2022-10-01,Del Norte,015,27424,7431,7421,398,7819,56
2022-10-01,El Dorado,017,186661,32320,32238,4274,36512,231
2022-10-01,Fresno,019,978130,277482,274028,31582,305610,2859
2022-10-01,Glenn,021,27897,5524,5509,1864,7373,48
2022-10-01,Humboldt,023,135768,21872,21744,5008,26752,157
2022-10-01,Imperial,025,180216,65545,65425,15786,81211,958
2022-10-01,Inyo,027,18085,4494,4483,993,5476,59
2022-10-01,Kern,029,883053,219401,218846,63953,282799,2417
2022-10-01,Kings,031,150075,59473,59394,4103,63497,459
2022-10-01,Lake,033,64148,12821,12761,1185,13946,147
2022-10-01,Lassen,035,31185,9966,9962,993,10955,65
2022-10-01,Los Angeles,037,10098052,3283685,3271661,181639,3453300,33336
2022-10-01,Madera,039,155013,44069,43953,8255,52208,374
2022-10-01,Marin,041,260295,45260,45002,5273,50275,310
2022-10-01,Mariposa,043,17540,3107,3079,343,3422,31
2022-10-01,Mendocino,045,87422,16047,15950,4485,20435,136
2022-10-01,Merced,047,269075,72637,72117,11860,83977,863
2022-10-01,Modoc,049,8938,876,873,324,1197,11
2022-10-01,Mono,051,14174,3209,3201,256,3457,7
2022-10-01,Monterey,053,433212,94202,93991,21069,115060,766
2022-10-01,Napa,055,140530,32227,32171,1407,33578,160
2022-10-01,Nevada,057,99092,19021,18923,1846,20769,132
2022-10-01,Orange,059,3164182,668073,665825,63262,729087,7435
2022-10-01,Placer,061,380077,75918,75573,9549,85122,661
2022-10-01,Plumas,063,18699,3670,3645,433,4078,13
2022-10-01,Riverside,065,2383286,695899,694250,35353,729603,6543
2022-10-01,Sacramento,067,1510023,347064,345905,34133,380038,3294
2022-10-01,San Benito,069,59416,16317,16152,966,17118,106
2022-10-01,San Bernardino,071,2135413,671609,668798,30930,699728,8106
2022-10-01,San Diego,073,3302833,924613,922323,72126,994449,5491
2022-10-01,San Francisco,075,870044,179390,178486,12113,190599,1043
2022-10-01,San Joaquin,077,732212,197936,197009,14951,211960,2319
2022-10-01,San Luis Obispo,079,281455,63332,63060,7137,70197,524
2022-10-01,San Mateo,081,765935,169018,167790,10481,178271,736
2022-10-01,Santa Barbara,083,443738,105838,105437,6869,112306,722
2022-10-01,Santa Clara,085,1922200,436660,430899,19089,449988,2494
2022-10-01,Santa Cruz,087,273765,63169,62866,3470,66336,273
2022-10-01,Shasta,089,179085,34953,34849,7470,42319,592
2022-10-01,Sierra,091,2930,306,304,60,364,5
2022-10-01,Siskiyou,093,43540,5146,5261,3305,8566,91
2022-10-01,Solano,095,438530,105184,104704,7911,112615,464
2022-10-01,Sonoma,097,501317,107010,106624,5283,111907,519
2022-10-01,Stanislaus,099,539301,137990,137589,21598,159187,1780
2022-10-01,Sutter,101,95872,24296,24265,2460,26725,232
2022-10-01,Tehama,103,63373,13638,13564,3075,16639,210
2022-10-01,Trinity,105,12862,1399,1392,397,1789,20
2022-10-01,Tulare,107,460477,121903,121589,36354,157943,1531
2022-10-01,Tuolumne,109,53932,15588,15516,924,16440,196
2022-10-01,Ventura,111,848112,208858,208124,15731,223855,1565
2022-10-01,Yolo,113,214977,47448,47279,4313,51592,341
2022-10-01,Yuba,115,75493,18900,18881,1719,20600,132
2022-09-30,Alameda,001,1643700,348105,346369,19698,366067,2020
2022-09-30,Alpine,003,1148,135,134,1,135,0
2022-09-30,Amador,005,37829,9999,9987,930,10917,90
2022-09-30,Butte,007,227075,39528,39378,9124,48502,454
2022-09-30,Calaveras,009,45235,8510,8497,559,9056,133
2022-09-30,Colusa,011,21464,3799,3782,1280,5062,22
2022-09-30,Contra Costa,013,1133247,251658,249273,20772,270045,1426
2022-09-30,Del Norte,015,27424,7430,7421,398,7819,56
2022-09-30,El Dorado,017,186661,32311,32238,4270,36508,231
2022-09-30,Fresno,019,978130,277439,274028,31575,305603,2859
2022-09-30,Glenn,021,27897,5523,5509,1864,7373,48
2022-09-30,Humboldt,023,135768,21858,21744,5005,26749,157
2022-09-30,Imperial,025,180216,65535,65425,15778,81203,958
2022-09-30,Inyo,027,18085,4493,4483,991,5474,59
2022-09-30,Kern,029,883053,219382,218846,63920,282766,2417
2022-09-30,Kings,031,150075,59467,59394,4103,63497,459
2022-09-30,Lake,033,64148,12818,12761,1185,13946,147
2022-09-30,Lassen,035,31185,9966,9962,993,10955,65
2022-09-30,Los Angeles,037,10098052,3282944,3271661,181519,3453180,33336
2022-09-30,Madera,039,155013,44063,43953,8254,52207,374
2022-09-30,Marin,041,260295,45236,45002,5272,50274,310
2022-09-30,Mariposa,043,17540,3106,3079,343,3422,31
2022-09-30,Mendocino,045,87422,16039,15950,4481,20431,136
2022-09-30,Merced,047,269075,72625,72117,11860,83977,863
2022-09-30,Modoc,049,8938,876,873,324,1197,11
2022-09-30,Mono,051,14174,3209,3201,256,3457,7
2022-09-30,Monterey,053,433212,94183,93991,21063,115054,766
2022-09-30,Napa,055,140530,32216,32171,1407,33578,160
2022-09-30,Nevada,057,99092,19015,18923,1846,20769,132
2022-09-30,Orange,059,3164182,667936,665825,63223,729048,7435
2022-09-30,Placer,061,380077,75900,75573,9543,85116,661
2022-09-30,Plumas,063,18699,3669,3645,433,4078,13
2022-09-30,Riverside,065,2383286,695787,694250,35341,729591,6543
2022-09-30,Sacramento,067,1510023,346980,345905,34129,380034,3294
2022-09-30,San Benito,069,59416,16314,16152,966,17118,106
2022-09-30,San Bernardino,071,2135413,671488,668798,30917,699715,8106
2022-09-30,San Diego,073,3302833,924396,922323,72098,994421,5491
2022-09-30,San Francisco,075,870044,179326,178486,12107,190593,1043
2022-09-30,San Joaquin,077,732212,197902,197009,14949,211958,2319
2022-09-30,San Luis Obispo,079,281455,63327,63060,7134,70194,524
2022-09-30,San Mateo,081,765935,168953,167790,10477,178267,736
2022-09-30,Santa Barbara,083,443738,105813,105437,6869,112306,722
2022-09-30,Santa Clara,085,1922200,436475,430899,19077,449976,2494
2022-09-30,Santa Cruz,087,273765,63147,62866,3468,66334,273
2022-09-30,Shasta,089,179085,34950,34849,7466,42315,592
2022-09-30,Sierra,091,2930,306,304,60,364,5
2022-09-30,Siskiyou,093,43540,5145,5261,3305,8566,91
2022-09-30,Solano,095,438530,105154,104704,7908,112612,464
2022-09-30,Sonoma,097,501317,106976,106624,5281,111905,519
2022-09-30,Stanislaus,099,539301,137970,137589,21596,159185,1780
2022-09-30,Sutter,101,95872,24294,24265,2460,26725,232
2022-09-30,Tehama,103,63373,13636,13564,3075,16639,210
2022-09-30,Trinity,105,12862,1398,1392,397,1789,20
2022-09-30,Tulare,107,460477,121882,121589,36341,157930,1531
2022-09-30,Tuolumne,109,53932,15585,15516,924,16440,196
2022-09-30,Ventura,111,848112,208806,208124,15726,223850,1565
2022-09-30,Yolo,113,214977,47437,47279,4313,51592,341
2022-09-30,Yuba,115,75493,18895,18881,1719,20600,132
2022-09-29,Alameda,001,1643700,347941,346369,19683,366052,2020
2022-09-29,Alpine,003,1148,135,134,1,135,0
2022-09-29,Amador,005,37829,9996,9987,929,10916,90
2022-09-29,Butte,007,227075,39522,39378,9119,48497,454
2022-09-29,Calaveras,009,45235,8505,8497,558,9055,133
2022-09-29,Colusa,011,21464,3798,3782,1280,5062,22
2022-09-29,Contra Costa,013,1133247,251557,249273,20762,270035,1426
2022-09-29,Del Norte,015,27424,7427,7421,398,7819,56
2022-09-29,El Dorado,017,186661,32300,32238,4265,36503,231
2022-09-29,Fresno,019,978130,277344,274028,31566,305594,2859
2022-09-29,Glenn,021,27897,5523,5509,1864,7373,48
2022-09-29,Humboldt,023,135768,21846,21744,5003,26747,157
2022-09-29,Imperial,025,180216,65515,65425,15766,81191,958
2022-09-29,Inyo,027,18085,4493,4483,989,5472,59
2022-09-29,Kern,029,883053,219350,218846,63880,282726,2417
2022-09-29,Kings,031,150075,59460,59394,4102,63496,459
2022-09-29,Lake,033,64148,12814,12761,1185,13946,147
2022-09-29,Lassen,035,31185,9965,9962,993,10955,65
2022-09-29,Los Angeles,037,10098052,3281958,3271661,181406,3453067,33336
2022-09-29,Madera,039,155013,44053,43953,8251,52204,374
2022-09-29,Marin,041,260295,45211,45002,5268,50270,310
2022-09-29,Mariposa,043,17540,3104,3079,343,3422,31
2022-09-29,Mendocino,045,87422,16035,15950,4481,20431,136
2022-09-29,Merced,047,269075,72610,72117,11859,83976,863
2022-09-29,Modoc,049,8938,876,873,324,1197,11
2022-09-29,Mono,051,14174,3208,3201,256,3457,7
2022-09-29,Monterey,053,433212,94172,93991,21056,115047,766
2022-09-29,Napa,055,140530,32205,32171,1407,33578,160
2022-09-29,Nevada,057,99092,19005,18923,1843,20766,132
2022-09-29,Orange,059,3164182,667709,665825,63171,728996,7435
2022-09-29,Placer,061,380077,75876,75573,9534,85107,661
2022-09-29,Plumas,063,18699,3668,3645,432,4077,13
2022-09-29,Riverside,065,2383286,695636,694250,35329,729579,6543
2022-09-29,Sacramento,067,1510023,346841,345905,34109,380014,3294
2022-09-29,San Benito,069,59416,16309,16152,965,17117,106
2022-09-29,San Bernardino,071,2135413,671340,668798,30905,699703,8106
2022-09-29,San Diego,073,3302833,924150,922323,72067,994390,5491
2022-09-29,San Francisco,075,870044,179239,178486,12095,190581,1043
2022-09-29,San Joaquin,077,732212,197857,197009,14940,211949,2319
2022-09-29,San Luis Obispo,079,281455,63307,63060,7128,70188,524
2022-09-29,San Mateo,081,765935,168870,167790,10475,178265,736
2022-09-29,Santa Barbara,083,443738,105779,105437,6866,112303,722
2022-09-29,Santa Clara,085,1922200,436280,430899,19066,449965,2494
2022-09-29,Santa Cruz,087,273765,63103,62866,3462,66328,273
2022-09-29,Shasta,089,179085,34943,34849,7460,42309,592
2022-09-29,Sierra,091,2930,306,304,60,364,5
2022-09-29,Siskiyou,093,43540,5142,5261,3304,8565,91
2022-09-29,Solano,095,438530,105119,104704,7903,112607,464
2022-09-29,Sonoma,097,501317,106917,106624,5279,111903,519
2022-09-29,Stanislaus,099,539301,137938,137589,21595,159184,1780
2022-09-29,Sutter,101,95872,24291,24265,2460,26725,232
2022-09-29,Tehama,103,63373,13634,13564,3074,16638,210
2022-09-29,Trinity,105,12862,1398,1392,394,1786,20
2022-09-29,Tulare,107,460477,121866,121589,36321,157910,1531
2022-09-29,Tuolumne,109,53932,15581,15516,924,16440,196
2022-09-29,Ventura,111,848112,208746,208124,15717,223841,1565
2022-09-29,Yolo,113,214977,47424,47279,4311,51590,341
2022-09-29,Yuba,115,75493,18893,18881,1719,20600,132
2022-09-28,Alameda,001,1643700,347780,346369,19667,366036,2020
2022-09-28,Alpine,003,1148,134,134,1,135,0
2022-09-28,Amador,005,37829,9994,9987,929,10916,90
2022-09-28,Butte,007,227075,39515,39378,9111,48489,454
2022-09-28,Calaveras,009,45235,8503,8497,558,9055,133
2022-09-28,Colusa,011,21464,3798,3782,1280,5062,22
2022-09-28,Contra Costa,013,1133247,251447,249273,20749,270022,1426
2022-09-28,Del Norte,015,27424,7425,7421,398,7819,56
2022-09-28,El Dorado,017,186661,32293,32238,4263,36501,231
2022-09-28,Fresno,019,978130,277261,274028,31549,305577,2859
2022-09-28,Glenn,021,27897,5522,5509,1864,7373,48
2022-09-28,Humboldt,023,135768,21836,21744,5000,26744,157
2022-09-28,Imperial,025,180216,65499,65425,15759,81184,958
2022-09-28,Inyo,027,18085,4491,4483,989,5472,59
2022-09-28,Kern,029,883053,219297,218846,63831,282677,2417
2022-09-28,Kings,031,150075,59438,59394,4098,63492,459
2022-09-28,Lake,033,64148,12805,12761,1185,13946,147
2022-09-28,Lassen,035,31185,9964,9962,993,10955,65
2022-09-28,Los Angeles,037,10098052,3280838,3271661,181299,3452960,33336
2022-09-28,Madera,039,155013,44047,43953,8250,52203,374
2022-09-28,Marin,041,260295,45184,45002,5267,50269,310
2022-09-28,Mariposa,043,17540,3104,3079,343,3422,31
2022-09-28,Mendocino,045,87422,16032,15950,4477,20427,136
2022-09-28,Merced,047,269075,72598,72117,11853,83970,863
2022-09-28,Modoc,049,8938,876,873,323,1196,11
2022-09-28,Mono,051,14174,3208,3201,256,3457,7
2022-09-28,Monterey,053,433212,94158,93991,21048,115039,766
2022-09-28,Napa,055,140530,32190,32171,1405,33576,160
2022-09-28,Nevada,057,99092,18997,18923,1830,20753,132
2022-09-28,Orange,059,3164182,667484,665825,63108,728933,7435
2022-09-28,Placer,061,380077,75842,75573,9531,85104,661
2022-09-28,Plumas,063,18699,3666,3645,432,4077,13
2022-09-28,Riverside,065,2383286,695472,694250,35311,729561,6543
2022-09-28,Sacramento,067,1510023,346714,345905,34084,379989,3294
2022-09-28,San Benito,069,59416,16304,16152,962,17114,106
2022-09-28,San Bernardino,071,2135413,671176,668798,30885,699683,8106
2022-09-28,San Diego,073,3302833,923832,922323,72036,994359,5491
2022-09-28,San Francisco,075,870044,179141,178486,12091,190577,1043
2022-09-28,San Joaquin,077,732212,197819,197009,14937,211946,2319
2022-09-28,San Luis Obispo,079,281455,63290,63060,7120,70180,524
2022-09-28,San Mateo,081,765935,168793,167790,10468,178258,736
2022-09-28,Santa Barbara,083,443738,105745,105437,6861,112298,722
2022-09-28,Santa Clara,085,1922200,436113,430899,19056,449955,2494
2022-09-28,Santa Cruz,087,273765,63066,62866,3461,66327,273
2022-09-28,Shasta,089,179085,34938,34849,7455,42304,592
2022-09-28,Sierra,091,2930,306,304,60,364,5
2022-09-28,Siskiyou,093,43540,5140,5261,3303,8564,91
2022-09-28,Solano,095,438530,105091,104704,7901,112605,464
2022-09-28,Sonoma,097,501317,106882,106624,5273,111897,519
2022-09-28,Stanislaus,099,539301,137902,137589,21591,159180,1780
2022-09-28,Sutter,101,95872,24277,24265,2459,26724,232
2022-09-28,Tehama,103,63373,13630,13564,3074,16638,210
2022-09-28,Trinity,105,12862,1398,1392,392,1784,20
2022-09-28,Tulare,107,460477,121840,121589,36312,157901,1531
2022-09-28,Tuolumne,109,53932,15577,15516,924,16440,196
2022-09-28,Ventura,111,848112,208681,208124,15714,223838,1565
2022-09-28,Yolo,113,214977,47401,47279,4308,51587,341
2022-09-28,Yuba,115,75493,18888,18881,1716,20597,132
2022-09-27,Alameda,001,1643700,347612,346369,19653,366022,2020
2022-09-27,Alpine,003,1148,134,134,1,135,0
2022-09-27,Amador,005,37829,9990,9987,927,10914,90
2022-09-27,Butte,007,227075,39507,39378,9106,48484,454
2022-09-27,Calaveras,009,45235,8501,8497,558,9055,133
2022-09-27,Colusa,011,21464,3798,3782,1280,5062,22
2022-09-27,Contra Costa,013,1133247,251336,249273,20740,270013,1426
2022-09-27,Del Norte,015,27424,7425,7421,398,7819,56
2022-09-27,El Dorado,017,186661,32276,32238,4261,36499,231
2022-09-27,Fresno,019,978130,277199,274028,31539,305567,2859
2022-09-27,Glenn,021,27897,5521,5509,1864,7373,48
2022-09-27,Humboldt,023,135768,21825,21744,4995,26739,157
2022-09-27,Imperial,025,180216,65477,65425,15753,81178,958
2022-09-27,Inyo,027,18085,4489,4483,987,5470,59
2022-09-27,Kern,029,883053,219239,218846,63803,282649,2417
2022-09-27,Kings,031,150075,59422,59394,4098,63492,459
2022-09-27,Lake,033,64148,12801,12761,1184,13945,147
2022-09-27,Lassen,035,31185,9962,9962,993,10955,65
2022-09-27,Los Angeles,037,10098052,3279643,3271661,181138,3452799,33336
2022-09-27,Madera,039,155013,44035,43953,8249,52202,374
2022-09-27,Marin,041,260295,45156,45002,5263,50265,310
2022-09-27,Mariposa,043,17540,3103,3079,343,3422,31
2022-09-27,Mendocino,045,87422,16023,15950,4471,20421,136
2022-09-27,Merced,047,269075,72579,72117,11847,83964,863
2022-09-27,Modoc,049,8938,876,873,323,1196,11
2022-09-27,Mono,051,14174,3207,3201,256,3457,7
2022-09-27,Monterey,053,433212,94137,93991,21032,115023,766
2022-09-27,Napa,055,140530,32173,32171,1405,33576,160
2022-09-27,Nevada,057,99092,18988,18923,1829,20752,132
2022-09-27,Orange,059,3164182,667216,665825,63043,728868,7435
2022-09-27,Placer,061,380077,75801,75573,9526,85099,661
2022-09-27,Plumas,063,18699,3663,3645,432,4077,13
2022-09-27,Riverside,065,2383286,695276,694250,35286,729536,6543
2022-09-27,Sacramento,067,1510023,346568,345905,34057,379962,3294
2022-09-27,San Benito,069,59416,16303,16152,962,17114,106
2022-09-27,San Bernardino,071,2135413,670926,668798,30869,699667,8106
2022-09-27,San Diego,073,3302833,923437,922323,72000,994323,5491
2022-09-27,San Francisco,075,870044,179031,178486,12089,190575,1043
2022-09-27,San Joaquin,077,732212,197765,197009,14930,211939,2319
2022-09-27,San Luis Obispo,079,281455,63261,63060,7119,70179,524
2022-09-27,San Mateo,081,765935,168722,167790,10465,178255,736
2022-09-27,Santa Barbara,083,443738,105702,105437,6855,112292,722
2022-09-27,Santa Clara,085,1922200,435891,430899,19035,449934,2494
2022-09-27,Santa Cruz,087,273765,63035,62866,3456,66322,273
2022-09-27,Shasta,089,179085,34927,34849,7447,42296,592
2022-09-27,Sierra,091,2930,304,304,60,364,5
2022-09-27,Siskiyou,093,43540,5138,5261,3303,8564,91
2022-09-27,Solano,095,438530,105048,104704,7899,112603,464
2022-09-27,Sonoma,097,501317,106832,106624,5270,111894,519
2022-09-27,Stanislaus,099,539301,137874,137589,21590,159179,1780
2022-09-27,Sutter,101,95872,24263,24265,2459,26724,232
2022-09-27,Tehama,103,63373,13628,13564,3073,16637,210
2022-09-27,Trinity,105,12862,1398,1392,389,1781,20
2022-09-27,Tulare,107,460477,121816,121589,36294,157883,1531
2022-09-27,Tuolumne,109,53932,15571,15516,924,16440,196
2022-09-27,Ventura,111,848112,208601,208124,15704,223828,1565
2022-09-27,Yolo,113,214977,47373,47279,4307,51586,341
2022-09-27,Yuba,115,75493,18884,18881,1715,20596,132
2022-09-26,Alameda,001,1643700,347421,345351,19647,364998,2012
2022-09-26,Alpine,003,1148,134,134,1,135,0
2022-09-26,Amador,005,37829,9989,9954,926,10880,90
2022-09-26,Butte,007,227075,39495,39282,9103,48385,453
2022-09-26,Calaveras,009,45235,8498,8475,555,9030,133
2022-09-26,Colusa,011,21464,3795,3775,1278,5053,22
2022-09-26,Contra Costa,013,1133247,251199,248053,20726,268779,1424
2022-09-26,Del Norte,015,27424,7424,7403,398,7801,57
2022-09-26,El Dorado,017,186661,32258,32159,4257,36416,231
2022-09-26,Fresno,019,978130,277127,273381,31523,304904,2850
2022-09-26,Glenn,021,27897,5521,5494,1864,7358,48
2022-09-26,Humboldt,023,135768,21813,21641,4990,26631,156
2022-09-26,Imperial,025,180216,65456,65297,15738,81035,957
2022-09-26,Inyo,027,18085,4489,4481,986,5467,59
2022-09-26,Kern,029,883053,219183,218413,63774,282187,2408
2022-09-26,Kings,031,150075,59410,59288,4096,63384,456
2022-09-26,Lake,033,64148,12795,12731,1184,13915,146
2022-09-26,Lassen,035,31185,9962,9947,992,10939,65
2022-09-26,Los Angeles,037,10098052,3278457,3263510,180964,3444474,33258
2022-09-26,Madera,039,155013,44016,43910,8246,52156,374
2022-09-26,Marin,041,260295,45125,44823,5258,50081,310
2022-09-26,Mariposa,043,17540,3102,3074,343,3417,31
2022-09-26,Mendocino,045,87422,16013,15911,4471,20382,136
2022-09-26,Merced,047,269075,72566,71875,11843,83718,862
2022-09-26,Modoc,049,8938,874,872,323,1195,11
2022-09-26,Mono,051,14174,3205,3198,256,3454,7
2022-09-26,Monterey,053,433212,94120,93829,21011,114840,766
2022-09-26,Napa,055,140530,32155,32094,1404,33498,160
2022-09-26,Nevada,057,99092,18979,18861,1827,20688,132
2022-09-26,Orange,059,3164182,666957,664263,62978,727241,7425
2022-09-26,Placer,061,380077,75765,75381,9518,84899,660
2022-09-26,Plumas,063,18699,3663,3632,432,4064,13
2022-09-26,Riverside,065,2383286,695074,693038,35271,728309,6610
2022-09-26,Sacramento,067,1510023,346408,344748,34028,378776,3282
2022-09-26,San Benito,069,59416,16296,16114,962,17076,106
2022-09-26,San Bernardino,071,2135413,670727,667124,30857,697981,8097
2022-09-26,San Diego,073,3302833,923016,920118,71970,992088,5487
2022-09-26,San Francisco,075,870044,178932,176887,12086,188973,1031
2022-09-26,San Joaquin,077,732212,197699,196573,14920,211493,2306
2022-09-26,San Luis Obispo,079,281455,63229,62950,7115,70065,522
2022-09-26,San Mateo,081,765935,168633,167123,10460,177583,736
2022-09-26,Santa Barbara,083,443738,105663,105185,6850,112035,720
2022-09-26,Santa Clara,085,1922200,435639,429334,19017,448351,2486
2022-09-26,Santa Cruz,087,273765,62996,62704,3454,66158,274
2022-09-26,Shasta,089,179085,34919,34762,7438,42200,592
2022-09-26,Sierra,091,2930,304,303,60,363,5
2022-09-26,Siskiyou,093,43540,5138,5243,3301,8544,90
2022-09-26,Solano,095,438530,105006,104383,7893,112276,463
2022-09-26,Sonoma,097,501317,106763,106322,5266,111588,519
2022-09-26,Stanislaus,099,539301,137844,137340,21584,158924,1752
2022-09-26,Sutter,101,95872,24254,24198,2459,26657,232
2022-09-26,Tehama,103,63373,13625,13528,3073,16601,210
2022-09-26,Trinity,105,12862,1398,1390,388,1778,20
2022-09-26,Tulare,107,460477,121776,121446,36279,157725,1530
2022-09-26,Tuolumne,109,53932,15569,15469,923,16392,196
2022-09-26,Ventura,111,848112,208509,207684,15696,223380,1566
2022-09-26,Yolo,113,214977,47348,47147,4301,51448,335
2022-09-26,Yuba,115,75493,18878,18834,1713,20547,129
2022-09-25,Alameda,001,1643700,347204,345351,19627,364978,2012
2022-09-25,Alpine,003,1148,134,134,1,135,0
2022-09-25,Amador,005,37829,9985,9954,924,10878,90
2022-09-25,Butte,007,227075,39473,39282,9096,48378,453
2022-09-25,Calaveras,009,45235,8494,8475,550,9025,133
2022-09-25,Colusa,011,21464,3793,3775,1272,5047,22
2022-09-25,Contra Costa,013,1133247,251047,248053,20707,268760,1424
2022-09-25,Del Norte,015,27424,7419,7403,398,7801,57
2022-09-25,El Dorado,017,186661,32244,32159,4255,36414,231
2022-09-25,Fresno,019,978130,277021,273381,31497,304878,2850
2022-09-25,Glenn,021,27897,5521,5494,1864,7358,48
2022-09-25,Humboldt,023,135768,21803,21641,4986,26627,156
2022-09-25,Imperial,025,180216,65436,65297,15725,81022,957
2022-09-25,Inyo,027,18085,4486,4481,985,5466,59
2022-09-25,Kern,029,883053,219122,218413,63699,282112,2408
2022-09-25,Kings,031,150075,59391,59288,4095,63383,456
2022-09-25,Lake,033,64148,12790,12731,1182,13913,146
2022-09-25,Lassen,035,31185,9961,9947,992,10939,65
2022-09-25,Los Angeles,037,10098052,3276992,3263510,180767,3444277,33258
2022-09-25,Madera,039,155013,44002,43910,8241,52151,374
2022-09-25,Marin,041,260295,45084,44823,5258,50081,310
2022-09-25,Mariposa,043,17540,3102,3074,343,3417,31
2022-09-25,Mendocino,045,87422,16003,15911,4464,20375,136
2022-09-25,Merced,047,269075,72542,71875,11836,83711,862
2022-09-25,Modoc,049,8938,874,872,323,1195,11
2022-09-25,Mono,051,14174,3205,3198,254,3452,7
2022-09-25,Monterey,053,433212,94096,93829,21000,114829,766
2022-09-25,Napa,055,140530,32136,32094,1403,33497,160
2022-09-25,Nevada,057,99092,18966,18861,1827,20688,132
2022-09-25,Orange,059,3164182,666653,664263,62909,727172,7425
2022-09-25,Placer,061,380077,75719,75381,9505,84886,660
2022-09-25,Plumas,063,18699,3657,3632,432,4064,13
2022-09-25,Riverside,065,2383286,694857,693038,35252,728290,6610
2022-09-25,Sacramento,067,1510023,346250,344748,33992,378740,3282
2022-09-25,San Benito,069,59416,16284,16114,962,17076,106
2022-09-25,San Bernardino,071,2135413,670490,667124,30835,697959,8097
2022-09-25,San Diego,073,3302833,922565,920118,71931,992049,5487
2022-09-25,San Francisco,075,870044,178806,176887,12081,188968,1031
2022-09-25,San Joaquin,077,732212,197612,196573,14903,211476,2306
2022-09-25,San Luis Obispo,079,281455,63195,62950,7107,70057,522
2022-09-25,San Mateo,081,765935,168507,167123,10451,177574,736
2022-09-25,Santa Barbara,083,443738,105609,105185,6849,112034,720
2022-09-25,Santa Clara,085,1922200,435395,429334,18996,448330,2486
2022-09-25,Santa Cruz,087,273765,62948,62704,3446,66150,274
2022-09-25,Shasta,089,179085,34906,34762,7429,42191,592
2022-09-25,Sierra,091,2930,304,303,60,363,5
2022-09-25,Siskiyou,093,43540,5136,5243,3300,8543,90
2022-09-25,Solano,095,438530,104939,104383,7889,112272,463
2022-09-25,Sonoma,097,501317,106707,106322,5263,111585,519
2022-09-25,Stanislaus,099,539301,137792,137340,21581,158921,1752
2022-09-25,Sutter,101,95872,24238,24198,2459,26657,232
2022-09-25,Tehama,103,63373,13617,13528,3073,16601,210
2022-09-25,Trinity,105,12862,1398,1390,388,1778,20
2022-09-25,Tulare,107,460477,121745,121446,36257,157703,1530
2022-09-25,Tuolumne,109,53932,15563,15469,922,16391,196
2022-09-25,Ventura,111,848112,208406,207684,15683,223367,1566
2022-09-25,Yolo,113,214977,47322,47147,4296,51443,335
2022-09-25,Yuba,115,75493,18874,18834,1712,20546,129
2022-09-24,Alameda,001,1643700,347092,345351,19620,364971,2012
2022-09-24,Alpine,003,1148,134,134,1,135,0
2022-09-24,Amador,005,37829,9983,9954,923,10877,90
2022-09-24,Butte,007,227075,39466,39282,9094,48376,453
2022-09-24,Calaveras,009,45235,8491,8475,550,9025,133
2022-09-24,Colusa,011,21464,3792,3775,1271,5046,22
2022-09-24,Contra Costa,013,1133247,250960,248053,20703,268756,1424
2022-09-24,Del Norte,015,27424,7416,7403,398,7801,57
2022-09-24,El Dorado,017,186661,32232,32159,4251,36410,231
2022-09-24,Fresno,019,978130,276982,273381,31491,304872,2850
2022-09-24,Glenn,021,27897,5520,5494,1864,7358,48
2022-09-24,Humboldt,023,135768,21789,21641,4985,26626,156
2022-09-24,Imperial,025,180216,65421,65297,15719,81016,957
2022-09-24,Inyo,027,18085,4486,4481,985,5466,59
2022-09-24,Kern,029,883053,219092,218413,63660,282073,2408
2022-09-24,Kings,031,150075,59379,59288,4095,63383,456
2022-09-24,Lake,033,64148,12788,12731,1181,13912,146
2022-09-24,Lassen,035,31185,9960,9947,992,10939,65
2022-09-24,Los Angeles,037,10098052,3276269,3263510,180621,3444131,33258
2022-09-24,Madera,039,155013,43999,43910,8238,52148,374
2022-09-24,Marin,041,260295,45069,44823,5258,50081,310
2022-09-24,Mariposa,043,17540,3100,3074,343,3417,31
2022-09-24,Mendocino,045,87422,15999,15911,4463,20374,136
2022-09-24,Merced,047,269075,72529,71875,11836,83711,862
2022-09-24,Modoc,049,8938,874,872,322,1194,11
2022-09-24,Mono,051,14174,3205,3198,254,3452,7
2022-09-24,Monterey,053,433212,94086,93829,20995,114824,766
2022-09-24,Napa,055,140530,32127,32094,1402,33496,160
2022-09-24,Nevada,057,99092,18961,18861,1824,20685,132
2022-09-24,Orange,059,3164182,666494,664263,62849,727112,7425
2022-09-24,Placer,061,380077,75695,75381,9499,84880,660
2022-09-24,Plumas,063,18699,3654,3632,432,4064,13
2022-09-24,Riverside,065,2383286,694732,693038,35242,728280,6610
2022-09-24,Sacramento,067,1510023,346178,344748,33982,378730,3282
2022-09-24,San Benito,069,59416,16276,16114,962,17076,106
2022-09-24,San Bernardino,071,2135413,670377,667124,30825,697949,8097
2022-09-24,San Diego,073,3302833,922361,920118,71917,992035,5487
2022-09-24,San Francisco,075,870044,178728,176887,12075,188962,1031
2022-09-24,San Joaquin,077,732212,197586,196573,14896,211469,2306
2022-09-24,San Luis Obispo,079,281455,63183,62950,7106,70056,522
2022-09-24,San Mateo,081,765935,168437,167123,10442,177565,736
2022-09-24,Santa Barbara,083,443738,105585,105185,6849,112034,720
2022-09-24,Santa Clara,085,1922200,435238,429334,18983,448317,2486
2022-09-24,Santa Cruz,087,273765,62931,62704,3443,66147,274
2022-09-24,Shasta,089,179085,34901,34762,7427,42189,592
2022-09-24,Sierra,091,2930,304,303,60,363,5
2022-09-24,Siskiyou,093,43540,5133,5243,3300,8543,90
2022-09-24,Solano,095,438530,104920,104383,7888,112271,463
2022-09-24,Sonoma,097,501317,106679,106322,5260,111582,519
2022-09-24,Stanislaus,099,539301,137765,137340,21575,158915,1752
2022-09-24,Sutter,101,95872,24231,24198,2459,26657,232
2022-09-24,Tehama,103,63373,13612,13528,3072,16600,210
2022-09-24,Trinity,105,12862,1398,1390,388,1778,20
2022-09-24,Tulare,107,460477,121726,121446,36240,157686,1530
2022-09-24,Tuolumne,109,53932,15555,15469,922,16391,196
2022-09-24,Ventura,111,848112,208359,207684,15676,223360,1566
2022-09-24,Yolo,113,214977,47307,47147,4294,51441,335
2022-09-24,Yuba,115,75493,18869,18834,1711,20545,129
2022-09-23,Alameda,001,1643700,346953,345351,19608,364959,2012
2022-09-23,Alpine,003,1148,134,134,1,135,0
2022-09-23,Amador,005,37829,9979,9954,923,10877,90
2022-09-23,Butte,007,227075,39458,39282,9091,48373,453
2022-09-23,Calaveras,009,45235,8490,8475,550,9025,133
2022-09-23,Colusa,011,21464,3792,3775,1271,5046,22
2022-09-23,Contra Costa,013,1133247,250878,248053,20699,268752,1424
2022-09-23,Del Norte,015,27424,7413,7403,398,7801,57
2022-09-23,El Dorado,017,186661,32218,32159,4249,36408,231
2022-09-23,Fresno,019,978130,276935,273381,31483,304864,2850
2022-09-23,Glenn,021,27897,5518,5494,1863,7357,48
2022-09-23,Humboldt,023,135768,21772,21641,4978,26619,156
2022-09-23,Imperial,025,180216,65411,65297,15712,81009,957
2022-09-23,Inyo,027,18085,4486,4481,981,5462,59
2022-09-23,Kern,029,883053,219053,218413,63636,282049,2408
2022-09-23,Kings,031,150075,59371,59288,4095,63383,456
2022-09-23,Lake,033,64148,12788,12731,1181,13912,146
2022-09-23,Lassen,035,31185,9958,9947,992,10939,65
2022-09-23,Los Angeles,037,10098052,3275504,3263510,180540,3444050,33258
2022-09-23,Madera,039,155013,43989,43910,8238,52148,374
2022-09-23,Marin,041,260295,45046,44823,5256,50079,310
2022-09-23,Mariposa,043,17540,3099,3074,343,3417,31
2022-09-23,Mendocino,045,87422,15997,15911,4463,20374,136
2022-09-23,Merced,047,269075,72518,71875,11835,83710,862
2022-09-23,Modoc,049,8938,874,872,322,1194,11
2022-09-23,Mono,051,14174,3205,3198,254,3452,7
2022-09-23,Monterey,053,433212,94078,93829,20985,114814,766
2022-09-23,Napa,055,140530,32118,32094,1402,33496,160
2022-09-23,Nevada,057,99092,18957,18861,1823,20684,132
2022-09-23,Orange,059,3164182,666325,664263,62816,727079,7425
2022-09-23,Placer,061,380077,75673,75381,9493,84874,660
2022-09-23,Plumas,063,18699,3651,3632,432,4064,13
2022-09-23,Riverside,065,2383286,694599,693038,35232,728270,6610
2022-09-23,Sacramento,067,1510023,346105,344748,33977,378725,3282
2022-09-23,San Benito,069,59416,16276,16114,962,17076,106
2022-09-23,San Bernardino,071,2135413,670246,667124,30818,697942,8097
2022-09-23,San Diego,073,3302833,922115,920118,71884,992002,5487
2022-09-23,San Francisco,075,870044,178651,176887,12070,188957,1031
2022-09-23,San Joaquin,077,732212,197548,196573,14885,211458,2306
2022-09-23,San Luis Obispo,079,281455,63173,62950,7105,70055,522
2022-09-23,San Mateo,081,765935,168365,167123,10437,177560,736
2022-09-23,Santa Barbara,083,443738,105558,105185,6848,112033,720
2022-09-23,Santa Clara,085,1922200,435075,429334,18969,448303,2486
2022-09-23,Santa Cruz,087,273765,62915,62704,3441,66145,274
2022-09-23,Shasta,089,179085,34896,34762,7422,42184,592
2022-09-23,Sierra,091,2930,304,303,60,363,5
2022-09-23,Siskiyou,093,43540,5131,5243,3300,8543,90
2022-09-23,Solano,095,438530,104891,104383,7885,112268,463
2022-09-23,Sonoma,097,501317,106651,106322,5259,111581,519
2022-09-23,Stanislaus,099,539301,137740,137340,21571,158911,1752
2022-09-23,Sutter,101,95872,24223,24198,2459,26657,232
2022-09-23,Tehama,103,63373,13608,13528,3070,16598,210
2022-09-23,Trinity,105,12862,1397,1390,388,1778,20
2022-09-23,Tulare,107,460477,121706,121446,36222,157668,1530
2022-09-23,Tuolumne,109,53932,15549,15469,922,16391,196
2022-09-23,Ventura,111,848112,208298,207684,15670,223354,1566
2022-09-23,Yolo,113,214977,47289,47147,4294,51441,335
2022-09-23,Yuba,115,75493,18867,18834,1711,20545,129
2022-09-22,Alameda,001,1643700,346784,345351,19603,364954,2012
2022-09-22,Alpine,003,1148,134,134,1,135,0
2022-09-22,Amador,005,37829,9975,9954,923,10877,90
2022-09-22,Butte,007,227075,39446,39282,9087,48369,453
2022-09-22,Calaveras,009,45235,8488,8475,544,9019,133
2022-09-22,Colusa,011,21464,3790,3775,1271,5046,22
2022-09-22,Contra Costa,013,1133247,250760,248053,20685,268738,1424
2022-09-22,Del Norte,015,27424,7412,7403,398,7801,57
2022-09-22,El Dorado,017,186661,32207,32159,4246,36405,231
2022-09-22,Fresno,019,978130,276851,273381,31467,304848,2850
2022-09-22,Glenn,021,27897,5517,5494,1863,7357,48
2022-09-22,Humboldt,023,135768,21758,21641,4976,26617,156
2022-09-22,Imperial,025,180216,65398,65297,15699,80996,957
2022-09-22,Inyo,027,18085,4486,4481,979,5460,59
2022-09-22,Kern,029,883053,219010,218413,63587,282000,2408
2022-09-22,Kings,031,150075,59356,59288,4095,63383,456
2022-09-22,Lake,033,64148,12785,12731,1181,13912,146
2022-09-22,Lassen,035,31185,9957,9947,992,10939,65
2022-09-22,Los Angeles,037,10098052,3274465,3263510,180390,3443900,33258
2022-09-22,Madera,039,155013,43982,43910,8238,52148,374
2022-09-22,Marin,041,260295,45031,44823,5254,50077,310
2022-09-22,Mariposa,043,17540,3098,3074,343,3417,31
2022-09-22,Mendocino,045,87422,15992,15911,4463,20374,136
2022-09-22,Merced,047,269075,72497,71875,11833,83708,862
2022-09-22,Modoc,049,8938,874,872,322,1194,11
2022-09-22,Mono,051,14174,3204,3198,253,3451,7
2022-09-22,Monterey,053,433212,94059,93829,20976,114805,766
2022-09-22,Napa,055,140530,32100,32094,1401,33495,160
2022-09-22,Nevada,057,99092,18951,18861,1822,20683,132
2022-09-22,Orange,059,3164182,666103,664263,62766,727029,7425
2022-09-22,Placer,061,380077,75641,75381,9487,84868,660
2022-09-22,Plumas,063,18699,3648,3632,432,4064,13
2022-09-22,Riverside,065,2383286,694421,693038,35224,728262,6610
2022-09-22,Sacramento,067,1510023,345946,344748,33957,378705,3282
2022-09-22,San Benito,069,59416,16276,16114,961,17075,106
2022-09-22,San Bernardino,071,2135413,670099,667124,30803,697927,8097
2022-09-22,San Diego,073,3302833,921753,920118,71844,991962,5487
2022-09-22,San Francisco,075,870044,178545,176887,12064,188951,1031
2022-09-22,San Joaquin,077,732212,197500,196573,14877,211450,2306
2022-09-22,San Luis Obispo,079,281455,63155,62950,7103,70053,522
2022-09-22,San Mateo,081,765935,168300,167123,10434,177557,736
2022-09-22,Santa Barbara,083,443738,105527,105185,6845,112030,720
2022-09-22,Santa Clara,085,1922200,434898,429334,18954,448288,2486
2022-09-22,Santa Cruz,087,273765,62871,62704,3430,66134,274
2022-09-22,Shasta,089,179085,34881,34762,7416,42178,592
2022-09-22,Sierra,091,2930,304,303,60,363,5
2022-09-22,Siskiyou,093,43540,5130,5243,3299,8542,90
2022-09-22,Solano,095,438530,104831,104383,7880,112263,463
2022-09-22,Sonoma,097,501317,106615,106322,5258,111580,519
2022-09-22,Stanislaus,099,539301,137705,137340,21568,158908,1752
2022-09-22,Sutter,101,95872,24212,24198,2459,26657,232
2022-09-22,Tehama,103,63373,13602,13528,3068,16596,210
2022-09-22,Trinity,105,12862,1395,1390,388,1778,20
2022-09-22,Tulare,107,460477,121688,121446,36206,157652,1530
2022-09-22,Tuolumne,109,53932,15542,15469,921,16390,196
2022-09-22,Ventura,111,848112,208212,207684,15663,223347,1566
2022-09-22,Yolo,113,214977,47275,47147,4288,51435,335
2022-09-22,Yuba,115,75493,18859,18834,1708,20542,129
2022-09-21,Alameda,001,1643700,346616,345351,19590,364941,2012
2022-09-21,Alpine,003,1148,134,134,1,135,0
2022-09-21,Amador,005,37829,9974,9954,923,10877,90
2022-09-21,Butte,007,227075,39433,39282,9078,48360,453
2022-09-21,Calaveras,009,45235,8485,8475,543,9018,133
2022-09-21,Colusa,011,21464,3790,3775,1271,5046,22
2022-09-21,Contra Costa,013,1133247,250642,248053,20676,268729,1424
2022-09-21,Del Norte,015,27424,7410,7403,398,7801,57
2022-09-21,El Dorado,017,186661,32195,32159,4243,36402,231
2022-09-21,Fresno,019,978130,276774,273381,31455,304836,2850
2022-09-21,Glenn,021,27897,5516,5494,1862,7356,48
2022-09-21,Humboldt,023,135768,21741,21641,4974,26615,156
2022-09-21,Imperial,025,180216,65382,65297,15689,80986,957
2022-09-21,Inyo,027,18085,4486,4481,976,5457,59
2022-09-21,Kern,029,883053,218956,218413,63541,281954,2408
2022-09-21,Kings,031,150075,59340,59288,4095,63383,456
2022-09-21,Lake,033,64148,12778,12731,1180,13911,146
2022-09-21,Lassen,035,31185,9957,9947,992,10939,65
2022-09-21,Los Angeles,037,10098052,3273302,3263510,180221,3443731,33258
2022-09-21,Madera,039,155013,43967,43910,8238,52148,374
2022-09-21,Marin,041,260295,45007,44823,5254,50077,310
2022-09-21,Mariposa,043,17540,3098,3074,343,3417,31
2022-09-21,Mendocino,045,87422,15984,15911,4462,20373,136
2022-09-21,Merced,047,269075,72480,71875,11833,83708,862
2022-09-21,Modoc,049,8938,874,872,322,1194,11
2022-09-21,Mono,051,14174,3204,3198,253,3451,7
2022-09-21,Monterey,053,433212,94038,93829,20967,114796,766
2022-09-21,Napa,055,140530,32093,32094,1401,33495,160
2022-09-21,Nevada,057,99092,18941,18861,1822,20683,132
2022-09-21,Orange,059,3164182,665853,664263,62711,726974,7425
2022-09-21,Placer,061,380077,75607,75381,9483,84864,660
2022-09-21,Plumas,063,18699,3646,3632,432,4064,13
2022-09-21,Riverside,065,2383286,694238,693038,35206,728244,6610
2022-09-21,Sacramento,067,1510023,345792,344748,33941,378689,3282
2022-09-21,San Benito,069,59416,16263,16114,959,17073,106
2022-09-21,San Bernardino,071,2135413,669948,667124,30797,697921,8097
2022-09-21,San Diego,073,3302833,921373,920118,71797,991915,5487
2022-09-21,San Francisco,075,870044,178445,176887,12055,188942,1031
2022-09-21,San Joaquin,077,732212,197445,196573,14871,211444,2306
2022-09-21,San Luis Obispo,079,281455,63137,62950,7096,70046,522
2022-09-21,San Mateo,081,765935,168223,167123,10433,177556,736
2022-09-21,Santa Barbara,083,443738,105481,105185,6843,112028,720
2022-09-21,Santa Clara,085,1922200,434710,429334,18946,448280,2486
2022-09-21,Santa Cruz,087,273765,62824,62704,3426,66130,274
2022-09-21,Shasta,089,179085,34875,34762,7411,42173,592
2022-09-21,Sierra,091,2930,303,303,60,363,5
2022-09-21,Siskiyou,093,43540,5127,5243,3298,8541,90
2022-09-21,Solano,095,438530,104787,104383,7877,112260,463
2022-09-21,Sonoma,097,501317,106581,106322,5252,111574,519
2022-09-21,Stanislaus,099,539301,137670,137340,21558,158898,1752
2022-09-21,Sutter,101,95872,24203,24198,2459,26657,232
2022-09-21,Tehama,103,63373,13596,13528,3068,16596,210
2022-09-21,Trinity,105,12862,1395,1390,388,1778,20
2022-09-21,Tulare,107,460477,121659,121446,36189,157635,1530
2022-09-21,Tuolumne,109,53932,15537,15469,918,16387,196
2022-09-21,Ventura,111,848112,208137,207684,15656,223340,1566
2022-09-21,Yolo,113,214977,47255,47147,4282,51429,335
2022-09-21,Yuba,115,75493,18851,18834,1708,20542,129
2022-09-20,Alameda,001,1643700,346461,345351,19577,364928,2012
2022-09-20,Alpine,003,1148,134,134,1,135,0
2022-09-20,Amador,005,37829,9966,9954,923,10877,90
2022-09-20,Butte,007,227075,39418,39282,9068,48350,453
2022-09-20,Calaveras,009,45235,8483,8475,543,9018,133
2022-09-20,Colusa,011,21464,3790,3775,1271,5046,22
2022-09-20,Contra Costa,013,1133247,250515,248053,20663,268716,1424
2022-09-20,Del Norte,015,27424,7405,7403,398,7801,57
2022-09-20,El Dorado,017,186661,32181,32159,4239,36398,231
2022-09-20,Fresno,019,978130,276698,273381,31441,304822,2850
2022-09-20,Glenn,021,27897,5515,5494,1861,7355,48
2022-09-20,Humboldt,023,135768,21728,21641,4971,26612,156
2022-09-20,Imperial,025,180216,65360,65297,15678,80975,957
2022-09-20,Inyo,027,18085,4485,4481,973,5454,59
2022-09-20,Kern,029,883053,218902,218413,63499,281912,2408
2022-09-20,Kings,031,150075,59317,59288,4094,63382,456
2022-09-20,Lake,033,64148,12775,12731,1180,13911,146
2022-09-20,Lassen,035,31185,9954,9947,992,10939,65
2022-09-20,Los Angeles,037,10098052,3272141,3263510,180074,3443584,33258
2022-09-20,Madera,039,155013,43958,43910,8233,52143,374
2022-09-20,Marin,041,260295,44982,44823,5249,50072,310
2022-09-20,Mariposa,043,17540,3098,3074,343,3417,31
2022-09-20,Mendocino,045,87422,15979,15911,4460,20371,136
2022-09-20,Merced,047,269075,72454,71875,11831,83706,862
2022-09-20,Modoc,049,8938,874,872,322,1194,11
2022-09-20,Mono,051,14174,3204,3198,253,3451,7
2022-09-20,Monterey,053,433212,94019,93829,20958,114787,766
2022-09-20,Napa,055,140530,32084,32094,1400,33494,160
2022-09-20,Nevada,057,99092,18936,18861,1822,20683,132
2022-09-20,Orange,059,3164182,665571,664263,62666,726929,7425
2022-09-20,Placer,061,380077,75578,75381,9478,84859,660
2022-09-20,Plumas,063,18699,3644,3632,432,4064,13
2022-09-20,Riverside,065,2383286,694035,693038,35178,728216,6610
2022-09-20,Sacramento,067,1510023,345639,344748,33918,378666,3282
2022-09-20,San Benito,069,59416,16256,16114,959,17073,106
2022-09-20,San Bernardino,071,2135413,669736,667124,30782,697906,8097
2022-09-20,San Diego,073,3302833,920962,920118,71741,991859,5487
2022-09-20,San Francisco,075,870044,178341,176887,12049,188936,1031
2022-09-20,San Joaquin,077,732212,197384,196573,14866,211439,2306
2022-09-20,San Luis Obispo,079,281455,63120,62950,7088,70038,522
2022-09-20,San Mateo,081,765935,168139,167123,10429,177552,736
2022-09-20,Santa Barbara,083,443738,105445,105185,6838,112023,720
2022-09-20,Santa Clara,085,1922200,434507,429334,18933,448267,2486
2022-09-20,Santa Cruz,087,273765,62802,62704,3421,66125,274
2022-09-20,Shasta,089,179085,34864,34762,7407,42169,592
2022-09-20,Sierra,091,2930,303,303,60,363,5
2022-09-20,Siskiyou,093,43540,5123,5243,3298,8541,90
2022-09-20,Solano,095,438530,104741,104383,7870,112253,463
2022-09-20,Sonoma,097,501317,106528,106322,5251,111573,519
2022-09-20,Stanislaus,099,539301,137624,137340,21553,158893,1752
2022-09-20,Sutter,101,95872,24199,24198,2459,26657,232
2022-09-20,Tehama,103,63373,13594,13528,3068,16596,210
2022-09-20,Trinity,105,12862,1395,1390,388,1778,20
2022-09-20,Tulare,107,460477,121637,121446,36167,157613,1530
2022-09-20,Tuolumne,109,53932,15531,15469,917,16386,196
2022-09-20,Ventura,111,848112,208055,207684,15651,223335,1566
2022-09-20,Yolo,113,214977,47234,47147,4278,51425,335
2022-09-20,Yuba,115,75493,18847,18834,1708,20542,129
2022-09-19,Alameda,001,1643700,346292,344045,19561,363606,2007
2022-09-19,Alpine,003,1148,134,134,1,135,0
2022-09-19,Amador,005,37829,9962,9908,923,10831,90
2022-09-19,Butte,007,227075,39405,39155,9060,48215,453
2022-09-19,Calaveras,009,45235,8478,8455,542,8997,133
2022-09-19,Colusa,011,21464,3788,3765,1271,5036,22
2022-09-19,Contra Costa,013,1133247,250419,247095,20639,267734,1423
2022-09-19,Del Norte,015,27424,7402,7381,398,7779,56
2022-09-19,El Dorado,017,186661,32172,32088,4235,36323,231
2022-09-19,Fresno,019,978130,276611,272774,31433,304207,2839
2022-09-19,Glenn,021,27897,5514,5481,1860,7341,48
2022-09-19,Humboldt,023,135768,21715,21561,4966,26527,155
2022-09-19,Imperial,025,180216,65341,65099,15664,80763,956
2022-09-19,Inyo,027,18085,4484,4472,971,5443,59
2022-09-19,Kern,029,883053,218839,217694,63439,281133,2405
2022-09-19,Kings,031,150075,59303,59122,4094,63216,456
2022-09-19,Lake,033,64148,12769,12696,1180,13876,144
2022-09-19,Lassen,035,31185,9949,9938,992,10930,65
2022-09-19,Los Angeles,037,10098052,3270764,3253906,179892,3433798,33160
2022-09-19,Madera,039,155013,43932,43782,8228,52010,373
2022-09-19,Marin,041,260295,44952,44702,5245,49947,309
2022-09-19,Mariposa,043,17540,3098,3064,343,3407,31
2022-09-19,Mendocino,045,87422,15972,15872,4458,20330,136
2022-09-19,Merced,047,269075,72439,71732,11827,83559,862
2022-09-19,Modoc,049,8938,874,872,322,1194,11
2022-09-19,Mono,051,14174,3204,3191,253,3444,7
2022-09-19,Monterey,053,433212,93985,93692,20945,114637,762
2022-09-19,Napa,055,140530,32069,31979,1399,33378,160
2022-09-19,Nevada,057,99092,18930,18824,1820,20644,132
2022-09-19,Orange,059,3164182,665288,662784,62611,725395,7398
2022-09-19,Placer,061,380077,75556,75159,9476,84635,660
2022-09-19,Plumas,063,18699,3642,3609,432,4041,13
2022-09-19,Riverside,065,2383286,693799,691630,35165,726795,6608
2022-09-19,Sacramento,067,1510023,345490,343926,33898,377824,3267
2022-09-19,San Benito,069,59416,16246,16057,959,17016,106
2022-09-19,San Bernardino,071,2135413,669516,664360,30764,695124,8074
2022-09-19,San Diego,073,3302833,920535,917229,71653,988882,5479
2022-09-19,San Francisco,075,870044,178247,176724,12041,188765,1025
2022-09-19,San Joaquin,077,732212,197291,196128,14859,210987,2304
2022-09-19,San Luis Obispo,079,281455,63098,62716,7082,69798,520
2022-09-19,San Mateo,081,765935,168040,166572,10423,176995,735
2022-09-19,Santa Barbara,083,443738,105403,104912,6833,111745,718
2022-09-19,Santa Clara,085,1922200,434276,428065,18917,446982,2473
2022-09-19,Santa Cruz,087,273765,62772,62480,3415,65895,274
2022-09-19,Shasta,089,179085,34845,34648,7400,42048,591
2022-09-19,Sierra,091,2930,303,303,60,363,5
2022-09-19,Siskiyou,093,43540,5120,5226,3296,8522,90
2022-09-19,Solano,095,438530,104696,104085,7867,111952,462
2022-09-19,Sonoma,097,501317,106471,106028,5251,111279,518
2022-09-19,Stanislaus,099,539301,137578,136981,21542,158523,1727
2022-09-19,Sutter,101,95872,24185,24119,2459,26578,232
2022-09-19,Tehama,103,63373,13589,13503,3067,16570,210
2022-09-19,Trinity,105,12862,1395,1385,388,1773,20
2022-09-19,Tulare,107,460477,121608,121230,36148,157378,1531
2022-09-19,Tuolumne,109,53932,15525,15411,917,16328,196
2022-09-19,Ventura,111,848112,207959,207049,15647,222696,1563
2022-09-19,Yolo,113,214977,47219,47085,4276,51361,334
2022-09-19,Yuba,115,75493,18837,18764,1701,20465,129
2022-09-18,Alameda,001,1643700,346089,344045,19546,363591,2007
2022-09-18,Alpine,003,1148,134,134,1,135,0
2022-09-18,Amador,005,37829,9956,9908,923,10831,90
2022-09-18,Butte,007,227075,39387,39155,9049,48204,453
2022-09-18,Calaveras,009,45235,8472,8455,539,8994,133
2022-09-18,Colusa,011,21464,3787,3765,1271,5036,22
2022-09-18,Contra Costa,013,1133247,250266,247095,20628,267723,1423
2022-09-18,Del Norte,015,27424,7396,7381,398,7779,56
2022-09-18,El Dorado,017,186661,32158,32088,4232,36320,231
2022-09-18,Fresno,019,978130,276513,272774,31410,304184,2839
2022-09-18,Glenn,021,27897,5509,5481,1860,7341,48
2022-09-18,Humboldt,023,135768,21701,21561,4958,26519,155
2022-09-18,Imperial,025,180216,65322,65099,15642,80741,956
2022-09-18,Inyo,027,18085,4482,4472,970,5442,59
2022-09-18,Kern,029,883053,218766,217694,63365,281059,2405
2022-09-18,Kings,031,150075,59285,59122,4090,63212,456
2022-09-18,Lake,033,64148,12763,12696,1177,13873,144
2022-09-18,Lassen,035,31185,9945,9938,992,10930,65
2022-09-18,Los Angeles,037,10098052,3269217,3253906,179727,3433633,33160
2022-09-18,Madera,039,155013,43908,43782,8225,52007,373
2022-09-18,Marin,041,260295,44929,44702,5241,49943,309
2022-09-18,Mariposa,043,17540,3097,3064,343,3407,31
2022-09-18,Mendocino,045,87422,15968,15872,4453,20325,136
2022-09-18,Merced,047,269075,72411,71732,11820,83552,862
2022-09-18,Modoc,049,8938,873,872,322,1194,11
2022-09-18,Mono,051,14174,3204,3191,252,3443,7
2022-09-18,Monterey,053,433212,93956,93692,20929,114621,762
2022-09-18,Napa,055,140530,32053,31979,1399,33378,160
2022-09-18,Nevada,057,99092,18917,18824,1819,20643,132
2022-09-18,Orange,059,3164182,665002,662784,62529,725313,7398
2022-09-18,Placer,061,380077,75520,75159,9467,84626,660
2022-09-18,Plumas,063,18699,3636,3609,432,4041,13
2022-09-18,Riverside,065,2383286,693562,691630,35138,726768,6608
2022-09-18,Sacramento,067,1510023,345305,343926,33866,377792,3267
2022-09-18,San Benito,069,59416,16240,16057,956,17013,106
2022-09-18,San Bernardino,071,2135413,669279,664360,30744,695104,8074
2022-09-18,San Diego,073,3302833,920056,917229,71602,988831,5479
2022-09-18,San Francisco,075,870044,178107,176724,12036,188760,1025
2022-09-18,San Joaquin,077,732212,197211,196128,14853,210981,2304
2022-09-18,San Luis Obispo,079,281455,63078,62716,7073,69789,520
2022-09-18,San Mateo,081,765935,167936,166572,10414,176986,735
2022-09-18,Santa Barbara,083,443738,105357,104912,6829,111741,718
2022-09-18,Santa Clara,085,1922200,434030,428065,18895,446960,2473
2022-09-18,Santa Cruz,087,273765,62742,62480,3410,65890,274
2022-09-18,Shasta,089,179085,34826,34648,7387,42035,591
2022-09-18,Sierra,091,2930,303,303,60,363,5
2022-09-18,Siskiyou,093,43540,5117,5226,3294,8520,90
2022-09-18,Solano,095,438530,104642,104085,7856,111941,462
2022-09-18,Sonoma,097,501317,106415,106028,5248,111276,518
2022-09-18,Stanislaus,099,539301,137525,136981,21530,158511,1727
2022-09-18,Sutter,101,95872,24172,24119,2459,26578,232
2022-09-18,Tehama,103,63373,13579,13503,3065,16568,210
2022-09-18,Trinity,105,12862,1395,1385,384,1769,20
2022-09-18,Tulare,107,460477,121558,121230,36118,157348,1531
2022-09-18,Tuolumne,109,53932,15515,15411,916,16327,196
2022-09-18,Ventura,111,848112,207848,207049,15634,222683,1563
2022-09-18,Yolo,113,214977,47206,47085,4273,51358,334
2022-09-18,Yuba,115,75493,18827,18764,1701,20465,129
2022-09-17,Alameda,001,1643700,345970,344045,19542,363587,2007
2022-09-17,Alpine,003,1148,134,134,1,135,0
2022-09-17,Amador,005,37829,9954,9908,923,10831,90
2022-09-17,Butte,007,227075,39376,39155,9044,48199,453
2022-09-17,Calaveras,009,45235,8468,8455,537,8992,133
2022-09-17,Colusa,011,21464,3783,3765,1271,5036,22
2022-09-17,Contra Costa,013,1133247,250180,247095,20625,267720,1423
2022-09-17,Del Norte,015,27424,7394,7381,398,7779,56
2022-09-17,El Dorado,017,186661,32152,32088,4232,36320,231
2022-09-17,Fresno,019,978130,276467,272774,31400,304174,2839
2022-09-17,Glenn,021,27897,5505,5481,1858,7339,48
2022-09-17,Humboldt,023,135768,21693,21561,4952,26513,155
2022-09-17,Imperial,025,180216,65301,65099,15634,80733,956
2022-09-17,Inyo,027,18085,4482,4472,968,5440,59
2022-09-17,Kern,029,883053,218729,217694,63322,281016,2405
2022-09-17,Kings,031,150075,59274,59122,4088,63210,456
2022-09-17,Lake,033,64148,12762,12696,1177,13873,144
2022-09-17,Lassen,035,31185,9945,9938,992,10930,65
2022-09-17,Los Angeles,037,10098052,3268389,3253906,179581,3433487,33160
2022-09-17,Madera,039,155013,43901,43782,8225,52007,373
2022-09-17,Marin,041,260295,44913,44702,5237,49939,309
2022-09-17,Mariposa,043,17540,3096,3064,343,3407,31
2022-09-17,Mendocino,045,87422,15966,15872,4453,20325,136
2022-09-17,Merced,047,269075,72397,71732,11816,83548,862
2022-09-17,Modoc,049,8938,873,872,322,1194,11
2022-09-17,Mono,051,14174,3204,3191,252,3443,7
2022-09-17,Monterey,053,433212,93943,93692,20920,114612,762
2022-09-17,Napa,055,140530,32047,31979,1398,33377,160
2022-09-17,Nevada,057,99092,18908,18824,1817,20641,132
2022-09-17,Orange,059,3164182,664829,662784,62489,725273,7398
2022-09-17,Placer,061,380077,75485,75159,9461,84620,660
2022-09-17,Plumas,063,18699,3634,3609,432,4041,13
2022-09-17,Riverside,065,2383286,693419,691630,35120,726750,6608
2022-09-17,Sacramento,067,1510023,345228,343926,33846,377772,3267
2022-09-17,San Benito,069,59416,16235,16057,955,17012,106
2022-09-17,San Bernardino,071,2135413,669148,664360,30733,695093,8074
2022-09-17,San Diego,073,3302833,919878,917229,71581,988810,5479
2022-09-17,San Francisco,075,870044,178046,176724,12032,188756,1025
2022-09-17,San Joaquin,077,732212,197186,196128,14850,210978,2304
2022-09-17,San Luis Obispo,079,281455,63067,62716,7073,69789,520
2022-09-17,San Mateo,081,765935,167871,166572,10406,176978,735
2022-09-17,Santa Barbara,083,443738,105327,104912,6828,111740,718
2022-09-17,Santa Clara,085,1922200,433889,428065,18888,446953,2473
2022-09-17,Santa Cruz,087,273765,62734,62480,3410,65890,274
2022-09-17,Shasta,089,179085,34815,34648,7382,42030,591
2022-09-17,Sierra,091,2930,303,303,60,363,5
2022-09-17,Siskiyou,093,43540,5116,5226,3293,8519,90
2022-09-17,Solano,095,438530,104631,104085,7853,111938,462
2022-09-17,Sonoma,097,501317,106380,106028,5247,111275,518
2022-09-17,Stanislaus,099,539301,137500,136981,21524,158505,1727
2022-09-17,Sutter,101,95872,24166,24119,2459,26578,232
2022-09-17,Tehama,103,63373,13577,13503,3064,16567,210
2022-09-17,Trinity,105,12862,1395,1385,384,1769,20
2022-09-17,Tulare,107,460477,121540,121230,36106,157336,1531
2022-09-17,Tuolumne,109,53932,15509,15411,916,16327,196
2022-09-17,Ventura,111,848112,207802,207049,15625,222674,1563
2022-09-17,Yolo,113,214977,47196,47085,4268,51353,334
2022-09-17,Yuba,115,75493,18824,18764,1701,20465,129
2022-09-16,Alameda,001,1643700,345835,344045,19529,363574,2007
2022-09-16,Alpine,003,1148,134,134,1,135,0
2022-09-16,Amador,005,37829,9952,9908,923,10831,90
2022-09-16,Butte,007,227075,39360,39155,9041,48196,453
2022-09-16,Calaveras,009,45235,8465,8455,537,8992,133
2022-09-16,Colusa,011,21464,3782,3765,1271,5036,22
2022-09-16,Contra Costa,013,1133247,250095,247095,20618,267713,1423
2022-09-16,Del Norte,015,27424,7393,7381,398,7779,56
2022-09-16,El Dorado,017,186661,32145,32088,4230,36318,231
2022-09-16,Fresno,019,978130,276428,272774,31392,304166,2839
2022-09-16,Glenn,021,27897,5505,5481,1858,7339,48
2022-09-16,Humboldt,023,135768,21683,21561,4952,26513,155
2022-09-16,Imperial,025,180216,65288,65099,15629,80728,956
2022-09-16,Inyo,027,18085,4482,4472,966,5438,59
2022-09-16,Kern,029,883053,218687,217694,63300,280994,2405
2022-09-16,Kings,031,150075,59259,59122,4088,63210,456
2022-09-16,Lake,033,64148,12758,12696,1177,13873,144
2022-09-16,Lassen,035,31185,9944,9938,991,10929,65
2022-09-16,Los Angeles,037,10098052,3267496,3253906,179478,3433384,33160
2022-09-16,Madera,039,155013,43887,43782,8225,52007,373
2022-09-16,Marin,041,260295,44891,44702,5234,49936,309
2022-09-16,Mariposa,043,17540,3095,3064,343,3407,31
2022-09-16,Mendocino,045,87422,15961,15872,4452,20324,136
2022-09-16,Merced,047,269075,72382,71732,11814,83546,862
2022-09-16,Modoc,049,8938,873,872,322,1194,11
2022-09-16,Mono,051,14174,3204,3191,252,3443,7
2022-09-16,Monterey,053,433212,93926,93692,20917,114609,762
2022-09-16,Napa,055,140530,32037,31979,1397,33376,160
2022-09-16,Nevada,057,99092,18903,18824,1817,20641,132
2022-09-16,Orange,059,3164182,664668,662784,62432,725216,7398
2022-09-16,Placer,061,380077,75467,75159,9456,84615,660
2022-09-16,Plumas,063,18699,3632,3609,432,4041,13
2022-09-16,Riverside,065,2383286,693301,691630,35102,726732,6608
2022-09-16,Sacramento,067,1510023,345133,343926,33838,377764,3267
2022-09-16,San Benito,069,59416,16228,16057,955,17012,106
2022-09-16,San Bernardino,071,2135413,669002,664360,30724,695084,8074
2022-09-16,San Diego,073,3302833,919598,917229,71554,988783,5479
2022-09-16,San Francisco,075,870044,177987,176724,12026,188750,1025
2022-09-16,San Joaquin,077,732212,197150,196128,14846,210974,2304
2022-09-16,San Luis Obispo,079,281455,63051,62716,7072,69788,520
2022-09-16,San Mateo,081,765935,167802,166572,10402,176974,735
2022-09-16,Santa Barbara,083,443738,105302,104912,6826,111738,718
2022-09-16,Santa Clara,085,1922200,433751,428065,18878,446943,2473
2022-09-16,Santa Cruz,087,273765,62713,62480,3410,65890,274
2022-09-16,Shasta,089,179085,34809,34648,7378,42026,591
2022-09-16,Sierra,091,2930,303,303,60,363,5
2022-09-16,Siskiyou,093,43540,5114,5226,3293,8519,90
2022-09-16,Solano,095,438530,104607,104085,7850,111935,462
2022-09-16,Sonoma,097,501317,106349,106028,5247,111275,518
2022-09-16,Stanislaus,099,539301,137462,136981,21521,158502,1727
2022-09-16,Sutter,101,95872,24153,24119,2459,26578,232
2022-09-16,Tehama,103,63373,13575,13503,3063,16566,210
2022-09-16,Trinity,105,12862,1395,1385,384,1769,20
2022-09-16,Tulare,107,460477,121514,121230,36088,157318,1531
2022-09-16,Tuolumne,109,53932,15498,15411,916,16327,196
2022-09-16,Ventura,111,848112,207733,207049,15614,222663,1563
2022-09-16,Yolo,113,214977,47185,47085,4263,51348,334
2022-09-16,Yuba,115,75493,18815,18764,1701,20465,129
2022-09-15,Alameda,001,1643700,345661,344045,19516,363561,2007
2022-09-15,Alpine,003,1148,134,134,1,135,0
2022-09-15,Amador,005,37829,9948,9908,923,10831,90
2022-09-15,Butte,007,227075,39350,39155,9036,48191,453
2022-09-15,Calaveras,009,45235,8463,8455,534,8989,133
2022-09-15,Colusa,011,21464,3781,3765,1271,5036,22
2022-09-15,Contra Costa,013,1133247,249963,247095,20600,267695,1423
2022-09-15,Del Norte,015,27424,7390,7381,398,7779,56
2022-09-15,El Dorado,017,186661,32136,32088,4228,36316,231
2022-09-15,Fresno,019,978130,276324,272774,31383,304157,2839
2022-09-15,Glenn,021,27897,5505,5481,1857,7338,48
2022-09-15,Humboldt,023,135768,21666,21561,4944,26505,155
2022-09-15,Imperial,025,180216,65264,65099,15614,80713,956
2022-09-15,Inyo,027,18085,4482,4472,963,5435,59
2022-09-15,Kern,029,883053,218629,217694,63245,280939,2405
2022-09-15,Kings,031,150075,59242,59122,4088,63210,456
2022-09-15,Lake,033,64148,12755,12696,1176,13872,144
2022-09-15,Lassen,035,31185,9943,9938,991,10929,65
2022-09-15,Los Angeles,037,10098052,3266336,3253906,179317,3433223,33160
2022-09-15,Madera,039,155013,43876,43782,8222,52004,373
2022-09-15,Marin,041,260295,44873,44702,5231,49933,309
2022-09-15,Mariposa,043,17540,3094,3064,342,3406,31
2022-09-15,Mendocino,045,87422,15950,15872,4450,20322,136
2022-09-15,Merced,047,269075,72360,71732,11810,83542,862
2022-09-15,Modoc,049,8938,873,872,321,1193,11
2022-09-15,Mono,051,14174,3204,3191,250,3441,7
2022-09-15,Monterey,053,433212,93905,93692,20907,114599,762
2022-09-15,Napa,055,140530,32024,31979,1397,33376,160
2022-09-15,Nevada,057,99092,18895,18824,1814,20638,132
2022-09-15,Orange,059,3164182,664439,662784,62357,725141,7398
2022-09-15,Placer,061,380077,75430,75159,9451,84610,660
2022-09-15,Plumas,063,18699,3632,3609,432,4041,13
2022-09-15,Riverside,065,2383286,693129,691630,35085,726715,6608
2022-09-15,Sacramento,067,1510023,344980,343926,33808,377734,3267
2022-09-15,San Benito,069,59416,16222,16057,955,17012,106
2022-09-15,San Bernardino,071,2135413,668807,664360,30708,695068,8074
2022-09-15,San Diego,073,3302833,919239,917229,71514,988743,5479
2022-09-15,San Francisco,075,870044,177880,176724,12019,188743,1025
2022-09-15,San Joaquin,077,732212,197082,196128,14833,210961,2304
2022-09-15,San Luis Obispo,079,281455,63027,62716,7069,69785,520
2022-09-15,San Mateo,081,765935,167711,166572,10393,176965,735
2022-09-15,Santa Barbara,083,443738,105262,104912,6820,111732,718
2022-09-15,Santa Clara,085,1922200,433544,428065,18863,446928,2473
2022-09-15,Santa Cruz,087,273765,62691,62480,3406,65886,274
2022-09-15,Shasta,089,179085,34803,34648,7370,42018,591
2022-09-15,Sierra,091,2930,303,303,60,363,5
2022-09-15,Siskiyou,093,43540,5110,5226,3290,8516,90
2022-09-15,Solano,095,438530,104565,104085,7844,111929,462
2022-09-15,Sonoma,097,501317,106312,106028,5245,111273,518
2022-09-15,Stanislaus,099,539301,137419,136981,21517,158498,1727
2022-09-15,Sutter,101,95872,24145,24119,2459,26578,232
2022-09-15,Tehama,103,63373,13570,13503,3061,16564,210
2022-09-15,Trinity,105,12862,1394,1385,383,1768,20
2022-09-15,Tulare,107,460477,121487,121230,36068,157298,1531
2022-09-15,Tuolumne,109,53932,15489,15411,916,16327,196
2022-09-15,Ventura,111,848112,207638,207049,15600,222649,1563
2022-09-15,Yolo,113,214977,47172,47085,4261,51346,334
2022-09-15,Yuba,115,75493,18807,18764,1699,20463,129
2022-09-14,Alameda,001,1643700,345478,344045,19504,363549,2007
2022-09-14,Alpine,003,1148,134,134,1,135,0
2022-09-14,Amador,005,37829,9942,9908,923,10831,90
2022-09-14,Butte,007,227075,39331,39155,9029,48184,453
2022-09-14,Calaveras,009,45235,8457,8455,532,8987,133
2022-09-14,Colusa,011,21464,3778,3765,1271,5036,22
2022-09-14,Contra Costa,013,1133247,249853,247095,20585,267680,1423
2022-09-14,Del Norte,015,27424,7387,7381,398,7779,56
2022-09-14,El Dorado,017,186661,32124,32088,4222,36310,231
2022-09-14,Fresno,019,978130,276230,272774,31367,304141,2839
2022-09-14,Glenn,021,27897,5505,5481,1854,7335,48
2022-09-14,Humboldt,023,135768,21644,21561,4941,26502,155
2022-09-14,Imperial,025,180216,65238,65099,15597,80696,956
2022-09-14,Inyo,027,18085,4480,4472,961,5433,59
2022-09-14,Kern,029,883053,218568,217694,63188,280882,2405
2022-09-14,Kings,031,150075,59220,59122,4084,63206,456
2022-09-14,Lake,033,64148,12747,12696,1175,13871,144
2022-09-14,Lassen,035,31185,9943,9938,989,10927,65
2022-09-14,Los Angeles,037,10098052,3265089,3253906,179171,3433077,33160
2022-09-14,Madera,039,155013,43846,43782,8217,51999,373
2022-09-14,Marin,041,260295,44851,44702,5223,49925,309
2022-09-14,Mariposa,043,17540,3093,3064,342,3406,31
2022-09-14,Mendocino,045,87422,15945,15872,4449,20321,136
2022-09-14,Merced,047,269075,72332,71732,11800,83532,862
2022-09-14,Modoc,049,8938,872,872,320,1192,11
2022-09-14,Mono,051,14174,3204,3191,249,3440,7
2022-09-14,Monterey,053,433212,93886,93692,20899,114591,762
2022-09-14,Napa,055,140530,32011,31979,1393,33372,160
2022-09-14,Nevada,057,99092,18884,18824,1812,20636,132
2022-09-14,Orange,059,3164182,664154,662784,62305,725089,7398
2022-09-14,Placer,061,380077,75399,75159,9448,84607,660
2022-09-14,Plumas,063,18699,3626,3609,432,4041,13
2022-09-14,Riverside,065,2383286,692895,691630,35056,726686,6608
2022-09-14,Sacramento,067,1510023,344824,343926,33768,377694,3267
2022-09-14,San Benito,069,59416,16214,16057,955,17012,106
2022-09-14,San Bernardino,071,2135413,668613,664360,30692,695052,8074
2022-09-14,San Diego,073,3302833,918859,917229,71466,988695,5479
2022-09-14,San Francisco,075,870044,177781,176724,12012,188736,1025
2022-09-14,San Joaquin,077,732212,197013,196128,14821,210949,2304
2022-09-14,San Luis Obispo,079,281455,63003,62716,7064,69780,520
2022-09-14,San Mateo,081,765935,167633,166572,10388,176960,735
2022-09-14,Santa Barbara,083,443738,105227,104912,6818,111730,718
2022-09-14,Santa Clara,085,1922200,433349,428065,18852,446917,2473
2022-09-14,Santa Cruz,087,273765,62677,62480,3404,65884,274
2022-09-14,Shasta,089,179085,34791,34648,7360,42008,591
2022-09-14,Sierra,091,2930,303,303,60,363,5
2022-09-14,Siskiyou,093,43540,5106,5226,3289,8515,90
2022-09-14,Solano,095,438530,104532,104085,7840,111925,462
2022-09-14,Sonoma,097,501317,106260,106028,5241,111269,518
2022-09-14,Stanislaus,099,539301,137351,136981,21507,158488,1727
2022-09-14,Sutter,101,95872,24132,24119,2459,26578,232
2022-09-14,Tehama,103,63373,13569,13503,3058,16561,210
2022-09-14,Trinity,105,12862,1394,1385,379,1764,20
2022-09-14,Tulare,107,460477,121462,121230,36045,157275,1531
2022-09-14,Tuolumne,109,53932,15481,15411,916,16327,196
2022-09-14,Ventura,111,848112,207549,207049,15590,222639,1563
2022-09-14,Yolo,113,214977,47163,47085,4255,51340,334
2022-09-14,Yuba,115,75493,18800,18764,1698,20462,129
2022-09-13,Alameda,001,1643700,345285,344045,19493,363538,2007
2022-09-13,Alpine,003,1148,134,134,1,135,0
2022-09-13,Amador,005,37829,9937,9908,923,10831,90
2022-09-13,Butte,007,227075,39303,39155,9023,48178,453
2022-09-13,Calaveras,009,45235,8454,8455,530,8985,133
2022-09-13,Colusa,011,21464,3776,3765,1271,5036,22
2022-09-13,Contra Costa,013,1133247,249721,247095,20575,267670,1423
2022-09-13,Del Norte,015,27424,7383,7381,398,7779,56
2022-09-13,El Dorado,017,186661,32110,32088,4218,36306,231
2022-09-13,Fresno,019,978130,276136,272774,31349,304123,2839
2022-09-13,Glenn,021,27897,5504,5481,1852,7333,48
2022-09-13,Humboldt,023,135768,21627,21561,4932,26493,155
2022-09-13,Imperial,025,180216,65215,65099,15587,80686,956
2022-09-13,Inyo,027,18085,4478,4472,958,5430,59
2022-09-13,Kern,029,883053,218476,217694,63104,280798,2405
2022-09-13,Kings,031,150075,59184,59122,4082,63204,456
2022-09-13,Lake,033,64148,12741,12696,1175,13871,144
2022-09-13,Lassen,035,31185,9943,9938,986,10924,65
2022-09-13,Los Angeles,037,10098052,3263767,3253906,179020,3432926,33160
2022-09-13,Madera,039,155013,43835,43782,8209,51991,373
2022-09-13,Marin,041,260295,44835,44702,5219,49921,309
2022-09-13,Mariposa,043,17540,3091,3064,342,3406,31
2022-09-13,Mendocino,045,87422,15940,15872,4445,20317,136
2022-09-13,Merced,047,269075,72309,71732,11797,83529,862
2022-09-13,Modoc,049,8938,872,872,320,1192,11
2022-09-13,Mono,051,14174,3204,3191,249,3440,7
2022-09-13,Monterey,053,433212,93857,93692,20886,114578,762
2022-09-13,Napa,055,140530,31992,31979,1393,33372,160
2022-09-13,Nevada,057,99092,18873,18824,1810,20634,132
2022-09-13,Orange,059,3164182,663870,662784,62235,725019,7398
2022-09-13,Placer,061,380077,75365,75159,9444,84603,660
2022-09-13,Plumas,063,18699,3623,3609,432,4041,13
2022-09-13,Riverside,065,2383286,692671,691630,35032,726662,6608
2022-09-13,Sacramento,067,1510023,344642,343926,33734,377660,3267
2022-09-13,San Benito,069,59416,16205,16057,955,17012,106
2022-09-13,San Bernardino,071,2135413,668368,664360,30673,695033,8074
2022-09-13,San Diego,073,3302833,918455,917229,71427,988656,5479
2022-09-13,San Francisco,075,870044,177676,176724,12006,188730,1025
2022-09-13,San Joaquin,077,732212,196930,196128,14811,210939,2304
2022-09-13,San Luis Obispo,079,281455,62973,62716,7056,69772,520
2022-09-13,San Mateo,081,765935,167548,166572,10385,176957,735
2022-09-13,Santa Barbara,083,443738,105172,104912,6811,111723,718
2022-09-13,Santa Clara,085,1922200,433118,428065,18840,446905,2473
2022-09-13,Santa Cruz,087,273765,62652,62480,3402,65882,274
2022-09-13,Shasta,089,179085,34767,34648,7356,42004,591
2022-09-13,Sierra,091,2930,303,303,60,363,5
2022-09-13,Siskiyou,093,43540,5102,5226,3288,8514,90
2022-09-13,Solano,095,438530,104476,104085,7831,111916,462
2022-09-13,Sonoma,097,501317,106204,106028,5239,111267,518
2022-09-13,Stanislaus,099,539301,137301,136981,21501,158482,1727
2022-09-13,Sutter,101,95872,24121,24119,2458,26577,232
2022-09-13,Tehama,103,63373,13560,13503,3057,16560,210
2022-09-13,Trinity,105,12862,1393,1385,379,1764,20
2022-09-13,Tulare,107,460477,121431,121230,36014,157244,1531
2022-09-13,Tuolumne,109,53932,15475,15411,916,16327,196
2022-09-13,Ventura,111,848112,207454,207049,15574,222623,1563
2022-09-13,Yolo,113,214977,47151,47085,4250,51335,334
2022-09-13,Yuba,115,75493,18791,18764,1697,20461,129
2022-09-12,Alameda,001,1643700,345064,343017,19476,362493,2006
2022-09-12,Alpine,003,1148,134,134,1,135,0
2022-09-12,Amador,005,37829,9929,9890,922,10812,89
2022-09-12,Butte,007,227075,39284,39049,9014,48063,453
2022-09-12,Calaveras,009,45235,8450,8444,530,8974,133
2022-09-12,Colusa,011,21464,3775,3755,1270,5025,22
2022-09-12,Contra Costa,013,1133247,249591,246174,20558,266732,1415
2022-09-12,Del Norte,015,27424,7380,7354,398,7752,56
2022-09-12,El Dorado,017,186661,32093,32027,4212,36239,229
2022-09-12,Fresno,019,978130,276010,272161,31331,303492,2835
2022-09-12,Glenn,021,27897,5500,5473,1852,7325,48
2022-09-12,Humboldt,023,135768,21611,21494,4921,26415,155
2022-09-12,Imperial,025,180216,65191,64926,15569,80495,956
2022-09-12,Inyo,027,18085,4476,4465,956,5421,59
2022-09-12,Kern,029,883053,218399,217203,63034,280237,2404
2022-09-12,Kings,031,150075,59167,58980,4078,63058,455
2022-09-12,Lake,033,64148,12732,12663,1172,13835,144
2022-09-12,Lassen,035,31185,9942,9931,986,10917,64
2022-09-12,Los Angeles,037,10098052,3262241,3246402,178832,3425234,33094
2022-09-12,Madera,039,155013,43823,43599,8199,51798,373
2022-09-12,Marin,041,260295,44815,44584,5215,49799,305
2022-09-12,Mariposa,043,17540,3086,3058,342,3400,31
2022-09-12,Mendocino,045,87422,15929,15853,4437,20290,135
2022-09-12,Merced,047,269075,72269,71563,11784,83347,856
2022-09-12,Modoc,049,8938,872,872,318,1190,11
2022-09-12,Mono,051,14174,3200,3188,249,3437,7
2022-09-12,Monterey,053,433212,93823,93513,20863,114376,762
2022-09-12,Napa,055,140530,31970,31910,1393,33303,158
2022-09-12,Nevada,057,99092,18864,18784,1809,20593,132
2022-09-12,Orange,059,3164182,663576,661329,62159,723488,7371
2022-09-12,Placer,061,380077,75334,74994,9439,84433,657
2022-09-12,Plumas,063,18699,3620,3594,431,4025,13
2022-09-12,Riverside,065,2383286,692386,690018,35009,725027,6596
2022-09-12,Sacramento,067,1510023,344474,343048,33703,376751,3254
2022-09-12,San Benito,069,59416,16192,16000,955,16955,103
2022-09-12,San Bernardino,071,2135413,668054,662248,30656,692904,8057
2022-09-12,San Diego,073,3302833,917972,915648,71378,987026,5474
2022-09-12,San Francisco,075,870044,177559,176512,11999,188511,1022
2022-09-12,San Joaquin,077,732212,196834,195697,14798,210495,2303
2022-09-12,San Luis Obispo,079,281455,62944,62569,7051,69620,519
2022-09-12,San Mateo,081,765935,167455,166165,10375,176540,735
2022-09-12,Santa Barbara,083,443738,105135,104627,6807,111434,717
2022-09-12,Santa Clara,085,1922200,432862,426854,18826,445680,2478
2022-09-12,Santa Cruz,087,273765,62624,62255,3401,65656,274
2022-09-12,Shasta,089,179085,34745,34531,7350,41881,591
2022-09-12,Sierra,091,2930,303,303,60,363,5
2022-09-12,Siskiyou,093,43540,5099,5197,3285,8482,90
2022-09-12,Solano,095,438530,104424,103841,7822,111663,461
2022-09-12,Sonoma,097,501317,106155,105778,5232,111010,521
2022-09-12,Stanislaus,099,539301,137242,136674,21496,158170,1726
2022-09-12,Sutter,101,95872,24110,24037,2456,26493,228
2022-09-12,Tehama,103,63373,13554,13471,3056,16527,210
2022-09-12,Trinity,105,12862,1392,1383,378,1761,20
2022-09-12,Tulare,107,460477,121374,120972,35983,156955,1529
2022-09-12,Tuolumne,109,53932,15466,15362,916,16278,196
2022-09-12,Ventura,111,848112,207344,206442,15559,222001,1558
2022-09-12,Yolo,113,214977,47136,46989,4248,51237,334
2022-09-12,Yuba,115,75493,18777,18709,1692,20401,129
2022-09-11,Alameda,001,1643700,344796,343017,19453,362470,2006
2022-09-11,Alpine,003,1148,134,134,1,135,0
2022-09-11,Amador,005,37829,9922,9890,919,10809,89
2022-09-11,Butte,007,227075,39249,39049,9007,48056,453
2022-09-11,Calaveras,009,45235,8447,8444,529,8973,133
2022-09-11,Colusa,011,21464,3773,3755,1268,5023,22
2022-09-11,Contra Costa,013,1133247,249426,246174,20530,266704,1415
2022-09-11,Del Norte,015,27424,7375,7354,397,7751,56
2022-09-11,El Dorado,017,186661,32077,32027,4204,36231,229
2022-09-11,Fresno,019,978130,275899,272161,31310,303471,2835
2022-09-11,Glenn,021,27897,5497,5473,1852,7325,48
2022-09-11,Humboldt,023,135768,21592,21494,4908,26402,155
2022-09-11,Imperial,025,180216,65148,64926,15541,80467,956
2022-09-11,Inyo,027,18085,4475,4465,947,5412,59
2022-09-11,Kern,029,883053,218293,217203,62933,280136,2404
2022-09-11,Kings,031,150075,59130,58980,4075,63055,455
2022-09-11,Lake,033,64148,12718,12663,1169,13832,144
2022-09-11,Lassen,035,31185,9937,9931,986,10917,64
2022-09-11,Los Angeles,037,10098052,3260503,3246402,178589,3424991,33094
2022-09-11,Madera,039,155013,43791,43599,8192,51791,373
2022-09-11,Marin,041,260295,44788,44584,5213,49797,305
2022-09-11,Mariposa,043,17540,3083,3058,342,3400,31
2022-09-11,Mendocino,045,87422,15919,15853,4431,20284,135
2022-09-11,Merced,047,269075,72232,71563,11773,83336,856
2022-09-11,Modoc,049,8938,872,872,317,1189,11
2022-09-11,Mono,051,14174,3197,3188,249,3437,7
2022-09-11,Monterey,053,433212,93794,93513,20845,114358,762
2022-09-11,Napa,055,140530,31949,31910,1392,33302,158
2022-09-11,Nevada,057,99092,18854,18784,1805,20589,132
2022-09-11,Orange,059,3164182,663276,661329,62088,723417,7371
2022-09-11,Placer,061,380077,75301,74994,9432,84426,657
2022-09-11,Plumas,063,18699,3614,3594,431,4025,13
2022-09-11,Riverside,065,2383286,692104,690018,34979,724997,6596
2022-09-11,Sacramento,067,1510023,344270,343048,33642,376690,3254
2022-09-11,San Benito,069,59416,16183,16000,951,16951,103
2022-09-11,San Bernardino,071,2135413,667731,662248,30638,692886,8057
2022-09-11,San Diego,073,3302833,917428,915648,71315,986963,5474
2022-09-11,San Francisco,075,870044,177405,176512,11985,188497,1022
2022-09-11,San Joaquin,077,732212,196731,195697,14777,210474,2303
2022-09-11,San Luis Obispo,079,281455,62912,62569,7037,69606,519
2022-09-11,San Mateo,081,765935,167341,166165,10370,176535,735
2022-09-11,Santa Barbara,083,443738,105094,104627,6803,111430,717
2022-09-11,Santa Clara,085,1922200,432575,426854,18810,445664,2478
2022-09-11,Santa Cruz,087,273765,62588,62255,3397,65652,274
2022-09-11,Shasta,089,179085,34715,34531,7342,41873,591
2022-09-11,Sierra,091,2930,303,303,60,363,5
2022-09-11,Siskiyou,093,43540,5097,5197,3279,8476,90
2022-09-11,Solano,095,438530,104343,103841,7817,111658,461
2022-09-11,Sonoma,097,501317,106088,105778,5226,111004,521
2022-09-11,Stanislaus,099,539301,137174,136674,21480,158154,1726
2022-09-11,Sutter,101,95872,24088,24037,2455,26492,228
2022-09-11,Tehama,103,63373,13540,13471,3053,16524,210
2022-09-11,Trinity,105,12862,1392,1383,378,1761,20
2022-09-11,Tulare,107,460477,121321,120972,35951,156923,1529
2022-09-11,Tuolumne,109,53932,15457,15362,916,16278,196
2022-09-11,Ventura,111,848112,207203,206442,15535,221977,1558
2022-09-11,Yolo,113,214977,47108,46989,4245,51234,334
2022-09-11,Yuba,115,75493,18768,18709,1689,20398,129
2022-09-10,Alameda,001,1643700,344658,343017,19447,362464,2006
2022-09-10,Alpine,003,1148,134,134,1,135,0
2022-09-10,Amador,005,37829,9919,9890,918,10808,89
2022-09-10,Butte,007,227075,39232,39049,9006,48055,453
2022-09-10,Calaveras,009,45235,8445,8444,529,8973,133
2022-09-10,Colusa,011,21464,3772,3755,1268,5023,22
2022-09-10,Contra Costa,013,1133247,249316,246174,20520,266694,1415
2022-09-10,Del Norte,015,27424,7372,7354,397,7751,56
2022-09-10,El Dorado,017,186661,32069,32027,4203,36230,229
2022-09-10,Fresno,019,978130,275814,272161,31300,303461,2835
2022-09-10,Glenn,021,27897,5494,5473,1851,7324,48
2022-09-10,Humboldt,023,135768,21583,21494,4904,26398,155
2022-09-10,Imperial,025,180216,65126,64926,15530,80456,956
2022-09-10,Inyo,027,18085,4475,4465,947,5412,59
2022-09-10,Kern,029,883053,218239,217203,62893,280096,2404
2022-09-10,Kings,031,150075,59120,58980,4075,63055,455
2022-09-10,Lake,033,64148,12715,12663,1169,13832,144
2022-09-10,Lassen,035,31185,9936,9931,986,10917,64
2022-09-10,Los Angeles,037,10098052,3259567,3246402,178444,3424846,33094
2022-09-10,Madera,039,155013,43774,43599,8189,51788,373
2022-09-10,Marin,041,260295,44763,44584,5208,49792,305
2022-09-10,Mariposa,043,17540,3083,3058,341,3399,31
2022-09-10,Mendocino,045,87422,15916,15853,4429,20282,135
2022-09-10,Merced,047,269075,72218,71563,11770,83333,856
2022-09-10,Modoc,049,8938,872,872,316,1188,11
2022-09-10,Mono,051,14174,3196,3188,249,3437,7
2022-09-10,Monterey,053,433212,93773,93513,20841,114354,762
2022-09-10,Napa,055,140530,31941,31910,1392,33302,158
2022-09-10,Nevada,057,99092,18850,18784,1805,20589,132
2022-09-10,Orange,059,3164182,663103,661329,62050,723379,7371
2022-09-10,Placer,061,380077,75272,74994,9430,84424,657
2022-09-10,Plumas,063,18699,3610,3594,431,4025,13
2022-09-10,Riverside,065,2383286,691922,690018,34968,724986,6596
2022-09-10,Sacramento,067,1510023,344176,343048,33632,376680,3254
2022-09-10,San Benito,069,59416,16176,16000,951,16951,103
2022-09-10,San Bernardino,071,2135413,667571,662248,30623,692871,8057
2022-09-10,San Diego,073,3302833,917200,915648,71291,986939,5474
2022-09-10,San Francisco,075,870044,177347,176512,11982,188494,1022
2022-09-10,San Joaquin,077,732212,196680,195697,14769,210466,2303
2022-09-10,San Luis Obispo,079,281455,62899,62569,7035,69604,519
2022-09-10,San Mateo,081,765935,167266,166165,10362,176527,735
2022-09-10,Santa Barbara,083,443738,105073,104627,6801,111428,717
2022-09-10,Santa Clara,085,1922200,432351,426854,18799,445653,2478
2022-09-10,Santa Cruz,087,273765,62577,62255,3395,65650,274
2022-09-10,Shasta,089,179085,34704,34531,7339,41870,591
2022-09-10,Sierra,091,2930,303,303,60,363,5
2022-09-10,Siskiyou,093,43540,5097,5197,3279,8476,90
2022-09-10,Solano,095,438530,104318,103841,7814,111655,461
2022-09-10,Sonoma,097,501317,106066,105778,5226,111004,521
2022-09-10,Stanislaus,099,539301,137134,136674,21474,158148,1726
2022-09-10,Sutter,101,95872,24073,24037,2455,26492,228
2022-09-10,Tehama,103,63373,13539,13471,3053,16524,210
2022-09-10,Trinity,105,12862,1392,1383,378,1761,20
2022-09-10,Tulare,107,460477,121295,120972,35938,156910,1529
2022-09-10,Tuolumne,109,53932,15451,15362,916,16278,196
2022-09-10,Ventura,111,848112,207134,206442,15521,221963,1558
2022-09-10,Yolo,113,214977,47098,46989,4242,51231,334
2022-09-10,Yuba,115,75493,18760,18709,1688,20397,129
2022-09-09,Alameda,001,1643700,344480,343017,19439,362456,2006
2022-09-09,Alpine,003,1148,134,134,1,135,0
2022-09-09,Amador,005,37829,9914,9890,918,10808,89
2022-09-09,Butte,007,227075,39219,39049,9001,48050,453
2022-09-09,Calaveras,009,45235,8443,8444,529,8973,133
2022-09-09,Colusa,011,21464,3770,3755,1267,5022,22
2022-09-09,Contra Costa,013,1133247,249239,246174,20509,266683,1415
2022-09-09,Del Norte,015,27424,7371,7354,397,7751,56
2022-09-09,El Dorado,017,186661,32061,32027,4201,36228,229
2022-09-09,Fresno,019,978130,275744,272161,31290,303451,2835
2022-09-09,Glenn,021,27897,5492,5473,1851,7324,48
2022-09-09,Humboldt,023,135768,21576,21494,4899,26393,155
2022-09-09,Imperial,025,180216,65101,64926,15522,80448,956
2022-09-09,Inyo,027,18085,4473,4465,939,5404,59
2022-09-09,Kern,029,883053,218177,217203,62849,280052,2404
2022-09-09,Kings,031,150075,59101,58980,4075,63055,455
2022-09-09,Lake,033,64148,12712,12663,1168,13831,144
2022-09-09,Lassen,035,31185,9936,9931,986,10917,64
2022-09-09,Los Angeles,037,10098052,3258530,3246402,178299,3424701,33094
2022-09-09,Madera,039,155013,43756,43599,8187,51786,373
2022-09-09,Marin,041,260295,44750,44584,5207,49791,305
2022-09-09,Mariposa,043,17540,3082,3058,341,3399,31
2022-09-09,Mendocino,045,87422,15910,15853,4425,20278,135
2022-09-09,Merced,047,269075,72197,71563,11768,83331,856
2022-09-09,Modoc,049,8938,872,872,316,1188,11
2022-09-09,Mono,051,14174,3196,3188,249,3437,7
2022-09-09,Monterey,053,433212,93758,93513,20832,114345,762
2022-09-09,Napa,055,140530,31929,31910,1392,33302,158
2022-09-09,Nevada,057,99092,18843,18784,1805,20589,132
2022-09-09,Orange,059,3164182,662917,661329,62007,723336,7371
2022-09-09,Placer,061,380077,75250,74994,9427,84421,657
2022-09-09,Plumas,063,18699,3608,3594,431,4025,13
2022-09-09,Riverside,065,2383286,691735,690018,34954,724972,6596
2022-09-09,Sacramento,067,1510023,344041,343048,33620,376668,3254
2022-09-09,San Benito,069,59416,16166,16000,951,16951,103
2022-09-09,San Bernardino,071,2135413,667396,662248,30614,692862,8057
2022-09-09,San Diego,073,3302833,916938,915648,71266,986914,5474
2022-09-09,San Francisco,075,870044,177274,176512,11974,188486,1022
2022-09-09,San Joaquin,077,732212,196624,195697,14754,210451,2303
2022-09-09,San Luis Obispo,079,281455,62893,62569,7032,69601,519
2022-09-09,San Mateo,081,765935,167211,166165,10360,176525,735
2022-09-09,Santa Barbara,083,443738,105036,104627,6798,111425,717
2022-09-09,Santa Clara,085,1922200,432162,426854,18787,445641,2478
2022-09-09,Santa Cruz,087,273765,62556,62255,3393,65648,274
2022-09-09,Shasta,089,179085,34688,34531,7333,41864,591
2022-09-09,Sierra,091,2930,303,303,60,363,5
2022-09-09,Siskiyou,093,43540,5090,5197,3279,8476,90
2022-09-09,Solano,095,438530,104284,103841,7809,111650,461
2022-09-09,Sonoma,097,501317,106038,105778,5226,111004,521
2022-09-09,Stanislaus,099,539301,137106,136674,21467,158141,1726
2022-09-09,Sutter,101,95872,24066,24037,2454,26491,228
2022-09-09,Tehama,103,63373,13534,13471,3053,16524,210
2022-09-09,Trinity,105,12862,1391,1383,378,1761,20
2022-09-09,Tulare,107,460477,121255,120972,35920,156892,1529
2022-09-09,Tuolumne,109,53932,15450,15362,916,16278,196
2022-09-09,Ventura,111,848112,207064,206442,15507,221949,1558
2022-09-09,Yolo,113,214977,47083,46989,4242,51231,334
2022-09-09,Yuba,115,75493,18751,18709,1688,20397,129
2022-09-08,Alameda,001,1643700,344252,343017,19428,362445,2006
2022-09-08,Alpine,003,1148,134,134,1,135,0
2022-09-08,Amador,005,37829,9907,9890,918,10808,89
2022-09-08,Butte,007,227075,39196,39049,8991,48040,453
2022-09-08,Calaveras,009,45235,8443,8444,528,8972,133
2022-09-08,Colusa,011,21464,3770,3755,1267,5022,22
2022-09-08,Contra Costa,013,1133247,249110,246174,20491,266665,1415
2022-09-08,Del Norte,015,27424,7361,7354,397,7751,56
2022-09-08,El Dorado,017,186661,32044,32027,4199,36226,229
2022-09-08,Fresno,019,978130,275628,272161,31268,303429,2835
2022-09-08,Glenn,021,27897,5492,5473,1851,7324,48
2022-09-08,Humboldt,023,135768,21551,21494,4894,26388,155
2022-09-08,Imperial,025,180216,65070,64926,15501,80427,956
2022-09-08,Inyo,027,18085,4471,4465,937,5402,59
2022-09-08,Kern,029,883053,218088,217203,62756,279959,2404
2022-09-08,Kings,031,150075,59072,58980,4073,63053,455
2022-09-08,Lake,033,64148,12703,12663,1168,13831,144
2022-09-08,Lassen,035,31185,9935,9931,986,10917,64
2022-09-08,Los Angeles,037,10098052,3257073,3246402,178102,3424504,33094
2022-09-08,Madera,039,155013,43726,43599,8181,51780,373
2022-09-08,Marin,041,260295,44725,44584,5203,49787,305
2022-09-08,Mariposa,043,17540,3079,3058,341,3399,31
2022-09-08,Mendocino,045,87422,15903,15853,4425,20278,135
2022-09-08,Merced,047,269075,72168,71563,11756,83319,856
2022-09-08,Modoc,049,8938,872,872,316,1188,11
2022-09-08,Mono,051,14174,3196,3188,248,3436,7
2022-09-08,Monterey,053,433212,93726,93513,20811,114324,762
2022-09-08,Napa,055,140530,31916,31910,1392,33302,158
2022-09-08,Nevada,057,99092,18833,18784,1804,20588,132
2022-09-08,Orange,059,3164182,662641,661329,61940,723269,7371
2022-09-08,Placer,061,380077,75218,74994,9423,84417,657
2022-09-08,Plumas,063,18699,3605,3594,431,4025,13
2022-09-08,Riverside,065,2383286,691458,690018,34930,724948,6596
2022-09-08,Sacramento,067,1510023,343868,343048,33597,376645,3254
2022-09-08,San Benito,069,59416,16155,16000,951,16951,103
2022-09-08,San Bernardino,071,2135413,667097,662248,30603,692851,8057
2022-09-08,San Diego,073,3302833,916561,915648,71213,986861,5474
2022-09-08,San Francisco,075,870044,177145,176512,11966,188478,1022
2022-09-08,San Joaquin,077,732212,196538,195697,14737,210434,2303
2022-09-08,San Luis Obispo,079,281455,62875,62569,7026,69595,519
2022-09-08,San Mateo,081,765935,167124,166165,10356,176521,735
2022-09-08,Santa Barbara,083,443738,104994,104627,6793,111420,717
2022-09-08,Santa Clara,085,1922200,431891,426854,18775,445629,2478
2022-09-08,Santa Cruz,087,273765,62525,62255,3390,65645,274
2022-09-08,Shasta,089,179085,34666,34531,7324,41855,591
2022-09-08,Sierra,091,2930,303,303,60,363,5
2022-09-08,Siskiyou,093,43540,5085,5197,3278,8475,90
2022-09-08,Solano,095,438530,104229,103841,7797,111638,461
2022-09-08,Sonoma,097,501317,105957,105778,5220,110998,521
2022-09-08,Stanislaus,099,539301,137040,136674,21452,158126,1726
2022-09-08,Sutter,101,95872,24054,24037,2454,26491,228
2022-09-08,Tehama,103,63373,13526,13471,3050,16521,210
2022-09-08,Trinity,105,12862,1391,1383,378,1761,20
2022-09-08,Tulare,107,460477,121207,120972,35891,156863,1529
2022-09-08,Tuolumne,109,53932,15443,15362,915,16277,196
2022-09-08,Ventura,111,848112,206946,206442,15483,221925,1558
2022-09-08,Yolo,113,214977,47062,46989,4234,51223,334
2022-09-08,Yuba,115,75493,18741,18709,1684,20393,129
2022-09-07,Alameda,001,1643700,344007,342480,19421,361901,1999
2022-09-07,Alpine,003,1148,134,133,1,134,0
2022-09-07,Amador,005,37829,9904,9877,918,10795,89
2022-09-07,Butte,007,227075,39166,38969,8979,47948,453
2022-09-07,Calaveras,009,45235,8441,8437,526,8963,133
2022-09-07,Colusa,011,21464,3767,3748,1267,5015,22
2022-09-07,Contra Costa,013,1133247,248970,245708,20475,266183,1415
2022-09-07,Del Norte,015,27424,7359,7346,397,7743,56
2022-09-07,El Dorado,017,186661,32031,31979,4198,36177,229
2022-09-07,Fresno,019,978130,275468,271753,31240,302993,2835
2022-09-07,Glenn,021,27897,5490,5468,1850,7318,48
2022-09-07,Humboldt,023,135768,21533,21459,4891,26350,155
2022-09-07,Imperial,025,180216,65037,64755,15479,80234,956
2022-09-07,Inyo,027,18085,4466,4456,930,5386,59
2022-09-07,Kern,029,883053,217989,216932,62663,279595,2404
2022-09-07,Kings,031,150075,59037,58922,4069,62991,455
2022-09-07,Lake,033,64148,12694,12647,1167,13814,143
2022-09-07,Lassen,035,31185,9935,9918,985,10903,64
2022-09-07,Los Angeles,037,10098052,3255477,3242352,177902,3420254,32971
2022-09-07,Madera,039,155013,43679,43533,8181,51714,373
2022-09-07,Marin,041,260295,44702,44489,5201,49690,305
2022-09-07,Mariposa,043,17540,3077,3046,341,3387,31
2022-09-07,Mendocino,045,87422,15898,15813,4419,20232,135
2022-09-07,Merced,047,269075,72133,71448,11744,83192,856
2022-09-07,Modoc,049,8938,872,868,316,1184,11
2022-09-07,Mono,051,14174,3195,3184,248,3432,7
2022-09-07,Monterey,053,433212,93696,93430,20792,114222,762
2022-09-07,Napa,055,140530,31896,31854,1392,33246,156
2022-09-07,Nevada,057,99092,18820,18761,1802,20563,132
2022-09-07,Orange,059,3164182,662331,660580,61866,722446,7362
2022-09-07,Placer,061,380077,75191,74884,9414,84298,658
2022-09-07,Plumas,063,18699,3603,3588,430,4018,13
2022-09-07,Riverside,065,2383286,691127,688794,34903,723697,6591
2022-09-07,Sacramento,067,1510023,343705,342602,33564,376166,3248
2022-09-07,San Benito,069,59416,16142,15933,950,16883,103
2022-09-07,San Bernardino,071,2135413,666839,660303,30587,690890,8023
2022-09-07,San Diego,073,3302833,916068,914552,71168,985720,5468
2022-09-07,San Francisco,075,870044,177042,176386,11956,188342,1018
2022-09-07,San Joaquin,077,732212,196425,195359,14725,210084,2303
2022-09-07,San Luis Obispo,079,281455,62854,62548,7023,69571,517
2022-09-07,San Mateo,081,765935,167023,165893,10349,176242,736
2022-09-07,Santa Barbara,083,443738,104950,104452,6788,111240,717
2022-09-07,Santa Clara,085,1922200,431606,426178,18762,444940,2472
2022-09-07,Santa Cruz,087,273765,62492,62187,3387,65574,274
2022-09-07,Shasta,089,179085,34644,34484,7307,41791,591
2022-09-07,Sierra,091,2930,303,303,60,363,5
2022-09-07,Siskiyou,093,43540,5080,5190,3277,8467,89
2022-09-07,Solano,095,438530,104171,103665,7790,111455,463
2022-09-07,Sonoma,097,501317,105894,105389,5217,110606,517
2022-09-07,Stanislaus,099,539301,136962,136477,21442,157919,1726
2022-09-07,Sutter,101,95872,24040,23984,2454,26438,228
2022-09-07,Tehama,103,63373,13523,13453,3046,16499,210
2022-09-07,Trinity,105,12862,1391,1382,378,1760,20
2022-09-07,Tulare,107,460477,121155,120846,35861,156707,1529
2022-09-07,Tuolumne,109,53932,15436,15327,915,16242,196
2022-09-07,Ventura,111,848112,206825,206121,15466,221587,1557
2022-09-07,Yolo,113,214977,47033,46966,4228,51194,334
2022-09-07,Yuba,115,75493,18728,18665,1683,20348,129
2022-09-06,Alameda,001,1643700,343744,342480,19407,361887,1999
2022-09-06,Alpine,003,1148,133,133,1,134,0
2022-09-06,Amador,005,37829,9901,9877,918,10795,89
2022-09-06,Butte,007,227075,39135,38969,8968,47937,453
2022-09-06,Calaveras,009,45235,8439,8437,524,8961,133
2022-09-06,Colusa,011,21464,3765,3748,1267,5015,22
2022-09-06,Contra Costa,013,1133247,248802,245708,20448,266156,1415
2022-09-06,Del Norte,015,27424,7351,7346,397,7743,56
2022-09-06,El Dorado,017,186661,32013,31979,4192,36171,229
2022-09-06,Fresno,019,978130,275340,271753,31211,302964,2835
2022-09-06,Glenn,021,27897,5488,5468,1848,7316,48
2022-09-06,Humboldt,023,135768,21515,21459,4886,26345,155
2022-09-06,Imperial,025,180216,64987,64755,15451,80206,956
2022-09-06,Inyo,027,18085,4463,4456,924,5380,59
2022-09-06,Kern,029,883053,217895,216932,62563,279495,2404
2022-09-06,Kings,031,150075,58997,58922,4064,62986,455
2022-09-06,Lake,033,64148,12691,12647,1151,13798,143
2022-09-06,Lassen,035,31185,9932,9918,983,10901,64
2022-09-06,Los Angeles,037,10098052,3253694,3242352,177688,3420040,32971
2022-09-06,Madera,039,155013,43637,43533,8176,51709,373
2022-09-06,Marin,041,260295,44671,44489,5197,49686,305
2022-09-06,Mariposa,043,17540,3075,3046,341,3387,31
2022-09-06,Mendocino,045,87422,15892,15813,4412,20225,135
2022-09-06,Merced,047,269075,72095,71448,11727,83175,856
2022-09-06,Modoc,049,8938,871,868,316,1184,11
2022-09-06,Mono,051,14174,3195,3184,247,3431,7
2022-09-06,Monterey,053,433212,93661,93430,20774,114204,762
2022-09-06,Napa,055,140530,31880,31854,1392,33246,156
2022-09-06,Nevada,057,99092,18810,18761,1798,20559,132
2022-09-06,Orange,059,3164182,661969,660580,61791,722371,7362
2022-09-06,Placer,061,380077,75147,74884,9412,84296,658
2022-09-06,Plumas,063,18699,3599,3588,430,4018,13
2022-09-06,Riverside,065,2383286,690656,688794,34869,723663,6591
2022-09-06,Sacramento,067,1510023,343488,342602,33525,376127,3248
2022-09-06,San Benito,069,59416,16126,15933,950,16883,103
2022-09-06,San Bernardino,071,2135413,666565,660303,30571,690874,8023
2022-09-06,San Diego,073,3302833,915561,914552,71115,985667,5468
2022-09-06,San Francisco,075,870044,176908,176386,11944,188330,1018
2022-09-06,San Joaquin,077,732212,196331,195359,14712,210071,2303
2022-09-06,San Luis Obispo,079,281455,62812,62548,7021,69569,517
2022-09-06,San Mateo,081,765935,166916,165893,10339,176232,736
2022-09-06,Santa Barbara,083,443738,104893,104452,6783,111235,717
2022-09-06,Santa Clara,085,1922200,431347,426178,18747,444925,2472
2022-09-06,Santa Cruz,087,273765,62412,62187,3387,65574,274
2022-09-06,Shasta,089,179085,34596,34484,7284,41768,591
2022-09-06,Sierra,091,2930,303,303,60,363,5
2022-09-06,Siskiyou,093,43540,5078,5190,3273,8463,89
2022-09-06,Solano,095,438530,104105,103665,7778,111443,463
2022-09-06,Sonoma,097,501317,105832,105389,5214,110603,517
2022-09-06,Stanislaus,099,539301,136891,136477,21428,157905,1726
2022-09-06,Sutter,101,95872,24015,23984,2454,26438,228
2022-09-06,Tehama,103,63373,13514,13453,3043,16496,210
2022-09-06,Trinity,105,12862,1390,1382,378,1760,20
2022-09-06,Tulare,107,460477,121103,120846,35824,156670,1529
2022-09-06,Tuolumne,109,53932,15425,15327,915,16242,196
2022-09-06,Ventura,111,848112,206679,206121,15449,221570,1557
2022-09-06,Yolo,113,214977,47017,46966,4217,51183,334
2022-09-06,Yuba,115,75493,18707,18665,1682,20347,129
2022-09-05,Alameda,001,1643700,343452,342480,19399,361879,1999
2022-09-05,Alpine,003,1148,133,133,1,134,0
2022-09-05,Amador,005,37829,9897,9877,918,10795,89
2022-09-05,Butte,007,227075,39088,38969,8955,47924,453
2022-09-05,Calaveras,009,45235,8436,8437,523,8960,133
2022-09-05,Colusa,011,21464,3758,3748,1264,5012,22
2022-09-05,Contra Costa,013,1133247,248614,245708,20429,266137,1415
2022-09-05,Del Norte,015,27424,7346,7346,395,7741,56
2022-09-05,El Dorado,017,186661,31989,31979,4186,36165,229
2022-09-05,Fresno,019,978130,275108,271753,31147,302900,2835
2022-09-05,Glenn,021,27897,5485,5468,1844,7312,48
2022-09-05,Humboldt,023,135768,21499,21459,4880,26339,155
2022-09-05,Imperial,025,180216,64934,64755,15407,80162,956
2022-09-05,Inyo,027,18085,4461,4456,922,5378,59
2022-09-05,Kern,029,883053,217762,216932,62435,279367,2404
2022-09-05,Kings,031,150075,58939,58922,4061,62983,455
2022-09-05,Lake,033,64148,12684,12647,1149,13796,143
2022-09-05,Lassen,035,31185,9923,9918,982,10900,64
2022-09-05,Los Angeles,037,10098052,3251269,3242352,177421,3419773,32971
2022-09-05,Madera,039,155013,43581,43533,8154,51687,373
2022-09-05,Marin,041,260295,44642,44489,5197,49686,305
2022-09-05,Mariposa,043,17540,3070,3046,341,3387,31
2022-09-05,Mendocino,045,87422,15871,15813,4401,20214,135
2022-09-05,Merced,047,269075,72032,71448,11696,83144,856
2022-09-05,Modoc,049,8938,870,868,315,1183,11
2022-09-05,Mono,051,14174,3193,3184,244,3428,7
2022-09-05,Monterey,053,433212,93594,93430,20753,114183,762
2022-09-05,Napa,055,140530,31852,31854,1389,33243,156
2022-09-05,Nevada,057,99092,18803,18761,1793,20554,132
2022-09-05,Orange,059,3164182,661496,660580,61692,722272,7362
2022-09-05,Placer,061,380077,75097,74884,9407,84291,658
2022-09-05,Plumas,063,18699,3598,3588,430,4018,13
2022-09-05,Riverside,065,2383286,690145,688794,34818,723612,6591
2022-09-05,Sacramento,067,1510023,343197,342602,33462,376064,3248
2022-09-05,San Benito,069,59416,16100,15933,947,16880,103
2022-09-05,San Bernardino,071,2135413,666130,660303,30539,690842,8023
2022-09-05,San Diego,073,3302833,914936,914552,71022,985574,5468
2022-09-05,San Francisco,075,870044,176745,176386,11937,188323,1018
2022-09-05,San Joaquin,077,732212,196190,195359,14697,210056,2303
2022-09-05,San Luis Obispo,079,281455,62757,62548,7004,69552,517
2022-09-05,San Mateo,081,765935,166797,165893,10331,176224,736
2022-09-05,Santa Barbara,083,443738,104806,104452,6778,111230,717
2022-09-05,Santa Clara,085,1922200,430983,426178,18729,444907,2472
2022-09-05,Santa Cruz,087,273765,62353,62187,3383,65570,274
2022-09-05,Shasta,089,179085,34565,34484,7271,41755,591
2022-09-05,Sierra,091,2930,303,303,60,363,5
2022-09-05,Siskiyou,093,43540,5072,5190,3273,8463,89
2022-09-05,Solano,095,438530,104008,103665,7760,111425,463
2022-09-05,Sonoma,097,501317,105760,105389,5207,110596,517
2022-09-05,Stanislaus,099,539301,136793,136477,21410,157887,1726
2022-09-05,Sutter,101,95872,23991,23984,2452,26436,228
2022-09-05,Tehama,103,63373,13506,13453,3042,16495,210
2022-09-05,Trinity,105,12862,1390,1382,377,1759,20
2022-09-05,Tulare,107,460477,121007,120846,35765,156611,1529
2022-09-05,Tuolumne,109,53932,15406,15327,914,16241,196
2022-09-05,Ventura,111,848112,206502,206121,15413,221534,1557
2022-09-05,Yolo,113,214977,46993,46966,4209,51175,334
2022-09-05,Yuba,115,75493,18685,18665,1680,20345,129
2022-09-04,Alameda,001,1643700,343310,341621,19388,361009,1998
2022-09-04,Alpine,003,1148,133,133,1,134,0
2022-09-04,Amador,005,37829,9893,9855,917,10772,89
2022-09-04,Butte,007,227075,39066,38851,8948,47799,453
2022-09-04,Calaveras,009,45235,8434,8422,522,8944,133
2022-09-04,Colusa,011,21464,3757,3742,1261,5003,22
2022-09-04,Contra Costa,013,1133247,248509,245022,20423,265445,1410
2022-09-04,Del Norte,015,27424,7345,7340,394,7734,56
2022-09-04,El Dorado,017,186661,31972,31929,4183,36112,229
2022-09-04,Fresno,019,978130,275003,271062,31136,302198,2835
2022-09-04,Glenn,021,27897,5484,5462,1844,7306,48
2022-09-04,Humboldt,023,135768,21489,21390,4876,26266,154
2022-09-04,Imperial,025,180216,64907,64678,15395,80073,956
2022-09-04,Inyo,027,18085,4459,4449,919,5368,59
2022-09-04,Kern,029,883053,217679,216471,62340,278811,2404
2022-09-04,Kings,031,150075,58925,58753,4061,62814,455
2022-09-04,Lake,033,64148,12677,12608,1148,13756,143
2022-09-04,Lassen,035,31185,9920,9908,982,10890,64
2022-09-04,Los Angeles,037,10098052,3250329,3235242,177303,3412545,32927
2022-09-04,Madera,039,155013,43567,43403,8147,51550,373
2022-09-04,Marin,041,260295,44615,44394,5193,49587,305
2022-09-04,Mariposa,043,17540,3069,3036,341,3377,31
2022-09-04,Mendocino,045,87422,15867,15781,4400,20181,134
2022-09-04,Merced,047,269075,72008,71280,11691,82971,856
2022-09-04,Modoc,049,8938,870,868,315,1183,11
2022-09-04,Mono,051,14174,3193,3183,244,3427,7
2022-09-04,Monterey,053,433212,93560,93246,20731,113977,761
2022-09-04,Napa,055,140530,31843,31799,1389,33188,156
2022-09-04,Nevada,057,99092,18793,18705,1792,20497,132
2022-09-04,Orange,059,3164182,661325,659290,61641,720931,7347
2022-09-04,Placer,061,380077,75062,74754,9405,84159,657
2022-09-04,Plumas,063,18699,3596,3587,430,4017,13
2022-09-04,Riverside,065,2383286,689955,687184,34800,721984,6581
2022-09-04,Sacramento,067,1510023,343097,341766,33443,375209,3243
2022-09-04,San Benito,069,59416,16095,15900,947,16847,103
2022-09-04,San Bernardino,071,2135413,665984,658354,30523,688877,8006
2022-09-04,San Diego,073,3302833,914697,912824,71003,983827,5464
2022-09-04,San Francisco,075,870044,176667,176131,11932,188063,1015
2022-09-04,San Joaquin,077,732212,196066,194904,14679,209583,2301
2022-09-04,San Luis Obispo,079,281455,62747,62455,7000,69455,517
2022-09-04,San Mateo,081,765935,166741,165520,10327,175847,738
2022-09-04,Santa Barbara,083,443738,104755,104161,6773,110934,716
2022-09-04,Santa Clara,085,1922200,430786,425040,18715,443755,2473
2022-09-04,Santa Cruz,087,273765,62334,61989,3382,65371,273
2022-09-04,Shasta,089,179085,34558,34422,7264,41686,591
2022-09-04,Sierra,091,2930,303,303,60,363,5
2022-09-04,Siskiyou,093,43540,5069,5168,3270,8438,89
2022-09-04,Solano,095,438530,103990,103457,7756,111213,461
2022-09-04,Sonoma,097,501317,105734,105162,5202,110364,517
2022-09-04,Stanislaus,099,539301,136733,136168,21401,157569,1726
2022-09-04,Sutter,101,95872,23976,23927,2452,26379,228
2022-09-04,Tehama,103,63373,13498,13406,3039,16445,210
2022-09-04,Trinity,105,12862,1390,1377,376,1753,20
2022-09-04,Tulare,107,460477,120964,120592,35730,156322,1527
2022-09-04,Tuolumne,109,53932,15392,15294,913,16207,196
2022-09-04,Ventura,111,848112,206411,205627,15404,221031,1558
2022-09-04,Yolo,113,214977,46983,46882,4203,51085,334
2022-09-04,Yuba,115,75493,18681,18615,1680,20295,129
2022-09-03,Alameda,001,1643700,343187,341621,19383,361004,1998
2022-09-03,Alpine,003,1148,133,133,1,134,0
2022-09-03,Amador,005,37829,9888,9855,916,10771,89
2022-09-03,Butte,007,227075,39049,38851,8940,47791,453
2022-09-03,Calaveras,009,45235,8433,8422,522,8944,133
2022-09-03,Colusa,011,21464,3757,3742,1260,5002,22
2022-09-03,Contra Costa,013,1133247,248398,245022,20418,265440,1410
2022-09-03,Del Norte,015,27424,7345,7340,394,7734,56
2022-09-03,El Dorado,017,186661,31964,31929,4181,36110,229
2022-09-03,Fresno,019,978130,274923,271062,31120,302182,2835
2022-09-03,Glenn,021,27897,5483,5462,1844,7306,48
2022-09-03,Humboldt,023,135768,21481,21390,4876,26266,154
2022-09-03,Imperial,025,180216,64888,64678,15385,80063,956
2022-09-03,Inyo,027,18085,4458,4449,917,5366,59
2022-09-03,Kern,029,883053,217610,216471,62276,278747,2404
2022-09-03,Kings,031,150075,58912,58753,4061,62814,455
2022-09-03,Lake,033,64148,12671,12608,1148,13756,143
2022-09-03,Lassen,035,31185,9920,9908,982,10890,64
2022-09-03,Los Angeles,037,10098052,3249384,3235242,177167,3412409,32927
2022-09-03,Madera,039,155013,43548,43403,8146,51549,373
2022-09-03,Marin,041,260295,44600,44394,5191,49585,305
2022-09-03,Mariposa,043,17540,3068,3036,340,3376,31
2022-09-03,Mendocino,045,87422,15855,15781,4397,20178,134
2022-09-03,Merced,047,269075,71982,71280,11688,82968,856
2022-09-03,Modoc,049,8938,870,868,315,1183,11
2022-09-03,Mono,051,14174,3193,3183,243,3426,7
2022-09-03,Monterey,053,433212,93544,93246,20720,113966,761
2022-09-03,Napa,055,140530,31837,31799,1389,33188,156
2022-09-03,Nevada,057,99092,18787,18705,1792,20497,132
2022-09-03,Orange,059,3164182,661130,659290,61584,720874,7347
2022-09-03,Placer,061,380077,75030,74754,9403,84157,657
2022-09-03,Plumas,063,18699,3594,3587,430,4017,13
2022-09-03,Riverside,065,2383286,689752,687184,34775,721959,6581
2022-09-03,Sacramento,067,1510023,342978,341766,33433,375199,3243
2022-09-03,San Benito,069,59416,16089,15900,946,16846,103
2022-09-03,San Bernardino,071,2135413,665794,658354,30500,688854,8006
2022-09-03,San Diego,073,3302833,914451,912824,70983,983807,5464
2022-09-03,San Francisco,075,870044,176613,176131,11927,188058,1015
2022-09-03,San Joaquin,077,732212,196010,194904,14670,209574,2301
2022-09-03,San Luis Obispo,079,281455,62737,62455,6997,69452,517
2022-09-03,San Mateo,081,765935,166679,165520,10318,175838,738
2022-09-03,Santa Barbara,083,443738,104709,104161,6769,110930,716
2022-09-03,Santa Clara,085,1922200,430607,425040,18708,443748,2473
2022-09-03,Santa Cruz,087,273765,62315,61989,3381,65370,273
2022-09-03,Shasta,089,179085,34545,34422,7261,41683,591
2022-09-03,Sierra,091,2930,303,303,60,363,5
2022-09-03,Siskiyou,093,43540,5066,5168,3270,8438,89
2022-09-03,Solano,095,438530,103976,103457,7751,111208,461
2022-09-03,Sonoma,097,501317,105711,105162,5202,110364,517
2022-09-03,Stanislaus,099,539301,136690,136168,21397,157565,1726
2022-09-03,Sutter,101,95872,23966,23927,2451,26378,228
2022-09-03,Tehama,103,63373,13493,13406,3038,16444,210
2022-09-03,Trinity,105,12862,1390,1377,376,1753,20
2022-09-03,Tulare,107,460477,120932,120592,35692,156284,1527
2022-09-03,Tuolumne,109,53932,15387,15294,913,16207,196
2022-09-03,Ventura,111,848112,206330,205627,15393,221020,1558
2022-09-03,Yolo,113,214977,46973,46882,4201,51083,334
2022-09-03,Yuba,115,75493,18672,18615,1679,20294,129
2022-09-02,Alameda,001,1643700,343056,341621,19377,360998,1998
2022-09-02,Alpine,003,1148,133,133,1,134,0
2022-09-02,Amador,005,37829,9886,9855,916,10771,89
2022-09-02,Butte,007,227075,39037,38851,8928,47779,453
2022-09-02,Calaveras,009,45235,8428,8422,522,8944,133
2022-09-02,Colusa,011,21464,3756,3742,1260,5002,22
2022-09-02,Contra Costa,013,1133247,248302,245022,20407,265429,1410
2022-09-02,Del Norte,015,27424,7344,7340,393,7733,56
2022-09-02,El Dorado,017,186661,31952,31929,4179,36108,229
2022-09-02,Fresno,019,978130,274809,271062,31100,302162,2835
2022-09-02,Glenn,021,27897,5479,5462,1844,7306,48
2022-09-02,Humboldt,023,135768,21472,21390,4873,26263,154
2022-09-02,Imperial,025,180216,64867,64678,15372,80050,956
2022-09-02,Inyo,027,18085,4455,4449,916,5365,59
2022-09-02,Kern,029,883053,217529,216471,62208,278679,2404
2022-09-02,Kings,031,150075,58900,58753,4058,62811,455
2022-09-02,Lake,033,64148,12667,12608,1147,13755,143
2022-09-02,Lassen,035,31185,9919,9908,982,10890,64
2022-09-02,Los Angeles,037,10098052,3248330,3235242,177004,3412246,32927
2022-09-02,Madera,039,155013,43534,43403,8142,51545,373
2022-09-02,Marin,041,260295,44582,44394,5181,49575,305
2022-09-02,Mariposa,043,17540,3064,3036,339,3375,31
2022-09-02,Mendocino,045,87422,15853,15781,4396,20177,134
2022-09-02,Merced,047,269075,71956,71280,11685,82965,856
2022-09-02,Modoc,049,8938,870,868,315,1183,11
2022-09-02,Mono,051,14174,3193,3183,243,3426,7
2022-09-02,Monterey,053,433212,93517,93246,20703,113949,761
2022-09-02,Napa,055,140530,31824,31799,1389,33188,156
2022-09-02,Nevada,057,99092,18782,18705,1790,20495,132
2022-09-02,Orange,059,3164182,660940,659290,61521,720811,7347
2022-09-02,Placer,061,380077,75013,74754,9397,84151,657
2022-09-02,Plumas,063,18699,3593,3587,430,4017,13
2022-09-02,Riverside,065,2383286,689504,687184,34761,721945,6581
2022-09-02,Sacramento,067,1510023,342831,341766,33426,375192,3243
2022-09-02,San Benito,069,59416,16082,15900,946,16846,103
2022-09-02,San Bernardino,071,2135413,665618,658354,30484,688838,8006
2022-09-02,San Diego,073,3302833,914178,912824,70956,983780,5464
2022-09-02,San Francisco,075,870044,176546,176131,11911,188042,1015
2022-09-02,San Joaquin,077,732212,195905,194904,14652,209556,2301
2022-09-02,San Luis Obispo,079,281455,62721,62455,6996,69451,517
2022-09-02,San Mateo,081,765935,166595,165520,10315,175835,738
2022-09-02,Santa Barbara,083,443738,104661,104161,6767,110928,716
2022-09-02,Santa Clara,085,1922200,430405,425040,18694,443734,2473
2022-09-02,Santa Cruz,087,273765,62292,61989,3379,65368,273
2022-09-02,Shasta,089,179085,34539,34422,7258,41680,591
2022-09-02,Sierra,091,2930,303,303,60,363,5
2022-09-02,Siskiyou,093,43540,5063,5168,3270,8438,89
2022-09-02,Solano,095,438530,103942,103457,7746,111203,461
2022-09-02,Sonoma,097,501317,105675,105162,5200,110362,517
2022-09-02,Stanislaus,099,539301,136644,136168,21391,157559,1726
2022-09-02,Sutter,101,95872,23955,23927,2451,26378,228
2022-09-02,Tehama,103,63373,13491,13406,3036,16442,210
2022-09-02,Trinity,105,12862,1389,1377,376,1753,20
2022-09-02,Tulare,107,460477,120889,120592,35669,156261,1527
2022-09-02,Tuolumne,109,53932,15385,15294,912,16206,196
2022-09-02,Ventura,111,848112,206239,205627,15380,221007,1558
2022-09-02,Yolo,113,214977,46962,46882,4197,51079,334
2022-09-02,Yuba,115,75493,18664,18615,1676,20291,129
2022-09-01,Alameda,001,1643700,342825,341621,19363,360984,1998
2022-09-01,Alpine,003,1148,133,133,1,134,0
2022-09-01,Amador,005,37829,9882,9855,916,10771,89
2022-09-01,Butte,007,227075,39008,38851,8914,47765,453
2022-09-01,Calaveras,009,45235,8422,8422,521,8943,133
2022-09-01,Colusa,011,21464,3752,3742,1260,5002,22
2022-09-01,Contra Costa,013,1133247,248148,245022,20385,265407,1410
2022-09-01,Del Norte,015,27424,7343,7340,391,7731,56
2022-09-01,El Dorado,017,186661,31943,31929,4178,36107,229
2022-09-01,Fresno,019,978130,274635,271062,31039,302101,2835
2022-09-01,Glenn,021,27897,5477,5462,1844,7306,48
2022-09-01,Humboldt,023,135768,21459,21390,4866,26256,154
2022-09-01,Imperial,025,180216,64820,64678,15350,80028,956
2022-09-01,Inyo,027,18085,4453,4449,915,5364,59
2022-09-01,Kern,029,883053,217454,216471,62092,278563,2404
2022-09-01,Kings,031,150075,58872,58753,4056,62809,455
2022-09-01,Lake,033,64148,12657,12608,1145,13753,143
2022-09-01,Lassen,035,31185,9919,9908,980,10888,64
2022-09-01,Los Angeles,037,10098052,3246745,3235242,176781,3412023,32927
2022-09-01,Madera,039,155013,43497,43403,8139,51542,373
2022-09-01,Marin,041,260295,44549,44394,5173,49567,305
2022-09-01,Mariposa,043,17540,3063,3036,339,3375,31
2022-09-01,Mendocino,045,87422,15848,15781,4394,20175,134
2022-09-01,Merced,047,269075,71923,71280,11670,82950,856
2022-09-01,Modoc,049,8938,870,868,314,1182,11
2022-09-01,Mono,051,14174,3193,3183,242,3425,7
2022-09-01,Monterey,053,433212,93477,93246,20683,113929,761
2022-09-01,Napa,055,140530,31805,31799,1389,33188,156
2022-09-01,Nevada,057,99092,18773,18705,1790,20495,132
2022-09-01,Orange,059,3164182,660627,659290,61440,720730,7347
2022-09-01,Placer,061,380077,74976,74754,9390,84144,657
2022-09-01,Plumas,063,18699,3592,3587,430,4017,13
2022-09-01,Riverside,065,2383286,689164,687184,34721,721905,6581
2022-09-01,Sacramento,067,1510023,342634,341766,33386,375152,3243
2022-09-01,San Benito,069,59416,16074,15900,945,16845,103
2022-09-01,San Bernardino,071,2135413,665288,658354,30451,688805,8006
2022-09-01,San Diego,073,3302833,913760,912824,70906,983730,5464
2022-09-01,San Francisco,075,870044,176408,176131,11900,188031,1015
2022-09-01,San Joaquin,077,732212,195814,194904,14632,209536,2301
2022-09-01,San Luis Obispo,079,281455,62683,62455,6989,69444,517
2022-09-01,San Mateo,081,765935,166500,165520,10306,175826,738
2022-09-01,Santa Barbara,083,443738,104599,104161,6759,110920,716
2022-09-01,Santa Clara,085,1922200,430114,425040,18685,443725,2473
2022-09-01,Santa Cruz,087,273765,62239,61989,3374,65363,273
2022-09-01,Shasta,089,179085,34519,34422,7253,41675,591
2022-09-01,Sierra,091,2930,303,303,60,363,5
2022-09-01,Siskiyou,093,43540,5062,5168,3269,8437,89
2022-09-01,Solano,095,438530,103873,103457,7742,111199,461
2022-09-01,Sonoma,097,501317,105606,105162,5193,110355,517
2022-09-01,Stanislaus,099,539301,136563,136168,21375,157543,1726
2022-09-01,Sutter,101,95872,23936,23927,2449,26376,228
2022-09-01,Tehama,103,63373,13485,13406,3033,16439,210
2022-09-01,Trinity,105,12862,1388,1377,373,1750,20
2022-09-01,Tulare,107,460477,120835,120592,35625,156217,1527
2022-09-01,Tuolumne,109,53932,15377,15294,912,16206,196
2022-09-01,Ventura,111,848112,206093,205627,15363,220990,1558
2022-09-01,Yolo,113,214977,46933,46882,4190,51072,334
2022-09-01,Yuba,115,75493,18650,18615,1676,20291,129
2022-08-31,Alameda,001,1643700,342593,340789,19349,360138,1986
2022-08-31,Alpine,003,1148,133,133,1,134,0
2022-08-31,Amador,005,37829,9878,9829,914,10743,89
2022-08-31,Butte,007,227075,38972,38720,8898,47618,452
2022-08-31,Calaveras,009,45235,8418,8404,520,8924,133
2022-08-31,Colusa,011,21464,3751,3744,1260,5004,22
2022-08-31,Contra Costa,013,1133247,247989,244168,20359,264527,1409
2022-08-31,Del Norte,015,27424,7340,7333,391,7724,56
2022-08-31,El Dorado,017,186661,31934,31864,4174,36038,226
2022-08-31,Fresno,019,978130,274453,270456,30906,301362,2829
2022-08-31,Glenn,021,27897,5476,5448,1843,7291,48
2022-08-31,Humboldt,023,135768,21433,21325,4861,26186,154
2022-08-31,Imperial,025,180216,64790,64562,15328,79890,953
2022-08-31,Inyo,027,18085,4451,4444,914,5358,59
2022-08-31,Kern,029,883053,217341,216037,61954,277991,2404
2022-08-31,Kings,031,150075,58836,58629,4051,62680,455
2022-08-31,Lake,033,64148,12646,12563,1145,13708,142
2022-08-31,Lassen,035,31185,9914,9889,979,10868,64
2022-08-31,Los Angeles,037,10098052,3244926,3228552,176545,3405097,32877
2022-08-31,Madera,039,155013,43465,43269,8125,51394,372
2022-08-31,Marin,041,260295,44519,44330,5167,49497,305
2022-08-31,Mariposa,043,17540,3062,3025,339,3364,31
2022-08-31,Mendocino,045,87422,15840,15733,4390,20123,134
2022-08-31,Merced,047,269075,71891,71089,11648,82737,852
2022-08-31,Modoc,049,8938,868,865,314,1179,11
2022-08-31,Mono,051,14174,3192,3181,241,3422,7
2022-08-31,Monterey,053,433212,93433,93046,20661,113707,762
2022-08-31,Napa,055,140530,31789,31725,1388,33113,156
2022-08-31,Nevada,057,99092,18756,18649,1789,20438,132
2022-08-31,Orange,059,3164182,660218,658076,61351,719427,7340
2022-08-31,Placer,061,380077,74934,74612,9384,83996,657
2022-08-31,Plumas,063,18699,3591,3581,430,4011,13
2022-08-31,Riverside,065,2383286,688755,685704,34683,720387,6581
2022-08-31,Sacramento,067,1510023,342425,340949,33340,374289,3230
2022-08-31,San Benito,069,59416,16062,15860,943,16803,103
2022-08-31,San Bernardino,071,2135413,664854,656343,30413,686756,8014
2022-08-31,San Diego,073,3302833,913292,910878,70848,981726,5459
2022-08-31,San Francisco,075,870044,176293,175752,11891,187643,1001
2022-08-31,San Joaquin,077,732212,195655,194437,14613,209050,2298
2022-08-31,San Luis Obispo,079,281455,62653,62312,6977,69289,515
2022-08-31,San Mateo,081,765935,166397,165161,10299,175460,738
2022-08-31,Santa Barbara,083,443738,104512,103894,6750,110644,717
2022-08-31,Santa Clara,085,1922200,429810,424011,18667,442678,2467
2022-08-31,Santa Cruz,087,273765,62190,61812,3371,65183,272
2022-08-31,Shasta,089,179085,34504,34355,7246,41601,590
2022-08-31,Sierra,091,2930,303,302,60,362,5
2022-08-31,Siskiyou,093,43540,5054,5152,3268,8420,89
2022-08-31,Solano,095,438530,103810,103173,7737,110910,461
2022-08-31,Sonoma,097,501317,105534,104964,5183,110147,527
2022-08-31,Stanislaus,099,539301,136472,135801,21353,157154,1722
2022-08-31,Sutter,101,95872,23921,23856,2448,26304,228
2022-08-31,Tehama,103,63373,13472,13370,3028,16398,210
2022-08-31,Trinity,105,12862,1388,1373,373,1746,20
2022-08-31,Tulare,107,460477,120757,120346,35580,155926,1527
2022-08-31,Tuolumne,109,53932,15368,15250,910,16160,196
2022-08-31,Ventura,111,848112,205948,205157,15346,220503,1557
2022-08-31,Yolo,113,214977,46900,46807,4178,50985,334
2022-08-31,Yuba,115,75493,18627,18558,1673,20231,129
2022-08-30,Alameda,001,1643700,342347,340789,19328,360117,1986
2022-08-30,Alpine,003,1148,133,133,1,134,0
2022-08-30,Amador,005,37829,9867,9829,914,10743,89
2022-08-30,Butte,007,227075,38937,38720,8883,47603,452
2022-08-30,Calaveras,009,45235,8415,8404,518,8922,133
2022-08-30,Colusa,011,21464,3750,3744,1258,5002,22
2022-08-30,Contra Costa,013,1133247,247834,244168,20340,264508,1409
2022-08-30,Del Norte,015,27424,7339,7333,391,7724,56
2022-08-30,El Dorado,017,186661,31916,31864,4171,36035,226
2022-08-30,Fresno,019,978130,274252,270456,30809,301265,2829
2022-08-30,Glenn,021,27897,5476,5448,1842,7290,48
2022-08-30,Humboldt,023,135768,21412,21325,4857,26182,154
2022-08-30,Imperial,025,180216,64743,64562,15293,79855,953
2022-08-30,Inyo,027,18085,4450,4444,911,5355,59
2022-08-30,Kern,029,883053,217211,216037,61807,277844,2404
2022-08-30,Kings,031,150075,58780,58629,4047,62676,455
2022-08-30,Lake,033,64148,12636,12563,1143,13706,142
2022-08-30,Lassen,035,31185,9910,9889,979,10868,64
2022-08-30,Los Angeles,037,10098052,3242830,3228552,176280,3404832,32877
2022-08-30,Madera,039,155013,43415,43269,8109,51378,372
2022-08-30,Marin,041,260295,44486,44330,5163,49493,305
2022-08-30,Mariposa,043,17540,3058,3025,339,3364,31
2022-08-30,Mendocino,045,87422,15829,15733,4380,20113,134
2022-08-30,Merced,047,269075,71842,71089,11626,82715,852
2022-08-30,Modoc,049,8938,868,865,314,1179,11
2022-08-30,Mono,051,14174,3190,3181,241,3422,7
2022-08-30,Monterey,053,433212,93387,93046,20646,113692,762
2022-08-30,Napa,055,140530,31771,31725,1387,33112,156
2022-08-30,Nevada,057,99092,18738,18649,1769,20418,132
2022-08-30,Orange,059,3164182,659773,658076,61240,719316,7340
2022-08-30,Placer,061,380077,74898,74612,9376,83988,657
2022-08-30,Plumas,063,18699,3590,3581,430,4011,13
2022-08-30,Riverside,065,2383286,688312,685704,34645,720349,6581
2022-08-30,Sacramento,067,1510023,342230,340949,33299,374248,3230
2022-08-30,San Benito,069,59416,16048,15860,940,16800,103
2022-08-30,San Bernardino,071,2135413,664379,656343,30381,686724,8014
2022-08-30,San Diego,073,3302833,912764,910878,70753,981631,5459
2022-08-30,San Francisco,075,870044,176173,175752,11882,187634,1001
2022-08-30,San Joaquin,077,732212,195503,194437,14579,209016,2298
2022-08-30,San Luis Obispo,079,281455,62614,62312,6963,69275,515
2022-08-30,San Mateo,081,765935,166291,165161,10290,175451,738
2022-08-30,Santa Barbara,083,443738,104417,103894,6740,110634,717
2022-08-30,Santa Clara,085,1922200,429486,424011,18652,442663,2467
2022-08-30,Santa Cruz,087,273765,62138,61812,3365,65177,272
2022-08-30,Shasta,089,179085,34481,34355,7241,41596,590
2022-08-30,Sierra,091,2930,303,302,60,362,5
2022-08-30,Siskiyou,093,43540,5046,5152,3266,8418,89
2022-08-30,Solano,095,438530,103722,103173,7730,110903,461
2022-08-30,Sonoma,097,501317,105472,104964,5176,110140,527
2022-08-30,Stanislaus,099,539301,136366,135801,21338,157139,1722
2022-08-30,Sutter,101,95872,23903,23856,2448,26304,228
2022-08-30,Tehama,103,63373,13465,13370,3021,16391,210
2022-08-30,Trinity,105,12862,1387,1373,372,1745,20
2022-08-30,Tulare,107,460477,120672,120346,35527,155873,1527
2022-08-30,Tuolumne,109,53932,15353,15250,910,16160,196
2022-08-30,Ventura,111,848112,205786,205157,15308,220465,1557
2022-08-30,Yolo,113,214977,46880,46807,4170,50977,334
2022-08-30,Yuba,115,75493,18615,18558,1671,20229,129
2022-08-29,Alameda,001,1643700,342020,340789,19302,360091,1986
2022-08-29,Alpine,003,1148,133,133,1,134,0
2022-08-29,Amador,005,37829,9853,9829,913,10742,89
2022-08-29,Butte,007,227075,38895,38720,8867,47587,452
2022-08-29,Calaveras,009,45235,8414,8404,516,8920,133
2022-08-29,Colusa,011,21464,3750,3744,1258,5002,22
2022-08-29,Contra Costa,013,1133247,247658,244168,20316,264484,1409
2022-08-29,Del Norte,015,27424,7338,7333,391,7724,56
2022-08-29,El Dorado,017,186661,31898,31864,4167,36031,226
2022-08-29,Fresno,019,978130,274024,270456,30769,301225,2829
2022-08-29,Glenn,021,27897,5474,5448,1839,7287,48
2022-08-29,Humboldt,023,135768,21389,21325,4850,26175,154
2022-08-29,Imperial,025,180216,64699,64562,15254,79816,953
2022-08-29,Inyo,027,18085,4449,4444,907,5351,59
2022-08-29,Kern,029,883053,217043,216037,61671,277708,2404
2022-08-29,Kings,031,150075,58710,58629,4043,62672,455
2022-08-29,Lake,033,64148,12622,12563,1142,13705,142
2022-08-29,Lassen,035,31185,9904,9889,979,10868,64
2022-08-29,Los Angeles,037,10098052,3240600,3228552,176002,3404554,32877
2022-08-29,Madera,039,155013,43376,43269,8089,51358,372
2022-08-29,Marin,041,260295,44452,44330,5157,49487,305
2022-08-29,Mariposa,043,17540,3054,3025,338,3363,31
2022-08-29,Mendocino,045,87422,15814,15733,4369,20102,134
2022-08-29,Merced,047,269075,71782,71089,11597,82686,852
2022-08-29,Modoc,049,8938,867,865,313,1178,11
2022-08-29,Mono,051,14174,3189,3181,241,3422,7
2022-08-29,Monterey,053,433212,93349,93046,20616,113662,762
2022-08-29,Napa,055,140530,31751,31725,1387,33112,156
2022-08-29,Nevada,057,99092,18722,18649,1767,20416,132
2022-08-29,Orange,059,3164182,659333,658076,61153,719229,7340
2022-08-29,Placer,061,380077,74859,74612,9364,83976,657
2022-08-29,Plumas,063,18699,3589,3581,430,4011,13
2022-08-29,Riverside,065,2383286,687744,685704,34588,720292,6581
2022-08-29,Sacramento,067,1510023,341955,340949,33242,374191,3230
2022-08-29,San Benito,069,59416,16035,15860,938,16798,103
2022-08-29,San Bernardino,071,2135413,663799,656343,30343,686686,8014
2022-08-29,San Diego,073,3302833,912137,910878,70685,981563,5459
2022-08-29,San Francisco,075,870044,176068,175752,11871,187623,1001
2022-08-29,San Joaquin,077,732212,195359,194437,14549,208986,2298
2022-08-29,San Luis Obispo,079,281455,62581,62312,6950,69262,515
2022-08-29,San Mateo,081,765935,166185,165161,10281,175442,738
2022-08-29,Santa Barbara,083,443738,104322,103894,6729,110623,717
2022-08-29,Santa Clara,085,1922200,429092,424011,18624,442635,2467
2022-08-29,Santa Cruz,087,273765,62071,61812,3358,65170,272
2022-08-29,Shasta,089,179085,34462,34355,7228,41583,590
2022-08-29,Sierra,091,2930,303,302,60,362,5
2022-08-29,Siskiyou,093,43540,5042,5152,3265,8417,89
2022-08-29,Solano,095,438530,103641,103173,7720,110893,461
2022-08-29,Sonoma,097,501317,105391,104964,5170,110134,527
2022-08-29,Stanislaus,099,539301,136246,135801,21305,157106,1722
2022-08-29,Sutter,101,95872,23875,23856,2445,26301,228
2022-08-29,Tehama,103,63373,13456,13370,3020,16390,210
2022-08-29,Trinity,105,12862,1386,1373,372,1745,20
2022-08-29,Tulare,107,460477,120580,120346,35459,155805,1527
2022-08-29,Tuolumne,109,53932,15338,15250,910,16160,196
2022-08-29,Ventura,111,848112,205638,205157,15285,220442,1557
2022-08-29,Yolo,113,214977,46854,46807,4160,50967,334
2022-08-29,Yuba,115,75493,18597,18558,1666,20224,129
2022-08-28,Alameda,001,1643700,341697,339618,19279,358897,1978
2022-08-28,Alpine,003,1148,133,133,1,134,0
2022-08-28,Amador,005,37829,9846,9802,911,10713,89
2022-08-28,Butte,007,227075,38844,38606,8856,47462,452
2022-08-28,Calaveras,009,45235,8406,8368,515,8883,133
2022-08-28,Colusa,011,21464,3748,3736,1254,4990,22
2022-08-28,Contra Costa,013,1133247,247438,243331,20296,263627,1404
2022-08-28,Del Norte,015,27424,7332,7316,390,7706,55
2022-08-28,El Dorado,017,186661,31867,31760,4159,35919,226
2022-08-28,Fresno,019,978130,273776,269680,30713,300393,2829
2022-08-28,Glenn,021,27897,5471,5434,1837,7271,49
2022-08-28,Humboldt,023,135768,21364,21264,4836,26100,154
2022-08-28,Imperial,025,180216,64646,64391,15205,79596,953
2022-08-28,Inyo,027,18085,4448,4443,904,5347,59
2022-08-28,Kern,029,883053,216905,215612,61490,277102,2399
2022-08-28,Kings,031,150075,58653,58443,4032,62475,455
2022-08-28,Lake,033,64148,12610,12524,1138,13662,142
2022-08-28,Lassen,035,31185,9892,9871,979,10850,64
2022-08-28,Los Angeles,037,10098052,3237904,3219328,175647,3394975,32833
2022-08-28,Madera,039,155013,43326,43105,8055,51160,372
2022-08-28,Marin,041,260295,44420,44192,5148,49340,305
2022-08-28,Mariposa,043,17540,3048,3018,337,3355,31
2022-08-28,Mendocino,045,87422,15800,15698,4365,20063,134
2022-08-28,Merced,047,269075,71707,70906,11547,82453,851
2022-08-28,Modoc,049,8938,867,865,313,1178,11
2022-08-28,Mono,051,14174,3188,3181,241,3422,7
2022-08-28,Monterey,053,433212,93282,92844,20587,113431,760
2022-08-28,Napa,055,140530,31723,31668,1386,33054,156
2022-08-28,Nevada,057,99092,18699,18592,1766,20358,132
2022-08-28,Orange,059,3164182,658872,656440,61043,717483,7326
2022-08-28,Placer,061,380077,74813,74391,9352,83743,657
2022-08-28,Plumas,063,18699,3586,3571,430,4001,13
2022-08-28,Riverside,065,2383286,687111,683511,34520,718031,6580
2022-08-28,Sacramento,067,1510023,341633,339846,33171,373017,3222
2022-08-28,San Benito,069,59416,16022,15805,935,16740,103
2022-08-28,San Bernardino,071,2135413,663198,653843,30286,684129,8017
2022-08-28,San Diego,073,3302833,911378,908809,70577,979386,5456
2022-08-28,San Francisco,075,870044,175913,175204,11859,187063,1000
2022-08-28,San Joaquin,077,732212,195125,193880,14519,208399,2296
2022-08-28,San Luis Obispo,079,281455,62532,62105,6931,69036,515
2022-08-28,San Mateo,081,765935,166033,164675,10268,174943,738
2022-08-28,Santa Barbara,083,443738,104188,103496,6710,110206,717
2022-08-28,Santa Clara,085,1922200,428682,422650,18603,441253,2459
2022-08-28,Santa Cruz,087,273765,61970,61594,3344,64938,273
2022-08-28,Shasta,089,179085,34428,34283,7214,41497,590
2022-08-28,Sierra,091,2930,302,300,60,360,5
2022-08-28,Siskiyou,093,43540,5036,5140,3263,8403,89
2022-08-28,Solano,095,438530,103546,102855,7712,110567,460
2022-08-28,Sonoma,097,501317,105308,104646,5160,109806,557
2022-08-28,Stanislaus,099,539301,136093,135310,21278,156588,1722
2022-08-28,Sutter,101,95872,23848,23759,2442,26201,228
2022-08-28,Tehama,103,63373,13436,13340,3018,16358,210
2022-08-28,Trinity,105,12862,1386,1370,370,1740,20
2022-08-28,Tulare,107,460477,120466,119942,35352,155294,1527
2022-08-28,Tuolumne,109,53932,15332,15193,905,16098,196
2022-08-28,Ventura,111,848112,205439,204567,15217,219784,1553
2022-08-28,Yolo,113,214977,46802,46744,4149,50893,334
2022-08-28,Yuba,115,75493,18578,18482,1660,20142,129
2022-08-27,Alameda,001,1643700,341509,339618,19269,358887,1978
2022-08-27,Alpine,003,1148,133,133,1,134,0
2022-08-27,Amador,005,37829,9840,9802,910,10712,89
2022-08-27,Butte,007,227075,38816,38606,8843,47449,452
2022-08-27,Calaveras,009,45235,8401,8368,515,8883,133
2022-08-27,Colusa,011,21464,3746,3736,1249,4985,22
2022-08-27,Contra Costa,013,1133247,247297,243331,20287,263618,1404
2022-08-27,Del Norte,015,27424,7330,7316,390,7706,55
2022-08-27,El Dorado,017,186661,31855,31760,4155,35915,226
2022-08-27,Fresno,019,978130,273653,269680,30697,300377,2829
2022-08-27,Glenn,021,27897,5469,5434,1837,7271,49
2022-08-27,Humboldt,023,135768,21348,21264,4828,26092,154
2022-08-27,Imperial,025,180216,64624,64391,15195,79586,953
2022-08-27,Inyo,027,18085,4447,4443,904,5347,59
2022-08-27,Kern,029,883053,216823,215612,61381,276993,2399
2022-08-27,Kings,031,150075,58623,58443,4029,62472,455
2022-08-27,Lake,033,64148,12605,12524,1134,13658,142
2022-08-27,Lassen,035,31185,9888,9871,979,10850,64
2022-08-27,Los Angeles,037,10098052,3236583,3219328,175433,3394761,32833
2022-08-27,Madera,039,155013,43291,43105,8051,51156,372
2022-08-27,Marin,041,260295,44399,44192,5139,49331,305
2022-08-27,Mariposa,043,17540,3047,3018,336,3354,31
2022-08-27,Mendocino,045,87422,15794,15698,4363,20061,134
2022-08-27,Merced,047,269075,71663,70906,11539,82445,851
2022-08-27,Modoc,049,8938,867,865,313,1178,11
2022-08-27,Mono,051,14174,3187,3181,241,3422,7
2022-08-27,Monterey,053,433212,93251,92844,20571,113415,760
2022-08-27,Napa,055,140530,31708,31668,1384,33052,156
2022-08-27,Nevada,057,99092,18688,18592,1764,20356,132
2022-08-27,Orange,059,3164182,658611,656440,60940,717380,7326
2022-08-27,Placer,061,380077,74776,74391,9348,83739,657
2022-08-27,Plumas,063,18699,3585,3571,430,4001,13
2022-08-27,Riverside,065,2383286,686778,683511,34494,718005,6580
2022-08-27,Sacramento,067,1510023,341502,339846,33153,372999,3222
2022-08-27,San Benito,069,59416,16006,15805,931,16736,103
2022-08-27,San Bernardino,071,2135413,662883,653843,30255,684098,8017
2022-08-27,San Diego,073,3302833,911039,908809,70536,979345,5456
2022-08-27,San Francisco,075,870044,175840,175204,11853,187057,1000
2022-08-27,San Joaquin,077,732212,195066,193880,14498,208378,2296
2022-08-27,San Luis Obispo,079,281455,62517,62105,6924,69029,515
2022-08-27,San Mateo,081,765935,165939,164675,10265,174940,738
2022-08-27,Santa Barbara,083,443738,104125,103496,6699,110195,717
2022-08-27,Santa Clara,085,1922200,428471,422650,18590,441240,2459
2022-08-27,Santa Cruz,087,273765,61957,61594,3343,64937,273
2022-08-27,Shasta,089,179085,34417,34283,7209,41492,590
2022-08-27,Sierra,091,2930,302,300,60,360,5
2022-08-27,Siskiyou,093,43540,5034,5140,3263,8403,89
2022-08-27,Solano,095,438530,103509,102855,7704,110559,460
2022-08-27,Sonoma,097,501317,105266,104646,5157,109803,557
2022-08-27,Stanislaus,099,539301,136014,135310,21257,156567,1722
2022-08-27,Sutter,101,95872,23833,23759,2442,26201,228
2022-08-27,Tehama,103,63373,13430,13340,3017,16357,210
2022-08-27,Trinity,105,12862,1385,1370,368,1738,20
2022-08-27,Tulare,107,460477,120406,119942,35303,155245,1527
2022-08-27,Tuolumne,109,53932,15325,15193,904,16097,196
2022-08-27,Ventura,111,848112,205354,204567,15204,219771,1553
2022-08-27,Yolo,113,214977,46782,46744,4145,50889,334
2022-08-27,Yuba,115,75493,18566,18482,1659,20141,129
2022-08-26,Alameda,001,1643700,341340,339618,19262,358880,1978
2022-08-26,Alpine,003,1148,133,133,1,134,0
2022-08-26,Amador,005,37829,9837,9802,908,10710,89
2022-08-26,Butte,007,227075,38802,38606,8831,47437,452
2022-08-26,Calaveras,009,45235,8396,8368,515,8883,133
2022-08-26,Colusa,011,21464,3745,3736,1249,4985,22
2022-08-26,Contra Costa,013,1133247,247141,243331,20280,263611,1404
2022-08-26,Del Norte,015,27424,7328,7316,390,7706,55
2022-08-26,El Dorado,017,186661,31835,31760,4154,35914,226
2022-08-26,Fresno,019,978130,273496,269680,30662,300342,2829
2022-08-26,Glenn,021,27897,5466,5434,1835,7269,49
2022-08-26,Humboldt,023,135768,21341,21264,4826,26090,154
2022-08-26,Imperial,025,180216,64601,64391,15182,79573,953
2022-08-26,Inyo,027,18085,4446,4443,897,5340,59
2022-08-26,Kern,029,883053,216733,215612,61284,276896,2399
2022-08-26,Kings,031,150075,58609,58443,4027,62470,455
2022-08-26,Lake,033,64148,12597,12524,1133,13657,142
2022-08-26,Lassen,035,31185,9886,9871,979,10850,64
2022-08-26,Los Angeles,037,10098052,3235173,3219328,175218,3394546,32833
2022-08-26,Madera,039,155013,43261,43105,8045,51150,372
2022-08-26,Marin,041,260295,44367,44192,5137,49329,305
2022-08-26,Mariposa,043,17540,3042,3018,332,3350,31
2022-08-26,Mendocino,045,87422,15788,15698,4361,20059,134
2022-08-26,Merced,047,269075,71623,70906,11531,82437,851
2022-08-26,Modoc,049,8938,866,865,313,1178,11
2022-08-26,Mono,051,14174,3187,3181,241,3422,7
2022-08-26,Monterey,053,433212,93211,92844,20556,113400,760
2022-08-26,Napa,055,140530,31694,31668,1384,33052,156
2022-08-26,Nevada,057,99092,18676,18592,1762,20354,132
2022-08-26,Orange,059,3164182,658352,656440,60878,717318,7326
2022-08-26,Placer,061,380077,74741,74391,9336,83727,657
2022-08-26,Plumas,063,18699,3584,3571,430,4001,13
2022-08-26,Riverside,065,2383286,686428,683511,34458,717969,6580
2022-08-26,Sacramento,067,1510023,341316,339846,33139,372985,3222
2022-08-26,San Benito,069,59416,15995,15805,931,16736,103
2022-08-26,San Bernardino,071,2135413,662565,653843,30229,684072,8017
2022-08-26,San Diego,073,3302833,910617,908809,70513,979322,5456
2022-08-26,San Francisco,075,870044,175756,175204,11847,187051,1000
2022-08-26,San Joaquin,077,732212,194992,193880,14481,208361,2296
2022-08-26,San Luis Obispo,079,281455,62495,62105,6920,69025,515
2022-08-26,San Mateo,081,765935,165848,164675,10258,174933,738
2022-08-26,Santa Barbara,083,443738,104073,103496,6693,110189,717
2022-08-26,Santa Clara,085,1922200,428254,422650,18577,441227,2459
2022-08-26,Santa Cruz,087,273765,61910,61594,3339,64933,273
2022-08-26,Shasta,089,179085,34405,34283,7205,41488,590
2022-08-26,Sierra,091,2930,302,300,60,360,5
2022-08-26,Siskiyou,093,43540,5031,5140,3263,8403,89
2022-08-26,Solano,095,438530,103451,102855,7693,110548,460
2022-08-26,Sonoma,097,501317,105221,104646,5157,109803,557
2022-08-26,Stanislaus,099,539301,135937,135310,21248,156558,1722
2022-08-26,Sutter,101,95872,23814,23759,2441,26200,228
2022-08-26,Tehama,103,63373,13419,13340,3015,16355,210
2022-08-26,Trinity,105,12862,1385,1370,368,1738,20
2022-08-26,Tulare,107,460477,120344,119942,35255,155197,1527
2022-08-26,Tuolumne,109,53932,15313,15193,904,16097,196
2022-08-26,Ventura,111,848112,205274,204567,15189,219756,1553
2022-08-26,Yolo,113,214977,46770,46744,4141,50885,334
2022-08-26,Yuba,115,75493,18553,18482,1659,20141,129
2022-08-25,Alameda,001,1643700,341048,339618,19235,358853,1978
2022-08-25,Alpine,003,1148,133,133,1,134,0
2022-08-25,Amador,005,37829,9830,9802,908,10710,89
2022-08-25,Butte,007,227075,38778,38606,8823,47429,452
2022-08-25,Calaveras,009,45235,8390,8368,515,8883,133
2022-08-25,Colusa,011,21464,3745,3736,1247,4983,22
2022-08-25,Contra Costa,013,1133247,246937,243331,20260,263591,1404
2022-08-25,Del Norte,015,27424,7319,7316,390,7706,55
2022-08-25,El Dorado,017,186661,31814,31760,4149,35909,226
2022-08-25,Fresno,019,978130,273297,269680,30612,300292,2829
2022-08-25,Glenn,021,27897,5461,5434,1834,7268,49
2022-08-25,Humboldt,023,135768,21320,21264,4816,26080,154
2022-08-25,Imperial,025,180216,64559,64391,15154,79545,953
2022-08-25,Inyo,027,18085,4446,4443,890,5333,59
2022-08-25,Kern,029,883053,216593,215612,61180,276792,2399
2022-08-25,Kings,031,150075,58553,58443,4019,62462,455
2022-08-25,Lake,033,64148,12583,12524,1131,13655,142
2022-08-25,Lassen,035,31185,9885,9871,978,10849,64
2022-08-25,Los Angeles,037,10098052,3233020,3219328,174922,3394250,32833
2022-08-25,Madera,039,155013,43214,43105,8031,51136,372
2022-08-25,Marin,041,260295,44339,44192,5129,49321,305
2022-08-25,Mariposa,043,17540,3040,3018,332,3350,31
2022-08-25,Mendocino,045,87422,15779,15698,4360,20058,134
2022-08-25,Merced,047,269075,71576,70906,11499,82405,851
2022-08-25,Modoc,049,8938,866,865,313,1178,11
2022-08-25,Mono,051,14174,3187,3181,241,3422,7
2022-08-25,Monterey,053,433212,93159,92844,20535,113379,760
2022-08-25,Napa,055,140530,31677,31668,1383,33051,156
2022-08-25,Nevada,057,99092,18654,18592,1757,20349,132
2022-08-25,Orange,059,3164182,657946,656440,60786,717226,7326
2022-08-25,Placer,061,380077,74691,74391,9329,83720,657
2022-08-25,Plumas,063,18699,3582,3571,430,4001,13
2022-08-25,Riverside,065,2383286,685909,683511,34410,717921,6580
2022-08-25,Sacramento,067,1510023,341040,339846,33096,372942,3222
2022-08-25,San Benito,069,59416,15982,15805,930,16735,103
2022-08-25,San Bernardino,071,2135413,662034,653843,30195,684038,8017
2022-08-25,San Diego,073,3302833,910072,908809,70434,979243,5456
2022-08-25,San Francisco,075,870044,175643,175204,11842,187046,1000
2022-08-25,San Joaquin,077,732212,194845,193880,14456,208336,2296
2022-08-25,San Luis Obispo,079,281455,62395,62105,6910,69015,515
2022-08-25,San Mateo,081,765935,165721,164675,10250,174925,738
2022-08-25,Santa Barbara,083,443738,103978,103496,6678,110174,717
2022-08-25,Santa Clara,085,1922200,427938,422650,18556,441206,2459
2022-08-25,Santa Cruz,087,273765,61850,61594,3335,64929,273
2022-08-25,Shasta,089,179085,34386,34283,7193,41476,590
2022-08-25,Sierra,091,2930,302,300,60,360,5
2022-08-25,Siskiyou,093,43540,5026,5140,3258,8398,89
2022-08-25,Solano,095,438530,103366,102855,7683,110538,460
2022-08-25,Sonoma,097,501317,105145,104646,5150,109796,557
2022-08-25,Stanislaus,099,539301,135811,135310,21225,156535,1722
2022-08-25,Sutter,101,95872,23791,23759,2439,26198,228
2022-08-25,Tehama,103,63373,13411,13340,3008,16348,210
2022-08-25,Trinity,105,12862,1385,1370,367,1737,20
2022-08-25,Tulare,107,460477,120250,119942,35183,155125,1527
2022-08-25,Tuolumne,109,53932,15295,15193,903,16096,196
2022-08-25,Ventura,111,848112,205121,204567,15139,219706,1553
2022-08-25,Yolo,113,214977,46742,46744,4132,50876,334
2022-08-25,Yuba,115,75493,18534,18482,1656,20138,129
2022-08-24,Alameda,001,1643700,340739,338591,19212,357803,1976
2022-08-24,Alpine,003,1148,133,131,1,132,0
2022-08-24,Amador,005,37829,9823,9786,905,10691,89
2022-08-24,Butte,007,227075,38740,38458,8807,47265,449
2022-08-24,Calaveras,009,45235,8375,8334,514,8848,132
2022-08-24,Colusa,011,21464,3745,3722,1244,4966,22
2022-08-24,Contra Costa,013,1133247,246750,242633,20234,262867,1399
2022-08-24,Del Norte,015,27424,7315,7308,388,7696,55
2022-08-24,El Dorado,017,186661,31799,31682,4144,35826,225
2022-08-24,Fresno,019,978130,273103,269025,30555,299580,2822
2022-08-24,Glenn,021,27897,5459,5423,1834,7257,48
2022-08-24,Humboldt,023,135768,21299,21195,4805,26000,153
2022-08-24,Imperial,025,180216,64522,64271,15137,79408,951
2022-08-24,Inyo,027,18085,4445,4440,889,5329,59
2022-08-24,Kern,029,883053,216445,215225,61058,276283,2399
2022-08-24,Kings,031,150075,58499,58324,4015,62339,454
2022-08-24,Lake,033,64148,12573,12476,1130,13606,142
2022-08-24,Lassen,035,31185,9882,9867,975,10842,64
2022-08-24,Los Angeles,037,10098052,3230663,3211321,174610,3385931,32783
2022-08-24,Madera,039,155013,43174,42984,8006,50990,372
2022-08-24,Marin,041,260295,44302,44082,5121,49203,305
2022-08-24,Mariposa,043,17540,3040,3010,332,3342,31
2022-08-24,Mendocino,045,87422,15767,15623,4350,19973,134
2022-08-24,Merced,047,269075,71526,70665,11467,82132,849
2022-08-24,Modoc,049,8938,866,864,312,1176,11
2022-08-24,Mono,051,14174,3187,3181,241,3422,7
2022-08-24,Monterey,053,433212,93098,92590,20495,113085,760
2022-08-24,Napa,055,140530,31667,31602,1381,32983,156
2022-08-24,Nevada,057,99092,18638,18565,1754,20319,132
2022-08-24,Orange,059,3164182,657496,654893,60692,715585,7312
2022-08-24,Placer,061,380077,74630,74226,9324,83550,657
2022-08-24,Plumas,063,18699,3578,3555,430,3985,13
2022-08-24,Riverside,065,2383286,685373,681805,34354,716159,6573
2022-08-24,Sacramento,067,1510023,340762,339009,33050,372059,3208
2022-08-24,San Benito,069,59416,15960,15745,927,16672,103
2022-08-24,San Bernardino,071,2135413,661524,651496,30154,681650,8018
2022-08-24,San Diego,073,3302833,909508,906885,70364,977249,5453
2022-08-24,San Francisco,075,870044,175502,174731,11837,186568,974
2022-08-24,San Joaquin,077,732212,194691,193370,14430,207800,2288
2022-08-24,San Luis Obispo,079,281455,62356,61962,6897,68859,515
2022-08-24,San Mateo,081,765935,165605,164307,10244,174551,738
2022-08-24,Santa Barbara,083,443738,103901,103237,6662,109899,716
2022-08-24,Santa Clara,085,1922200,427587,421483,18544,440027,2454
2022-08-24,Santa Cruz,087,273765,61823,61387,3330,64717,270
2022-08-24,Shasta,089,179085,34372,34180,7179,41359,589
2022-08-24,Sierra,091,2930,302,301,60,361,5
2022-08-24,Siskiyou,093,43540,5022,5133,3257,8390,88
2022-08-24,Solano,095,438530,103279,102631,7672,110303,459
2022-08-24,Sonoma,097,501317,105068,104444,5149,109593,520
2022-08-24,Stanislaus,099,539301,135682,134894,21200,156094,1720
2022-08-24,Sutter,101,95872,23759,23673,2438,26111,228
2022-08-24,Tehama,103,63373,13406,13312,3004,16316,209
2022-08-24,Trinity,105,12862,1384,1369,367,1736,20
2022-08-24,Tulare,107,460477,120143,119644,35082,154726,1525
2022-08-24,Tuolumne,109,53932,15285,15140,903,16043,196
2022-08-24,Ventura,111,848112,204954,204064,15099,219163,1551
2022-08-24,Yolo,113,214977,46713,46665,4124,50789,333
2022-08-24,Yuba,115,75493,18510,18425,1650,20075,129
2022-08-23,Alameda,001,1643700,340419,338591,19189,357780,1976
2022-08-23,Alpine,003,1148,133,131,1,132,0
2022-08-23,Amador,005,37829,9812,9786,904,10690,89
2022-08-23,Butte,007,227075,38708,38458,8787,47245,449
2022-08-23,Calaveras,009,45235,8366,8334,510,8844,132
2022-08-23,Colusa,011,21464,3742,3722,1240,4962,22
2022-08-23,Contra Costa,013,1133247,246553,242633,20204,262837,1399
2022-08-23,Del Norte,015,27424,7311,7308,388,7696,55
2022-08-23,El Dorado,017,186661,31779,31682,4141,35823,225
2022-08-23,Fresno,019,978130,272849,269025,30496,299521,2822
2022-08-23,Glenn,021,27897,5453,5423,1833,7256,48
2022-08-23,Humboldt,023,135768,21286,21195,4793,25988,153
2022-08-23,Imperial,025,180216,64479,64271,15118,79389,951
2022-08-23,Inyo,027,18085,4443,4440,882,5322,59
2022-08-23,Kern,029,883053,216313,215225,60895,276120,2399
2022-08-23,Kings,031,150075,58448,58324,4010,62334,454
2022-08-23,Lake,033,64148,12553,12476,1129,13605,142
2022-08-23,Lassen,035,31185,9878,9867,975,10842,64
2022-08-23,Los Angeles,037,10098052,3228005,3211321,174283,3385604,32783
2022-08-23,Madera,039,155013,43129,42984,7982,50966,372
2022-08-23,Marin,041,260295,44270,44082,5118,49200,305
2022-08-23,Mariposa,043,17540,3036,3010,328,3338,31
2022-08-23,Mendocino,045,87422,15749,15623,4342,19965,134
2022-08-23,Merced,047,269075,71466,70665,11413,82078,849
2022-08-23,Modoc,049,8938,866,864,312,1176,11
2022-08-23,Mono,051,14174,3187,3181,241,3422,7
2022-08-23,Monterey,053,433212,93029,92590,20451,113041,760
2022-08-23,Napa,055,140530,31649,31602,1381,32983,156
2022-08-23,Nevada,057,99092,18624,18565,1746,20311,132
2022-08-23,Orange,059,3164182,656987,654893,60576,715469,7312
2022-08-23,Placer,061,380077,74566,74226,9310,83536,657
2022-08-23,Plumas,063,18699,3572,3555,430,3985,13
2022-08-23,Riverside,065,2383286,684759,681805,34289,716094,6573
2022-08-23,Sacramento,067,1510023,340441,339009,32996,372005,3208
2022-08-23,San Benito,069,59416,15937,15745,923,16668,103
2022-08-23,San Bernardino,071,2135413,660914,651496,30094,681590,8018
2022-08-23,San Diego,073,3302833,908890,906885,70288,977173,5453
2022-08-23,San Francisco,075,870044,175348,174731,11827,186558,974
2022-08-23,San Joaquin,077,732212,194535,193370,14387,207757,2288
2022-08-23,San Luis Obispo,079,281455,62308,61962,6886,68848,515
2022-08-23,San Mateo,081,765935,165480,164307,10241,174548,738
2022-08-23,Santa Barbara,083,443738,103806,103237,6647,109884,716
2022-08-23,Santa Clara,085,1922200,427211,421483,18529,440012,2454
2022-08-23,Santa Cruz,087,273765,61770,61387,3327,64714,270
2022-08-23,Shasta,089,179085,34349,34180,7173,41353,589
2022-08-23,Sierra,091,2930,302,301,60,361,5
2022-08-23,Siskiyou,093,43540,5022,5133,3255,8388,88
2022-08-23,Solano,095,438530,103184,102631,7666,110297,459
2022-08-23,Sonoma,097,501317,104987,104444,5138,109582,520
2022-08-23,Stanislaus,099,539301,135562,134894,21157,156051,1720
2022-08-23,Sutter,101,95872,23740,23673,2433,26106,228
2022-08-23,Tehama,103,63373,13396,13312,3002,16314,209
2022-08-23,Trinity,105,12862,1382,1369,367,1736,20
2022-08-23,Tulare,107,460477,120031,119644,34980,154624,1525
2022-08-23,Tuolumne,109,53932,15270,15140,902,16042,196
2022-08-23,Ventura,111,848112,204780,204064,15062,219126,1551
2022-08-23,Yolo,113,214977,46688,46665,4122,50787,333
2022-08-23,Yuba,115,75493,18489,18425,1646,20071,129
2022-08-22,Alameda,001,1643700,340055,338591,19160,357751,1976
2022-08-22,Alpine,003,1148,133,131,1,132,0
2022-08-22,Amador,005,37829,9807,9786,903,10689,89
2022-08-22,Butte,007,227075,38659,38458,8770,47228,449
2022-08-22,Calaveras,009,45235,8355,8334,508,8842,132
2022-08-22,Colusa,011,21464,3740,3722,1236,4958,22
2022-08-22,Contra Costa,013,1133247,246307,242633,20165,262798,1399
2022-08-22,Del Norte,015,27424,7310,7308,388,7696,55
2022-08-22,El Dorado,017,186661,31754,31682,4137,35819,225
2022-08-22,Fresno,019,978130,272607,269025,30412,299437,2822
2022-08-22,Glenn,021,27897,5452,5423,1831,7254,48
2022-08-22,Humboldt,023,135768,21265,21195,4778,25973,153
2022-08-22,Imperial,025,180216,64405,64271,15077,79348,951
2022-08-22,Inyo,027,18085,4441,4440,882,5322,59
2022-08-22,Kern,029,883053,216158,215225,60708,275933,2399
2022-08-22,Kings,031,150075,58396,58324,4002,62326,454
2022-08-22,Lake,033,64148,12529,12476,1126,13602,142
2022-08-22,Lassen,035,31185,9876,9867,975,10842,64
2022-08-22,Los Angeles,037,10098052,3225081,3211321,173935,3385256,32783
2022-08-22,Madera,039,155013,43075,42984,7957,50941,372
2022-08-22,Marin,041,260295,44237,44082,5110,49192,305
2022-08-22,Mariposa,043,17540,3029,3010,327,3337,31
2022-08-22,Mendocino,045,87422,15727,15623,4325,19948,134
2022-08-22,Merced,047,269075,71390,70665,11371,82036,849
2022-08-22,Modoc,049,8938,866,864,312,1176,11
2022-08-22,Mono,051,14174,3187,3181,241,3422,7
2022-08-22,Monterey,053,433212,92953,92590,20402,112992,760
2022-08-22,Napa,055,140530,31623,31602,1378,32980,156
2022-08-22,Nevada,057,99092,18606,18565,1740,20305,132
2022-08-22,Orange,059,3164182,656397,654893,60451,715344,7312
2022-08-22,Placer,061,380077,74490,74226,9301,83527,657
2022-08-22,Plumas,063,18699,3571,3555,430,3985,13
2022-08-22,Riverside,065,2383286,684097,681805,34220,716025,6573
2022-08-22,Sacramento,067,1510023,340100,339009,32914,371923,3208
2022-08-22,San Benito,069,59416,15915,15745,922,16667,103
2022-08-22,San Bernardino,071,2135413,660181,651496,30026,681522,8018
2022-08-22,San Diego,073,3302833,908204,906885,70167,977052,5453
2022-08-22,San Francisco,075,870044,175198,174731,11813,186544,974
2022-08-22,San Joaquin,077,732212,194356,193370,14347,207717,2288
2022-08-22,San Luis Obispo,079,281455,62255,61962,6873,68835,515
2022-08-22,San Mateo,081,765935,165336,164307,10229,174536,738
2022-08-22,Santa Barbara,083,443738,103684,103237,6629,109866,716
2022-08-22,Santa Clara,085,1922200,426785,421483,18502,439985,2454
2022-08-22,Santa Cruz,087,273765,61687,61387,3323,64710,270
2022-08-22,Shasta,089,179085,34333,34180,7163,41343,589
2022-08-22,Sierra,091,2930,302,301,60,361,5
2022-08-22,Siskiyou,093,43540,5018,5133,3253,8386,88
2022-08-22,Solano,095,438530,103095,102631,7653,110284,459
2022-08-22,Sonoma,097,501317,104905,104444,5125,109569,520
2022-08-22,Stanislaus,099,539301,135398,134894,21121,156015,1720
2022-08-22,Sutter,101,95872,23705,23673,2433,26106,228
2022-08-22,Tehama,103,63373,13390,13312,2999,16311,209
2022-08-22,Trinity,105,12862,1377,1369,365,1734,20
2022-08-22,Tulare,107,460477,119901,119644,34879,154523,1525
2022-08-22,Tuolumne,109,53932,15247,15140,902,16042,196
2022-08-22,Ventura,111,848112,204618,204064,14988,219052,1551
2022-08-22,Yolo,113,214977,46650,46665,4112,50777,333
2022-08-22,Yuba,115,75493,18462,18425,1642,20067,129
2022-08-21,Alameda,001,1643700,339626,337238,19134,356372,1970
2022-08-21,Alpine,003,1148,132,131,1,132,0
2022-08-21,Amador,005,37829,9800,9761,898,10659,89
2022-08-21,Butte,007,227075,38613,38316,8752,47068,449
2022-08-21,Calaveras,009,45235,8342,8313,506,8819,132
2022-08-21,Colusa,011,21464,3734,3718,1230,4948,22
2022-08-21,Contra Costa,013,1133247,246019,241665,20134,261799,1399
2022-08-21,Del Norte,015,27424,7303,7290,387,7677,55
2022-08-21,El Dorado,017,186661,31721,31600,4132,35732,225
2022-08-21,Fresno,019,978130,272333,268147,30321,298468,2822
2022-08-21,Glenn,021,27897,5448,5413,1830,7243,48
2022-08-21,Humboldt,023,135768,21241,21104,4760,25864,153
2022-08-21,Imperial,025,180216,64344,64092,15037,79129,951
2022-08-21,Inyo,027,18085,4441,4435,878,5313,59
2022-08-21,Kern,029,883053,215970,214656,60521,275177,2389
2022-08-21,Kings,031,150075,58325,58109,3991,62100,454
2022-08-21,Lake,033,64148,12505,12426,1124,13550,142
2022-08-21,Lassen,035,31185,9870,9843,974,10817,64
2022-08-21,Los Angeles,037,10098052,3221823,3200023,173534,3373557,32746
2022-08-21,Madera,039,155013,43025,42822,7919,50741,372
2022-08-21,Marin,041,260295,44188,43966,5091,49057,305
2022-08-21,Mariposa,043,17540,3027,3003,327,3330,31
2022-08-21,Mendocino,045,87422,15697,15578,4302,19880,134
2022-08-21,Merced,047,269075,71298,70449,11297,81746,846
2022-08-21,Modoc,049,8938,865,862,312,1174,11
2022-08-21,Mono,051,14174,3187,3177,239,3416,7
2022-08-21,Monterey,053,433212,92850,92287,20347,112634,760
2022-08-21,Napa,055,140530,31601,31534,1377,32911,156
2022-08-21,Nevada,057,99092,18594,18497,1736,20233,132
2022-08-21,Orange,059,3164182,655744,652703,60315,713018,7280
2022-08-21,Placer,061,380077,74428,74027,9297,83324,657
2022-08-21,Plumas,063,18699,3564,3550,430,3980,13
2022-08-21,Riverside,065,2383286,683265,679298,34135,713433,6574
2022-08-21,Sacramento,067,1510023,339731,337745,32842,370587,3208
2022-08-21,San Benito,069,59416,15892,15698,919,16617,103
2022-08-21,San Bernardino,071,2135413,659330,648583,29962,678545,8014
2022-08-21,San Diego,073,3302833,907346,904015,70086,974101,5448
2022-08-21,San Francisco,075,870044,174996,174151,11795,185946,973
2022-08-21,San Joaquin,077,732212,194110,192738,14307,207045,2288
2022-08-21,San Luis Obispo,079,281455,62203,61764,6848,68612,516
2022-08-21,San Mateo,081,765935,165181,163705,10221,173926,738
2022-08-21,Santa Barbara,083,443738,103554,102795,6604,109399,713
2022-08-21,Santa Clara,085,1922200,426257,419723,18469,438192,2437
2022-08-21,Santa Cruz,087,273765,61572,61098,3318,64416,269
2022-08-21,Shasta,089,179085,34294,34105,7148,41253,588
2022-08-21,Sierra,091,2930,302,298,60,358,4
2022-08-21,Siskiyou,093,43540,5017,5119,3246,8365,88
2022-08-21,Solano,095,438530,103010,102355,7642,109997,457
2022-08-21,Sonoma,097,501317,104798,104090,5112,109202,511
2022-08-21,Stanislaus,099,539301,135232,134407,21050,155457,1719
2022-08-21,Sutter,101,95872,23672,23587,2426,26013,228
2022-08-21,Tehama,103,63373,13379,13289,2995,16284,209
2022-08-21,Trinity,105,12862,1375,1366,364,1730,20
2022-08-21,Tulare,107,460477,119774,119251,34727,153978,1521
2022-08-21,Tuolumne,109,53932,15230,15085,900,15985,196
2022-08-21,Ventura,111,848112,204384,203318,14919,218237,1547
2022-08-21,Yolo,113,214977,46610,46567,4107,50674,333
2022-08-21,Yuba,115,75493,18440,18363,1635,19998,129
2022-08-20,Alameda,001,1643700,339414,337238,19119,356357,1970
2022-08-20,Alpine,003,1148,132,131,1,132,0
2022-08-20,Amador,005,37829,9797,9761,898,10659,89
2022-08-20,Butte,007,227075,38584,38316,8748,47064,449
2022-08-20,Calaveras,009,45235,8339,8313,505,8818,132
2022-08-20,Colusa,011,21464,3730,3718,1224,4942,22
2022-08-20,Contra Costa,013,1133247,245878,241665,20125,261790,1399
2022-08-20,Del Norte,015,27424,7302,7290,387,7677,55
2022-08-20,El Dorado,017,186661,31701,31600,4130,35730,225
2022-08-20,Fresno,019,978130,272189,268147,30297,298444,2822
2022-08-20,Glenn,021,27897,5445,5413,1830,7243,48
2022-08-20,Humboldt,023,135768,21222,21104,4748,25852,153
2022-08-20,Imperial,025,180216,64308,64092,15018,79110,951
2022-08-20,Inyo,027,18085,4441,4435,878,5313,59
2022-08-20,Kern,029,883053,215882,214656,60397,275053,2389
2022-08-20,Kings,031,150075,58298,58109,3986,62095,454
2022-08-20,Lake,033,64148,12495,12426,1120,13546,142
2022-08-20,Lassen,035,31185,9867,9843,974,10817,64
2022-08-20,Los Angeles,037,10098052,3220234,3200023,173309,3373332,32746
2022-08-20,Madera,039,155013,43001,42822,7913,50735,372
2022-08-20,Marin,041,260295,44170,43966,5089,49055,305
2022-08-20,Mariposa,043,17540,3027,3003,327,3330,31
2022-08-20,Mendocino,045,87422,15681,15578,4301,19879,134
2022-08-20,Merced,047,269075,71274,70449,11289,81738,846
2022-08-20,Modoc,049,8938,865,862,312,1174,11
2022-08-20,Mono,051,14174,3187,3177,237,3414,7
2022-08-20,Monterey,053,433212,92804,92287,20319,112606,760
2022-08-20,Napa,055,140530,31593,31534,1377,32911,156
2022-08-20,Nevada,057,99092,18591,18497,1734,20231,132
2022-08-20,Orange,059,3164182,655424,652703,60228,712931,7280
2022-08-20,Placer,061,380077,74379,74027,9293,83320,657
2022-08-20,Plumas,063,18699,3564,3550,430,3980,13
2022-08-20,Riverside,065,2383286,682840,679298,34107,713405,6574
2022-08-20,Sacramento,067,1510023,339569,337745,32819,370564,3208
2022-08-20,San Benito,069,59416,15873,15698,916,16614,103
2022-08-20,San Bernardino,071,2135413,658909,648583,29924,678507,8014
2022-08-20,San Diego,073,3302833,906965,904015,70060,974075,5448
2022-08-20,San Francisco,075,870044,174872,174151,11794,185945,973
2022-08-20,San Joaquin,077,732212,194010,192738,14280,207018,2288
2022-08-20,San Luis Obispo,079,281455,62185,61764,6840,68604,516
2022-08-20,San Mateo,081,765935,165080,163705,10218,173923,738
2022-08-20,Santa Barbara,083,443738,103483,102795,6597,109392,713
2022-08-20,Santa Clara,085,1922200,425990,419723,18453,438176,2437
2022-08-20,Santa Cruz,087,273765,61542,61098,3314,64412,269
2022-08-20,Shasta,089,179085,34269,34105,7146,41251,588
2022-08-20,Sierra,091,2930,302,298,60,358,4
2022-08-20,Siskiyou,093,43540,5012,5119,3245,8364,88
2022-08-20,Solano,095,438530,102964,102355,7634,109989,457
2022-08-20,Sonoma,097,501317,104744,104090,5109,109199,511
2022-08-20,Stanislaus,099,539301,135141,134407,21035,155442,1719
2022-08-20,Sutter,101,95872,23644,23587,2426,26013,228
2022-08-20,Tehama,103,63373,13371,13289,2995,16284,209
2022-08-20,Trinity,105,12862,1375,1366,364,1730,20
2022-08-20,Tulare,107,460477,119692,119251,34677,153928,1521
2022-08-20,Tuolumne,109,53932,15221,15085,898,15983,196
2022-08-20,Ventura,111,848112,204275,203318,14903,218221,1547
2022-08-20,Yolo,113,214977,46582,46567,4099,50666,333
2022-08-20,Yuba,115,75493,18433,18363,1634,19997,129
2022-08-19,Alameda,001,1643700,339202,337238,19097,356335,1970
2022-08-19,Alpine,003,1148,132,131,1,132,0
2022-08-19,Amador,005,37829,9796,9761,898,10659,89
2022-08-19,Butte,007,227075,38563,38316,8737,47053,449
2022-08-19,Calaveras,009,45235,8334,8313,505,8818,132
2022-08-19,Colusa,011,21464,3729,3718,1223,4941,22
2022-08-19,Contra Costa,013,1133247,245736,241665,20114,261779,1399
2022-08-19,Del Norte,015,27424,7297,7290,387,7677,55
2022-08-19,El Dorado,017,186661,31689,31600,4126,35726,225
2022-08-19,Fresno,019,978130,272024,268147,30274,298421,2822
2022-08-19,Glenn,021,27897,5444,5413,1830,7243,48
2022-08-19,Humboldt,023,135768,21212,21104,4738,25842,153
2022-08-19,Imperial,025,180216,64280,64092,15003,79095,951
2022-08-19,Inyo,027,18085,4441,4435,874,5309,59
2022-08-19,Kern,029,883053,215792,214656,60306,274962,2389
2022-08-19,Kings,031,150075,58256,58109,3979,62088,454
2022-08-19,Lake,033,64148,12482,12426,1118,13544,142
2022-08-19,Lassen,035,31185,9864,9843,974,10817,64
2022-08-19,Los Angeles,037,10098052,3218411,3200023,173088,3373111,32746
2022-08-19,Madera,039,155013,42979,42822,7909,50731,372
2022-08-19,Marin,041,260295,44135,43966,5083,49049,305
2022-08-19,Mariposa,043,17540,3025,3003,327,3330,31
2022-08-19,Mendocino,045,87422,15668,15578,4293,19871,134
2022-08-19,Merced,047,269075,71234,70449,11284,81733,846
2022-08-19,Modoc,049,8938,865,862,312,1174,11
2022-08-19,Mono,051,14174,3187,3177,237,3414,7
2022-08-19,Monterey,053,433212,92750,92287,20288,112575,760
2022-08-19,Napa,055,140530,31575,31534,1375,32909,156
2022-08-19,Nevada,057,99092,18586,18497,1733,20230,132
2022-08-19,Orange,059,3164182,655060,652703,60143,712846,7280
2022-08-19,Placer,061,380077,74343,74027,9286,83313,657
2022-08-19,Plumas,063,18699,3563,3550,430,3980,13
2022-08-19,Riverside,065,2383286,682422,679298,34077,713375,6574
2022-08-19,Sacramento,067,1510023,339380,337745,32791,370536,3208
2022-08-19,San Benito,069,59416,15870,15698,915,16613,103
2022-08-19,San Bernardino,071,2135413,658457,648583,29908,678491,8014
2022-08-19,San Diego,073,3302833,906470,904015,70007,974022,5448
2022-08-19,San Francisco,075,870044,174733,174151,11777,185928,973
2022-08-19,San Joaquin,077,732212,193906,192738,14257,206995,2288
2022-08-19,San Luis Obispo,079,281455,62170,61764,6838,68602,516
2022-08-19,San Mateo,081,765935,164966,163705,10213,173918,738
2022-08-19,Santa Barbara,083,443738,103403,102795,6593,109388,713
2022-08-19,Santa Clara,085,1922200,425679,419723,18437,438160,2437
2022-08-19,Santa Cruz,087,273765,61479,61098,3309,64407,269
2022-08-19,Shasta,089,179085,34252,34105,7146,41251,588
2022-08-19,Sierra,091,2930,302,298,60,358,4
2022-08-19,Siskiyou,093,43540,5005,5119,3245,8364,88
2022-08-19,Solano,095,438530,102905,102355,7627,109982,457
2022-08-19,Sonoma,097,501317,104684,104090,5106,109196,511
2022-08-19,Stanislaus,099,539301,135058,134407,21018,155425,1719
2022-08-19,Sutter,101,95872,23627,23587,2425,26012,228
2022-08-19,Tehama,103,63373,13361,13289,2989,16278,209
2022-08-19,Trinity,105,12862,1374,1366,364,1730,20
2022-08-19,Tulare,107,460477,119606,119251,34625,153876,1521
2022-08-19,Tuolumne,109,53932,15214,15085,897,15982,196
2022-08-19,Ventura,111,848112,204148,203318,14883,218201,1547
2022-08-19,Yolo,113,214977,46559,46567,4096,50663,333
2022-08-19,Yuba,115,75493,18418,18363,1634,19997,129
2022-08-18,Alameda,001,1643700,338905,337238,19064,356302,1970
2022-08-18,Alpine,003,1148,131,131,1,132,0
2022-08-18,Amador,005,37829,9791,9761,897,10658,89
2022-08-18,Butte,007,227075,38533,38316,8723,47039,449
2022-08-18,Calaveras,009,45235,8329,8313,505,8818,132
2022-08-18,Colusa,011,21464,3729,3718,1219,4937,22
2022-08-18,Contra Costa,013,1133247,245525,241665,20085,261750,1399
2022-08-18,Del Norte,015,27424,7292,7290,386,7676,55
2022-08-18,El Dorado,017,186661,31674,31600,4123,35723,225
2022-08-18,Fresno,019,978130,271800,268147,30217,298364,2822
2022-08-18,Glenn,021,27897,5439,5413,1829,7242,48
2022-08-18,Humboldt,023,135768,21187,21104,4711,25815,153
2022-08-18,Imperial,025,180216,64255,64092,14962,79054,951
2022-08-18,Inyo,027,18085,4440,4435,869,5304,59
2022-08-18,Kern,029,883053,215643,214656,60175,274831,2389
2022-08-18,Kings,031,150075,58211,58109,3968,62077,454
2022-08-18,Lake,033,64148,12468,12426,1117,13543,142
2022-08-18,Lassen,035,31185,9863,9843,973,10816,64
2022-08-18,Los Angeles,037,10098052,3215924,3200023,172805,3372828,32746
2022-08-18,Madera,039,155013,42938,42822,7891,50713,372
2022-08-18,Marin,041,260295,44103,43966,5072,49038,305
2022-08-18,Mariposa,043,17540,3023,3003,327,3330,31
2022-08-18,Mendocino,045,87422,15654,15578,4292,19870,134
2022-08-18,Merced,047,269075,71152,70449,11253,81702,846
2022-08-18,Modoc,049,8938,865,862,312,1174,11
2022-08-18,Mono,051,14174,3185,3177,236,3413,7
2022-08-18,Monterey,053,433212,92663,92287,20251,112538,760
2022-08-18,Napa,055,140530,31555,31534,1375,32909,156
2022-08-18,Nevada,057,99092,18569,18497,1729,20226,132
2022-08-18,Orange,059,3164182,654599,652703,60030,712733,7280
2022-08-18,Placer,061,380077,74288,74027,9283,83310,657
2022-08-18,Plumas,063,18699,3559,3550,430,3980,13
2022-08-18,Riverside,065,2383286,681842,679298,34029,713327,6574
2022-08-18,Sacramento,067,1510023,339084,337745,32733,370478,3208
2022-08-18,San Benito,069,59416,15858,15698,912,16610,103
2022-08-18,San Bernardino,071,2135413,657780,648583,29858,678441,8014
2022-08-18,San Diego,073,3302833,905825,904015,69931,973946,5448
2022-08-18,San Francisco,075,870044,174581,174151,11753,185904,973
2022-08-18,San Joaquin,077,732212,193735,192738,14228,206966,2288
2022-08-18,San Luis Obispo,079,281455,62126,61764,6825,68589,516
2022-08-18,San Mateo,081,765935,164786,163705,10205,173910,738
2022-08-18,Santa Barbara,083,443738,103294,102795,6584,109379,713
2022-08-18,Santa Clara,085,1922200,425242,419723,18403,438126,2437
2022-08-18,Santa Cruz,087,273765,61408,61098,3303,64401,269
2022-08-18,Shasta,089,179085,34231,34105,7142,41247,588
2022-08-18,Sierra,091,2930,301,298,60,358,4
2022-08-18,Siskiyou,093,43540,5003,5119,3243,8362,88
2022-08-18,Solano,095,438530,102834,102355,7616,109971,457
2022-08-18,Sonoma,097,501317,104596,104090,5097,109187,511
2022-08-18,Stanislaus,099,539301,134930,134407,20983,155390,1719
2022-08-18,Sutter,101,95872,23606,23587,2423,26010,228
2022-08-18,Tehama,103,63373,13354,13289,2985,16274,209
2022-08-18,Trinity,105,12862,1373,1366,361,1727,20
2022-08-18,Tulare,107,460477,119510,119251,34529,153780,1521
2022-08-18,Tuolumne,109,53932,15171,15085,894,15979,196
2022-08-18,Ventura,111,848112,203971,203318,14845,218163,1547
2022-08-18,Yolo,113,214977,46534,46567,4088,50655,333
2022-08-18,Yuba,115,75493,18398,18363,1631,19994,129
2022-08-17,Alameda,001,1643700,338570,336198,19031,355229,1948
2022-08-17,Alpine,003,1148,131,131,1,132,0
2022-08-17,Amador,005,37829,9783,9728,897,10625,89
2022-08-17,Butte,007,227075,38494,38203,8711,46914,447
2022-08-17,Calaveras,009,45235,8322,8295,502,8797,131
2022-08-17,Colusa,011,21464,3728,3716,1217,4933,22
2022-08-17,Contra Costa,013,1133247,245298,240894,20050,260944,1394
2022-08-17,Del Norte,015,27424,7288,7274,386,7660,55
2022-08-17,El Dorado,017,186661,31656,31523,4119,35642,225
2022-08-17,Fresno,019,978130,271570,267367,30153,297520,2818
2022-08-17,Glenn,021,27897,5438,5403,1827,7230,48
2022-08-17,Humboldt,023,135768,21163,21029,4697,25726,153
2022-08-17,Imperial,025,180216,64212,63972,14932,78904,950
2022-08-17,Inyo,027,18085,4438,4421,866,5287,58
2022-08-17,Kern,029,883053,215510,214040,60043,274083,2389
2022-08-17,Kings,031,150075,58147,57948,3966,61914,454
2022-08-17,Lake,033,64148,12458,12383,1116,13499,142
2022-08-17,Lassen,035,31185,9854,9813,973,10786,64
2022-08-17,Los Angeles,037,10098052,3213126,3190808,172480,3363288,32701
2022-08-17,Madera,039,155013,42889,42677,7854,50531,372
2022-08-17,Marin,041,260295,44070,43852,5068,48920,305
2022-08-17,Mariposa,043,17540,3019,2998,326,3324,31
2022-08-17,Mendocino,045,87422,15644,15504,4286,19790,132
2022-08-17,Merced,047,269075,71093,70232,11210,81442,843
2022-08-17,Modoc,049,8938,864,857,312,1169,11
2022-08-17,Mono,051,14174,3185,3175,236,3411,7
2022-08-17,Monterey,053,433212,92599,91984,20197,112181,759
2022-08-17,Napa,055,140530,31539,31454,1374,32828,155
2022-08-17,Nevada,057,99092,18552,18443,1727,20170,132
2022-08-17,Orange,059,3164182,653992,650827,59912,710739,7266
2022-08-17,Placer,061,380077,74237,73852,9277,83129,655
2022-08-17,Plumas,063,18699,3557,3544,429,3973,13
2022-08-17,Riverside,065,2383286,681202,677437,33971,711408,6562
2022-08-17,Sacramento,067,1510023,338759,336667,32688,369355,3194
2022-08-17,San Benito,069,59416,15842,15655,911,16566,103
2022-08-17,San Bernardino,071,2135413,657138,646584,29801,676385,7999
2022-08-17,San Diego,073,3302833,905081,901794,69862,971656,5442
2022-08-17,San Francisco,075,870044,174446,173590,11741,185331,971
2022-08-17,San Joaquin,077,732212,193584,192078,14191,206269,2283
2022-08-17,San Luis Obispo,079,281455,62072,61604,6813,68417,514
2022-08-17,San Mateo,081,765935,164687,163218,10198,173416,738
2022-08-17,Santa Barbara,083,443738,103177,102430,6569,108999,712
2022-08-17,Santa Clara,085,1922200,424776,418231,18393,436624,2424
2022-08-17,Santa Cruz,087,273765,61318,60880,3298,64178,269
2022-08-17,Shasta,089,179085,34213,33984,7133,41117,587
2022-08-17,Sierra,091,2930,301,297,60,357,4
2022-08-17,Siskiyou,093,43540,5000,5102,3240,8342,88
2022-08-17,Solano,095,438530,102751,102115,7610,109725,459
2022-08-17,Sonoma,097,501317,104493,103844,5091,108935,504
2022-08-17,Stanislaus,099,539301,134784,133989,20946,154935,1715
2022-08-17,Sutter,101,95872,23572,23489,2417,25906,228
2022-08-17,Tehama,103,63373,13351,13259,2980,16239,209
2022-08-17,Trinity,105,12862,1373,1362,359,1721,20
2022-08-17,Tulare,107,460477,119401,118997,34424,153421,1521
2022-08-17,Tuolumne,109,53932,15163,15044,892,15936,196
2022-08-17,Ventura,111,848112,203790,202609,14790,217399,1546
2022-08-17,Yolo,113,214977,46502,46414,4083,50497,331
2022-08-17,Yuba,115,75493,18378,18305,1628,19933,129
2022-08-16,Alameda,001,1643700,338199,336198,19014,355212,1948
2022-08-16,Alpine,003,1148,131,131,1,132,0
2022-08-16,Amador,005,37829,9770,9728,892,10620,89
2022-08-16,Butte,007,227075,38460,38203,8698,46901,447
2022-08-16,Calaveras,009,45235,8314,8295,502,8797,131
2022-08-16,Colusa,011,21464,3727,3716,1215,4931,22
2022-08-16,Contra Costa,013,1133247,245062,240894,20009,260903,1394
2022-08-16,Del Norte,015,27424,7283,7274,386,7660,55
2022-08-16,El Dorado,017,186661,31635,31523,4113,35636,225
2022-08-16,Fresno,019,978130,271323,267367,30105,297472,2818
2022-08-16,Glenn,021,27897,5437,5403,1824,7227,48
2022-08-16,Humboldt,023,135768,21136,21029,4670,25699,153
2022-08-16,Imperial,025,180216,64161,63972,14894,78866,950
2022-08-16,Inyo,027,18085,4434,4421,862,5283,58
2022-08-16,Kern,029,883053,215367,214040,59894,273934,2389
2022-08-16,Kings,031,150075,58101,57948,3963,61911,454
2022-08-16,Lake,033,64148,12442,12383,1112,13495,142
2022-08-16,Lassen,035,31185,9841,9813,972,10785,64
2022-08-16,Los Angeles,037,10098052,3210056,3190808,172130,3362938,32701
2022-08-16,Madera,039,155013,42831,42677,7833,50510,372
2022-08-16,Marin,041,260295,44032,43852,5063,48915,305
2022-08-16,Mariposa,043,17540,3017,2998,326,3324,31
2022-08-16,Mendocino,045,87422,15625,15504,4273,19777,132
2022-08-16,Merced,047,269075,71014,70232,11167,81399,843
2022-08-16,Modoc,049,8938,864,857,312,1169,11
2022-08-16,Mono,051,14174,3185,3175,235,3410,7
2022-08-16,Monterey,053,433212,92518,91984,20127,112111,759
2022-08-16,Napa,055,140530,31520,31454,1373,32827,155
2022-08-16,Nevada,057,99092,18536,18443,1724,20167,132
2022-08-16,Orange,059,3164182,653325,650827,59779,710606,7266
2022-08-16,Placer,061,380077,74167,73852,9269,83121,655
2022-08-16,Plumas,063,18699,3555,3544,429,3973,13
2022-08-16,Riverside,065,2383286,680511,677437,33923,711360,6562
2022-08-16,Sacramento,067,1510023,338424,336667,32653,369320,3194
2022-08-16,San Benito,069,59416,15829,15655,907,16562,103
2022-08-16,San Bernardino,071,2135413,656407,646584,29734,676318,7999
2022-08-16,San Diego,073,3302833,904263,901794,69768,971562,5442
2022-08-16,San Francisco,075,870044,174284,173590,11735,185325,971
2022-08-16,San Joaquin,077,732212,193369,192078,14161,206239,2283
2022-08-16,San Luis Obispo,079,281455,62034,61604,6806,68410,514
2022-08-16,San Mateo,081,765935,164525,163218,10185,173403,738
2022-08-16,Santa Barbara,083,443738,103046,102430,6549,108979,712
2022-08-16,Santa Clara,085,1922200,424295,418231,18368,436599,2424
2022-08-16,Santa Cruz,087,273765,61265,60880,3294,64174,269
2022-08-16,Shasta,089,179085,34186,33984,7124,41108,587
2022-08-16,Sierra,091,2930,300,297,60,357,4
2022-08-16,Siskiyou,093,43540,4996,5102,3235,8337,88
2022-08-16,Solano,095,438530,102678,102115,7592,109707,459
2022-08-16,Sonoma,097,501317,104390,103844,5083,108927,504
2022-08-16,Stanislaus,099,539301,134647,133989,20886,154875,1715
2022-08-16,Sutter,101,95872,23548,23489,2411,25900,228
2022-08-16,Tehama,103,63373,13345,13259,2975,16234,209
2022-08-16,Trinity,105,12862,1370,1362,359,1721,20
2022-08-16,Tulare,107,460477,119311,118997,34307,153304,1521
2022-08-16,Tuolumne,109,53932,15149,15044,892,15936,196
2022-08-16,Ventura,111,848112,203554,202609,14741,217350,1546
2022-08-16,Yolo,113,214977,46484,46414,4078,50492,331
2022-08-16,Yuba,115,75493,18359,18305,1622,19927,129
2022-08-15,Alameda,001,1643700,337816,336198,18983,355181,1948
2022-08-15,Alpine,003,1148,131,131,1,132,0
2022-08-15,Amador,005,37829,9758,9728,892,10620,89
2022-08-15,Butte,007,227075,38437,38203,8680,46883,447
2022-08-15,Calaveras,009,45235,8312,8295,501,8796,131
2022-08-15,Colusa,011,21464,3724,3716,1214,4930,22
2022-08-15,Contra Costa,013,1133247,244779,240894,19977,260871,1394
2022-08-15,Del Norte,015,27424,7279,7274,385,7659,55
2022-08-15,El Dorado,017,186661,31602,31523,4109,35632,225
2022-08-15,Fresno,019,978130,271016,267367,30039,297406,2818
2022-08-15,Glenn,021,27897,5429,5403,1823,7226,48
2022-08-15,Humboldt,023,135768,21114,21029,4649,25678,153
2022-08-15,Imperial,025,180216,64114,63972,14858,78830,950
2022-08-15,Inyo,027,18085,4433,4421,860,5281,58
2022-08-15,Kern,029,883053,215178,214040,59753,273793,2389
2022-08-15,Kings,031,150075,58027,57948,3954,61902,454
2022-08-15,Lake,033,64148,12425,12383,1111,13494,142
2022-08-15,Lassen,035,31185,9840,9813,972,10785,64
2022-08-15,Los Angeles,037,10098052,3206640,3190808,171784,3362592,32701
2022-08-15,Madera,039,155013,42776,42677,7794,50471,372
2022-08-15,Marin,041,260295,43988,43852,5057,48909,305
2022-08-15,Mariposa,043,17540,3015,2998,325,3323,31
2022-08-15,Mendocino,045,87422,15606,15504,4268,19772,132
2022-08-15,Merced,047,269075,70944,70232,11119,81351,843
2022-08-15,Modoc,049,8938,860,857,312,1169,11
2022-08-15,Mono,051,14174,3183,3175,235,3410,7
2022-08-15,Monterey,053,433212,92407,91984,20060,112044,759
2022-08-15,Napa,055,140530,31495,31454,1373,32827,155
2022-08-15,Nevada,057,99092,18522,18443,1723,20166,132
2022-08-15,Orange,059,3164182,652611,650827,59650,710477,7266
2022-08-15,Placer,061,380077,74107,73852,9261,83113,655
2022-08-15,Plumas,063,18699,3551,3544,429,3973,13
2022-08-15,Riverside,065,2383286,679717,677437,33864,711301,6562
2022-08-15,Sacramento,067,1510023,338024,336667,32614,369281,3194
2022-08-15,San Benito,069,59416,15813,15655,905,16560,103
2022-08-15,San Bernardino,071,2135413,655567,646584,29664,676248,7999
2022-08-15,San Diego,073,3302833,903420,901794,69657,971451,5442
2022-08-15,San Francisco,075,870044,174104,173590,11730,185320,971
2022-08-15,San Joaquin,077,732212,193161,192078,14123,206201,2283
2022-08-15,San Luis Obispo,079,281455,61997,61604,6788,68392,514
2022-08-15,San Mateo,081,765935,164323,163218,10179,173397,738
2022-08-15,Santa Barbara,083,443738,102948,102430,6527,108957,712
2022-08-15,Santa Clara,085,1922200,423772,418231,18337,436568,2424
2022-08-15,Santa Cruz,087,273765,61185,60880,3289,64169,269
2022-08-15,Shasta,089,179085,34161,33984,7114,41098,587
2022-08-15,Sierra,091,2930,300,297,60,357,4
2022-08-15,Siskiyou,093,43540,4993,5102,3231,8333,88
2022-08-15,Solano,095,438530,102569,102115,7577,109692,459
2022-08-15,Sonoma,097,501317,104300,103844,5076,108920,504
2022-08-15,Stanislaus,099,539301,134506,133989,20852,154841,1715
2022-08-15,Sutter,101,95872,23516,23489,2409,25898,228
2022-08-15,Tehama,103,63373,13337,13259,2968,16227,209
2022-08-15,Trinity,105,12862,1367,1362,357,1719,20
2022-08-15,Tulare,107,460477,119174,118997,34197,153194,1521
2022-08-15,Tuolumne,109,53932,15141,15044,892,15936,196
2022-08-15,Ventura,111,848112,203300,202609,14680,217289,1546
2022-08-15,Yolo,113,214977,46450,46414,4075,50489,331
2022-08-15,Yuba,115,75493,18336,18305,1617,19922,129
2022-08-14,Alameda,001,1643700,337357,334944,18959,353903,1948
2022-08-14,Alpine,003,1148,131,131,1,132,0
2022-08-14,Amador,005,37829,9749,9705,890,10595,89
2022-08-14,Butte,007,227075,38387,38062,8664,46726,447
2022-08-14,Calaveras,009,45235,8303,8271,500,8771,131
2022-08-14,Colusa,011,21464,3724,3704,1211,4915,22
2022-08-14,Contra Costa,013,1133247,244506,239735,19928,259663,1393
2022-08-14,Del Norte,015,27424,7270,7245,384,7629,54
2022-08-14,El Dorado,017,186661,31571,31430,4104,35534,225
2022-08-14,Fresno,019,978130,270717,266211,29985,296196,2816
2022-08-14,Glenn,021,27897,5426,5393,1822,7215,48
2022-08-14,Humboldt,023,135768,21085,20954,4635,25589,153
2022-08-14,Imperial,025,180216,64047,63766,14818,78584,950
2022-08-14,Inyo,027,18085,4426,4418,856,5274,58
2022-08-14,Kern,029,883053,214992,213071,59574,272645,2380
2022-08-14,Kings,031,150075,57971,57748,3947,61695,454
2022-08-14,Lake,033,64148,12407,12324,1108,13432,142
2022-08-14,Lassen,035,31185,9820,9795,971,10766,64
2022-08-14,Los Angeles,037,10098052,3203073,3177769,171383,3349152,32657
2022-08-14,Madera,039,155013,42714,42517,7751,50268,372
2022-08-14,Marin,041,260295,43942,43662,5052,48714,305
2022-08-14,Mariposa,043,17540,3013,2986,324,3310,31
2022-08-14,Mendocino,045,87422,15586,15456,4262,19718,132
2022-08-14,Merced,047,269075,70831,69974,11060,81034,842
2022-08-14,Modoc,049,8938,859,856,312,1168,11
2022-08-14,Mono,051,14174,3181,3170,235,3405,7
2022-08-14,Monterey,053,433212,92282,91612,19986,111598,759
2022-08-14,Napa,055,140530,31458,31312,1372,32684,156
2022-08-14,Nevada,057,99092,18502,18398,1720,20118,132
2022-08-14,Orange,059,3164182,651882,648171,59500,707671,7248
2022-08-14,Placer,061,380077,74043,73588,9248,82836,656
2022-08-14,Plumas,063,18699,3549,3539,429,3968,13
2022-08-14,Riverside,065,2383286,678902,674362,33781,708143,6561
2022-08-14,Sacramento,067,1510023,337544,335292,32558,367850,3190
2022-08-14,San Benito,069,59416,15791,15578,896,16474,103
2022-08-14,San Bernardino,071,2135413,654693,643895,29599,673494,7983
2022-08-14,San Diego,073,3302833,902524,898646,69545,968191,5437
2022-08-14,San Francisco,075,870044,173890,172876,11717,184593,955
2022-08-14,San Joaquin,077,732212,192863,191272,14063,205335,2283
2022-08-14,San Luis Obispo,079,281455,61935,61403,6761,68164,512
2022-08-14,San Mateo,081,765935,164116,162531,10166,172697,738
2022-08-14,Santa Barbara,083,443738,102810,101942,6501,108443,712
2022-08-14,Santa Clara,085,1922200,423198,416369,18300,434669,2422
2022-08-14,Santa Cruz,087,273765,61079,60594,3282,63876,273
2022-08-14,Shasta,089,179085,34117,33895,7100,40995,584
2022-08-14,Sierra,091,2930,300,296,60,356,4
2022-08-14,Siskiyou,093,43540,4987,5086,3229,8315,88
2022-08-14,Solano,095,438530,102430,101761,7568,109329,458
2022-08-14,Sonoma,097,501317,104192,103496,5062,108558,504
2022-08-14,Stanislaus,099,539301,134322,133490,20798,154288,1702
2022-08-14,Sutter,101,95872,23474,23386,2405,25791,228
2022-08-14,Tehama,103,63373,13330,13213,2967,16180,209
2022-08-14,Trinity,105,12862,1366,1356,357,1713,20
2022-08-14,Tulare,107,460477,119019,118563,34081,152644,1520
2022-08-14,Tuolumne,109,53932,15121,14964,891,15855,196
2022-08-14,Ventura,111,848112,203033,201765,14640,216405,1541
2022-08-14,Yolo,113,214977,46403,46225,4069,50294,331
2022-08-14,Yuba,115,75493,18314,18232,1614,19846,129
2022-08-13,Alameda,001,1643700,337107,334944,18944,353888,1948
2022-08-13,Alpine,003,1148,131,131,1,132,0
2022-08-13,Amador,005,37829,9745,9705,890,10595,89
2022-08-13,Butte,007,227075,38363,38062,8653,46715,447
2022-08-13,Calaveras,009,45235,8299,8271,499,8770,131
2022-08-13,Colusa,011,21464,3721,3704,1211,4915,22
2022-08-13,Contra Costa,013,1133247,244337,239735,19905,259640,1393
2022-08-13,Del Norte,015,27424,7268,7245,384,7629,54
2022-08-13,El Dorado,017,186661,31558,31430,4103,35533,225
2022-08-13,Fresno,019,978130,270577,266211,29956,296167,2816
2022-08-13,Glenn,021,27897,5426,5393,1820,7213,48
2022-08-13,Humboldt,023,135768,21068,20954,4626,25580,153
2022-08-13,Imperial,025,180216,64005,63766,14801,78567,950
2022-08-13,Inyo,027,18085,4424,4418,855,5273,58
2022-08-13,Kern,029,883053,214899,213071,59493,272564,2380
2022-08-13,Kings,031,150075,57946,57748,3947,61695,454
2022-08-13,Lake,033,64148,12396,12324,1108,13432,142
2022-08-13,Lassen,035,31185,9814,9795,970,10765,64
2022-08-13,Los Angeles,037,10098052,3201213,3177769,171117,3348886,32657
2022-08-13,Madera,039,155013,42698,42517,7744,50261,372
2022-08-13,Marin,041,260295,43922,43662,5049,48711,305
2022-08-13,Mariposa,043,17540,3012,2986,324,3310,31
2022-08-13,Mendocino,045,87422,15574,15456,4259,19715,132
2022-08-13,Merced,047,269075,70793,69974,11054,81028,842
2022-08-13,Modoc,049,8938,859,856,312,1168,11
2022-08-13,Mono,051,14174,3181,3170,234,3404,7
2022-08-13,Monterey,053,433212,92217,91612,19951,111563,759
2022-08-13,Napa,055,140530,31444,31312,1371,32683,156
2022-08-13,Nevada,057,99092,18491,18398,1718,20116,132
2022-08-13,Orange,059,3164182,651492,648171,59423,707594,7248
2022-08-13,Placer,061,380077,73996,73588,9243,82831,656
2022-08-13,Plumas,063,18699,3547,3539,429,3968,13
2022-08-13,Riverside,065,2383286,678467,674362,33749,708111,6561
2022-08-13,Sacramento,067,1510023,337354,335292,32547,367839,3190
2022-08-13,San Benito,069,59416,15783,15578,891,16469,103
2022-08-13,San Bernardino,071,2135413,654220,643895,29573,673468,7983
2022-08-13,San Diego,073,3302833,902072,898646,69502,968148,5437
2022-08-13,San Francisco,075,870044,173773,172876,11711,184587,955
2022-08-13,San Joaquin,077,732212,192739,191272,14041,205313,2283
2022-08-13,San Luis Obispo,079,281455,61916,61403,6756,68159,512
2022-08-13,San Mateo,081,765935,164004,162531,10154,172685,738
2022-08-13,Santa Barbara,083,443738,102730,101942,6488,108430,712
2022-08-13,Santa Clara,085,1922200,422884,416369,18279,434648,2422
2022-08-13,Santa Cruz,087,273765,61041,60594,3277,63871,273
2022-08-13,Shasta,089,179085,34079,33895,7096,40991,584
2022-08-13,Sierra,091,2930,300,296,60,356,4
2022-08-13,Siskiyou,093,43540,4986,5086,3226,8312,88
2022-08-13,Solano,095,438530,102390,101761,7559,109320,458
2022-08-13,Sonoma,097,501317,104138,103496,5062,108558,504
2022-08-13,Stanislaus,099,539301,134220,133490,20775,154265,1702
2022-08-13,Sutter,101,95872,23460,23386,2405,25791,228
2022-08-13,Tehama,103,63373,13325,13213,2966,16179,209
2022-08-13,Trinity,105,12862,1365,1356,357,1713,20
2022-08-13,Tulare,107,460477,118946,118563,34025,152588,1520
2022-08-13,Tuolumne,109,53932,15106,14964,887,15851,196
2022-08-13,Ventura,111,848112,202869,201765,14626,216391,1541
2022-08-13,Yolo,113,214977,46374,46225,4067,50292,331
2022-08-13,Yuba,115,75493,18305,18232,1612,19844,129
2022-08-12,Alameda,001,1643700,336857,334944,18932,353876,1948
2022-08-12,Alpine,003,1148,131,131,1,132,0
2022-08-12,Amador,005,37829,9735,9705,887,10592,89
2022-08-12,Butte,007,227075,38343,38062,8644,46706,447
2022-08-12,Calaveras,009,45235,8291,8271,496,8767,131
2022-08-12,Colusa,011,21464,3718,3704,1211,4915,22
2022-08-12,Contra Costa,013,1133247,244168,239735,19888,259623,1393
2022-08-12,Del Norte,015,27424,7264,7245,384,7629,54
2022-08-12,El Dorado,017,186661,31540,31430,4099,35529,225
2022-08-12,Fresno,019,978130,270367,266211,29931,296142,2816
2022-08-12,Glenn,021,27897,5426,5393,1820,7213,48
2022-08-12,Humboldt,023,135768,21046,20954,4618,25572,153
2022-08-12,Imperial,025,180216,63978,63766,14786,78552,950
2022-08-12,Inyo,027,18085,4423,4418,853,5271,58
2022-08-12,Kern,029,883053,214798,213071,59404,272475,2380
2022-08-12,Kings,031,150075,57926,57748,3946,61694,454
2022-08-12,Lake,033,64148,12392,12324,1105,13429,142
2022-08-12,Lassen,035,31185,9812,9795,970,10765,64
2022-08-12,Los Angeles,037,10098052,3199120,3177769,170866,3348635,32657
2022-08-12,Madera,039,155013,42669,42517,7738,50255,372
2022-08-12,Marin,041,260295,43891,43662,5042,48704,305
2022-08-12,Mariposa,043,17540,3012,2986,324,3310,31
2022-08-12,Mendocino,045,87422,15562,15456,4252,19708,132
2022-08-12,Merced,047,269075,70760,69974,11047,81021,842
2022-08-12,Modoc,049,8938,859,856,312,1168,11
2022-08-12,Mono,051,14174,3181,3170,234,3404,7
2022-08-12,Monterey,053,433212,92160,91612,19918,111530,759
2022-08-12,Napa,055,140530,31423,31312,1370,32682,156
2022-08-12,Nevada,057,99092,18487,18398,1716,20114,132
2022-08-12,Orange,059,3164182,651077,648171,59329,707500,7248
2022-08-12,Placer,061,380077,73945,73588,9233,82821,656
2022-08-12,Plumas,063,18699,3545,3539,429,3968,13
2022-08-12,Riverside,065,2383286,678045,674362,33718,708080,6561
2022-08-12,Sacramento,067,1510023,337138,335292,32530,367822,3190
2022-08-12,San Benito,069,59416,15766,15578,890,16468,103
2022-08-12,San Bernardino,071,2135413,653811,643895,29557,673452,7983
2022-08-12,San Diego,073,3302833,901543,898646,69427,968073,5437
2022-08-12,San Francisco,075,870044,173645,172876,11703,184579,955
2022-08-12,San Joaquin,077,732212,192614,191272,14022,205294,2283
2022-08-12,San Luis Obispo,079,281455,61893,61403,6750,68153,512
2022-08-12,San Mateo,081,765935,163874,162531,10150,172681,738
2022-08-12,Santa Barbara,083,443738,102648,101942,6483,108425,712
2022-08-12,Santa Clara,085,1922200,422541,416369,18258,434627,2422
2022-08-12,Santa Cruz,087,273765,60988,60594,3275,63869,273
2022-08-12,Shasta,089,179085,34065,33895,7088,40983,584
2022-08-12,Sierra,091,2930,298,296,59,355,4
2022-08-12,Siskiyou,093,43540,4985,5086,3226,8312,88
2022-08-12,Solano,095,438530,102317,101761,7547,109308,458
2022-08-12,Sonoma,097,501317,104080,103496,5061,108557,504
2022-08-12,Stanislaus,099,539301,134133,133490,20764,154254,1702
2022-08-12,Sutter,101,95872,23445,23386,2405,25791,228
2022-08-12,Tehama,103,63373,13317,13213,2965,16178,209
2022-08-12,Trinity,105,12862,1362,1356,356,1712,20
2022-08-12,Tulare,107,460477,118883,118563,33970,152533,1520
2022-08-12,Tuolumne,109,53932,15098,14964,887,15851,196
2022-08-12,Ventura,111,848112,202723,201765,14609,216374,1541
2022-08-12,Yolo,113,214977,46352,46225,4062,50287,331
2022-08-12,Yuba,115,75493,18294,18232,1611,19843,129
2022-08-11,Alameda,001,1643700,336535,334944,18902,353846,1948
2022-08-11,Alpine,003,1148,131,131,1,132,0
2022-08-11,Amador,005,37829,9732,9705,884,10589,89
2022-08-11,Butte,007,227075,38305,38062,8632,46694,447
2022-08-11,Calaveras,009,45235,8284,8271,495,8766,131
2022-08-11,Colusa,011,21464,3715,3704,1210,4914,22
2022-08-11,Contra Costa,013,1133247,243906,239735,19858,259593,1393
2022-08-11,Del Norte,015,27424,7257,7245,383,7628,54
2022-08-11,El Dorado,017,186661,31509,31430,4092,35522,225
2022-08-11,Fresno,019,978130,270117,266211,29885,296096,2816
2022-08-11,Glenn,021,27897,5424,5393,1819,7212,48
2022-08-11,Humboldt,023,135768,21016,20954,4609,25563,153
2022-08-11,Imperial,025,180216,63931,63766,14741,78507,950
2022-08-11,Inyo,027,18085,4421,4418,848,5266,58
2022-08-11,Kern,029,883053,214609,213071,59257,272328,2380
2022-08-11,Kings,031,150075,57868,57748,3939,61687,454
2022-08-11,Lake,033,64148,12382,12324,1104,13428,142
2022-08-11,Lassen,035,31185,9807,9795,970,10765,64
2022-08-11,Los Angeles,037,10098052,3196103,3177769,170487,3348256,32657
2022-08-11,Madera,039,155013,42622,42517,7713,50230,372
2022-08-11,Marin,041,260295,43852,43662,5035,48697,305
2022-08-11,Mariposa,043,17540,3010,2986,323,3309,31
2022-08-11,Mendocino,045,87422,15550,15456,4250,19706,132
2022-08-11,Merced,047,269075,70701,69974,11012,80986,842
2022-08-11,Modoc,049,8938,858,856,312,1168,11
2022-08-11,Mono,051,14174,3181,3170,234,3404,7
2022-08-11,Monterey,053,433212,92059,91612,19864,111476,759
2022-08-11,Napa,055,140530,31384,31312,1369,32681,156
2022-08-11,Nevada,057,99092,18467,18398,1714,20112,132
2022-08-11,Orange,059,3164182,650424,648171,59185,707356,7248
2022-08-11,Placer,061,380077,73878,73588,9222,82810,656
2022-08-11,Plumas,063,18699,3544,3539,428,3967,13
2022-08-11,Riverside,065,2383286,677436,674362,33674,708036,6561
2022-08-11,Sacramento,067,1510023,336828,335292,32498,367790,3190
2022-08-11,San Benito,069,59416,15750,15578,889,16467,103
2022-08-11,San Bernardino,071,2135413,653060,643895,29509,673404,7983
2022-08-11,San Diego,073,3302833,900765,898646,69301,967947,5437
2022-08-11,San Francisco,075,870044,173486,172876,11686,184562,955
2022-08-11,San Joaquin,077,732212,192423,191272,13990,205262,2283
2022-08-11,San Luis Obispo,079,281455,61841,61403,6726,68129,512
2022-08-11,San Mateo,081,765935,163709,162531,10141,172672,738
2022-08-11,Santa Barbara,083,443738,102538,101942,6463,108405,712
2022-08-11,Santa Clara,085,1922200,422107,416369,18234,434603,2422
2022-08-11,Santa Cruz,087,273765,60923,60594,3271,63865,273
2022-08-11,Shasta,089,179085,34044,33895,7076,40971,584
2022-08-11,Sierra,091,2930,297,296,59,355,4
2022-08-11,Siskiyou,093,43540,4983,5086,3222,8308,88
2022-08-11,Solano,095,438530,102250,101761,7533,109294,458
2022-08-11,Sonoma,097,501317,103984,103496,5055,108551,504
2022-08-11,Stanislaus,099,539301,133976,133490,20723,154213,1702
2022-08-11,Sutter,101,95872,23415,23386,2405,25791,228
2022-08-11,Tehama,103,63373,13309,13213,2965,16178,209
2022-08-11,Trinity,105,12862,1362,1356,355,1711,20
2022-08-11,Tulare,107,460477,118784,118563,33883,152446,1520
2022-08-11,Tuolumne,109,53932,15090,14964,885,15849,196
2022-08-11,Ventura,111,848112,202518,201765,14575,216340,1541
2022-08-11,Yolo,113,214977,46318,46225,4058,50283,331
2022-08-11,Yuba,115,75493,18271,18232,1608,19840,129
2022-08-10,Alameda,001,1643700,336137,333587,18875,352462,1944
2022-08-10,Alpine,003,1148,131,131,1,132,0
2022-08-10,Amador,005,37829,9727,9677,881,10558,88
2022-08-10,Butte,007,227075,38269,37892,8624,46516,446
2022-08-10,Calaveras,009,45235,8278,8251,492,8743,130
2022-08-10,Colusa,011,21464,3711,3700,1210,4910,22
2022-08-10,Contra Costa,013,1133247,243652,238658,19821,258479,1382
2022-08-10,Del Norte,015,27424,7252,7220,383,7603,54
2022-08-10,El Dorado,017,186661,31482,31354,4078,35432,225
2022-08-10,Fresno,019,978130,269844,265300,29825,295125,2815
2022-08-10,Glenn,021,27897,5422,5387,1816,7203,48
2022-08-10,Humboldt,023,135768,21001,20843,4592,25435,153
2022-08-10,Imperial,025,180216,63872,63532,14699,78231,949
2022-08-10,Inyo,027,18085,4421,4416,847,5263,57
2022-08-10,Kern,029,883053,214421,212602,59108,271710,2380
2022-08-10,Kings,031,150075,57821,57569,3936,61505,453
2022-08-10,Lake,033,64148,12368,12281,1104,13385,142
2022-08-10,Lassen,035,31185,9800,9682,970,10652,64
2022-08-10,Los Angeles,037,10098052,3192887,3168105,170117,3338222,32609
2022-08-10,Madera,039,155013,42583,42350,7699,50049,372
2022-08-10,Marin,041,260295,43806,43532,5032,48564,302
2022-08-10,Mariposa,043,17540,3009,2980,323,3303,31
2022-08-10,Mendocino,045,87422,15535,15394,4249,19643,132
2022-08-10,Merced,047,269075,70628,69740,10988,80728,839
2022-08-10,Modoc,049,8938,857,855,311,1166,11
2022-08-10,Mono,051,14174,3179,3165,234,3399,7
2022-08-10,Monterey,053,433212,91957,91307,19798,111105,758
2022-08-10,Napa,055,140530,31346,31223,1368,32591,153
2022-08-10,Nevada,057,99092,18453,18354,1712,20066,132
2022-08-10,Orange,059,3164182,649709,646005,59062,705067,7235
2022-08-10,Placer,061,380077,73821,73348,9214,82562,650
2022-08-10,Plumas,063,18699,3542,3525,428,3953,13
2022-08-10,Riverside,065,2383286,676712,672334,33618,705952,6555
2022-08-10,Sacramento,067,1510023,336499,334382,32463,366845,3177
2022-08-10,San Benito,069,59416,15720,15507,883,16390,101
2022-08-10,San Bernardino,071,2135413,652410,641936,29460,671396,7977
2022-08-10,San Diego,073,3302833,899914,895482,69184,964666,5429
2022-08-10,San Francisco,075,870044,173321,172265,11668,183933,945
2022-08-10,San Joaquin,077,732212,192196,190596,13945,204541,2281
2022-08-10,San Luis Obispo,079,281455,61796,61207,6711,67918,510
2022-08-10,San Mateo,081,765935,163511,161882,10134,172016,738
2022-08-10,Santa Barbara,083,443738,102411,101558,6445,108003,711
2022-08-10,Santa Clara,085,1922200,421581,414659,18207,432866,2398
2022-08-10,Santa Cruz,087,273765,60842,60360,3269,63629,269
2022-08-10,Shasta,089,179085,34021,33816,7069,40885,584
2022-08-10,Sierra,091,2930,297,295,59,354,4
2022-08-10,Siskiyou,093,43540,4980,5074,3216,8290,87
2022-08-10,Solano,095,438530,102158,101393,7529,108922,457
2022-08-10,Sonoma,097,501317,103889,103168,5050,108218,501
2022-08-10,Stanislaus,099,539301,133835,133071,20691,153762,1702
2022-08-10,Sutter,101,95872,23386,23279,2404,25683,228
2022-08-10,Tehama,103,63373,13301,13187,2965,16152,209
2022-08-10,Trinity,105,12862,1361,1350,355,1705,20
2022-08-10,Tulare,107,460477,118697,118239,33805,152044,1520
2022-08-10,Tuolumne,109,53932,15055,14922,883,15805,196
2022-08-10,Ventura,111,848112,202289,201179,14542,215721,1539
2022-08-10,Yolo,113,214977,46282,46069,4053,50122,330
2022-08-10,Yuba,115,75493,18251,18179,1604,19783,129
2022-08-09,Alameda,001,1643700,335712,333587,18836,352423,1944
2022-08-09,Alpine,003,1148,131,131,1,132,0
2022-08-09,Amador,005,37829,9717,9677,880,10557,88
2022-08-09,Butte,007,227075,38231,37892,8613,46505,446
2022-08-09,Calaveras,009,45235,8271,8251,492,8743,130
2022-08-09,Colusa,011,21464,3708,3700,1209,4909,22
2022-08-09,Contra Costa,013,1133247,243375,238658,19776,258434,1382
2022-08-09,Del Norte,015,27424,7235,7220,382,7602,54
2022-08-09,El Dorado,017,186661,31453,31354,4072,35426,225
2022-08-09,Fresno,019,978130,269514,265300,29789,295089,2815
2022-08-09,Glenn,021,27897,5420,5387,1816,7203,48
2022-08-09,Humboldt,023,135768,20975,20843,4583,25426,153
2022-08-09,Imperial,025,180216,63808,63532,14643,78175,949
2022-08-09,Inyo,027,18085,4420,4416,843,5259,57
2022-08-09,Kern,029,883053,214223,212602,58964,271566,2380
2022-08-09,Kings,031,150075,57755,57569,3934,61503,453
2022-08-09,Lake,033,64148,12344,12281,1103,13384,142
2022-08-09,Lassen,035,31185,9794,9682,970,10652,64
2022-08-09,Los Angeles,037,10098052,3189384,3168105,169727,3337832,32609
2022-08-09,Madera,039,155013,42529,42350,7688,50038,372
2022-08-09,Marin,041,260295,43751,43532,5028,48560,302
2022-08-09,Mariposa,043,17540,3005,2980,322,3302,31
2022-08-09,Mendocino,045,87422,15516,15394,4240,19634,132
2022-08-09,Merced,047,269075,70563,69740,10960,80700,839
2022-08-09,Modoc,049,8938,857,855,310,1165,11
2022-08-09,Mono,051,14174,3179,3165,233,3398,7
2022-08-09,Monterey,053,433212,91845,91307,19731,111038,758
2022-08-09,Napa,055,140530,31318,31223,1366,32589,153
2022-08-09,Nevada,057,99092,18441,18354,1710,20064,132
2022-08-09,Orange,059,3164182,648888,646005,58903,704908,7235
2022-08-09,Placer,061,380077,73755,73348,9207,82555,650
2022-08-09,Plumas,063,18699,3537,3525,428,3953,13
2022-08-09,Riverside,065,2383286,675961,672334,33564,705898,6555
2022-08-09,Sacramento,067,1510023,336078,334382,32428,366810,3177
2022-08-09,San Benito,069,59416,15701,15507,879,16386,101
2022-08-09,San Bernardino,071,2135413,651722,641936,29400,671336,7977
2022-08-09,San Diego,073,3302833,899011,895482,69055,964537,5429
2022-08-09,San Francisco,075,870044,173064,172265,11649,183914,945
2022-08-09,San Joaquin,077,732212,191982,190596,13903,204499,2281
2022-08-09,San Luis Obispo,079,281455,61738,61207,6688,67895,510
2022-08-09,San Mateo,081,765935,163313,161882,10119,172001,738
2022-08-09,Santa Barbara,083,443738,102253,101558,6416,107974,711
2022-08-09,Santa Clara,085,1922200,421056,414659,18183,432842,2398
2022-08-09,Santa Cruz,087,273765,60768,60360,3260,63620,269
2022-08-09,Shasta,089,179085,33999,33816,7066,40882,584
2022-08-09,Sierra,091,2930,297,295,59,354,4
2022-08-09,Siskiyou,093,43540,4978,5074,3212,8286,87
2022-08-09,Solano,095,438530,102054,101393,7518,108911,457
2022-08-09,Sonoma,097,501317,103784,103168,5044,108212,501
2022-08-09,Stanislaus,099,539301,133692,133071,20660,153731,1702
2022-08-09,Sutter,101,95872,23355,23279,2403,25682,228
2022-08-09,Tehama,103,63373,13287,13187,2956,16143,209
2022-08-09,Trinity,105,12862,1359,1350,354,1704,20
2022-08-09,Tulare,107,460477,118582,118239,33722,151961,1520
2022-08-09,Tuolumne,109,53932,15039,14922,883,15805,196
2022-08-09,Ventura,111,848112,202053,201179,14509,215688,1539
2022-08-09,Yolo,113,214977,46240,46069,4041,50110,330
2022-08-09,Yuba,115,75493,18232,18179,1594,19773,129
2022-08-08,Alameda,001,1643700,335255,333587,18793,352380,1944
2022-08-08,Alpine,003,1148,131,131,1,132,0
2022-08-08,Amador,005,37829,9711,9677,878,10555,88
2022-08-08,Butte,007,227075,38177,37892,8600,46492,446
2022-08-08,Calaveras,009,45235,8266,8251,489,8740,130
2022-08-08,Colusa,011,21464,3708,3700,1208,4908,22
2022-08-08,Contra Costa,013,1133247,243002,238658,19729,258387,1382
2022-08-08,Del Norte,015,27424,7227,7220,382,7602,54
2022-08-08,El Dorado,017,186661,31425,31354,4065,35419,225
2022-08-08,Fresno,019,978130,269149,265300,29739,295039,2815
2022-08-08,Glenn,021,27897,5414,5387,1815,7202,48
2022-08-08,Humboldt,023,135768,20935,20843,4568,25411,153
2022-08-08,Imperial,025,180216,63748,63532,14576,78108,949
2022-08-08,Inyo,027,18085,4419,4416,842,5258,57
2022-08-08,Kern,029,883053,213963,212602,58808,271410,2380
2022-08-08,Kings,031,150075,57695,57569,3925,61494,453
2022-08-08,Lake,033,64148,12322,12281,1100,13381,142
2022-08-08,Lassen,035,31185,9781,9682,967,10649,64
2022-08-08,Los Angeles,037,10098052,3185739,3168105,169291,3337396,32609
2022-08-08,Madera,039,155013,42472,42350,7665,50015,372
2022-08-08,Marin,041,260295,43695,43532,5016,48548,302
2022-08-08,Mariposa,043,17540,3000,2980,319,3299,31
2022-08-08,Mendocino,045,87422,15502,15394,4230,19624,132
2022-08-08,Merced,047,269075,70493,69740,10932,80672,839
2022-08-08,Modoc,049,8938,856,855,310,1165,11
2022-08-08,Mono,051,14174,3179,3165,233,3398,7
2022-08-08,Monterey,053,433212,91745,91307,19650,110957,758
2022-08-08,Napa,055,140530,31283,31223,1365,32588,153
2022-08-08,Nevada,057,99092,18424,18354,1703,20057,132
2022-08-08,Orange,059,3164182,648050,646005,58735,704740,7235
2022-08-08,Placer,061,380077,73696,73348,9197,82545,650
2022-08-08,Plumas,063,18699,3534,3525,427,3952,13
2022-08-08,Riverside,065,2383286,675159,672334,33512,705846,6555
2022-08-08,Sacramento,067,1510023,335675,334382,32388,366770,3177
2022-08-08,San Benito,069,59416,15673,15507,876,16383,101
2022-08-08,San Bernardino,071,2135413,650882,641936,29342,671278,7977
2022-08-08,San Diego,073,3302833,897921,895482,68922,964404,5429
2022-08-08,San Francisco,075,870044,172843,172265,11632,183897,945
2022-08-08,San Joaquin,077,732212,191716,190596,13861,204457,2281
2022-08-08,San Luis Obispo,079,281455,61672,61207,6666,67873,510
2022-08-08,San Mateo,081,765935,163102,161882,10108,171990,738
2022-08-08,Santa Barbara,083,443738,102119,101558,6400,107958,711
2022-08-08,Santa Clara,085,1922200,420444,414659,18156,432815,2398
2022-08-08,Santa Cruz,087,273765,60692,60360,3257,63617,269
2022-08-08,Shasta,089,179085,33968,33816,7058,40874,584
2022-08-08,Sierra,091,2930,297,295,59,354,4
2022-08-08,Siskiyou,093,43540,4975,5074,3209,8283,87
2022-08-08,Solano,095,438530,101910,101393,7504,108897,457
2022-08-08,Sonoma,097,501317,103671,103168,5035,108203,501
2022-08-08,Stanislaus,099,539301,133568,133071,20632,153703,1702
2022-08-08,Sutter,101,95872,23319,23279,2403,25682,228
2022-08-08,Tehama,103,63373,13277,13187,2954,16141,209
2022-08-08,Trinity,105,12862,1359,1350,353,1703,20
2022-08-08,Tulare,107,460477,118441,118239,33636,151875,1520
2022-08-08,Tuolumne,109,53932,15031,14922,882,15804,196
2022-08-08,Ventura,111,848112,201806,201179,14460,215639,1539
2022-08-08,Yolo,113,214977,46186,46069,4035,50104,330
2022-08-08,Yuba,115,75493,18208,18179,1592,19771,129
2022-08-07,Alameda,001,1643700,334699,331755,18753,350508,1945
2022-08-07,Alpine,003,1148,131,130,1,131,0
2022-08-07,Amador,005,37829,9704,9655,876,10531,88
2022-08-07,Butte,007,227075,38105,37717,8588,46305,446
2022-08-07,Calaveras,009,45235,8253,8219,485,8704,129
2022-08-07,Colusa,011,21464,3704,3696,1207,4903,22
2022-08-07,Contra Costa,013,1133247,242610,237436,19683,257119,1383
2022-08-07,Del Norte,015,27424,7215,7191,379,7570,54
2022-08-07,El Dorado,017,186661,31385,31240,4060,35300,225
2022-08-07,Fresno,019,978130,268723,263912,29666,293578,2815
2022-08-07,Glenn,021,27897,5412,5379,1812,7191,48
2022-08-07,Humboldt,023,135768,20896,20746,4548,25294,153
2022-08-07,Imperial,025,180216,63665,63198,14504,77702,949
2022-08-07,Inyo,027,18085,4419,4408,839,5247,57
2022-08-07,Kern,029,883053,213732,211798,58606,270404,2375
2022-08-07,Kings,031,150075,57597,57294,3918,61212,453
2022-08-07,Lake,033,64148,12308,12220,1100,13320,142
2022-08-07,Lassen,035,31185,9725,9654,967,10621,64
2022-08-07,Los Angeles,037,10098052,3181282,3153757,168897,3322654,32563
2022-08-07,Madera,039,155013,42415,42139,7626,49765,372
2022-08-07,Marin,041,260295,43639,43295,5006,48301,302
2022-08-07,Mariposa,043,17540,2997,2965,318,3283,31
2022-08-07,Mendocino,045,87422,15482,15335,4212,19547,132
2022-08-07,Merced,047,269075,70366,69498,10881,80379,838
2022-08-07,Modoc,049,8938,855,853,310,1163,11
2022-08-07,Mono,051,14174,3176,3161,233,3394,7
2022-08-07,Monterey,053,433212,91611,90884,19562,110446,757
2022-08-07,Napa,055,140530,31239,31052,1363,32415,151
2022-08-07,Nevada,057,99092,18400,18309,1697,20006,132
2022-08-07,Orange,059,3164182,647148,643029,58537,701566,7213
2022-08-07,Placer,061,380077,73606,73064,9181,82245,648
2022-08-07,Plumas,063,18699,3533,3516,427,3943,13
2022-08-07,Riverside,065,2383286,674230,669230,33432,702662,6555
2022-08-07,Sacramento,067,1510023,335188,332928,32334,365262,3175
2022-08-07,San Benito,069,59416,15647,15403,873,16276,101
2022-08-07,San Bernardino,071,2135413,649986,639120,29276,668396,7956
2022-08-07,San Diego,073,3302833,896647,891504,68809,960313,5424
2022-08-07,San Francisco,075,870044,172563,171486,11605,183091,946
2022-08-07,San Joaquin,077,732212,191413,189696,13803,203499,2276
2022-08-07,San Luis Obispo,079,281455,61574,60903,6634,67537,510
2022-08-07,San Mateo,081,765935,162852,161011,10091,171102,734
2022-08-07,Santa Barbara,083,443738,101932,100995,6374,107369,711
2022-08-07,Santa Clara,085,1922200,419732,412411,18137,430548,2386
2022-08-07,Santa Cruz,087,273765,60570,59982,3242,63224,269
2022-08-07,Shasta,089,179085,33919,33727,7044,40771,583
2022-08-07,Sierra,091,2930,296,295,59,354,4
2022-08-07,Siskiyou,093,43540,4973,5045,3205,8250,87
2022-08-07,Solano,095,438530,101750,100081,7487,107568,457
2022-08-07,Sonoma,097,501317,103553,102682,5028,107710,502
2022-08-07,Stanislaus,099,539301,133374,132406,20598,153004,1701
2022-08-07,Sutter,101,95872,23283,23178,2402,25580,228
2022-08-07,Tehama,103,63373,13267,13155,2950,16105,209
2022-08-07,Trinity,105,12862,1357,1347,352,1699,20
2022-08-07,Tulare,107,460477,118288,117668,33539,151207,1516
2022-08-07,Tuolumne,109,53932,15014,14844,882,15726,196
2022-08-07,Ventura,111,848112,201546,200270,14415,214685,1537
2022-08-07,Yolo,113,214977,46136,45902,4025,49927,331
2022-08-07,Yuba,115,75493,18189,18099,1588,19687,124
2022-08-06,Alameda,001,1643700,334455,331755,18742,350497,1945
2022-08-06,Alpine,003,1148,131,130,1,131,0
2022-08-06,Amador,005,37829,9697,9655,874,10529,88
2022-08-06,Butte,007,227075,38067,37717,8578,46295,446
2022-08-06,Calaveras,009,45235,8246,8219,484,8703,129
2022-08-06,Colusa,011,21464,3702,3696,1204,4900,22
2022-08-06,Contra Costa,013,1133247,242364,237436,19664,257100,1383
2022-08-06,Del Norte,015,27424,7209,7191,379,7570,54
2022-08-06,El Dorado,017,186661,31368,31240,4057,35297,225
2022-08-06,Fresno,019,978130,268544,263912,29644,293556,2815
2022-08-06,Glenn,021,27897,5412,5379,1811,7190,48
2022-08-06,Humboldt,023,135768,20875,20746,4540,25286,153
2022-08-06,Imperial,025,180216,63618,63198,14476,77674,949
2022-08-06,Inyo,027,18085,4419,4408,838,5246,57
2022-08-06,Kern,029,883053,213634,211798,58492,270290,2375
2022-08-06,Kings,031,150075,57557,57294,3918,61212,453
2022-08-06,Lake,033,64148,12303,12220,1099,13319,142
2022-08-06,Lassen,035,31185,9692,9654,967,10621,64
2022-08-06,Los Angeles,037,10098052,3179081,3153757,168612,3322369,32563
2022-08-06,Madera,039,155013,42371,42139,7620,49759,372
2022-08-06,Marin,041,260295,43610,43295,5001,48296,302
2022-08-06,Mariposa,043,17540,2996,2965,318,3283,31
2022-08-06,Mendocino,045,87422,15473,15335,4211,19546,132
2022-08-06,Merced,047,269075,70336,69498,10876,80374,838
2022-08-06,Modoc,049,8938,855,853,310,1163,11
2022-08-06,Mono,051,14174,3173,3161,233,3394,7
2022-08-06,Monterey,053,433212,91558,90884,19518,110402,757
2022-08-06,Napa,055,140530,31218,31052,1362,32414,151
2022-08-06,Nevada,057,99092,18391,18309,1696,20005,132
2022-08-06,Orange,059,3164182,646707,643029,58423,701452,7213
2022-08-06,Placer,061,380077,73549,73064,9174,82238,648
2022-08-06,Plumas,063,18699,3531,3516,427,3943,13
2022-08-06,Riverside,065,2383286,673716,669230,33393,702623,6555
2022-08-06,Sacramento,067,1510023,335013,332928,32325,365253,3175
2022-08-06,San Benito,069,59416,15630,15403,871,16274,101
2022-08-06,San Bernardino,071,2135413,649520,639120,29240,668360,7956
2022-08-06,San Diego,073,3302833,896093,891504,68766,960270,5424
2022-08-06,San Francisco,075,870044,172406,171486,11595,183081,946
2022-08-06,San Joaquin,077,732212,191284,189696,13767,203463,2276
2022-08-06,San Luis Obispo,079,281455,61546,60903,6629,67532,510
2022-08-06,San Mateo,081,765935,162715,161011,10084,171095,734
2022-08-06,Santa Barbara,083,443738,101858,100995,6362,107357,711
2022-08-06,Santa Clara,085,1922200,419270,412411,18116,430527,2386
2022-08-06,Santa Cruz,087,273765,60513,59982,3235,63217,269
2022-08-06,Shasta,089,179085,33888,33727,7034,40761,583
2022-08-06,Sierra,091,2930,296,295,59,354,4
2022-08-06,Siskiyou,093,43540,4971,5045,3203,8248,87
2022-08-06,Solano,095,438530,101702,100081,7481,107562,457
2022-08-06,Sonoma,097,501317,103489,102682,5021,107703,502
2022-08-06,Stanislaus,099,539301,133271,132406,20587,152993,1701
2022-08-06,Sutter,101,95872,23259,23178,2402,25580,228
2022-08-06,Tehama,103,63373,13262,13155,2946,16101,209
2022-08-06,Trinity,105,12862,1357,1347,352,1699,20
2022-08-06,Tulare,107,460477,118207,117668,33496,151164,1516
2022-08-06,Tuolumne,109,53932,15006,14844,881,15725,196
2022-08-06,Ventura,111,848112,201437,200270,14393,214663,1537
2022-08-06,Yolo,113,214977,46105,45902,4017,49919,331
2022-08-06,Yuba,115,75493,18173,18099,1587,19686,124
2022-08-05,Alameda,001,1643700,334147,331755,18731,350486,1945
2022-08-05,Alpine,003,1148,131,130,1,131,0
2022-08-05,Amador,005,37829,9695,9655,873,10528,88
2022-08-05,Butte,007,227075,38029,37717,8567,46284,446
2022-08-05,Calaveras,009,45235,8242,8219,484,8703,129
2022-08-05,Colusa,011,21464,3701,3696,1204,4900,22
2022-08-05,Contra Costa,013,1133247,242171,237436,19638,257074,1383
2022-08-05,Del Norte,015,27424,7205,7191,378,7569,54
2022-08-05,El Dorado,017,186661,31360,31240,4056,35296,225
2022-08-05,Fresno,019,978130,268361,263912,29622,293534,2815
2022-08-05,Glenn,021,27897,5411,5379,1810,7189,48
2022-08-05,Humboldt,023,135768,20858,20746,4527,25273,153
2022-08-05,Imperial,025,180216,63543,63198,14437,77635,949
2022-08-05,Inyo,027,18085,4419,4408,838,5246,57
2022-08-05,Kern,029,883053,213518,211798,58401,270199,2375
2022-08-05,Kings,031,150075,57532,57294,3917,61211,453
2022-08-05,Lake,033,64148,12293,12220,1099,13319,142
2022-08-05,Lassen,035,31185,9680,9654,966,10620,64
2022-08-05,Los Angeles,037,10098052,3176571,3153757,168330,3322087,32563
2022-08-05,Madera,039,155013,42328,42139,7610,49749,372
2022-08-05,Marin,041,260295,43567,43295,4995,48290,302
2022-08-05,Mariposa,043,17540,2991,2965,317,3282,31
2022-08-05,Mendocino,045,87422,15457,15335,4209,19544,132
2022-08-05,Merced,047,269075,70285,69498,10870,80368,838
2022-08-05,Modoc,049,8938,855,853,310,1163,11
2022-08-05,Mono,051,14174,3172,3161,233,3394,7
2022-08-05,Monterey,053,433212,91490,90884,19483,110367,757
2022-08-05,Napa,055,140530,31189,31052,1361,32413,151
2022-08-05,Nevada,057,99092,18381,18309,1695,20004,132
2022-08-05,Orange,059,3164182,646199,643029,58314,701343,7213
2022-08-05,Placer,061,380077,73496,73064,9167,82231,648
2022-08-05,Plumas,063,18699,3529,3516,427,3943,13
2022-08-05,Riverside,065,2383286,673154,669230,33348,702578,6555
2022-08-05,Sacramento,067,1510023,334763,332928,32304,365232,3175
2022-08-05,San Benito,069,59416,15608,15403,869,16272,101
2022-08-05,San Bernardino,071,2135413,649061,639120,29213,668333,7956
2022-08-05,San Diego,073,3302833,895432,891504,68685,960189,5424
2022-08-05,San Francisco,075,870044,172263,171486,11575,183061,946
2022-08-05,San Joaquin,077,732212,191156,189696,13733,203429,2276
2022-08-05,San Luis Obispo,079,281455,61511,60903,6621,67524,510
2022-08-05,San Mateo,081,765935,162540,161011,10074,171085,734
2022-08-05,Santa Barbara,083,443738,101756,100995,6354,107349,711
2022-08-05,Santa Clara,085,1922200,418770,412411,18084,430495,2386
2022-08-05,Santa Cruz,087,273765,60446,59982,3231,63213,269
2022-08-05,Shasta,089,179085,33878,33727,7031,40758,583
2022-08-05,Sierra,091,2930,296,295,59,354,4
2022-08-05,Siskiyou,093,43540,4968,5045,3201,8246,87
2022-08-05,Solano,095,438530,101624,100081,7473,107554,457
2022-08-05,Sonoma,097,501317,103411,102682,5017,107699,502
2022-08-05,Stanislaus,099,539301,133169,132406,20576,152982,1701
2022-08-05,Sutter,101,95872,23240,23178,2400,25578,228
2022-08-05,Tehama,103,63373,13254,13155,2946,16101,209
2022-08-05,Trinity,105,12862,1356,1347,352,1699,20
2022-08-05,Tulare,107,460477,118121,117668,33443,151111,1516
2022-08-05,Tuolumne,109,53932,14993,14844,880,15724,196
2022-08-05,Ventura,111,848112,201287,200270,14364,214634,1537
2022-08-05,Yolo,113,214977,46086,45902,4003,49905,331
2022-08-05,Yuba,115,75493,18165,18099,1586,19685,124
2022-08-04,Alameda,001,1643700,333684,331755,18688,350443,1945
2022-08-04,Alpine,003,1148,130,130,1,131,0
2022-08-04,Amador,005,37829,9684,9655,869,10524,88
2022-08-04,Butte,007,227075,37985,37717,8551,46268,446
2022-08-04,Calaveras,009,45235,8235,8219,483,8702,129
2022-08-04,Colusa,011,21464,3700,3696,1204,4900,22
2022-08-04,Contra Costa,013,1133247,241898,237436,19598,257034,1383
2022-08-04,Del Norte,015,27424,7197,7191,377,7568,54
2022-08-04,El Dorado,017,186661,31329,31240,4053,35293,225
2022-08-04,Fresno,019,978130,268026,263912,29571,293483,2815
2022-08-04,Glenn,021,27897,5406,5379,1807,7186,48
2022-08-04,Humboldt,023,135768,20832,20746,4516,25262,153
2022-08-04,Imperial,025,180216,63476,63198,14383,77581,949
2022-08-04,Inyo,027,18085,4418,4408,837,5245,57
2022-08-04,Kern,029,883053,213312,211798,58268,270066,2375
2022-08-04,Kings,031,150075,57465,57294,3909,61203,453
2022-08-04,Lake,033,64148,12278,12220,1099,13319,142
2022-08-04,Lassen,035,31185,9675,9654,963,10617,64
2022-08-04,Los Angeles,037,10098052,3172854,3153757,167943,3321700,32563
2022-08-04,Madera,039,155013,42285,42139,7569,49708,372
2022-08-04,Marin,041,260295,43512,43295,4967,48262,302
2022-08-04,Mariposa,043,17540,2985,2965,316,3281,31
2022-08-04,Mendocino,045,87422,15442,15335,4203,19538,132
2022-08-04,Merced,047,269075,70212,69498,10832,80330,838
2022-08-04,Modoc,049,8938,855,853,310,1163,11
2022-08-04,Mono,051,14174,3172,3161,233,3394,7
2022-08-04,Monterey,053,433212,91379,90884,19420,110304,757
2022-08-04,Napa,055,140530,31153,31052,1360,32412,151
2022-08-04,Nevada,057,99092,18369,18309,1689,19998,132
2022-08-04,Orange,059,3164182,645429,643029,58171,701200,7213
2022-08-04,Placer,061,380077,73425,73064,9155,82219,648
2022-08-04,Plumas,063,18699,3523,3516,427,3943,13
2022-08-04,Riverside,065,2383286,672437,669230,33305,702535,6555
2022-08-04,Sacramento,067,1510023,334340,332928,32279,365207,3175
2022-08-04,San Benito,069,59416,15578,15403,863,16266,101
2022-08-04,San Bernardino,071,2135413,648357,639120,29158,668278,7956
2022-08-04,San Diego,073,3302833,894449,891504,68584,960088,5424
2022-08-04,San Francisco,075,870044,172051,171486,11546,183032,946
2022-08-04,San Joaquin,077,732212,190951,189696,13693,203389,2276
2022-08-04,San Luis Obispo,079,281455,61438,60903,6599,67502,510
2022-08-04,San Mateo,081,765935,162316,161011,10067,171078,734
2022-08-04,Santa Barbara,083,443738,101623,100995,6333,107328,711
2022-08-04,Santa Clara,085,1922200,418192,412411,18053,430464,2386
2022-08-04,Santa Cruz,087,273765,60358,59982,3230,63212,269
2022-08-04,Shasta,089,179085,33854,33727,7018,40745,583
2022-08-04,Sierra,091,2930,296,295,59,354,4
2022-08-04,Siskiyou,093,43540,4964,5045,3195,8240,87
2022-08-04,Solano,095,438530,101513,100081,7462,107543,457
2022-08-04,Sonoma,097,501317,103302,102682,5007,107689,502
2022-08-04,Stanislaus,099,539301,133011,132406,20552,152958,1701
2022-08-04,Sutter,101,95872,23214,23178,2398,25576,228
2022-08-04,Tehama,103,63373,13240,13155,2941,16096,209
2022-08-04,Trinity,105,12862,1355,1347,351,1698,20
2022-08-04,Tulare,107,460477,118005,117668,33383,151051,1516
2022-08-04,Tuolumne,109,53932,14969,14844,878,15722,196
2022-08-04,Ventura,111,848112,201054,200270,14326,214596,1537
2022-08-04,Yolo,113,214977,46048,45902,3995,49897,331
2022-08-04,Yuba,115,75493,18146,18099,1585,19684,124
2022-08-03,Alameda,001,1643700,333175,330158,18649,348807,1941
2022-08-03,Alpine,003,1148,130,130,1,131,0
2022-08-03,Amador,005,37829,9678,9627,866,10493,88
2022-08-03,Butte,007,227075,37940,37567,8541,46108,444
2022-08-03,Calaveras,009,45235,8227,8194,482,8676,128
2022-08-03,Colusa,011,21464,3700,3676,1204,4880,22
2022-08-03,Contra Costa,013,1133247,241571,236190,19550,255740,1381
2022-08-03,Del Norte,015,27424,7193,7156,377,7533,54
2022-08-03,El Dorado,017,186661,31293,31165,4044,35209,222
2022-08-03,Fresno,019,978130,267619,262758,29523,292281,2806
2022-08-03,Glenn,021,27897,5404,5363,1803,7166,48
2022-08-03,Humboldt,023,135768,20798,20640,4499,25139,153
2022-08-03,Imperial,025,180216,63396,62884,14334,77218,949
2022-08-03,Inyo,027,18085,4418,4398,831,5229,57
2022-08-03,Kern,029,883053,213127,211047,58092,269139,2375
2022-08-03,Kings,031,150075,57401,57065,3906,60971,453
2022-08-03,Lake,033,64148,12259,12172,1098,13270,142
2022-08-03,Lassen,035,31185,9672,9563,963,10526,64
2022-08-03,Los Angeles,037,10098052,3169112,3140955,167548,3308503,32500
2022-08-03,Madera,039,155013,42242,41918,7551,49469,372
2022-08-03,Marin,041,260295,43448,43127,4955,48082,300
2022-08-03,Mariposa,043,17540,2981,2950,316,3266,30
2022-08-03,Mendocino,045,87422,15424,15260,4195,19455,132
2022-08-03,Merced,047,269075,70146,69198,10800,79998,838
2022-08-03,Modoc,049,8938,854,842,310,1152,11
2022-08-03,Mono,051,14174,3171,3157,232,3389,7
2022-08-03,Monterey,053,433212,91274,90456,19356,109812,754
2022-08-03,Napa,055,140530,31116,30935,1355,32290,151
2022-08-03,Nevada,057,99092,18358,18253,1686,19939,132
2022-08-03,Orange,059,3164182,644612,640110,57992,698102,7202
2022-08-03,Placer,061,380077,73341,72834,9139,81973,646
2022-08-03,Plumas,063,18699,3520,3496,427,3923,13
2022-08-03,Riverside,065,2383286,671585,666773,33240,700013,6547
2022-08-03,Sacramento,067,1510023,333911,331584,32244,363828,3162
2022-08-03,San Benito,069,59416,15548,15338,856,16194,100
2022-08-03,San Bernardino,071,2135413,647617,636510,29105,665615,7951
2022-08-03,San Diego,073,3302833,893235,887729,68459,956188,5417
2022-08-03,San Francisco,075,870044,171841,170637,11528,182165,939
2022-08-03,San Joaquin,077,732212,190706,188962,13660,202622,2276
2022-08-03,San Luis Obispo,079,281455,61351,60648,6586,67234,504
2022-08-03,San Mateo,081,765935,162126,160258,10058,170316,725
2022-08-03,Santa Barbara,083,443738,101499,100558,6313,106871,710
2022-08-03,Santa Clara,085,1922200,417711,410394,18022,428416,2383
2022-08-03,Santa Cruz,087,273765,60269,59661,3227,62888,269
2022-08-03,Shasta,089,179085,33824,33630,7014,40644,582
2022-08-03,Sierra,091,2930,296,295,59,354,4
2022-08-03,Siskiyou,093,43540,4962,5021,3193,8214,86
2022-08-03,Solano,095,438530,101395,99608,7449,107057,459
2022-08-03,Sonoma,097,501317,103177,102306,4994,107300,500
2022-08-03,Stanislaus,099,539301,132867,131869,20526,152395,1701
2022-08-03,Sutter,101,95872,23186,23056,2396,25452,228
2022-08-03,Tehama,103,63373,13228,13135,2937,16072,209
2022-08-03,Trinity,105,12862,1355,1342,350,1692,20
2022-08-03,Tulare,107,460477,117871,117288,33316,150604,1516
2022-08-03,Tuolumne,109,53932,14949,14778,878,15656,196
2022-08-03,Ventura,111,848112,200815,199530,14292,213822,1536
2022-08-03,Yolo,113,214977,45999,45757,3978,49735,330
2022-08-03,Yuba,115,75493,18117,18036,1584,19620,124
2022-08-02,Alameda,001,1643700,332636,330158,18618,348776,1941
2022-08-02,Alpine,003,1148,130,130,1,131,0
2022-08-02,Amador,005,37829,9668,9627,859,10486,88
2022-08-02,Butte,007,227075,37901,37567,8529,46096,444
2022-08-02,Calaveras,009,45235,8212,8194,480,8674,128
2022-08-02,Colusa,011,21464,3697,3676,1203,4879,22
2022-08-02,Contra Costa,013,1133247,241220,236190,19490,255680,1381
2022-08-02,Del Norte,015,27424,7183,7156,377,7533,54
2022-08-02,El Dorado,017,186661,31259,31165,4038,35203,222
2022-08-02,Fresno,019,978130,267192,262758,29440,292198,2806
2022-08-02,Glenn,021,27897,5400,5363,1802,7165,48
2022-08-02,Humboldt,023,135768,20760,20640,4477,25117,153
2022-08-02,Imperial,025,180216,63314,62884,14285,77169,949
2022-08-02,Inyo,027,18085,4415,4398,821,5219,57
2022-08-02,Kern,029,883053,212887,211047,57894,268941,2375
2022-08-02,Kings,031,150075,57320,57065,3901,60966,453
2022-08-02,Lake,033,64148,12246,12172,1096,13268,142
2022-08-02,Lassen,035,31185,9669,9563,962,10525,64
2022-08-02,Los Angeles,037,10098052,3164756,3140955,167058,3308013,32500
2022-08-02,Madera,039,155013,42175,41918,7528,49446,372
2022-08-02,Marin,041,260295,43390,43127,4947,48074,300
2022-08-02,Mariposa,043,17540,2977,2950,316,3266,30
2022-08-02,Mendocino,045,87422,15394,15260,4181,19441,132
2022-08-02,Merced,047,269075,70067,69198,10760,79958,838
2022-08-02,Modoc,049,8938,854,842,310,1152,11
2022-08-02,Mono,051,14174,3170,3157,230,3387,7
2022-08-02,Monterey,053,433212,91150,90456,19286,109742,754
2022-08-02,Napa,055,140530,31080,30935,1352,32287,151
2022-08-02,Nevada,057,99092,18342,18253,1686,19939,132
2022-08-02,Orange,059,3164182,643732,640110,57814,697924,7202
2022-08-02,Placer,061,380077,73252,72834,9126,81960,646
2022-08-02,Plumas,063,18699,3515,3496,427,3923,13
2022-08-02,Riverside,065,2383286,670665,666773,33189,699962,6547
2022-08-02,Sacramento,067,1510023,333494,331584,32195,363779,3162
2022-08-02,San Benito,069,59416,15510,15338,852,16190,100
2022-08-02,San Bernardino,071,2135413,646770,636510,29054,665564,7951
2022-08-02,San Diego,073,3302833,892072,887729,68328,956057,5417
2022-08-02,San Francisco,075,870044,171605,170637,11514,182151,939
2022-08-02,San Joaquin,077,732212,190468,188962,13615,202577,2276
2022-08-02,San Luis Obispo,079,281455,61262,60648,6559,67207,504
2022-08-02,San Mateo,081,765935,161880,160258,10052,170310,725
2022-08-02,Santa Barbara,083,443738,101333,100558,6287,106845,710
2022-08-02,Santa Clara,085,1922200,417085,410394,17987,428381,2383
2022-08-02,Santa Cruz,087,273765,60179,59661,3220,62881,269
2022-08-02,Shasta,089,179085,33799,33630,7003,40633,582
2022-08-02,Sierra,091,2930,296,295,59,354,4
2022-08-02,Siskiyou,093,43540,4954,5021,3189,8210,86
2022-08-02,Solano,095,438530,101213,99608,7427,107035,459
2022-08-02,Sonoma,097,501317,103001,102306,4981,107287,500
2022-08-02,Stanislaus,099,539301,132708,131869,20485,152354,1701
2022-08-02,Sutter,101,95872,23151,23056,2396,25452,228
2022-08-02,Tehama,103,63373,13216,13135,2934,16069,209
2022-08-02,Trinity,105,12862,1355,1342,348,1690,20
2022-08-02,Tulare,107,460477,117733,117288,33231,150519,1516
2022-08-02,Tuolumne,109,53932,14932,14778,876,15654,196
2022-08-02,Ventura,111,848112,200560,199530,14250,213780,1536
2022-08-02,Yolo,113,214977,45950,45757,3973,49730,330
2022-08-02,Yuba,115,75493,18096,18036,1579,19615,124
2022-08-01,Alameda,001,1643700,331977,330158,18581,348739,1941
2022-08-01,Alpine,003,1148,130,130,1,131,0
2022-08-01,Amador,005,37829,9661,9627,857,10484,88
2022-08-01,Butte,007,227075,37843,37567,8515,46082,444
2022-08-01,Calaveras,009,45235,8209,8194,479,8673,128
2022-08-01,Colusa,011,21464,3693,3676,1194,4870,22
2022-08-01,Contra Costa,013,1133247,240825,236190,19436,255626,1381
2022-08-01,Del Norte,015,27424,7178,7156,377,7533,54
2022-08-01,El Dorado,017,186661,31233,31165,4033,35198,222
2022-08-01,Fresno,019,978130,266734,262758,29359,292117,2806
2022-08-01,Glenn,021,27897,5392,5363,1801,7164,48
2022-08-01,Humboldt,023,135768,20727,20640,4461,25101,153
2022-08-01,Imperial,025,180216,63201,62884,14226,77110,949
2022-08-01,Inyo,027,18085,4411,4398,817,5215,57
2022-08-01,Kern,029,883053,212649,211047,57721,268768,2375
2022-08-01,Kings,031,150075,57227,57065,3891,60956,453
2022-08-01,Lake,033,64148,12216,12172,1096,13268,142
2022-08-01,Lassen,035,31185,9649,9563,962,10525,64
2022-08-01,Los Angeles,037,10098052,3160011,3140955,166571,3307526,32500
2022-08-01,Madera,039,155013,42092,41918,7497,49415,372
2022-08-01,Marin,041,260295,43336,43127,4923,48050,300
2022-08-01,Mariposa,043,17540,2972,2950,315,3265,30
2022-08-01,Mendocino,045,87422,15370,15260,4172,19432,132
2022-08-01,Merced,047,269075,69955,69198,10729,79927,838
2022-08-01,Modoc,049,8938,854,842,310,1152,11
2022-08-01,Mono,051,14174,3169,3157,228,3385,7
2022-08-01,Monterey,053,433212,91006,90456,19211,109667,754
2022-08-01,Napa,055,140530,31031,30935,1348,32283,151
2022-08-01,Nevada,057,99092,18330,18253,1681,19934,132
2022-08-01,Orange,059,3164182,642782,640110,57640,697750,7202
2022-08-01,Placer,061,380077,73184,72834,9112,81946,646
2022-08-01,Plumas,063,18699,3511,3496,427,3923,13
2022-08-01,Riverside,065,2383286,669661,666773,33141,699914,6547
2022-08-01,Sacramento,067,1510023,333050,331584,32156,363740,3162
2022-08-01,San Benito,069,59416,15489,15338,852,16190,100
2022-08-01,San Bernardino,071,2135413,645846,636510,28995,665505,7951
2022-08-01,San Diego,073,3302833,890645,887729,68152,955881,5417
2022-08-01,San Francisco,075,870044,171351,170637,11500,182137,939
2022-08-01,San Joaquin,077,732212,190197,188962,13573,202535,2276
2022-08-01,San Luis Obispo,079,281455,61163,60648,6545,67193,504
2022-08-01,San Mateo,081,765935,161585,160258,10040,170298,725
2022-08-01,Santa Barbara,083,443738,101158,100558,6262,106820,710
2022-08-01,Santa Clara,085,1922200,416307,410394,17957,428351,2383
2022-08-01,Santa Cruz,087,273765,60074,59661,3208,62869,269
2022-08-01,Shasta,089,179085,33771,33630,6993,40623,582
2022-08-01,Sierra,091,2930,296,295,59,354,4
2022-08-01,Siskiyou,093,43540,4948,5021,3183,8204,86
2022-08-01,Solano,095,438530,101033,99608,7408,107016,459
2022-08-01,Sonoma,097,501317,102832,102306,4970,107276,500
2022-08-01,Stanislaus,099,539301,132535,131869,20456,152325,1701
2022-08-01,Sutter,101,95872,23096,23056,2395,25451,228
2022-08-01,Tehama,103,63373,13200,13135,2928,16063,209
2022-08-01,Trinity,105,12862,1354,1342,347,1689,20
2022-08-01,Tulare,107,460477,117558,117288,33153,150441,1516
2022-08-01,Tuolumne,109,53932,14913,14778,876,15654,196
2022-08-01,Ventura,111,848112,200303,199530,14206,213736,1536
2022-08-01,Yolo,113,214977,45899,45757,3958,49715,330
2022-08-01,Yuba,115,75493,18072,18036,1575,19611,124
2022-07-31,Alameda,001,1643700,331242,327608,18542,346150,1941
2022-07-31,Alpine,003,1148,130,130,1,131,0
2022-07-31,Amador,005,37829,9648,9609,852,10461,88
2022-07-31,Butte,007,227075,37767,37349,8495,45844,444
2022-07-31,Calaveras,009,45235,8197,8145,476,8621,128
2022-07-31,Colusa,011,21464,3689,3664,1192,4856,22
2022-07-31,Contra Costa,013,1133247,240352,234635,19367,254002,1375
2022-07-31,Del Norte,015,27424,7166,7136,374,7510,54
2022-07-31,El Dorado,017,186661,31206,31007,4024,35031,222
2022-07-31,Fresno,019,978130,266180,260858,29275,290133,2805
2022-07-31,Glenn,021,27897,5389,5350,1799,7149,48
2022-07-31,Humboldt,023,135768,20687,20523,4430,24953,151
2022-07-31,Imperial,025,180216,63096,62471,14147,76618,949
2022-07-31,Inyo,027,18085,4406,4388,812,5200,57
2022-07-31,Kern,029,883053,212338,210190,57475,267665,2375
2022-07-31,Kings,031,150075,57101,56673,3882,60555,454
2022-07-31,Lake,033,64148,12200,12102,1094,13196,142
2022-07-31,Lassen,035,31185,9570,9548,962,10510,64
2022-07-31,Los Angeles,037,10098052,3154753,3122700,165943,3288643,32445
2022-07-31,Madera,039,155013,42003,41641,7463,49104,372
2022-07-31,Marin,041,260295,43264,42840,4910,47750,300
2022-07-31,Mariposa,043,17540,2966,2940,314,3254,30
2022-07-31,Mendocino,045,87422,15350,15172,4163,19335,132
2022-07-31,Merced,047,269075,69827,68853,10685,79538,838
2022-07-31,Modoc,049,8938,850,841,310,1151,11
2022-07-31,Mono,051,14174,3168,3155,225,3380,7
2022-07-31,Monterey,053,433212,90847,89974,19127,109101,754
2022-07-31,Napa,055,140530,30965,30777,1344,32121,150
2022-07-31,Nevada,057,99092,18292,18187,1679,19866,131
2022-07-31,Orange,059,3164182,641755,636403,57435,693838,7194
2022-07-31,Placer,061,380077,73081,72444,9096,81540,647
2022-07-31,Plumas,063,18699,3505,3490,426,3916,13
2022-07-31,Riverside,065,2383286,668575,662929,33058,695987,6543
2022-07-31,Sacramento,067,1510023,332452,329639,32099,361738,3156
2022-07-31,San Benito,069,59416,15456,15256,846,16102,100
2022-07-31,San Bernardino,071,2135413,644694,633131,28896,662027,7941
2022-07-31,San Diego,073,3302833,889036,881822,68002,949824,5409
2022-07-31,San Francisco,075,870044,170955,169564,11460,181024,937
2022-07-31,San Joaquin,077,732212,189837,187937,13484,201421,2276
2022-07-31,San Luis Obispo,079,281455,61015,60370,6510,66880,503
2022-07-31,San Mateo,081,765935,161336,159145,10013,169158,726
2022-07-31,Santa Barbara,083,443738,100926,99946,6220,106166,708
2022-07-31,Santa Clara,085,1922200,415533,407392,17922,425314,2381
2022-07-31,Santa Cruz,087,273765,59906,59227,3192,62419,269
2022-07-31,Shasta,089,179085,33720,33454,6970,40424,581
2022-07-31,Sierra,091,2930,296,293,59,352,4
2022-07-31,Siskiyou,093,43540,4938,4997,3180,8177,86
2022-07-31,Solano,095,438530,100836,99034,7394,106428,457
2022-07-31,Sonoma,097,501317,102677,101747,4944,106691,500
2022-07-31,Stanislaus,099,539301,132299,131081,20409,151490,1696
2022-07-31,Sutter,101,95872,23052,22931,2384,25315,228
2022-07-31,Tehama,103,63373,13192,13079,2919,15998,208
2022-07-31,Trinity,105,12862,1352,1340,346,1686,20
2022-07-31,Tulare,107,460477,117367,116640,33033,149673,1514
2022-07-31,Tuolumne,109,53932,14889,14701,873,15574,196
2022-07-31,Ventura,111,848112,199985,198498,14126,212624,1530
2022-07-31,Yolo,113,214977,45838,45511,3947,49458,327
2022-07-31,Yuba,115,75493,18041,17951,1567,19518,124
2022-07-30,Alameda,001,1643700,330904,327608,18523,346131,1941
2022-07-30,Alpine,003,1148,130,130,1,131,0
2022-07-30,Amador,005,37829,9646,9609,847,10456,88
2022-07-30,Butte,007,227075,37738,37349,8486,45835,444
2022-07-30,Calaveras,009,45235,8187,8145,475,8620,128
2022-07-30,Colusa,011,21464,3684,3664,1192,4856,22
2022-07-30,Contra Costa,013,1133247,240077,234635,19326,253961,1375
2022-07-30,Del Norte,015,27424,7161,7136,372,7508,54
2022-07-30,El Dorado,017,186661,31187,31007,4020,35027,222
2022-07-30,Fresno,019,978130,265974,260858,29232,290090,2805
2022-07-30,Glenn,021,27897,5384,5350,1798,7148,48
2022-07-30,Humboldt,023,135768,20668,20523,4418,24941,151
2022-07-30,Imperial,025,180216,63049,62471,14119,76590,949
2022-07-30,Inyo,027,18085,4405,4388,808,5196,57
2022-07-30,Kern,029,883053,212213,210190,57332,267522,2375
2022-07-30,Kings,031,150075,57068,56673,3882,60555,454
2022-07-30,Lake,033,64148,12190,12102,1093,13195,142
2022-07-30,Lassen,035,31185,9569,9548,960,10508,64
2022-07-30,Los Angeles,037,10098052,3152269,3122700,165540,3288240,32445
2022-07-30,Madera,039,155013,41969,41641,7458,49099,372
2022-07-30,Marin,041,260295,43232,42840,4908,47748,300
2022-07-30,Mariposa,043,17540,2964,2940,313,3253,30
2022-07-30,Mendocino,045,87422,15326,15172,4159,19331,132
2022-07-30,Merced,047,269075,69777,68853,10678,79531,838
2022-07-30,Modoc,049,8938,850,841,310,1151,11
2022-07-30,Mono,051,14174,3167,3155,224,3379,7
2022-07-30,Monterey,053,433212,90755,89974,19081,109055,754
2022-07-30,Napa,055,140530,30937,30777,1341,32118,150
2022-07-30,Nevada,057,99092,18283,18187,1675,19862,131
2022-07-30,Orange,059,3164182,641203,636403,57327,693730,7194
2022-07-30,Placer,061,380077,73042,72444,9083,81527,647
2022-07-30,Plumas,063,18699,3505,3490,426,3916,13
2022-07-30,Riverside,065,2383286,668025,662929,33029,695958,6543
2022-07-30,Sacramento,067,1510023,332209,329639,32088,361727,3156
2022-07-30,San Benito,069,59416,15443,15256,843,16099,100
2022-07-30,San Bernardino,071,2135413,644207,633131,28853,661984,7941
2022-07-30,San Diego,073,3302833,888390,881822,67943,949765,5409
2022-07-30,San Francisco,075,870044,170803,169564,11450,181014,937
2022-07-30,San Joaquin,077,732212,189711,187937,13454,201391,2276
2022-07-30,San Luis Obispo,079,281455,60975,60370,6497,66867,503
2022-07-30,San Mateo,081,765935,161151,159145,9995,169140,726
2022-07-30,Santa Barbara,083,443738,100833,99946,6201,106147,708
2022-07-30,Santa Clara,085,1922200,415048,407392,17903,425295,2381
2022-07-30,Santa Cruz,087,273765,59840,59227,3185,62412,269
2022-07-30,Shasta,089,179085,33700,33454,6969,40423,581
2022-07-30,Sierra,091,2930,296,293,59,352,4
2022-07-30,Siskiyou,093,43540,4938,4997,3178,8175,86
2022-07-30,Solano,095,438530,100778,99034,7381,106415,457
2022-07-30,Sonoma,097,501317,102587,101747,4937,106684,500
2022-07-30,Stanislaus,099,539301,132167,131081,20384,151465,1696
2022-07-30,Sutter,101,95872,23027,22931,2383,25314,228
2022-07-30,Tehama,103,63373,13186,13079,2916,15995,208
2022-07-30,Trinity,105,12862,1352,1340,346,1686,20
2022-07-30,Tulare,107,460477,117276,116640,32968,149608,1514
2022-07-30,Tuolumne,109,53932,14870,14701,873,15574,196
2022-07-30,Ventura,111,848112,199814,198498,14093,212591,1530
2022-07-30,Yolo,113,214977,45811,45511,3944,49455,327
2022-07-30,Yuba,115,75493,18028,17951,1567,19518,124
2022-07-29,Alameda,001,1643700,330538,327608,18495,346103,1941
2022-07-29,Alpine,003,1148,130,130,1,131,0
2022-07-29,Amador,005,37829,9645,9609,846,10455,88
2022-07-29,Butte,007,227075,37707,37349,8469,45818,444
2022-07-29,Calaveras,009,45235,8183,8145,475,8620,128
2022-07-29,Colusa,011,21464,3684,3664,1192,4856,22
2022-07-29,Contra Costa,013,1133247,239849,234635,19302,253937,1375
2022-07-29,Del Norte,015,27424,7156,7136,371,7507,54
2022-07-29,El Dorado,017,186661,31165,31007,4019,35026,222
2022-07-29,Fresno,019,978130,265728,260858,29184,290042,2805
2022-07-29,Glenn,021,27897,5381,5350,1796,7146,48
2022-07-29,Humboldt,023,135768,20642,20523,4408,24931,151
2022-07-29,Imperial,025,180216,62988,62471,14091,76562,949
2022-07-29,Inyo,027,18085,4404,4388,807,5195,57
2022-07-29,Kern,029,883053,212049,210190,57191,267381,2375
2022-07-29,Kings,031,150075,57031,56673,3881,60554,454
2022-07-29,Lake,033,64148,12175,12102,1090,13192,142
2022-07-29,Lassen,035,31185,9567,9548,960,10508,64
2022-07-29,Los Angeles,037,10098052,3149404,3122700,165207,3287907,32445
2022-07-29,Madera,039,155013,41924,41641,7447,49088,372
2022-07-29,Marin,041,260295,43185,42840,4900,47740,300
2022-07-29,Mariposa,043,17540,2963,2940,313,3253,30
2022-07-29,Mendocino,045,87422,15308,15172,4147,19319,132
2022-07-29,Merced,047,269075,69716,68853,10662,79515,838
2022-07-29,Modoc,049,8938,850,841,310,1151,11
2022-07-29,Mono,051,14174,3166,3155,223,3378,7
2022-07-29,Monterey,053,433212,90662,89974,19046,109020,754
2022-07-29,Napa,055,140530,30912,30777,1340,32117,150
2022-07-29,Nevada,057,99092,18272,18187,1673,19860,131
2022-07-29,Orange,059,3164182,640609,636403,57184,693587,7194
2022-07-29,Placer,061,380077,72970,72444,9069,81513,647
2022-07-29,Plumas,063,18699,3504,3490,426,3916,13
2022-07-29,Riverside,065,2383286,667482,662929,32984,695913,6543
2022-07-29,Sacramento,067,1510023,331898,329639,32070,361709,3156
2022-07-29,San Benito,069,59416,15425,15256,842,16098,100
2022-07-29,San Bernardino,071,2135413,643673,633131,28819,661950,7941
2022-07-29,San Diego,073,3302833,887536,881822,67832,949654,5409
2022-07-29,San Francisco,075,870044,170625,169564,11438,181002,937
2022-07-29,San Joaquin,077,732212,189596,187937,13429,201366,2276
2022-07-29,San Luis Obispo,079,281455,60939,60370,6485,66855,503
2022-07-29,San Mateo,081,765935,160975,159145,9986,169131,726
2022-07-29,Santa Barbara,083,443738,100711,99946,6191,106137,708
2022-07-29,Santa Clara,085,1922200,414572,407392,17882,425274,2381
2022-07-29,Santa Cruz,087,273765,59764,59227,3182,62409,269
2022-07-29,Shasta,089,179085,33673,33454,6962,40416,581
2022-07-29,Sierra,091,2930,296,293,58,351,4
2022-07-29,Siskiyou,093,43540,4937,4997,3178,8175,86
2022-07-29,Solano,095,438530,100648,99034,7369,106403,457
2022-07-29,Sonoma,097,501317,102483,101747,4926,106673,500
2022-07-29,Stanislaus,099,539301,132063,131081,20372,151453,1696
2022-07-29,Sutter,101,95872,23007,22931,2383,25314,228
2022-07-29,Tehama,103,63373,13179,13079,2914,15993,208
2022-07-29,Trinity,105,12862,1348,1340,345,1685,20
2022-07-29,Tulare,107,460477,117174,116640,32908,149548,1514
2022-07-29,Tuolumne,109,53932,14856,14701,872,15573,196
2022-07-29,Ventura,111,848112,199664,198498,14054,212552,1530
2022-07-29,Yolo,113,214977,45776,45511,3931,49442,327
2022-07-29,Yuba,115,75493,18007,17951,1565,19516,124
2022-07-28,Alameda,001,1643700,330053,327608,18446,346054,1941
2022-07-28,Alpine,003,1148,130,130,1,131,0
2022-07-28,Amador,005,37829,9638,9609,845,10454,88
2022-07-28,Butte,007,227075,37655,37349,8456,45805,444
2022-07-28,Calaveras,009,45235,8172,8145,474,8619,128
2022-07-28,Colusa,011,21464,3678,3664,1192,4856,22
2022-07-28,Contra Costa,013,1133247,239484,234635,19248,253883,1375
2022-07-28,Del Norte,015,27424,7150,7136,370,7506,54
2022-07-28,El Dorado,017,186661,31130,31007,4014,35021,222
2022-07-28,Fresno,019,978130,265295,260858,29109,289967,2805
2022-07-28,Glenn,021,27897,5379,5350,1792,7142,48
2022-07-28,Humboldt,023,135768,20608,20523,4397,24920,151
2022-07-28,Imperial,025,180216,62889,62471,14027,76498,949
2022-07-28,Inyo,027,18085,4400,4388,805,5193,57
2022-07-28,Kern,029,883053,211799,210190,57019,267209,2375
2022-07-28,Kings,031,150075,56929,56673,3878,60551,454
2022-07-28,Lake,033,64148,12158,12102,1089,13191,142
2022-07-28,Lassen,035,31185,9562,9548,960,10508,64
2022-07-28,Los Angeles,037,10098052,3145080,3122700,164651,3287351,32445
2022-07-28,Madera,039,155013,41866,41641,7438,49079,372
2022-07-28,Marin,041,260295,43137,42840,4895,47735,300
2022-07-28,Mariposa,043,17540,2960,2940,310,3250,30
2022-07-28,Mendocino,045,87422,15287,15172,4136,19308,132
2022-07-28,Merced,047,269075,69634,68853,10622,79475,838
2022-07-28,Modoc,049,8938,847,841,310,1151,11
2022-07-28,Mono,051,14174,3166,3155,222,3377,7
2022-07-28,Monterey,053,433212,90506,89974,18971,108945,754
2022-07-28,Napa,055,140530,30873,30777,1338,32115,150
2022-07-28,Nevada,057,99092,18259,18187,1667,19854,131
2022-07-28,Orange,059,3164182,639656,636403,57033,693436,7194
2022-07-28,Placer,061,380077,72879,72444,9048,81492,647
2022-07-28,Plumas,063,18699,3503,3490,426,3916,13
2022-07-28,Riverside,065,2383286,666676,662929,32933,695862,6543
2022-07-28,Sacramento,067,1510023,331482,329639,32041,361680,3156
2022-07-28,San Benito,069,59416,15396,15256,837,16093,100
2022-07-28,San Bernardino,071,2135413,642826,633131,28775,661906,7941
2022-07-28,San Diego,073,3302833,886188,881822,67698,949520,5409
2022-07-28,San Francisco,075,870044,170389,169564,11408,180972,937
2022-07-28,San Joaquin,077,732212,189342,187937,13381,201318,2276
2022-07-28,San Luis Obispo,079,281455,60852,60370,6465,66835,503
2022-07-28,San Mateo,081,765935,160719,159145,9973,169118,726
2022-07-28,Santa Barbara,083,443738,100572,99946,6160,106106,708
2022-07-28,Santa Clara,085,1922200,413929,407392,17849,425241,2381
2022-07-28,Santa Cruz,087,273765,59646,59227,3170,62397,269
2022-07-28,Shasta,089,179085,33646,33454,6947,40401,581
2022-07-28,Sierra,091,2930,296,293,58,351,4
2022-07-28,Siskiyou,093,43540,4933,4997,3172,8169,86
2022-07-28,Solano,095,438530,100498,99034,7358,106392,457
2022-07-28,Sonoma,097,501317,102359,101747,4900,106647,500
2022-07-28,Stanislaus,099,539301,131914,131081,20331,151412,1696
2022-07-28,Sutter,101,95872,22976,22931,2378,25309,228
2022-07-28,Tehama,103,63373,13161,13079,2905,15984,208
2022-07-28,Trinity,105,12862,1347,1340,344,1684,20
2022-07-28,Tulare,107,460477,117048,116640,32810,149450,1514
2022-07-28,Tuolumne,109,53932,14837,14701,870,15571,196
2022-07-28,Ventura,111,848112,199396,198498,14014,212512,1530
2022-07-28,Yolo,113,214977,45727,45511,3919,49430,327
2022-07-28,Yuba,115,75493,17993,17951,1556,19507,124
2022-07-27,Alameda,001,1643700,329526,325669,18400,344069,1938
2022-07-27,Alpine,003,1148,130,130,1,131,0
2022-07-27,Amador,005,37829,9629,9568,844,10412,87
2022-07-27,Butte,007,227075,37611,37146,8444,45590,441
2022-07-27,Calaveras,009,45235,8162,8105,473,8578,130
2022-07-27,Colusa,011,21464,3669,3649,1192,4841,22
2022-07-27,Contra Costa,013,1133247,239127,233236,19199,252435,1374
2022-07-27,Del Norte,015,27424,7146,7161,370,7531,54
2022-07-27,El Dorado,017,186661,31084,30891,4005,34896,222
2022-07-27,Fresno,019,978130,264882,259483,29030,288513,2801
2022-07-27,Glenn,021,27897,5375,5327,1791,7118,48
2022-07-27,Humboldt,023,135768,20568,20406,4389,24795,150
2022-07-27,Imperial,025,180216,62805,62014,13973,75987,948
2022-07-27,Inyo,027,18085,4396,4381,801,5182,57
2022-07-27,Kern,029,883053,211572,209400,56803,266203,2368
2022-07-27,Kings,031,150075,56854,56417,3870,60287,451
2022-07-27,Lake,033,64148,12142,12025,1087,13112,142
2022-07-27,Lassen,035,31185,9557,9509,959,10468,64
2022-07-27,Los Angeles,037,10098052,3140308,3107063,164136,3271199,32392
2022-07-27,Madera,039,155013,41779,41423,7425,48848,372
2022-07-27,Marin,041,260295,43065,42624,4887,47511,300
2022-07-27,Mariposa,043,17540,2955,2927,310,3237,30
2022-07-27,Mendocino,045,87422,15258,15066,4121,19187,131
2022-07-27,Merced,047,269075,69520,68455,10592,79047,838
2022-07-27,Modoc,049,8938,845,840,310,1150,10
2022-07-27,Mono,051,14174,3164,3148,220,3368,7
2022-07-27,Monterey,053,433212,90373,89520,18899,108419,752
2022-07-27,Napa,055,140530,30830,30647,1337,31984,150
2022-07-27,Nevada,057,99092,18240,18134,1667,19801,132
2022-07-27,Orange,059,3164182,638661,632871,56858,689729,7188
2022-07-27,Placer,061,380077,72798,72194,9027,81221,647
2022-07-27,Plumas,063,18699,3497,3472,426,3898,13
2022-07-27,Riverside,065,2383286,665665,659650,32854,692504,6528
2022-07-27,Sacramento,067,1510023,331025,328249,31987,360236,3146
2022-07-27,San Benito,069,59416,15376,15188,835,16023,100
2022-07-27,San Bernardino,071,2135413,641949,629895,28720,658615,7937
2022-07-27,San Diego,073,3302833,884747,876507,67555,944062,5386
2022-07-27,San Francisco,075,870044,170142,168570,11392,179962,931
2022-07-27,San Joaquin,077,732212,189052,187066,13338,200404,2267
2022-07-27,San Luis Obispo,079,281455,60770,60180,6431,66611,502
2022-07-27,San Mateo,081,765935,160471,158343,9964,168307,724
2022-07-27,Santa Barbara,083,443738,100414,99460,6122,105582,707
2022-07-27,Santa Clara,085,1922200,413246,404896,17826,422722,2380
2022-07-27,Santa Cruz,087,273765,59551,58873,3157,62030,269
2022-07-27,Shasta,089,179085,33613,33314,6937,40251,578
2022-07-27,Sierra,091,2930,295,293,58,351,4
2022-07-27,Siskiyou,093,43540,4927,4975,3169,8144,84
2022-07-27,Solano,095,438530,100334,98579,7347,105926,457
2022-07-27,Sonoma,097,501317,102218,101316,4886,106202,499
2022-07-27,Stanislaus,099,539301,131713,130451,20289,150740,1695
2022-07-27,Sutter,101,95872,22940,22811,2372,25183,228
2022-07-27,Tehama,103,63373,13147,13036,2900,15936,207
2022-07-27,Trinity,105,12862,1346,1337,343,1680,20
2022-07-27,Tulare,107,460477,116886,116167,32737,148904,1514
2022-07-27,Tuolumne,109,53932,14807,14594,867,15461,196
2022-07-27,Ventura,111,848112,199116,197572,13949,211521,1527
2022-07-27,Yolo,113,214977,45682,45359,3902,49261,326
2022-07-27,Yuba,115,75493,17969,17873,1548,19421,124
2022-07-26,Alameda,001,1643700,328888,325669,18359,344028,1938
2022-07-26,Alpine,003,1148,130,130,1,131,0
2022-07-26,Amador,005,37829,9620,9568,840,10408,87
2022-07-26,Butte,007,227075,37551,37146,8427,45573,441
2022-07-26,Calaveras,009,45235,8152,8105,471,8576,130
2022-07-26,Colusa,011,21464,3668,3649,1192,4841,22
2022-07-26,Contra Costa,013,1133247,238690,233236,19144,252380,1374
2022-07-26,Del Norte,015,27424,7133,7161,370,7531,54
2022-07-26,El Dorado,017,186661,31040,30891,3999,34890,222
2022-07-26,Fresno,019,978130,264342,259483,28934,288417,2801
2022-07-26,Glenn,021,27897,5372,5327,1787,7114,48
2022-07-26,Humboldt,023,135768,20536,20406,4375,24781,150
2022-07-26,Imperial,025,180216,62685,62014,13892,75906,948
2022-07-26,Inyo,027,18085,4393,4381,799,5180,57
2022-07-26,Kern,029,883053,211252,209400,56580,265980,2368
2022-07-26,Kings,031,150075,56739,56417,3868,60285,451
2022-07-26,Lake,033,64148,12112,12025,1085,13110,142
2022-07-26,Lassen,035,31185,9554,9509,957,10466,64
2022-07-26,Los Angeles,037,10098052,3135283,3107063,163538,3270601,32392
2022-07-26,Madera,039,155013,41715,41423,7399,48822,372
2022-07-26,Marin,041,260295,42999,42624,4876,47500,300
2022-07-26,Mariposa,043,17540,2953,2927,310,3237,30
2022-07-26,Mendocino,045,87422,15234,15066,4110,19176,131
2022-07-26,Merced,047,269075,69428,68455,10567,79022,838
2022-07-26,Modoc,049,8938,843,840,310,1150,10
2022-07-26,Mono,051,14174,3162,3148,219,3367,7
2022-07-26,Monterey,053,433212,90234,89520,18812,108332,752
2022-07-26,Napa,055,140530,30793,30647,1331,31978,150
2022-07-26,Nevada,057,99092,18217,18134,1664,19798,132
2022-07-26,Orange,059,3164182,637562,632871,56634,689505,7188
2022-07-26,Placer,061,380077,72680,72194,9007,81201,647
2022-07-26,Plumas,063,18699,3494,3472,425,3897,13
2022-07-26,Riverside,065,2383286,664635,659650,32775,692425,6528
2022-07-26,Sacramento,067,1510023,330492,328249,31919,360168,3146
2022-07-26,San Benito,069,59416,15346,15188,833,16021,100
2022-07-26,San Bernardino,071,2135413,640957,629895,28651,658546,7937
2022-07-26,San Diego,073,3302833,883058,876507,67363,943870,5386
2022-07-26,San Francisco,075,870044,169854,168570,11377,179947,931
2022-07-26,San Joaquin,077,732212,188757,187066,13278,200344,2267
2022-07-26,San Luis Obispo,079,281455,60691,60180,6404,66584,502
2022-07-26,San Mateo,081,765935,160186,158343,9953,168296,724
2022-07-26,Santa Barbara,083,443738,100235,99460,6099,105559,707
2022-07-26,Santa Clara,085,1922200,412385,404896,17788,422684,2380
2022-07-26,Santa Cruz,087,273765,59447,58873,3140,62013,269
2022-07-26,Shasta,089,179085,33579,33314,6922,40236,578
2022-07-26,Sierra,091,2930,294,293,58,351,4
2022-07-26,Siskiyou,093,43540,4922,4975,3161,8136,84
2022-07-26,Solano,095,438530,100141,98579,7331,105910,457
2022-07-26,Sonoma,097,501317,102069,101316,4858,106174,499
2022-07-26,Stanislaus,099,539301,131499,130451,20264,150715,1695
2022-07-26,Sutter,101,95872,22910,22811,2371,25182,228
2022-07-26,Tehama,103,63373,13128,13036,2896,15932,207
2022-07-26,Trinity,105,12862,1345,1337,341,1678,20
2022-07-26,Tulare,107,460477,116736,116167,32649,148816,1514
2022-07-26,Tuolumne,109,53932,14788,14594,865,15459,196
2022-07-26,Ventura,111,848112,198805,197572,13890,211462,1527
2022-07-26,Yolo,113,214977,45632,45359,3891,49250,326
2022-07-26,Yuba,115,75493,17951,17873,1547,19420,124
2022-07-25,Alameda,001,1643700,328164,325669,18300,343969,1938
2022-07-25,Alpine,003,1148,130,130,1,131,0
2022-07-25,Amador,005,37829,9607,9568,837,10405,87
2022-07-25,Butte,007,227075,37475,37146,8412,45558,441
2022-07-25,Calaveras,009,45235,8141,8105,470,8575,130
2022-07-25,Colusa,011,21464,3667,3649,1189,4838,22
2022-07-25,Contra Costa,013,1133247,238207,233236,19062,252298,1374
2022-07-25,Del Norte,015,27424,7126,7161,369,7530,54
2022-07-25,El Dorado,017,186661,31001,30891,3985,34876,222
2022-07-25,Fresno,019,978130,263750,259483,28831,288314,2801
2022-07-25,Glenn,021,27897,5364,5327,1784,7111,48
2022-07-25,Humboldt,023,135768,20504,20406,4355,24761,150
2022-07-25,Imperial,025,180216,62566,62014,13804,75818,948
2022-07-25,Inyo,027,18085,4391,4381,793,5174,57
2022-07-25,Kern,029,883053,210961,209400,56352,265752,2368
2022-07-25,Kings,031,150075,56604,56417,3858,60275,451
2022-07-25,Lake,033,64148,12091,12025,1083,13108,142
2022-07-25,Lassen,035,31185,9547,9509,956,10465,64
2022-07-25,Los Angeles,037,10098052,3129433,3107063,162974,3270037,32392
2022-07-25,Madera,039,155013,41628,41423,7373,48796,372
2022-07-25,Marin,041,260295,42925,42624,4869,47493,300
2022-07-25,Mariposa,043,17540,2950,2927,307,3234,30
2022-07-25,Mendocino,045,87422,15195,15066,4097,19163,131
2022-07-25,Merced,047,269075,69315,68455,10536,78991,838
2022-07-25,Modoc,049,8938,838,840,308,1148,10
2022-07-25,Mono,051,14174,3160,3148,218,3366,7
2022-07-25,Monterey,053,433212,90078,89520,18702,108222,752
2022-07-25,Napa,055,140530,30749,30647,1330,31977,150
2022-07-25,Nevada,057,99092,18205,18134,1656,19790,132
2022-07-25,Orange,059,3164182,636313,632871,56427,689298,7188
2022-07-25,Placer,061,380077,72596,72194,9001,81195,647
2022-07-25,Plumas,063,18699,3488,3472,424,3896,13
2022-07-25,Riverside,065,2383286,663545,659650,32696,692346,6528
2022-07-25,Sacramento,067,1510023,329960,328249,31856,360105,3146
2022-07-25,San Benito,069,59416,15312,15188,831,16019,100
2022-07-25,San Bernardino,071,2135413,639788,629895,28594,658489,7937
2022-07-25,San Diego,073,3302833,881278,876507,67170,943677,5386
2022-07-25,San Francisco,075,870044,169538,168570,11362,179932,931
2022-07-25,San Joaquin,077,732212,188464,187066,13202,200268,2267
2022-07-25,San Luis Obispo,079,281455,60586,60180,6371,66551,502
2022-07-25,San Mateo,081,765935,159811,158343,9932,168275,724
2022-07-25,Santa Barbara,083,443738,100041,99460,6074,105534,707
2022-07-25,Santa Clara,085,1922200,411491,404896,17702,422598,2380
2022-07-25,Santa Cruz,087,273765,59326,58873,3127,62000,269
2022-07-25,Shasta,089,179085,33528,33314,6914,40228,578
2022-07-25,Sierra,091,2930,293,293,58,351,4
2022-07-25,Siskiyou,093,43540,4919,4975,3152,8127,84
2022-07-25,Solano,095,438530,99894,98579,7316,105895,457
2022-07-25,Sonoma,097,501317,101910,101316,4840,106156,499
2022-07-25,Stanislaus,099,539301,131301,130451,20234,150685,1695
2022-07-25,Sutter,101,95872,22864,22811,2370,25181,228
2022-07-25,Tehama,103,63373,13111,13036,2888,15924,207
2022-07-25,Trinity,105,12862,1343,1337,341,1678,20
2022-07-25,Tulare,107,460477,116525,116167,32551,148718,1514
2022-07-25,Tuolumne,109,53932,14769,14594,865,15459,196
2022-07-25,Ventura,111,848112,198497,197572,13835,211407,1527
2022-07-25,Yolo,113,214977,45568,45359,3875,49234,326
2022-07-25,Yuba,115,75493,17913,17873,1546,19419,124
2022-07-24,Alameda,001,1643700,327363,323165,18256,341421,1933
2022-07-24,Alpine,003,1148,130,130,1,131,0
2022-07-24,Amador,005,37829,9585,9526,834,10360,87
2022-07-24,Butte,007,227075,37410,36994,8384,45378,440
2022-07-24,Calaveras,009,45235,8124,8064,468,8532,128
2022-07-24,Colusa,011,21464,3661,3639,1189,4828,22
2022-07-24,Contra Costa,013,1133247,237675,231714,18982,250696,1363
2022-07-24,Del Norte,015,27424,7108,7128,365,7493,54
2022-07-24,El Dorado,017,186661,30955,30722,3969,34691,222
2022-07-24,Fresno,019,978130,263095,257571,28729,286300,2792
2022-07-24,Glenn,021,27897,5358,5311,1782,7093,48
2022-07-24,Humboldt,023,135768,20471,20283,4338,24621,150
2022-07-24,Imperial,025,180216,62404,61671,13684,75355,948
2022-07-24,Inyo,027,18085,4387,4366,782,5148,57
2022-07-24,Kern,029,883053,210592,208535,56111,264646,2366
2022-07-24,Kings,031,150075,56479,56103,3845,59948,451
2022-07-24,Lake,033,64148,12065,11957,1080,13037,142
2022-07-24,Lassen,035,31185,9520,9504,953,10457,64
2022-07-24,Los Angeles,037,10098052,3122943,3085376,162286,3247662,32340
2022-07-24,Madera,039,155013,41529,41145,7342,48487,372
2022-07-24,Marin,041,260295,42855,42347,4857,47204,300
2022-07-24,Mariposa,043,17540,2947,2897,306,3203,30
2022-07-24,Mendocino,045,87422,15145,14988,4065,19053,131
2022-07-24,Merced,047,269075,69158,68127,10477,78604,837
2022-07-24,Modoc,049,8938,838,829,307,1136,10
2022-07-24,Mono,051,14174,3159,3141,218,3359,7
2022-07-24,Monterey,053,433212,89901,89067,18602,107669,747
2022-07-24,Napa,055,140530,30695,30495,1329,31824,148
2022-07-24,Nevada,057,99092,18186,18073,1647,19720,131
2022-07-24,Orange,059,3164182,634963,627948,56176,684124,7181
2022-07-24,Placer,061,380077,72471,71870,8988,80858,644
2022-07-24,Plumas,063,18699,3487,3464,424,3888,13
2022-07-24,Riverside,065,2383286,662252,655603,32582,688185,6527
2022-07-24,Sacramento,067,1510023,329279,326216,31786,358002,3136
2022-07-24,San Benito,069,59416,15290,15049,830,15879,100
2022-07-24,San Bernardino,071,2135413,638403,626059,28514,654573,7933
2022-07-24,San Diego,073,3302833,879203,870102,66977,937079,5380
2022-07-24,San Francisco,075,870044,169083,167260,11332,178592,931
2022-07-24,San Joaquin,077,732212,188103,186142,13125,199267,2267
2022-07-24,San Luis Obispo,079,281455,60439,59919,6339,66258,500
2022-07-24,San Mateo,081,765935,159468,157266,9911,167177,724
2022-07-24,Santa Barbara,083,443738,99814,98826,6034,104860,706
2022-07-24,Santa Clara,085,1922200,410527,401495,17662,419157,2381
2022-07-24,Santa Cruz,087,273765,59154,58386,3106,61492,268
2022-07-24,Shasta,089,179085,33464,33185,6899,40084,578
2022-07-24,Sierra,091,2930,293,293,58,351,4
2022-07-24,Siskiyou,093,43540,4915,4938,3137,8075,84
2022-07-24,Solano,095,438530,99677,98016,7301,105317,457
2022-07-24,Sonoma,097,501317,101707,100735,4819,105554,499
2022-07-24,Stanislaus,099,539301,131007,129813,20197,150010,1695
2022-07-24,Sutter,101,95872,22813,22687,2367,25054,228
2022-07-24,Tehama,103,63373,13099,12974,2877,15851,207
2022-07-24,Trinity,105,12862,1342,1330,339,1669,20
2022-07-24,Tulare,107,460477,116340,115548,32447,147995,1513
2022-07-24,Tuolumne,109,53932,14735,14514,864,15378,196
2022-07-24,Ventura,111,848112,198088,196127,13733,209860,1525
2022-07-24,Yolo,113,214977,45493,45141,3863,49004,327
2022-07-24,Yuba,115,75493,17886,17770,1544,19314,124
2022-07-23,Alameda,001,1643700,326947,323165,18240,341405,1933
2022-07-23,Alpine,003,1148,130,130,1,131,0
2022-07-23,Amador,005,37829,9576,9526,834,10360,87
2022-07-23,Butte,007,227075,37363,36994,8377,45371,440
2022-07-23,Calaveras,009,45235,8113,8064,468,8532,128
2022-07-23,Colusa,011,21464,3656,3639,1189,4828,22
2022-07-23,Contra Costa,013,1133247,237377,231714,18952,250666,1363
2022-07-23,Del Norte,015,27424,7105,7128,364,7492,54
2022-07-23,El Dorado,017,186661,30937,30722,3967,34689,222
2022-07-23,Fresno,019,978130,262870,257571,28672,286243,2792
2022-07-23,Glenn,021,27897,5356,5311,1780,7091,48
2022-07-23,Humboldt,023,135768,20444,20283,4325,24608,150
2022-07-23,Imperial,025,180216,62342,61671,13663,75334,948
2022-07-23,Inyo,027,18085,4385,4366,781,5147,57
2022-07-23,Kern,029,883053,210424,208535,55968,264503,2366
2022-07-23,Kings,031,150075,56436,56103,3842,59945,451
2022-07-23,Lake,033,64148,12054,11957,1079,13036,142
2022-07-23,Lassen,035,31185,9518,9504,953,10457,64
2022-07-23,Los Angeles,037,10098052,3120100,3085376,161833,3247209,32340
2022-07-23,Madera,039,155013,41467,41145,7336,48481,372
2022-07-23,Marin,041,260295,42780,42347,4847,47194,300
2022-07-23,Mariposa,043,17540,2944,2897,306,3203,30
2022-07-23,Mendocino,045,87422,15125,14988,4058,19046,131
2022-07-23,Merced,047,269075,69087,68127,10462,78589,837
2022-07-23,Modoc,049,8938,838,829,307,1136,10
2022-07-23,Mono,051,14174,3158,3141,218,3359,7
2022-07-23,Monterey,053,433212,89813,89067,18581,107648,747
2022-07-23,Napa,055,140530,30662,30495,1328,31823,148
2022-07-23,Nevada,057,99092,18174,18073,1645,19718,131
2022-07-23,Orange,059,3164182,634262,627948,55978,683926,7181
2022-07-23,Placer,061,380077,72399,71870,8978,80848,644
2022-07-23,Plumas,063,18699,3486,3464,424,3888,13
2022-07-23,Riverside,065,2383286,661545,655603,32542,688145,6527
2022-07-23,Sacramento,067,1510023,329004,326216,31769,357985,3136
2022-07-23,San Benito,069,59416,15281,15049,821,15870,100
2022-07-23,San Bernardino,071,2135413,637775,626059,28471,654530,7933
2022-07-23,San Diego,073,3302833,878380,870102,66916,937018,5380
2022-07-23,San Francisco,075,870044,168891,167260,11316,178576,931
2022-07-23,San Joaquin,077,732212,187947,186142,13102,199244,2267
2022-07-23,San Luis Obispo,079,281455,60410,59919,6328,66247,500
2022-07-23,San Mateo,081,765935,159288,157266,9897,167163,724
2022-07-23,Santa Barbara,083,443738,99715,98826,6003,104829,706
2022-07-23,Santa Clara,085,1922200,409914,401495,17637,419132,2381
2022-07-23,Santa Cruz,087,273765,59103,58386,3094,61480,268
2022-07-23,Shasta,089,179085,33425,33185,6893,40078,578
2022-07-23,Sierra,091,2930,293,293,58,351,4
2022-07-23,Siskiyou,093,43540,4913,4938,3135,8073,84
2022-07-23,Solano,095,438530,99610,98016,7295,105311,457
2022-07-23,Sonoma,097,501317,101619,100735,4809,105544,499
2022-07-23,Stanislaus,099,539301,130876,129813,20161,149974,1695
2022-07-23,Sutter,101,95872,22792,22687,2367,25054,228
2022-07-23,Tehama,103,63373,13085,12974,2874,15848,207
2022-07-23,Trinity,105,12862,1342,1330,338,1668,20
2022-07-23,Tulare,107,460477,116224,115548,32378,147926,1513
2022-07-23,Tuolumne,109,53932,14712,14514,864,15378,196
2022-07-23,Ventura,111,848112,197904,196127,13698,209825,1525
2022-07-23,Yolo,113,214977,45458,45141,3855,48996,327
2022-07-23,Yuba,115,75493,17873,17770,1540,19310,124
2022-07-22,Alameda,001,1643700,326537,323165,18211,341376,1933
2022-07-22,Alpine,003,1148,130,130,1,131,0
2022-07-22,Amador,005,37829,9570,9526,833,10359,87
2022-07-22,Butte,007,227075,37328,36994,8361,45355,440
2022-07-22,Calaveras,009,45235,8104,8064,468,8532,128
2022-07-22,Colusa,011,21464,3655,3639,1185,4824,22
2022-07-22,Contra Costa,013,1133247,237083,231714,18915,250629,1363
2022-07-22,Del Norte,015,27424,7098,7128,364,7492,54
2022-07-22,El Dorado,017,186661,30908,30722,3962,34684,222
2022-07-22,Fresno,019,978130,262588,257571,28623,286194,2792
2022-07-22,Glenn,021,27897,5352,5311,1779,7090,48
2022-07-22,Humboldt,023,135768,20420,20283,4315,24598,150
2022-07-22,Imperial,025,180216,62251,61671,13631,75302,948
2022-07-22,Inyo,027,18085,4385,4366,774,5140,57
2022-07-22,Kern,029,883053,210223,208535,55817,264352,2366
2022-07-22,Kings,031,150075,56400,56103,3841,59944,451
2022-07-22,Lake,033,64148,12040,11957,1077,13034,142
2022-07-22,Lassen,035,31185,9518,9504,953,10457,64
2022-07-22,Los Angeles,037,10098052,3116565,3085376,161383,3246759,32340
2022-07-22,Madera,039,155013,41424,41145,7325,48470,372
2022-07-22,Marin,041,260295,42725,42347,4839,47186,300
2022-07-22,Mariposa,043,17540,2942,2897,306,3203,30
2022-07-22,Mendocino,045,87422,15101,14988,4050,19038,131
2022-07-22,Merced,047,269075,69017,68127,10450,78577,837
2022-07-22,Modoc,049,8938,838,829,307,1136,10
2022-07-22,Mono,051,14174,3157,3141,217,3358,7
2022-07-22,Monterey,053,433212,89723,89067,18547,107614,747
2022-07-22,Napa,055,140530,30631,30495,1328,31823,148
2022-07-22,Nevada,057,99092,18162,18073,1638,19711,131
2022-07-22,Orange,059,3164182,633488,627948,55819,683767,7181
2022-07-22,Placer,061,380077,72354,71870,8970,80840,644
2022-07-22,Plumas,063,18699,3485,3464,424,3888,13
2022-07-22,Riverside,065,2383286,660800,655603,32478,688081,6527
2022-07-22,Sacramento,067,1510023,328647,326216,31744,357960,3136
2022-07-22,San Benito,069,59416,15271,15049,821,15870,100
2022-07-22,San Bernardino,071,2135413,637152,626059,28426,654485,7933
2022-07-22,San Diego,073,3302833,877301,870102,66778,936880,5380
2022-07-22,San Francisco,075,870044,168698,167260,11287,178547,931
2022-07-22,San Joaquin,077,732212,187786,186142,13070,199212,2267
2022-07-22,San Luis Obispo,079,281455,60355,59919,6316,66235,500
2022-07-22,San Mateo,081,765935,159057,157266,9885,167151,724
2022-07-22,Santa Barbara,083,443738,99613,98826,5997,104823,706
2022-07-22,Santa Clara,085,1922200,409260,401495,17610,419105,2381
2022-07-22,Santa Cruz,087,273765,58997,58386,3086,61472,268
2022-07-22,Shasta,089,179085,33394,33185,6888,40073,578
2022-07-22,Sierra,091,2930,293,293,58,351,4
2022-07-22,Siskiyou,093,43540,4910,4938,3132,8070,84
2022-07-22,Solano,095,438530,99472,98016,7281,105297,457
2022-07-22,Sonoma,097,501317,101513,100735,4791,105526,499
2022-07-22,Stanislaus,099,539301,130746,129813,20136,149949,1695
2022-07-22,Sutter,101,95872,22768,22687,2366,25053,228
2022-07-22,Tehama,103,63373,13076,12974,2872,15846,207
2022-07-22,Trinity,105,12862,1340,1330,337,1667,20
2022-07-22,Tulare,107,460477,116110,115548,32321,147869,1513
2022-07-22,Tuolumne,109,53932,14688,14514,860,15374,196
2022-07-22,Ventura,111,848112,197717,196127,13663,209790,1525
2022-07-22,Yolo,113,214977,45404,45141,3838,48979,327
2022-07-22,Yuba,115,75493,17859,17770,1538,19308,124
2022-07-21,Alameda,001,1643700,325862,323165,18163,341328,1933
2022-07-21,Alpine,003,1148,130,130,1,131,0
2022-07-21,Amador,005,37829,9563,9526,831,10357,87
2022-07-21,Butte,007,227075,37288,36994,8341,45335,440
2022-07-21,Calaveras,009,45235,8089,8064,466,8530,128
2022-07-21,Colusa,011,21464,3651,3639,1183,4822,22
2022-07-21,Contra Costa,013,1133247,236701,231714,18857,250571,1363
2022-07-21,Del Norte,015,27424,7088,7128,364,7492,54
2022-07-21,El Dorado,017,186661,30857,30722,3959,34681,222
2022-07-21,Fresno,019,978130,262114,257571,28539,286110,2792
2022-07-21,Glenn,021,27897,5346,5311,1779,7090,48
2022-07-21,Humboldt,023,135768,20389,20283,4292,24575,150
2022-07-21,Imperial,025,180216,62138,61671,13535,75206,948
2022-07-21,Inyo,027,18085,4381,4366,767,5133,57
2022-07-21,Kern,029,883053,209950,208535,55633,264168,2366
2022-07-21,Kings,031,150075,56326,56103,3828,59931,451
2022-07-21,Lake,033,64148,12027,11957,1074,13031,142
2022-07-21,Lassen,035,31185,9515,9504,953,10457,64
2022-07-21,Los Angeles,037,10098052,3110950,3085376,160771,3246147,32340
2022-07-21,Madera,039,155013,41347,41145,7303,48448,372
2022-07-21,Marin,041,260295,42660,42347,4835,47182,300
2022-07-21,Mariposa,043,17540,2938,2897,305,3202,30
2022-07-21,Mendocino,045,87422,15075,14988,4044,19032,131
2022-07-21,Merced,047,269075,68912,68127,10425,78552,837
2022-07-21,Modoc,049,8938,836,829,307,1136,10
2022-07-21,Mono,051,14174,3153,3141,216,3357,7
2022-07-21,Monterey,053,433212,89599,89067,18472,107539,747
2022-07-21,Napa,055,140530,30587,30495,1328,31823,148
2022-07-21,Nevada,057,99092,18143,18073,1632,19705,131
2022-07-21,Orange,059,3164182,632361,627948,55593,683541,7181
2022-07-21,Placer,061,380077,72246,71870,8947,80817,644
2022-07-21,Plumas,063,18699,3484,3464,424,3888,13
2022-07-21,Riverside,065,2383286,659737,655603,32404,688007,6527
2022-07-21,Sacramento,067,1510023,328133,326216,31705,357921,3136
2022-07-21,San Benito,069,59416,15229,15049,818,15867,100
2022-07-21,San Bernardino,071,2135413,636127,626059,28361,654420,7933
2022-07-21,San Diego,073,3302833,875618,870102,66583,936685,5380
2022-07-21,San Francisco,075,870044,168343,167260,11235,178495,931
2022-07-21,San Joaquin,077,732212,187532,186142,13022,199164,2267
2022-07-21,San Luis Obispo,079,281455,60298,59919,6286,66205,500
2022-07-21,San Mateo,081,765935,158755,157266,9870,167136,724
2022-07-21,Santa Barbara,083,443738,99452,98826,5977,104803,706
2022-07-21,Santa Clara,085,1922200,408456,401495,17572,419067,2381
2022-07-21,Santa Cruz,087,273765,58879,58386,3071,61457,268
2022-07-21,Shasta,089,179085,33345,33185,6874,40059,578
2022-07-21,Sierra,091,2930,293,293,58,351,4
2022-07-21,Siskiyou,093,43540,4904,4938,3126,8064,84
2022-07-21,Solano,095,438530,99325,98016,7273,105289,457
2022-07-21,Sonoma,097,501317,101369,100735,4777,105512,499
2022-07-21,Stanislaus,099,539301,130555,129813,20112,149925,1695
2022-07-21,Sutter,101,95872,22741,22687,2364,25051,228
2022-07-21,Tehama,103,63373,13059,12974,2861,15835,207
2022-07-21,Trinity,105,12862,1336,1330,337,1667,20
2022-07-21,Tulare,107,460477,115949,115548,32249,147797,1513
2022-07-21,Tuolumne,109,53932,14655,14514,857,15371,196
2022-07-21,Ventura,111,848112,197391,196127,13573,209700,1525
2022-07-21,Yolo,113,214977,45343,45141,3825,48966,327
2022-07-21,Yuba,115,75493,17830,17770,1535,19305,124
2022-07-20,Alameda,001,1643700,325182,321347,18122,339469,1915
2022-07-20,Alpine,003,1148,130,130,1,131,0
2022-07-20,Amador,005,37829,9545,9478,829,10307,87
2022-07-20,Butte,007,227075,37239,36820,8321,45141,440
2022-07-20,Calaveras,009,45235,8080,8035,465,8500,126
2022-07-20,Colusa,011,21464,3647,3627,1181,4808,22
2022-07-20,Contra Costa,013,1133247,236301,230356,18808,249164,1362
2022-07-20,Del Norte,015,27424,7079,7081,364,7445,54
2022-07-20,El Dorado,017,186661,30826,30628,3949,34577,221
2022-07-20,Fresno,019,978130,261599,256217,28466,284683,2790
2022-07-20,Glenn,021,27897,5342,5287,1776,7063,48
2022-07-20,Humboldt,023,135768,20350,20149,4274,24423,150
2022-07-20,Imperial,025,180216,61993,61170,13440,74610,944
2022-07-20,Inyo,027,18085,4379,4355,762,5117,56
2022-07-20,Kern,029,883053,209656,207603,55443,263046,2366
2022-07-20,Kings,031,150075,56241,55836,3817,59653,449
2022-07-20,Lake,033,64148,12006,11895,1069,12964,142
2022-07-20,Lassen,035,31185,9506,9455,953,10408,64
2022-07-20,Los Angeles,037,10098052,3105338,3068779,160148,3228927,32292
2022-07-20,Madera,039,155013,41275,40902,7283,48185,372
2022-07-20,Marin,041,260295,42580,42153,4828,46981,300
2022-07-20,Mariposa,043,17540,2923,2884,303,3187,30
2022-07-20,Mendocino,045,87422,15060,14890,4032,18922,131
2022-07-20,Merced,047,269075,68812,67775,10401,78176,833
2022-07-20,Modoc,049,8938,835,799,306,1105,9
2022-07-20,Mono,051,14174,3150,3138,213,3351,7
2022-07-20,Monterey,053,433212,89461,88606,18391,106997,747
2022-07-20,Napa,055,140530,30549,30353,1326,31679,145
2022-07-20,Nevada,057,99092,18117,18020,1626,19646,131
2022-07-20,Orange,059,3164182,631090,624998,55352,680350,7173
2022-07-20,Placer,061,380077,72165,71614,8929,80543,639
2022-07-20,Plumas,063,18699,3478,3433,423,3856,13
2022-07-20,Riverside,065,2383286,658638,652192,32306,684498,6510
2022-07-20,Sacramento,067,1510023,327584,324765,31658,356423,3123
2022-07-20,San Benito,069,59416,15197,14966,815,15781,100
2022-07-20,San Bernardino,071,2135413,635085,622760,28297,651057,7921
2022-07-20,San Diego,073,3302833,873787,864434,66399,930833,5375
2022-07-20,San Francisco,075,870044,168015,166241,11217,177458,929
2022-07-20,San Joaquin,077,732212,187244,185319,12965,198284,2262
2022-07-20,San Luis Obispo,079,281455,60228,59727,6257,65984,499
2022-07-20,San Mateo,081,765935,158459,156191,9850,166041,724
2022-07-20,Santa Barbara,083,443738,99273,98322,5950,104272,703
2022-07-20,Santa Clara,085,1922200,407650,398816,17534,416350,2374
2022-07-20,Santa Cruz,087,273765,58765,58004,3058,61062,267
2022-07-20,Shasta,089,179085,33304,33017,6867,39884,576
2022-07-20,Sierra,091,2930,293,292,58,350,4
2022-07-20,Siskiyou,093,43540,4892,4921,3120,8041,84
2022-07-20,Solano,095,438530,99157,97577,7251,104828,459
2022-07-20,Sonoma,097,501317,101181,100304,4764,105068,499
2022-07-20,Stanislaus,099,539301,130388,129200,20068,149268,1695
2022-07-20,Sutter,101,95872,22706,22592,2361,24953,228
2022-07-20,Tehama,103,63373,13043,12923,2857,15780,205
2022-07-20,Trinity,105,12862,1336,1319,336,1655,20
2022-07-20,Tulare,107,460477,115763,115073,32138,147211,1510
2022-07-20,Tuolumne,109,53932,14629,14389,856,15245,196
2022-07-20,Ventura,111,848112,197072,195189,13500,208689,1522
2022-07-20,Yolo,113,214977,45287,44950,3814,48764,325
2022-07-20,Yuba,115,75493,17806,17661,1534,19195,124
2022-07-19,Alameda,001,1643700,324505,321347,18098,339445,1915
2022-07-19,Alpine,003,1148,130,130,1,131,0
2022-07-19,Amador,005,37829,9533,9478,825,10303,87
2022-07-19,Butte,007,227075,37186,36820,8307,45127,440
2022-07-19,Calaveras,009,45235,8070,8035,465,8500,126
2022-07-19,Colusa,011,21464,3644,3627,1177,4804,22
2022-07-19,Contra Costa,013,1133247,235851,230356,18751,249107,1362
2022-07-19,Del Norte,015,27424,7071,7081,363,7444,54
2022-07-19,El Dorado,017,186661,30782,30628,3940,34568,221
2022-07-19,Fresno,019,978130,260990,256217,28376,284593,2790
2022-07-19,Glenn,021,27897,5335,5287,1775,7062,48
2022-07-19,Humboldt,023,135768,20315,20149,4260,24409,150
2022-07-19,Imperial,025,180216,61859,61170,13350,74520,944
2022-07-19,Inyo,027,18085,4377,4355,760,5115,56
2022-07-19,Kern,029,883053,209377,207603,55251,262854,2366
2022-07-19,Kings,031,150075,56138,55836,3798,59634,449
2022-07-19,Lake,033,64148,11985,11895,1061,12956,142
2022-07-19,Lassen,035,31185,9498,9455,953,10408,64
2022-07-19,Los Angeles,037,10098052,3099162,3068779,159447,3228226,32292
2022-07-19,Madera,039,155013,41196,40902,7260,48162,372
2022-07-19,Marin,041,260295,42517,42153,4815,46968,300
2022-07-19,Mariposa,043,17540,2918,2884,302,3186,30
2022-07-19,Mendocino,045,87422,15028,14890,4021,18911,131
2022-07-19,Merced,047,269075,68707,67775,10369,78144,833
2022-07-19,Modoc,049,8938,834,799,306,1105,9
2022-07-19,Mono,051,14174,3146,3138,213,3351,7
2022-07-19,Monterey,053,433212,89310,88606,18310,106916,747
2022-07-19,Napa,055,140530,30493,30353,1322,31675,145
2022-07-19,Nevada,057,99092,18103,18020,1619,19639,131
2022-07-19,Orange,059,3164182,629803,624998,55102,680100,7173
2022-07-19,Placer,061,380077,72077,71614,8912,80526,639
2022-07-19,Plumas,063,18699,3472,3433,421,3854,13
2022-07-19,Riverside,065,2383286,657328,652192,32211,684403,6510
2022-07-19,Sacramento,067,1510023,326954,324765,31617,356382,3123
2022-07-19,San Benito,069,59416,15153,14966,813,15779,100
2022-07-19,San Bernardino,071,2135413,633966,622760,28224,650984,7921
2022-07-19,San Diego,073,3302833,871698,864434,66152,930586,5375
2022-07-19,San Francisco,075,870044,167663,166241,11198,177439,929
2022-07-19,San Joaquin,077,732212,186962,185319,12903,198222,2262
2022-07-19,San Luis Obispo,079,281455,60144,59727,6219,65946,499
2022-07-19,San Mateo,081,765935,158161,156191,9827,166018,724
2022-07-19,Santa Barbara,083,443738,99062,98322,5928,104250,703
2022-07-19,Santa Clara,085,1922200,406699,398816,17482,416298,2374
2022-07-19,Santa Cruz,087,273765,58643,58004,3043,61047,267
2022-07-19,Shasta,089,179085,33272,33017,6853,39870,576
2022-07-19,Sierra,091,2930,293,292,58,350,4
2022-07-19,Siskiyou,093,43540,4887,4921,3113,8034,84
2022-07-19,Solano,095,438530,98932,97577,7224,104801,459
2022-07-19,Sonoma,097,501317,101024,100304,4736,105040,499
2022-07-19,Stanislaus,099,539301,130145,129200,20036,149236,1695
2022-07-19,Sutter,101,95872,22676,22592,2358,24950,228
2022-07-19,Tehama,103,63373,13029,12923,2850,15773,205
2022-07-19,Trinity,105,12862,1333,1319,335,1654,20
2022-07-19,Tulare,107,460477,115577,115073,32031,147104,1510
2022-07-19,Tuolumne,109,53932,14605,14389,847,15236,196
2022-07-19,Ventura,111,848112,196726,195189,13422,208611,1522
2022-07-19,Yolo,113,214977,45226,44950,3804,48754,325
2022-07-19,Yuba,115,75493,17773,17661,1533,19194,124
2022-07-18,Alameda,001,1643700,323766,321347,18062,339409,1915
2022-07-18,Alpine,003,1148,130,130,1,131,0
2022-07-18,Amador,005,37829,9518,9478,825,10303,87
2022-07-18,Butte,007,227075,37116,36820,8294,45114,440
2022-07-18,Calaveras,009,45235,8059,8035,462,8497,126
2022-07-18,Colusa,011,21464,3641,3627,1171,4798,22
2022-07-18,Contra Costa,013,1133247,235386,230356,18680,249036,1362
2022-07-18,Del Norte,015,27424,7060,7081,361,7442,54
2022-07-18,El Dorado,017,186661,30730,30628,3931,34559,221
2022-07-18,Fresno,019,978130,260397,256217,28295,284512,2790
2022-07-18,Glenn,021,27897,5333,5287,1775,7062,48
2022-07-18,Humboldt,023,135768,20274,20149,4240,24389,150
2022-07-18,Imperial,025,180216,61694,61170,13253,74423,944
2022-07-18,Inyo,027,18085,4373,4355,759,5114,56
2022-07-18,Kern,029,883053,209064,207603,54998,262601,2366
2022-07-18,Kings,031,150075,56031,55836,3790,59626,449
2022-07-18,Lake,033,64148,11963,11895,1055,12950,142
2022-07-18,Lassen,035,31185,9494,9455,952,10407,64
2022-07-18,Los Angeles,037,10098052,3092323,3068779,158781,3227560,32292
2022-07-18,Madera,039,155013,41090,40902,7232,48134,372
2022-07-18,Marin,041,260295,42437,42153,4805,46958,300
2022-07-18,Mariposa,043,17540,2910,2884,301,3185,30
2022-07-18,Mendocino,045,87422,14999,14890,4010,18900,131
2022-07-18,Merced,047,269075,68585,67775,10343,78118,833
2022-07-18,Modoc,049,8938,833,799,306,1105,9
2022-07-18,Mono,051,14174,3145,3138,213,3351,7
2022-07-18,Monterey,053,433212,89146,88606,18230,106836,747
2022-07-18,Napa,055,140530,30453,30353,1319,31672,145
2022-07-18,Nevada,057,99092,18089,18020,1607,19627,131
2022-07-18,Orange,059,3164182,628322,624998,54835,679833,7173
2022-07-18,Placer,061,380077,71991,71614,8896,80510,639
2022-07-18,Plumas,063,18699,3463,3433,420,3853,13
2022-07-18,Riverside,065,2383286,656043,652192,32101,684293,6510
2022-07-18,Sacramento,067,1510023,326333,324765,31560,356325,3123
2022-07-18,San Benito,069,59416,15114,14966,808,15774,100
2022-07-18,San Bernardino,071,2135413,632701,622760,28152,650912,7921
2022-07-18,San Diego,073,3302833,869380,864434,65880,930314,5375
2022-07-18,San Francisco,075,870044,167246,166241,11173,177414,929
2022-07-18,San Joaquin,077,732212,186629,185319,12844,198163,2262
2022-07-18,San Luis Obispo,079,281455,60048,59727,6194,65921,499
2022-07-18,San Mateo,081,765935,157787,156191,9807,165998,724
2022-07-18,Santa Barbara,083,443738,98864,98322,5907,104229,703
2022-07-18,Santa Clara,085,1922200,405717,398816,17430,416246,2374
2022-07-18,Santa Cruz,087,273765,58494,58004,3031,61035,267
2022-07-18,Shasta,089,179085,33223,33017,6837,39854,576
2022-07-18,Sierra,091,2930,293,292,58,350,4
2022-07-18,Siskiyou,093,43540,4883,4921,3106,8027,84
2022-07-18,Solano,095,438530,98697,97577,7203,104780,459
2022-07-18,Sonoma,097,501317,100845,100304,4718,105022,499
2022-07-18,Stanislaus,099,539301,129922,129200,19996,149196,1695
2022-07-18,Sutter,101,95872,22642,22592,2358,24950,228
2022-07-18,Tehama,103,63373,13008,12923,2850,15773,205
2022-07-18,Trinity,105,12862,1331,1319,334,1653,20
2022-07-18,Tulare,107,460477,115385,115073,31944,147017,1510
2022-07-18,Tuolumne,109,53932,14569,14389,845,15234,196
2022-07-18,Ventura,111,848112,196343,195189,13349,208538,1522
2022-07-18,Yolo,113,214977,45157,44950,3793,48743,325
2022-07-18,Yuba,115,75493,17738,17661,1524,19185,124
2022-07-17,Alameda,001,1643700,322867,318442,18005,336447,1911
2022-07-17,Alpine,003,1148,130,130,1,131,0
2022-07-17,Amador,005,37829,9509,9437,821,10258,87
2022-07-17,Butte,007,227075,37055,36644,8272,44916,440
2022-07-17,Calaveras,009,45235,8043,7994,452,8446,126
2022-07-17,Colusa,011,21464,3635,3617,1165,4782,22
2022-07-17,Contra Costa,013,1133247,234821,228634,18606,247240,1356
2022-07-17,Del Norte,015,27424,7033,6860,359,7219,54
2022-07-17,El Dorado,017,186661,30682,30461,3917,34378,219
2022-07-17,Fresno,019,978130,259703,254088,28187,282275,2790
2022-07-17,Glenn,021,27897,5327,5273,1773,7046,48
2022-07-17,Humboldt,023,135768,20218,20016,4223,24239,150
2022-07-17,Imperial,025,180216,61499,60550,13108,73658,944
2022-07-17,Inyo,027,18085,4363,4343,755,5098,56
2022-07-17,Kern,029,883053,208568,206466,54767,261233,2364
2022-07-17,Kings,031,150075,55893,55432,3767,59199,449
2022-07-17,Lake,033,64148,11931,11835,1051,12886,141
2022-07-17,Lassen,035,31185,9468,9425,948,10373,64
2022-07-17,Los Angeles,037,10098052,3085008,3042708,157987,3200695,32248
2022-07-17,Madera,039,155013,40981,40627,7187,47814,372
2022-07-17,Marin,041,260295,42339,41829,4798,46627,300
2022-07-17,Mariposa,043,17540,2903,2866,301,3167,30
2022-07-17,Mendocino,045,87422,14959,14799,3992,18791,131
2022-07-17,Merced,047,269075,68449,67416,10303,77719,833
2022-07-17,Modoc,049,8938,830,799,306,1105,9
2022-07-17,Mono,051,14174,3143,3131,209,3340,7
2022-07-17,Monterey,053,433212,88953,88118,18160,106278,747
2022-07-17,Napa,055,140530,30394,30176,1318,31494,145
2022-07-17,Nevada,057,99092,18062,17941,1599,19540,131
2022-07-17,Orange,059,3164182,626743,620414,54555,674969,7161
2022-07-17,Placer,061,380077,71902,71232,8877,80109,637
2022-07-17,Plumas,063,18699,3448,3406,420,3826,13
2022-07-17,Riverside,065,2383286,654577,647328,31985,679313,6508
2022-07-17,Sacramento,067,1510023,325669,322788,31502,354290,3119
2022-07-17,San Benito,069,59416,15088,14869,802,15671,100
2022-07-17,San Bernardino,071,2135413,631275,618482,28042,646524,7914
2022-07-17,San Diego,073,3302833,867002,857262,65677,922939,5370
2022-07-17,San Francisco,075,870044,166782,164853,11129,175982,928
2022-07-17,San Joaquin,077,732212,186253,184187,12764,196951,2262
2022-07-17,San Luis Obispo,079,281455,59929,59437,6155,65592,499
2022-07-17,San Mateo,081,765935,157416,154961,9786,164747,723
2022-07-17,Santa Barbara,083,443738,98595,97600,5880,103480,702
2022-07-17,Santa Clara,085,1922200,404656,395466,17375,412841,2371
2022-07-17,Santa Cruz,087,273765,58297,57531,3013,60544,267
2022-07-17,Shasta,089,179085,33170,32871,6811,39682,575
2022-07-17,Sierra,091,2930,293,291,58,349,4
2022-07-17,Siskiyou,093,43540,4877,4899,3092,7991,83
2022-07-17,Solano,095,438530,98495,96974,7178,104152,457
2022-07-17,Sonoma,097,501317,100651,99679,4700,104379,499
2022-07-17,Stanislaus,099,539301,129654,128436,19959,148395,1692
2022-07-17,Sutter,101,95872,22589,22452,2355,24807,228
2022-07-17,Tehama,103,63373,12984,12860,2842,15702,205
2022-07-17,Trinity,105,12862,1328,1304,332,1636,20
2022-07-17,Tulare,107,460477,115163,114399,31851,146250,1510
2022-07-17,Tuolumne,109,53932,14536,14280,837,15117,196
2022-07-17,Ventura,111,848112,195884,193965,13232,207197,1519
2022-07-17,Yolo,113,214977,45080,44703,3776,48479,324
2022-07-17,Yuba,115,75493,17698,17567,1514,19081,124
2022-07-16,Alameda,001,1643700,322452,318442,17988,336430,1911
2022-07-16,Alpine,003,1148,130,130,1,131,0
2022-07-16,Amador,005,37829,9501,9437,821,10258,87
2022-07-16,Butte,007,227075,37034,36644,8257,44901,440
2022-07-16,Calaveras,009,45235,8038,7994,446,8440,126
2022-07-16,Colusa,011,21464,3631,3617,1161,4778,22
2022-07-16,Contra Costa,013,1133247,234512,228634,18553,247187,1356
2022-07-16,Del Norte,015,27424,7022,6860,359,7219,54
2022-07-16,El Dorado,017,186661,30661,30461,3915,34376,219
2022-07-16,Fresno,019,978130,259413,254088,28144,282232,2790
2022-07-16,Glenn,021,27897,5322,5273,1770,7043,48
2022-07-16,Humboldt,023,135768,20187,20016,4211,24227,150
2022-07-16,Imperial,025,180216,61414,60550,13064,73614,944
2022-07-16,Inyo,027,18085,4362,4343,754,5097,56
2022-07-16,Kern,029,883053,208396,206466,54599,261065,2364
2022-07-16,Kings,031,150075,55853,55432,3763,59195,449
2022-07-16,Lake,033,64148,11915,11835,1051,12886,141
2022-07-16,Lassen,035,31185,9466,9425,947,10372,64
2022-07-16,Los Angeles,037,10098052,3081534,3042708,157510,3200218,32248
2022-07-16,Madera,039,155013,40938,40627,7174,47801,372
2022-07-16,Marin,041,260295,42303,41829,4791,46620,300
2022-07-16,Mariposa,043,17540,2901,2866,301,3167,30
2022-07-16,Mendocino,045,87422,14951,14799,3989,18788,131
2022-07-16,Merced,047,269075,68360,67416,10292,77708,833
2022-07-16,Modoc,049,8938,830,799,306,1105,9
2022-07-16,Mono,051,14174,3142,3131,208,3339,7
2022-07-16,Monterey,053,433212,88859,88118,18118,106236,747
2022-07-16,Napa,055,140530,30365,30176,1316,31492,145
2022-07-16,Nevada,057,99092,18048,17941,1592,19533,131
2022-07-16,Orange,059,3164182,626016,620414,54397,674811,7161
2022-07-16,Placer,061,380077,71817,71232,8861,80093,637
2022-07-16,Plumas,063,18699,3444,3406,419,3825,13
2022-07-16,Riverside,065,2383286,653788,647328,31934,679262,6508
2022-07-16,Sacramento,067,1510023,325395,322788,31487,354275,3119
2022-07-16,San Benito,069,59416,15071,14869,798,15667,100
2022-07-16,San Bernardino,071,2135413,630530,618482,27980,646462,7914
2022-07-16,San Diego,073,3302833,866093,857262,65592,922854,5370
2022-07-16,San Francisco,075,870044,166598,164853,11113,175966,928
2022-07-16,San Joaquin,077,732212,186094,184187,12734,196921,2262
2022-07-16,San Luis Obispo,079,281455,59901,59437,6135,65572,499
2022-07-16,San Mateo,081,765935,157174,154961,9776,164737,723
2022-07-16,Santa Barbara,083,443738,98479,97600,5860,103460,702
2022-07-16,Santa Clara,085,1922200,403986,395466,17349,412815,2371
2022-07-16,Santa Cruz,087,273765,58225,57531,3008,60539,267
2022-07-16,Shasta,089,179085,33150,32871,6807,39678,575
2022-07-16,Sierra,091,2930,293,291,58,349,4
2022-07-16,Siskiyou,093,43540,4876,4899,3087,7986,83
2022-07-16,Solano,095,438530,98422,96974,7161,104135,457
2022-07-16,Sonoma,097,501317,100564,99679,4689,104368,499
2022-07-16,Stanislaus,099,539301,129523,128436,19925,148361,1692
2022-07-16,Sutter,101,95872,22566,22452,2354,24806,228
2022-07-16,Tehama,103,63373,12975,12860,2837,15697,205
2022-07-16,Trinity,105,12862,1326,1304,332,1636,20
2022-07-16,Tulare,107,460477,115057,114399,31791,146190,1510
2022-07-16,Tuolumne,109,53932,14512,14280,837,15117,196
2022-07-16,Ventura,111,848112,195658,193965,13191,207156,1519
2022-07-16,Yolo,113,214977,45034,44703,3763,48466,324
2022-07-16,Yuba,115,75493,17674,17567,1514,19081,124
2022-07-15,Alameda,001,1643700,321990,318442,17953,336395,1911
2022-07-15,Alpine,003,1148,130,130,1,131,0
2022-07-15,Amador,005,37829,9498,9437,820,10257,87
2022-07-15,Butte,007,227075,36995,36644,8252,44896,440
2022-07-15,Calaveras,009,45235,8032,7994,442,8436,126
2022-07-15,Colusa,011,21464,3629,3617,1159,4776,22
2022-07-15,Contra Costa,013,1133247,234237,228634,18502,247136,1356
2022-07-15,Del Norte,015,27424,7011,6860,356,7216,54
2022-07-15,El Dorado,017,186661,30633,30461,3912,34373,219
2022-07-15,Fresno,019,978130,259018,254088,28078,282166,2790
2022-07-15,Glenn,021,27897,5319,5273,1767,7040,48
2022-07-15,Humboldt,023,135768,20163,20016,4199,24215,150
2022-07-15,Imperial,025,180216,61341,60550,13022,73572,944
2022-07-15,Inyo,027,18085,4357,4343,749,5092,56
2022-07-15,Kern,029,883053,208181,206466,54428,260894,2364
2022-07-15,Kings,031,150075,55789,55432,3756,59188,449
2022-07-15,Lake,033,64148,11903,11835,1048,12883,141
2022-07-15,Lassen,035,31185,9464,9425,945,10370,64
2022-07-15,Los Angeles,037,10098052,3077341,3042708,156992,3199700,32248
2022-07-15,Madera,039,155013,40875,40627,7155,47782,372
2022-07-15,Marin,041,260295,42243,41829,4780,46609,300
2022-07-15,Mariposa,043,17540,2898,2866,300,3166,30
2022-07-15,Mendocino,045,87422,14927,14799,3984,18783,131
2022-07-15,Merced,047,269075,68296,67416,10279,77695,833
2022-07-15,Modoc,049,8938,829,799,306,1105,9
2022-07-15,Mono,051,14174,3140,3131,207,3338,7
2022-07-15,Monterey,053,433212,88745,88118,18091,106209,747
2022-07-15,Napa,055,140530,30333,30176,1315,31491,145
2022-07-15,Nevada,057,99092,18036,17941,1590,19531,131
2022-07-15,Orange,059,3164182,625173,620414,54221,674635,7161
2022-07-15,Placer,061,380077,71744,71232,8834,80066,637
2022-07-15,Plumas,063,18699,3437,3406,417,3823,13
2022-07-15,Riverside,065,2383286,652962,647328,31872,679200,6508
2022-07-15,Sacramento,067,1510023,325025,322788,31463,354251,3119
2022-07-15,San Benito,069,59416,15056,14869,798,15667,100
2022-07-15,San Bernardino,071,2135413,629782,618482,27939,646421,7914
2022-07-15,San Diego,073,3302833,864819,857262,65427,922689,5370
2022-07-15,San Francisco,075,870044,166343,164853,11073,175926,928
2022-07-15,San Joaquin,077,732212,185915,184187,12689,196876,2262
2022-07-15,San Luis Obispo,079,281455,59869,59437,6123,65560,499
2022-07-15,San Mateo,081,765935,156936,154961,9759,164720,723
2022-07-15,Santa Barbara,083,443738,98350,97600,5853,103453,702
2022-07-15,Santa Clara,085,1922200,403302,395466,17320,412786,2371
2022-07-15,Santa Cruz,087,273765,58135,57531,2996,60527,267
2022-07-15,Shasta,089,179085,33127,32871,6800,39671,575
2022-07-15,Sierra,091,2930,293,291,58,349,4
2022-07-15,Siskiyou,093,43540,4876,4899,3085,7984,83
2022-07-15,Solano,095,438530,98273,96974,7149,104123,457
2022-07-15,Sonoma,097,501317,100441,99679,4680,104359,499
2022-07-15,Stanislaus,099,539301,129399,128436,19904,148340,1692
2022-07-15,Sutter,101,95872,22539,22452,2353,24805,228
2022-07-15,Tehama,103,63373,12968,12860,2829,15689,205
2022-07-15,Trinity,105,12862,1322,1304,332,1636,20
2022-07-15,Tulare,107,460477,114906,114399,31706,146105,1510
2022-07-15,Tuolumne,109,53932,14469,14280,834,15114,196
2022-07-15,Ventura,111,848112,195432,193965,13152,207117,1519
2022-07-15,Yolo,113,214977,44988,44703,3752,48455,324
2022-07-15,Yuba,115,75493,17648,17567,1514,19081,124
2022-07-14,Alameda,001,1643700,321227,318442,17892,336334,1911
2022-07-14,Alpine,003,1148,130,130,1,131,0
2022-07-14,Amador,005,37829,9485,9437,814,10251,87
2022-07-14,Butte,007,227075,36955,36644,8246,44890,440
2022-07-14,Calaveras,009,45235,8025,7994,438,8432,126
2022-07-14,Colusa,011,21464,3629,3617,1157,4774,22
2022-07-14,Contra Costa,013,1133247,233793,228634,18415,247049,1356
2022-07-14,Del Norte,015,27424,6990,6860,354,7214,54
2022-07-14,El Dorado,017,186661,30597,30461,3903,34364,219
2022-07-14,Fresno,019,978130,258483,254088,27983,282071,2790
2022-07-14,Glenn,021,27897,5310,5273,1764,7037,48
2022-07-14,Humboldt,023,135768,20123,20016,4184,24200,150
2022-07-14,Imperial,025,180216,61162,60550,12907,73457,944
2022-07-14,Inyo,027,18085,4355,4343,744,5087,56
2022-07-14,Kern,029,883053,207852,206466,54229,260695,2364
2022-07-14,Kings,031,150075,55695,55432,3745,59177,449
2022-07-14,Lake,033,64148,11887,11835,1046,12881,141
2022-07-14,Lassen,035,31185,9459,9425,944,10369,64
2022-07-14,Los Angeles,037,10098052,3071151,3042708,156276,3198984,32248
2022-07-14,Madera,039,155013,40801,40627,7097,47724,372
2022-07-14,Marin,041,260295,42152,41829,4775,46604,300
2022-07-14,Mariposa,043,17540,2892,2866,295,3161,30
2022-07-14,Mendocino,045,87422,14913,14799,3978,18777,131
2022-07-14,Merced,047,269075,68203,67416,10252,77668,833
2022-07-14,Modoc,049,8938,829,799,306,1105,9
2022-07-14,Mono,051,14174,3139,3131,207,3338,7
2022-07-14,Monterey,053,433212,88628,88118,18013,106131,747
2022-07-14,Napa,055,140530,30289,30176,1311,31487,145
2022-07-14,Nevada,057,99092,18011,17941,1581,19522,131
2022-07-14,Orange,059,3164182,623906,620414,53985,674399,7161
2022-07-14,Placer,061,380077,71634,71232,8814,80046,637
2022-07-14,Plumas,063,18699,3428,3406,416,3822,13
2022-07-14,Riverside,065,2383286,651727,647328,31798,679126,6508
2022-07-14,Sacramento,067,1510023,324473,322788,31420,354208,3119
2022-07-14,San Benito,069,59416,15026,14869,794,15663,100
2022-07-14,San Bernardino,071,2135413,628626,618482,27861,646343,7914
2022-07-14,San Diego,073,3302833,862943,857262,65197,922459,5370
2022-07-14,San Francisco,075,870044,165999,164853,11026,175879,928
2022-07-14,San Joaquin,077,732212,185601,184187,12647,196834,2262
2022-07-14,San Luis Obispo,079,281455,59782,59437,6077,65514,499
2022-07-14,San Mateo,081,765935,156645,154961,9738,164699,723
2022-07-14,Santa Barbara,083,443738,98171,97600,5841,103441,702
2022-07-14,Santa Clara,085,1922200,402444,395466,17277,412743,2371
2022-07-14,Santa Cruz,087,273765,58043,57531,2982,60513,267
2022-07-14,Shasta,089,179085,33080,32871,6788,39659,575
2022-07-14,Sierra,091,2930,293,291,58,349,4
2022-07-14,Siskiyou,093,43540,4869,4899,3077,7976,83
2022-07-14,Solano,095,438530,98095,96974,7136,104110,457
2022-07-14,Sonoma,097,501317,100308,99679,4657,104336,499
2022-07-14,Stanislaus,099,539301,129192,128436,19870,148306,1692
2022-07-14,Sutter,101,95872,22513,22452,2352,24804,228
2022-07-14,Tehama,103,63373,12945,12860,2824,15684,205
2022-07-14,Trinity,105,12862,1322,1304,328,1632,20
2022-07-14,Tulare,107,460477,114777,114399,31607,146006,1510
2022-07-14,Tuolumne,109,53932,14429,14280,830,15110,196
2022-07-14,Ventura,111,848112,195083,193965,13078,207043,1519
2022-07-14,Yolo,113,214977,44924,44703,3737,48440,324
2022-07-14,Yuba,115,75493,17616,17567,1505,19072,124
2022-07-13,Alameda,001,1643700,320526,316026,17853,333879,1911
2022-07-13,Alpine,003,1148,130,129,1,130,0
2022-07-13,Amador,005,37829,9474,9388,813,10201,87
2022-07-13,Butte,007,227075,36899,36405,8232,44637,439
2022-07-13,Calaveras,009,45235,8012,7945,437,8382,125
2022-07-13,Colusa,011,21464,3624,3606,1157,4763,22
2022-07-13,Contra Costa,013,1133247,233312,226833,18330,245163,1356
2022-07-13,Del Norte,015,27424,6971,6790,354,7144,54
2022-07-13,El Dorado,017,186661,30547,30273,3897,34170,218
2022-07-13,Fresno,019,978130,257927,252573,27870,280443,2786
2022-07-13,Glenn,021,27897,5306,5256,1763,7019,48
2022-07-13,Humboldt,023,135768,20089,19854,4169,24023,150
2022-07-13,Imperial,025,180216,61008,60011,12825,72836,944
2022-07-13,Inyo,027,18085,4354,4324,739,5063,56
2022-07-13,Kern,029,883053,207441,205428,53991,259419,2359
2022-07-13,Kings,031,150075,55584,55138,3736,58874,449
2022-07-13,Lake,033,64148,11869,11773,1045,12818,140
2022-07-13,Lassen,035,31185,9437,9381,943,10324,64
2022-07-13,Los Angeles,037,10098052,3064474,3024953,155570,3180523,32206
2022-07-13,Madera,039,155013,40735,40378,7069,47447,372
2022-07-13,Marin,041,260295,42085,41616,4767,46383,300
2022-07-13,Mariposa,043,17540,2887,2847,294,3141,30
2022-07-13,Mendocino,045,87422,14893,14713,3961,18674,128
2022-07-13,Merced,047,269075,68069,67028,10221,77249,832
2022-07-13,Modoc,049,8938,828,791,305,1096,9
2022-07-13,Mono,051,14174,3138,3131,203,3334,7
2022-07-13,Monterey,053,433212,88484,87575,17936,105511,745
2022-07-13,Napa,055,140530,30250,30032,1309,31341,145
2022-07-13,Nevada,057,99092,17993,17849,1573,19422,131
2022-07-13,Orange,059,3164182,622524,616278,53735,670013,7147
2022-07-13,Placer,061,380077,71526,70890,8800,79690,637
2022-07-13,Plumas,063,18699,3420,3354,415,3769,13
2022-07-13,Riverside,065,2383286,650518,643472,31701,675173,6504
2022-07-13,Sacramento,067,1510023,323944,321076,31380,352456,3114
2022-07-13,San Benito,069,59416,14999,14774,788,15562,100
2022-07-13,San Bernardino,071,2135413,627440,614957,27764,642721,7907
2022-07-13,San Diego,073,3302833,861038,851596,64964,916560,5363
2022-07-13,San Francisco,075,870044,165593,163635,10998,174633,919
2022-07-13,San Joaquin,077,732212,185272,183283,12603,195886,2260
2022-07-13,San Luis Obispo,079,281455,59676,59134,6029,65163,498
2022-07-13,San Mateo,081,765935,156302,153875,9721,163596,723
2022-07-13,Santa Barbara,083,443738,97991,97053,5828,102881,699
2022-07-13,Santa Clara,085,1922200,401554,392415,17237,409652,2365
2022-07-13,Santa Cruz,087,273765,57907,57124,2975,60099,267
2022-07-13,Shasta,089,179085,33023,32708,6773,39481,574
2022-07-13,Sierra,091,2930,293,289,58,347,4
2022-07-13,Siskiyou,093,43540,4864,4873,3075,7948,82
2022-07-13,Solano,095,438530,97889,96479,7110,103589,455
2022-07-13,Sonoma,097,501317,100150,99173,4640,103813,499
2022-07-13,Stanislaus,099,539301,128994,127845,19812,147657,1689
2022-07-13,Sutter,101,95872,22467,22331,2350,24681,228
2022-07-13,Tehama,103,63373,12932,12793,2821,15614,205
2022-07-13,Trinity,105,12862,1321,1293,326,1619,20
2022-07-13,Tulare,107,460477,114583,113830,31513,145343,1508
2022-07-13,Tuolumne,109,53932,14404,14159,825,14984,194
2022-07-13,Ventura,111,848112,194746,192923,12995,205918,1518
2022-07-13,Yolo,113,214977,44863,44447,3727,48174,326
2022-07-13,Yuba,115,75493,17589,17464,1497,18961,124
2022-07-12,Alameda,001,1643700,319752,316026,17810,333836,1911
2022-07-12,Alpine,003,1148,130,129,1,130,0
2022-07-12,Amador,005,37829,9441,9388,806,10194,87
2022-07-12,Butte,007,227075,36842,36405,8213,44618,439
2022-07-12,Calaveras,009,45235,7997,7945,435,8380,125
2022-07-12,Colusa,011,21464,3622,3606,1154,4760,22
2022-07-12,Contra Costa,013,1133247,232809,226833,18254,245087,1356
2022-07-12,Del Norte,015,27424,6924,6790,351,7141,54
2022-07-12,El Dorado,017,186661,30507,30273,3891,34164,218
2022-07-12,Fresno,019,978130,257380,252573,27779,280352,2786
2022-07-12,Glenn,021,27897,5302,5256,1759,7015,48
2022-07-12,Humboldt,023,135768,20039,19854,4152,24006,150
2022-07-12,Imperial,025,180216,60832,60011,12725,72736,944
2022-07-12,Inyo,027,18085,4346,4324,739,5063,56
2022-07-12,Kern,029,883053,207111,205428,53778,259206,2359
2022-07-12,Kings,031,150075,55473,55138,3726,58864,449
2022-07-12,Lake,033,64148,11857,11773,1040,12813,140
2022-07-12,Lassen,035,31185,9423,9381,937,10318,64
2022-07-12,Los Angeles,037,10098052,3057661,3024953,154871,3179824,32206
2022-07-12,Madera,039,155013,40649,40378,7054,47432,372
2022-07-12,Marin,041,260295,42010,41616,4758,46374,300
2022-07-12,Mariposa,043,17540,2876,2847,294,3141,30
2022-07-12,Mendocino,045,87422,14853,14713,3937,18650,128
2022-07-12,Merced,047,269075,67959,67028,10189,77217,832
2022-07-12,Modoc,049,8938,826,791,302,1093,9
2022-07-12,Mono,051,14174,3135,3131,203,3334,7
2022-07-12,Monterey,053,433212,88331,87575,17848,105423,745
2022-07-12,Napa,055,140530,30196,30032,1306,31338,145
2022-07-12,Nevada,057,99092,17971,17849,1566,19415,131
2022-07-12,Orange,059,3164182,621114,616278,53473,669751,7147
2022-07-12,Placer,061,380077,71416,70890,8785,79675,637
2022-07-12,Plumas,063,18699,3414,3354,414,3768,13
2022-07-12,Riverside,065,2383286,649235,643472,31606,675078,6504
2022-07-12,Sacramento,067,1510023,323345,321076,31339,352415,3114
2022-07-12,San Benito,069,59416,14953,14774,782,15556,100
2022-07-12,San Bernardino,071,2135413,626113,614957,27676,642633,7907
2022-07-12,San Diego,073,3302833,858678,851596,64730,916326,5363
2022-07-12,San Francisco,075,870044,165184,163635,10974,174609,919
2022-07-12,San Joaquin,077,732212,184959,183283,12545,195828,2260
2022-07-12,San Luis Obispo,079,281455,59597,59134,5999,65133,498
2022-07-12,San Mateo,081,765935,155902,153875,9702,163577,723
2022-07-12,Santa Barbara,083,443738,97776,97053,5811,102864,699
2022-07-12,Santa Clara,085,1922200,400593,392415,17195,409610,2365
2022-07-12,Santa Cruz,087,273765,57770,57124,2966,60090,267
2022-07-12,Shasta,089,179085,32960,32708,6754,39462,574
2022-07-12,Sierra,091,2930,292,289,58,347,4
2022-07-12,Siskiyou,093,43540,4855,4873,3073,7946,82
2022-07-12,Solano,095,438530,97673,96479,7085,103564,455
2022-07-12,Sonoma,097,501317,99987,99173,4612,103785,499
2022-07-12,Stanislaus,099,539301,128746,127845,19773,147618,1689
2022-07-12,Sutter,101,95872,22433,22331,2348,24679,228
2022-07-12,Tehama,103,63373,12912,12793,2814,15607,205
2022-07-12,Trinity,105,12862,1313,1293,326,1619,20
2022-07-12,Tulare,107,460477,114390,113830,31413,145243,1508
2022-07-12,Tuolumne,109,53932,14370,14159,821,14980,194
2022-07-12,Ventura,111,848112,194414,192923,12895,205818,1518
2022-07-12,Yolo,113,214977,44793,44447,3719,48166,326
2022-07-12,Yuba,115,75493,17561,17464,1484,18948,124
2022-07-11,Alameda,001,1643700,318839,316026,17750,333776,1911
2022-07-11,Alpine,003,1148,130,129,1,130,0
2022-07-11,Amador,005,37829,9433,9388,800,10188,87
2022-07-11,Butte,007,227075,36783,36405,8194,44599,439
2022-07-11,Calaveras,009,45235,7981,7945,433,8378,125
2022-07-11,Colusa,011,21464,3618,3606,1151,4757,22
2022-07-11,Contra Costa,013,1133247,232331,226833,18194,245027,1356
2022-07-11,Del Norte,015,27424,6893,6790,341,7131,54
2022-07-11,El Dorado,017,186661,30450,30273,3880,34153,218
2022-07-11,Fresno,019,978130,256707,252573,27696,280269,2786
2022-07-11,Glenn,021,27897,5299,5256,1757,7013,48
2022-07-11,Humboldt,023,135768,19980,19854,4133,23987,150
2022-07-11,Imperial,025,180216,60673,60011,12614,72625,944
2022-07-11,Inyo,027,18085,4343,4324,735,5059,56
2022-07-11,Kern,029,883053,206773,205428,53576,259004,2359
2022-07-11,Kings,031,150075,55325,55138,3716,58854,449
2022-07-11,Lake,033,64148,11831,11773,1038,12811,140
2022-07-11,Lassen,035,31185,9416,9381,937,10318,64
2022-07-11,Los Angeles,037,10098052,3050515,3024953,154076,3179029,32206
2022-07-11,Madera,039,155013,40562,40378,7009,47387,372
2022-07-11,Marin,041,260295,41921,41616,4749,46365,300
2022-07-11,Mariposa,043,17540,2868,2847,292,3139,30
2022-07-11,Mendocino,045,87422,14814,14713,3923,18636,128
2022-07-11,Merced,047,269075,67834,67028,10154,77182,832
2022-07-11,Modoc,049,8938,820,791,300,1091,9
2022-07-11,Mono,051,14174,3135,3131,202,3333,7
2022-07-11,Monterey,053,433212,88162,87575,17782,105357,745
2022-07-11,Napa,055,140530,30135,30032,1306,31338,145
2022-07-11,Nevada,057,99092,17954,17849,1564,19413,131
2022-07-11,Orange,059,3164182,619535,616278,53210,669488,7147
2022-07-11,Placer,061,380077,71307,70890,8770,79660,637
2022-07-11,Plumas,063,18699,3403,3354,412,3766,13
2022-07-11,Riverside,065,2383286,647799,643472,31521,674993,6504
2022-07-11,Sacramento,067,1510023,322799,321076,31293,352369,3114
2022-07-11,San Benito,069,59416,14916,14774,779,15553,100
2022-07-11,San Bernardino,071,2135413,624735,614957,27585,642542,7907
2022-07-11,San Diego,073,3302833,856300,851596,64485,916081,5363
2022-07-11,San Francisco,075,870044,164756,163635,10946,174581,919
2022-07-11,San Joaquin,077,732212,184577,183283,12498,195781,2260
2022-07-11,San Luis Obispo,079,281455,59488,59134,5967,65101,498
2022-07-11,San Mateo,081,765935,155498,153875,9669,163544,723
2022-07-11,Santa Barbara,083,443738,97567,97053,5798,102851,699
2022-07-11,Santa Clara,085,1922200,399525,392415,17137,409552,2365
2022-07-11,Santa Cruz,087,273765,57620,57124,2952,60076,267
2022-07-11,Shasta,089,179085,32904,32708,6724,39432,574
2022-07-11,Sierra,091,2930,292,289,58,347,4
2022-07-11,Siskiyou,093,43540,4849,4873,3066,7939,82
2022-07-11,Solano,095,438530,97460,96479,7067,103546,455
2022-07-11,Sonoma,097,501317,99793,99173,4592,103765,499
2022-07-11,Stanislaus,099,539301,128521,127845,19734,147579,1689
2022-07-11,Sutter,101,95872,22391,22331,2341,24672,228
2022-07-11,Tehama,103,63373,12898,12793,2807,15600,205
2022-07-11,Trinity,105,12862,1311,1293,325,1618,20
2022-07-11,Tulare,107,460477,114202,113830,31308,145138,1508
2022-07-11,Tuolumne,109,53932,14330,14159,819,14978,194
2022-07-11,Ventura,111,848112,194018,192923,12807,205730,1518
2022-07-11,Yolo,113,214977,44727,44447,3704,48151,326
2022-07-11,Yuba,115,75493,17525,17464,1481,18945,124
2022-07-10,Alameda,001,1643700,317838,312651,17670,330321,1912
2022-07-10,Alpine,003,1148,130,129,1,130,0
2022-07-10,Amador,005,37829,9423,9335,797,10132,87
2022-07-10,Butte,007,227075,36683,36165,8172,44337,438
2022-07-10,Calaveras,009,45235,7972,7895,432,8327,125
2022-07-10,Colusa,011,21464,3614,3586,1143,4729,22
2022-07-10,Contra Costa,013,1133247,231721,224718,18100,242818,1351
2022-07-10,Del Norte,015,27424,6853,6666,335,7001,54
2022-07-10,El Dorado,017,186661,30365,30070,3872,33942,218
2022-07-10,Fresno,019,978130,256032,250379,27602,277981,2786
2022-07-10,Glenn,021,27897,5294,5231,1753,6984,48
2022-07-10,Humboldt,023,135768,19921,19677,4119,23796,149
2022-07-10,Imperial,025,180216,60449,59558,12475,72033,944
2022-07-10,Inyo,027,18085,4338,4297,729,5026,56
2022-07-10,Kern,029,883053,206258,204128,53332,257460,2359
2022-07-10,Kings,031,150075,55150,54725,3710,58435,449
2022-07-10,Lake,033,64148,11806,11685,1035,12720,140
2022-07-10,Lassen,035,31185,9401,9362,935,10297,64
2022-07-10,Los Angeles,037,10098052,3043206,3002013,153254,3155267,32151
2022-07-10,Madera,039,155013,40454,40081,6975,47056,372
2022-07-10,Marin,041,260295,41824,41271,4740,46011,302
2022-07-10,Mariposa,043,17540,2861,2805,288,3093,30
2022-07-10,Mendocino,045,87422,14784,14610,3906,18516,128
2022-07-10,Merced,047,269075,67677,66616,10097,76713,832
2022-07-10,Modoc,049,8938,819,789,292,1081,9
2022-07-10,Mono,051,14174,3134,3119,200,3319,7
2022-07-10,Monterey,053,433212,87969,87002,17705,104707,745
2022-07-10,Napa,055,140530,30072,29807,1304,31111,145
2022-07-10,Nevada,057,99092,17893,17693,1555,19248,131
2022-07-10,Orange,059,3164182,617835,610975,52886,663861,7132
2022-07-10,Placer,061,380077,71190,70401,8751,79152,632
2022-07-10,Plumas,063,18699,3390,3339,408,3747,13
2022-07-10,Riverside,065,2383286,646206,638193,31390,669583,6506
2022-07-10,Sacramento,067,1510023,322095,318556,31217,349773,3108
2022-07-10,San Benito,069,59416,14880,14628,768,15396,100
2022-07-10,San Bernardino,071,2135413,623273,610086,27504,637590,7893
2022-07-10,San Diego,073,3302833,853808,844085,64214,908299,5357
2022-07-10,San Francisco,075,870044,164207,161931,10873,172804,914
2022-07-10,San Joaquin,077,732212,184200,181958,12437,194395,2257
2022-07-10,San Luis Obispo,079,281455,59367,58636,5928,64564,498
2022-07-10,San Mateo,081,765935,155028,152319,9642,161961,723
2022-07-10,Santa Barbara,083,443738,97334,96266,5772,102038,697
2022-07-10,Santa Clara,085,1922200,398390,388270,17075,405345,2360
2022-07-10,Santa Cruz,087,273765,57429,56455,2935,59390,266
2022-07-10,Shasta,089,179085,32837,32536,6700,39236,576
2022-07-10,Sierra,091,2930,290,291,58,349,4
2022-07-10,Siskiyou,093,43540,4846,4855,3053,7908,82
2022-07-10,Solano,095,438530,97210,95651,7034,102685,455
2022-07-10,Sonoma,097,501317,99590,98430,4560,102990,496
2022-07-10,Stanislaus,099,539301,128281,126897,19686,146583,1686
2022-07-10,Sutter,101,95872,22342,22165,2340,24505,228
2022-07-10,Tehama,103,63373,12871,12716,2794,15510,205
2022-07-10,Trinity,105,12862,1305,1272,323,1595,20
2022-07-10,Tulare,107,460477,113948,113002,31212,144214,1508
2022-07-10,Tuolumne,109,53932,14294,14019,811,14830,194
2022-07-10,Ventura,111,848112,193543,191462,12703,204165,1518
2022-07-10,Yolo,113,214977,44649,44152,3689,47841,323
2022-07-10,Yuba,115,75493,17486,17345,1479,18824,125
2022-07-09,Alameda,001,1643700,317350,312651,17646,330297,1912
2022-07-09,Alpine,003,1148,130,129,1,130,0
2022-07-09,Amador,005,37829,9415,9335,795,10130,87
2022-07-09,Butte,007,227075,36638,36165,8158,44323,438
2022-07-09,Calaveras,009,45235,7957,7895,431,8326,125
2022-07-09,Colusa,011,21464,3613,3586,1142,4728,22
2022-07-09,Contra Costa,013,1133247,231413,224718,18041,242759,1351
2022-07-09,Del Norte,015,27424,6845,6666,335,7001,54
2022-07-09,El Dorado,017,186661,30322,30070,3867,33937,218
2022-07-09,Fresno,019,978130,255770,250379,27562,277941,2786
2022-07-09,Glenn,021,27897,5287,5231,1753,6984,48
2022-07-09,Humboldt,023,135768,19903,19677,4109,23786,149
2022-07-09,Imperial,025,180216,60370,59558,12422,71980,944
2022-07-09,Inyo,027,18085,4333,4297,728,5025,56
2022-07-09,Kern,029,883053,206076,204128,53189,257317,2359
2022-07-09,Kings,031,150075,55111,54725,3708,58433,449
2022-07-09,Lake,033,64148,11798,11685,1034,12719,140
2022-07-09,Lassen,035,31185,9400,9362,935,10297,64
2022-07-09,Los Angeles,037,10098052,3039701,3002013,152760,3154773,32151
2022-07-09,Madera,039,155013,40414,40081,6967,47048,372
2022-07-09,Marin,041,260295,41768,41271,4729,46000,302
2022-07-09,Mariposa,043,17540,2856,2805,288,3093,30
2022-07-09,Mendocino,045,87422,14769,14610,3896,18506,128
2022-07-09,Merced,047,269075,67625,66616,10092,76708,832
2022-07-09,Modoc,049,8938,819,789,288,1077,9
2022-07-09,Mono,051,14174,3133,3119,200,3319,7
2022-07-09,Monterey,053,433212,87871,87002,17656,104658,745
2022-07-09,Napa,055,140530,30040,29807,1301,31108,145
2022-07-09,Nevada,057,99092,17881,17693,1551,19244,131
2022-07-09,Orange,059,3164182,616974,610975,52710,663685,7132
2022-07-09,Placer,061,380077,71101,70401,8743,79144,632
2022-07-09,Plumas,063,18699,3383,3339,406,3745,13
2022-07-09,Riverside,065,2383286,645308,638193,31335,669528,6506
2022-07-09,Sacramento,067,1510023,321794,318556,31198,349754,3108
2022-07-09,San Benito,069,59416,14860,14628,767,15395,100
2022-07-09,San Bernardino,071,2135413,622554,610086,27453,637539,7893
2022-07-09,San Diego,073,3302833,852900,844085,64126,908211,5357
2022-07-09,San Francisco,075,870044,163977,161931,10852,172783,914
2022-07-09,San Joaquin,077,732212,184032,181958,12408,194366,2257
2022-07-09,San Luis Obispo,079,281455,59310,58636,5909,64545,498
2022-07-09,San Mateo,081,765935,154783,152319,9627,161946,723
2022-07-09,Santa Barbara,083,443738,97201,96266,5762,102028,697
2022-07-09,Santa Clara,085,1922200,397654,388270,17047,405317,2360
2022-07-09,Santa Cruz,087,273765,57352,56455,2926,59381,266
2022-07-09,Shasta,089,179085,32815,32536,6690,39226,576
2022-07-09,Sierra,091,2930,290,291,58,349,4
2022-07-09,Siskiyou,093,43540,4843,4855,3051,7906,82
2022-07-09,Solano,095,438530,97125,95651,7019,102670,455
2022-07-09,Sonoma,097,501317,99505,98430,4554,102984,496
2022-07-09,Stanislaus,099,539301,128118,126897,19655,146552,1686
2022-07-09,Sutter,101,95872,22314,22165,2340,24505,228
2022-07-09,Tehama,103,63373,12855,12716,2785,15501,205
2022-07-09,Trinity,105,12862,1305,1272,322,1594,20
2022-07-09,Tulare,107,460477,113838,113002,31154,144156,1508
2022-07-09,Tuolumne,109,53932,14256,14019,809,14828,194
2022-07-09,Ventura,111,848112,193281,191462,12656,204118,1518
2022-07-09,Yolo,113,214977,44599,44152,3675,47827,323
2022-07-09,Yuba,115,75493,17463,17345,1479,18824,125
2022-07-08,Alameda,001,1643700,316827,312651,17603,330254,1912
2022-07-08,Alpine,003,1148,130,129,1,130,0
2022-07-08,Amador,005,37829,9405,9335,793,10128,87
2022-07-08,Butte,007,227075,36607,36165,8144,44309,438
2022-07-08,Calaveras,009,45235,7942,7895,431,8326,125
2022-07-08,Colusa,011,21464,3609,3586,1142,4728,22
2022-07-08,Contra Costa,013,1133247,231062,224718,17992,242710,1351
2022-07-08,Del Norte,015,27424,6834,6666,333,6999,54
2022-07-08,El Dorado,017,186661,30297,30070,3860,33930,218
2022-07-08,Fresno,019,978130,255401,250379,27509,277888,2786
2022-07-08,Glenn,021,27897,5282,5231,1750,6981,48
2022-07-08,Humboldt,023,135768,19890,19677,4098,23775,149
2022-07-08,Imperial,025,180216,60282,59558,12382,71940,944
2022-07-08,Inyo,027,18085,4332,4297,724,5021,56
2022-07-08,Kern,029,883053,205830,204128,53051,257179,2359
2022-07-08,Kings,031,150075,55069,54725,3707,58432,449
2022-07-08,Lake,033,64148,11781,11685,1031,12716,140
2022-07-08,Lassen,035,31185,9394,9362,934,10296,64
2022-07-08,Los Angeles,037,10098052,3035423,3002013,152177,3154190,32151
2022-07-08,Madera,039,155013,40360,40081,6953,47034,372
2022-07-08,Marin,041,260295,41682,41271,4713,45984,302
2022-07-08,Mariposa,043,17540,2853,2805,287,3092,30
2022-07-08,Mendocino,045,87422,14751,14610,3892,18502,128
2022-07-08,Merced,047,269075,67557,66616,10082,76698,832
2022-07-08,Modoc,049,8938,819,789,288,1077,9
2022-07-08,Mono,051,14174,3131,3119,199,3318,7
2022-07-08,Monterey,053,433212,87743,87002,17626,104628,745
2022-07-08,Napa,055,140530,30016,29807,1300,31107,145
2022-07-08,Nevada,057,99092,17873,17693,1549,19242,131
2022-07-08,Orange,059,3164182,616073,610975,52520,663495,7132
2022-07-08,Placer,061,380077,71026,70401,8729,79130,632
2022-07-08,Plumas,063,18699,3378,3339,406,3745,13
2022-07-08,Riverside,065,2383286,644396,638193,31277,669470,6506
2022-07-08,Sacramento,067,1510023,321354,318556,31173,349729,3108
2022-07-08,San Benito,069,59416,14843,14628,764,15392,100
2022-07-08,San Bernardino,071,2135413,621797,610086,27410,637496,7893
2022-07-08,San Diego,073,3302833,851646,844085,63959,908044,5357
2022-07-08,San Francisco,075,870044,163712,161931,10825,172756,914
2022-07-08,San Joaquin,077,732212,183858,181958,12391,194349,2257
2022-07-08,San Luis Obispo,079,281455,59274,58636,5894,64530,498
2022-07-08,San Mateo,081,765935,154486,152319,9613,161932,723
2022-07-08,Santa Barbara,083,443738,97074,96266,5758,102024,697
2022-07-08,Santa Clara,085,1922200,396882,388270,17025,405295,2360
2022-07-08,Santa Cruz,087,273765,57264,56455,2918,59373,266
2022-07-08,Shasta,089,179085,32785,32536,6682,39218,576
2022-07-08,Sierra,091,2930,290,291,58,349,4
2022-07-08,Siskiyou,093,43540,4841,4855,3048,7903,82
2022-07-08,Solano,095,438530,97007,95651,7005,102656,455
2022-07-08,Sonoma,097,501317,99355,98430,4537,102967,496
2022-07-08,Stanislaus,099,539301,127980,126897,19642,146539,1686
2022-07-08,Sutter,101,95872,22289,22165,2339,24504,228
2022-07-08,Tehama,103,63373,12843,12716,2783,15499,205
2022-07-08,Trinity,105,12862,1303,1272,321,1593,20
2022-07-08,Tulare,107,460477,113718,113002,31086,144088,1508
2022-07-08,Tuolumne,109,53932,14225,14019,803,14822,194
2022-07-08,Ventura,111,848112,193042,191462,12617,204079,1518
2022-07-08,Yolo,113,214977,44546,44152,3663,47815,323
2022-07-08,Yuba,115,75493,17447,17345,1478,18823,125
2022-07-07,Alameda,001,1643700,316024,312651,17556,330207,1912
2022-07-07,Alpine,003,1148,129,129,1,130,0
2022-07-07,Amador,005,37829,9389,9335,786,10121,87
2022-07-07,Butte,007,227075,36543,36165,8124,44289,438
2022-07-07,Calaveras,009,45235,7933,7895,426,8321,125
2022-07-07,Colusa,011,21464,3604,3586,1141,4727,22
2022-07-07,Contra Costa,013,1133247,230515,224718,17916,242634,1351
2022-07-07,Del Norte,015,27424,6808,6666,329,6995,54
2022-07-07,El Dorado,017,186661,30245,30070,3849,33919,218
2022-07-07,Fresno,019,978130,254851,250379,27405,277784,2786
2022-07-07,Glenn,021,27897,5276,5231,1748,6979,48
2022-07-07,Humboldt,023,135768,19845,19677,4082,23759,149
2022-07-07,Imperial,025,180216,60107,59558,12272,71830,944
2022-07-07,Inyo,027,18085,4328,4297,716,5013,56
2022-07-07,Kern,029,883053,205530,204128,52843,256971,2359
2022-07-07,Kings,031,150075,54992,54725,3703,58428,449
2022-07-07,Lake,033,64148,11760,11685,1031,12716,140
2022-07-07,Lassen,035,31185,9393,9362,934,10296,64
2022-07-07,Los Angeles,037,10098052,3029084,3002013,151490,3153503,32151
2022-07-07,Madera,039,155013,40280,40081,6937,47018,372
2022-07-07,Marin,041,260295,41604,41271,4702,45973,302
2022-07-07,Mariposa,043,17540,2846,2805,284,3089,30
2022-07-07,Mendocino,045,87422,14734,14610,3887,18497,128
2022-07-07,Merced,047,269075,67443,66616,10049,76665,832
2022-07-07,Modoc,049,8938,814,789,285,1074,9
2022-07-07,Mono,051,14174,3130,3119,197,3316,7
2022-07-07,Monterey,053,433212,87583,87002,17563,104565,745
2022-07-07,Napa,055,140530,29946,29807,1292,31099,145
2022-07-07,Nevada,057,99092,17843,17693,1544,19237,131
2022-07-07,Orange,059,3164182,614681,610975,52307,663282,7132
2022-07-07,Placer,061,380077,70916,70401,8704,79105,632
2022-07-07,Plumas,063,18699,3371,3339,405,3744,13
2022-07-07,Riverside,065,2383286,643073,638193,31214,669407,6506
2022-07-07,Sacramento,067,1510023,320717,318556,31122,349678,3108
2022-07-07,San Benito,069,59416,14813,14628,764,15392,100
2022-07-07,San Bernardino,071,2135413,620495,610086,27346,637432,7893
2022-07-07,San Diego,073,3302833,849732,844085,63726,907811,5357
2022-07-07,San Francisco,075,870044,163330,161931,10772,172703,914
2022-07-07,San Joaquin,077,732212,183521,181958,12340,194298,2257
2022-07-07,San Luis Obispo,079,281455,59195,58636,5862,64498,498
2022-07-07,San Mateo,081,765935,154137,152319,9604,161923,723
2022-07-07,Santa Barbara,083,443738,96880,96266,5743,102009,697
2022-07-07,Santa Clara,085,1922200,395892,388270,16974,405244,2360
2022-07-07,Santa Cruz,087,273765,57107,56455,2904,59359,266
2022-07-07,Shasta,089,179085,32750,32536,6665,39201,576
2022-07-07,Sierra,091,2930,289,291,57,348,4
2022-07-07,Siskiyou,093,43540,4835,4855,3043,7898,82
2022-07-07,Solano,095,438530,96733,95651,6992,102643,455
2022-07-07,Sonoma,097,501317,99218,98430,4518,102948,496
2022-07-07,Stanislaus,099,539301,127780,126897,19605,146502,1686
2022-07-07,Sutter,101,95872,22243,22165,2337,24502,228
2022-07-07,Tehama,103,63373,12826,12716,2774,15490,205
2022-07-07,Trinity,105,12862,1298,1272,320,1592,20
2022-07-07,Tulare,107,460477,113510,113002,30993,143995,1508
2022-07-07,Tuolumne,109,53932,14188,14019,798,14817,194
2022-07-07,Ventura,111,848112,192722,191462,12536,203998,1518
2022-07-07,Yolo,113,214977,44489,44152,3650,47802,323
2022-07-07,Yuba,115,75493,17413,17345,1476,18821,125
2022-07-06,Alameda,001,1643700,315188,310551,17512,328063,1899
2022-07-06,Alpine,003,1148,129,129,1,130,0
2022-07-06,Amador,005,37829,9370,9301,786,10087,87
2022-07-06,Butte,007,227075,36479,36053,8108,44161,436
2022-07-06,Calaveras,009,45235,7924,7873,424,8297,124
2022-07-06,Colusa,011,21464,3601,3579,1140,4719,22
2022-07-06,Contra Costa,013,1133247,229999,223500,17861,241361,1348
2022-07-06,Del Norte,015,27424,6778,6623,327,6950,54
2022-07-06,El Dorado,017,186661,30200,29953,3837,33790,218
2022-07-06,Fresno,019,978130,254292,249480,27322,276802,2786
2022-07-06,Glenn,021,27897,5271,5222,1748,6970,48
2022-07-06,Humboldt,023,135768,19798,19608,4071,23679,149
2022-07-06,Imperial,025,180216,59907,59184,12185,71369,944
2022-07-06,Inyo,027,18085,4322,4282,710,4992,56
2022-07-06,Kern,029,883053,205207,203587,52623,256210,2353
2022-07-06,Kings,031,150075,54875,54560,3698,58258,449
2022-07-06,Lake,033,64148,11741,11659,1031,12690,140
2022-07-06,Lassen,035,31185,9376,9350,934,10284,64
2022-07-06,Los Angeles,037,10098052,3022632,2991161,150770,3141931,32116
2022-07-06,Madera,039,155013,40209,39952,6915,46867,372
2022-07-06,Marin,041,260295,41536,41036,4692,45728,302
2022-07-06,Mariposa,043,17540,2836,2797,284,3081,30
2022-07-06,Mendocino,045,87422,14706,14540,3875,18415,127
2022-07-06,Merced,047,269075,67322,66420,10026,76446,832
2022-07-06,Modoc,049,8938,808,788,283,1071,8
2022-07-06,Mono,051,14174,3129,3109,197,3306,7
2022-07-06,Monterey,053,433212,87425,86639,17497,104136,744
2022-07-06,Napa,055,140530,29886,29690,1290,30980,144
2022-07-06,Nevada,057,99092,17814,17660,1538,19198,131
2022-07-06,Orange,059,3164182,613158,608084,52084,660168,7125
2022-07-06,Placer,061,380077,70802,70113,8683,78796,632
2022-07-06,Plumas,063,18699,3360,3316,404,3720,13
2022-07-06,Riverside,065,2383286,641710,636209,31142,667351,6505
2022-07-06,Sacramento,067,1510023,320028,317315,31077,348392,3104
2022-07-06,San Benito,069,59416,14771,14556,753,15309,100
2022-07-06,San Bernardino,071,2135413,619242,608119,27270,635389,7870
2022-07-06,San Diego,073,3302833,847607,839970,63470,903440,5349
2022-07-06,San Francisco,075,870044,162910,160612,10739,171351,910
2022-07-06,San Joaquin,077,732212,183205,181448,12310,193758,2256
2022-07-06,San Luis Obispo,079,281455,59083,58488,5823,64311,496
2022-07-06,San Mateo,081,765935,153730,151344,9574,160918,723
2022-07-06,Santa Barbara,083,443738,96689,95918,5722,101640,702
2022-07-06,Santa Clara,085,1922200,394791,385553,16908,402461,2358
2022-07-06,Santa Cruz,087,273765,56965,56307,2885,59192,267
2022-07-06,Shasta,089,179085,32696,32444,6642,39086,570
2022-07-06,Sierra,091,2930,289,290,57,347,4
2022-07-06,Siskiyou,093,43540,4830,4841,3037,7878,82
2022-07-06,Solano,095,438530,96481,95181,6967,102148,455
2022-07-06,Sonoma,097,501317,99036,98031,4500,102531,495
2022-07-06,Stanislaus,099,539301,127557,126492,19574,146066,1682
2022-07-06,Sutter,101,95872,22192,22089,2336,24425,228
2022-07-06,Tehama,103,63373,12815,12680,2768,15448,205
2022-07-06,Trinity,105,12862,1290,1263,316,1579,20
2022-07-06,Tulare,107,460477,113297,112684,30900,143584,1500
2022-07-06,Tuolumne,109,53932,14155,13960,786,14746,189
2022-07-06,Ventura,111,848112,192339,190794,12461,203255,1517
2022-07-06,Yolo,113,214977,44405,43171,3630,46801,324
2022-07-06,Yuba,115,75493,17375,17277,1470,18747,124
2022-07-05,Alameda,001,1643700,314201,310551,17456,328007,1899
2022-07-05,Alpine,003,1148,129,129,1,130,0
2022-07-05,Amador,005,37829,9355,9301,782,10083,87
2022-07-05,Butte,007,227075,36396,36053,8087,44140,436
2022-07-05,Calaveras,009,45235,7913,7873,423,8296,124
2022-07-05,Colusa,011,21464,3596,3579,1138,4717,22
2022-07-05,Contra Costa,013,1133247,229367,223500,17785,241285,1348
2022-07-05,Del Norte,015,27424,6752,6623,322,6945,54
2022-07-05,El Dorado,017,186661,30150,29953,3828,33781,218
2022-07-05,Fresno,019,978130,253692,249480,27235,276715,2786
2022-07-05,Glenn,021,27897,5262,5222,1747,6969,48
2022-07-05,Humboldt,023,135768,19760,19608,4060,23668,149
2022-07-05,Imperial,025,180216,59766,59184,12086,71270,944
2022-07-05,Inyo,027,18085,4308,4282,700,4982,56
2022-07-05,Kern,029,883053,204770,203587,52382,255969,2353
2022-07-05,Kings,031,150075,54745,54560,3684,58244,449
2022-07-05,Lake,033,64148,11718,11659,1028,12687,140
2022-07-05,Lassen,035,31185,9365,9350,934,10284,64
2022-07-05,Los Angeles,037,10098052,3015702,2991161,150010,3141171,32116
2022-07-05,Madera,039,155013,40124,39952,6890,46842,372
2022-07-05,Marin,041,260295,41435,41036,4682,45718,302
2022-07-05,Mariposa,043,17540,2826,2797,281,3078,30
2022-07-05,Mendocino,045,87422,14660,14540,3859,18399,127
2022-07-05,Merced,047,269075,67202,66420,9995,76415,832
2022-07-05,Modoc,049,8938,800,788,283,1071,8
2022-07-05,Mono,051,14174,3126,3109,194,3303,7
2022-07-05,Monterey,053,433212,87261,86639,17445,104084,744
2022-07-05,Napa,055,140530,29833,29690,1285,30975,144
2022-07-05,Nevada,057,99092,17775,17660,1528,19188,131
2022-07-05,Orange,059,3164182,611608,608084,51837,659921,7125
2022-07-05,Placer,061,380077,70697,70113,8662,78775,632
2022-07-05,Plumas,063,18699,3350,3316,403,3719,13
2022-07-05,Riverside,065,2383286,640243,636209,31055,667264,6505
2022-07-05,Sacramento,067,1510023,319379,317315,31008,348323,3104
2022-07-05,San Benito,069,59416,14737,14556,746,15302,100
2022-07-05,San Bernardino,071,2135413,617914,608119,27192,635311,7870
2022-07-05,San Diego,073,3302833,845261,839970,63235,903205,5349
2022-07-05,San Francisco,075,870044,162387,160612,10713,171325,910
2022-07-05,San Joaquin,077,732212,182841,181448,12237,193685,2256
2022-07-05,San Luis Obispo,079,281455,58924,58488,5781,64269,496
2022-07-05,San Mateo,081,765935,153245,151344,9552,160896,723
2022-07-05,Santa Barbara,083,443738,96465,95918,5693,101611,702
2022-07-05,Santa Clara,085,1922200,393627,385553,16845,402398,2358
2022-07-05,Santa Cruz,087,273765,56790,56307,2869,59176,267
2022-07-05,Shasta,089,179085,32654,32444,6618,39062,570
2022-07-05,Sierra,091,2930,289,290,57,347,4
2022-07-05,Siskiyou,093,43540,4826,4841,3025,7866,82
2022-07-05,Solano,095,438530,96191,95181,6943,102124,455
2022-07-05,Sonoma,097,501317,98791,98031,4482,102513,495
2022-07-05,Stanislaus,099,539301,127316,126492,19532,146024,1682
2022-07-05,Sutter,101,95872,22150,22089,2334,24423,228
2022-07-05,Tehama,103,63373,12790,12680,2764,15444,205
2022-07-05,Trinity,105,12862,1281,1263,314,1577,20
2022-07-05,Tulare,107,460477,113059,112684,30819,143503,1500
2022-07-05,Tuolumne,109,53932,14121,13960,779,14739,189
2022-07-05,Ventura,111,848112,191939,190794,12398,203192,1517
2022-07-05,Yolo,113,214977,44319,43171,3620,46791,324
2022-07-05,Yuba,115,75493,17346,17277,1469,18746,124
2022-07-04,Alameda,001,1643700,313046,310551,17373,327924,1899
2022-07-04,Alpine,003,1148,129,129,1,130,0
2022-07-04,Amador,005,37829,9342,9301,781,10082,87
2022-07-04,Butte,007,227075,36286,36053,8069,44122,436
2022-07-04,Calaveras,009,45235,7903,7873,423,8296,124
2022-07-04,Colusa,011,21464,3592,3579,1136,4715,22
2022-07-04,Contra Costa,013,1133247,228653,223500,17684,241184,1348
2022-07-04,Del Norte,015,27424,6719,6623,318,6941,54
2022-07-04,El Dorado,017,186661,30065,29953,3810,33763,218
2022-07-04,Fresno,019,978130,253051,249480,27104,276584,2786
2022-07-04,Glenn,021,27897,5254,5222,1741,6963,48
2022-07-04,Humboldt,023,135768,19689,19608,4046,23654,149
2022-07-04,Imperial,025,180216,59559,59184,11966,71150,944
2022-07-04,Inyo,027,18085,4305,4282,690,4972,56
2022-07-04,Kern,029,883053,204321,203587,52104,255691,2353
2022-07-04,Kings,031,150075,54595,54560,3680,58240,449
2022-07-04,Lake,033,64148,11705,11659,1026,12685,140
2022-07-04,Lassen,035,31185,9357,9350,933,10283,64
2022-07-04,Los Angeles,037,10098052,3007216,2991161,149091,3140252,32116
2022-07-04,Madera,039,155013,40030,39952,6864,46816,372
2022-07-04,Marin,041,260295,41318,41036,4671,45707,302
2022-07-04,Mariposa,043,17540,2816,2797,276,3073,30
2022-07-04,Mendocino,045,87422,14624,14540,3813,18353,127
2022-07-04,Merced,047,269075,67072,66420,9947,76367,832
2022-07-04,Modoc,049,8938,792,788,279,1067,8
2022-07-04,Mono,051,14174,3124,3109,192,3301,7
2022-07-04,Monterey,053,433212,87067,86639,17375,104014,744
2022-07-04,Napa,055,140530,29768,29690,1281,30971,144
2022-07-04,Nevada,057,99092,17733,17660,1520,19180,131
2022-07-04,Orange,059,3164182,609810,608084,51533,659617,7125
2022-07-04,Placer,061,380077,70522,70113,8632,78745,632
2022-07-04,Plumas,063,18699,3332,3316,402,3718,13
2022-07-04,Riverside,065,2383286,638600,636209,30960,667169,6505
2022-07-04,Sacramento,067,1510023,318599,317315,30916,348231,3104
2022-07-04,San Benito,069,59416,14681,14556,741,15297,100
2022-07-04,San Bernardino,071,2135413,616310,608119,27117,635236,7870
2022-07-04,San Diego,073,3302833,842634,839970,62898,902868,5349
2022-07-04,San Francisco,075,870044,161764,160612,10653,171265,910
2022-07-04,San Joaquin,077,732212,182436,181448,12171,193619,2256
2022-07-04,San Luis Obispo,079,281455,58735,58488,5710,64198,496
2022-07-04,San Mateo,081,765935,152722,151344,9513,160857,723
2022-07-04,Santa Barbara,083,443738,96241,95918,5670,101588,702
2022-07-04,Santa Clara,085,1922200,392133,385553,16777,402330,2358
2022-07-04,Santa Cruz,087,273765,56592,56307,2847,59154,267
2022-07-04,Shasta,089,179085,32577,32444,6589,39033,570
2022-07-04,Sierra,091,2930,289,290,57,347,4
2022-07-04,Siskiyou,093,43540,4820,4841,3019,7860,82
2022-07-04,Solano,095,438530,95842,95181,6907,102088,455
2022-07-04,Sonoma,097,501317,98496,98031,4455,102486,495
2022-07-04,Stanislaus,099,539301,127026,126492,19480,145972,1682
2022-07-04,Sutter,101,95872,22104,22089,2332,24421,228
2022-07-04,Tehama,103,63373,12764,12680,2750,15430,205
2022-07-04,Trinity,105,12862,1276,1263,312,1575,20
2022-07-04,Tulare,107,460477,112822,112684,30707,143391,1500
2022-07-04,Tuolumne,109,53932,14079,13960,775,14735,189
2022-07-04,Ventura,111,848112,191469,190794,12292,203086,1517
2022-07-04,Yolo,113,214977,44225,43171,3602,46773,324
2022-07-04,Yuba,115,75493,17307,17277,1469,18746,124
2022-07-03,Alameda,001,1643700,312489,307672,17344,325016,1898
2022-07-03,Alpine,003,1148,129,129,1,130,0
2022-07-03,Amador,005,37829,9334,9243,778,10021,87
2022-07-03,Butte,007,227075,36272,35846,8062,43908,436
2022-07-03,Calaveras,009,45235,7887,7836,423,8259,124
2022-07-03,Colusa,011,21464,3590,3566,1134,4700,22
2022-07-03,Contra Costa,013,1133247,228300,221545,17652,239197,1343
2022-07-03,Del Norte,015,27424,6710,6543,317,6860,53
2022-07-03,El Dorado,017,186661,30033,29764,3804,33568,217
2022-07-03,Fresno,019,978130,252800,247952,27068,275020,2783
2022-07-03,Glenn,021,27897,5253,5211,1738,6949,48
2022-07-03,Humboldt,023,135768,19667,19516,4037,23553,149
2022-07-03,Imperial,025,180216,59484,58768,11927,70695,944
2022-07-03,Inyo,027,18085,4301,4261,688,4949,56
2022-07-03,Kern,029,883053,204179,202502,51949,254451,2352
2022-07-03,Kings,031,150075,54570,54262,3678,57940,449
2022-07-03,Lake,033,64148,11694,11595,1026,12621,140
2022-07-03,Lassen,035,31185,9354,9336,932,10268,64
2022-07-03,Los Angeles,037,10098052,3004394,2969395,148712,3118107,32089
2022-07-03,Madera,039,155013,40003,39738,6859,46597,372
2022-07-03,Marin,041,260295,41248,40653,4662,45315,297
2022-07-03,Mariposa,043,17540,2812,2780,275,3055,30
2022-07-03,Mendocino,045,87422,14612,14464,3812,18276,127
2022-07-03,Merced,047,269075,67025,66093,9942,76035,832
2022-07-03,Modoc,049,8938,792,787,279,1066,8
2022-07-03,Mono,051,14174,3123,3099,191,3290,7
2022-07-03,Monterey,053,433212,86955,86212,17321,103533,744
2022-07-03,Napa,055,140530,29748,29486,1278,30764,145
2022-07-03,Nevada,057,99092,17714,17546,1513,19059,131
2022-07-03,Orange,059,3164182,609266,603511,51389,654900,7114
2022-07-03,Placer,061,380077,70436,69606,8618,78224,631
2022-07-03,Plumas,063,18699,3325,3294,402,3696,13
2022-07-03,Riverside,065,2383286,638029,632038,30917,662955,6502
2022-07-03,Sacramento,067,1510023,318330,315165,30896,346061,3100
2022-07-03,San Benito,069,59416,14674,14420,740,15160,100
2022-07-03,San Bernardino,071,2135413,615703,604093,27082,631175,7860
2022-07-03,San Diego,073,3302833,841904,834116,62825,896941,5341
2022-07-03,San Francisco,075,870044,161428,158871,10641,169512,910
2022-07-03,San Joaquin,077,732212,182263,180368,12134,192502,2256
2022-07-03,San Luis Obispo,079,281455,58666,58079,5700,63779,489
2022-07-03,San Mateo,081,765935,152416,149812,9496,159308,723
2022-07-03,Santa Barbara,083,443738,96133,95214,5658,100872,699
2022-07-03,Santa Clara,085,1922200,391406,381630,16746,398376,2355
2022-07-03,Santa Cruz,087,273765,56531,55757,2826,58583,267
2022-07-03,Shasta,089,179085,32542,32280,6579,38859,570
2022-07-03,Sierra,091,2930,288,283,57,340,4
2022-07-03,Siskiyou,093,43540,4817,4808,3017,7825,82
2022-07-03,Solano,095,438530,95764,94437,6901,101338,455
2022-07-03,Sonoma,097,501317,98387,97379,4450,101829,495
2022-07-03,Stanislaus,099,539301,126906,125788,19464,145252,1681
2022-07-03,Sutter,101,95872,22083,21935,2331,24266,228
2022-07-03,Tehama,103,63373,12746,12615,2748,15363,205
2022-07-03,Trinity,105,12862,1275,1256,309,1565,20
2022-07-03,Tulare,107,460477,112724,112118,30669,142787,1500
2022-07-03,Tuolumne,109,53932,14056,13886,772,14658,189
2022-07-03,Ventura,111,848112,191258,189493,12271,201764,1517
2022-07-03,Yolo,113,214977,44182,42760,3592,46352,324
2022-07-03,Yuba,115,75493,17293,17168,1468,18636,124
2022-07-02,Alameda,001,1643700,312110,307672,17316,324988,1898
2022-07-02,Alpine,003,1148,129,129,1,130,0
2022-07-02,Amador,005,37829,9318,9243,777,10020,87
2022-07-02,Butte,007,227075,36247,35846,8049,43895,436
2022-07-02,Calaveras,009,45235,7881,7836,423,8259,124
2022-07-02,Colusa,011,21464,3586,3566,1132,4698,22
2022-07-02,Contra Costa,013,1133247,227955,221545,17600,239145,1343
2022-07-02,Del Norte,015,27424,6700,6543,317,6860,53
2022-07-02,El Dorado,017,186661,29999,29764,3800,33564,217
2022-07-02,Fresno,019,978130,252573,247952,27031,274983,2783
2022-07-02,Glenn,021,27897,5248,5211,1737,6948,48
2022-07-02,Humboldt,023,135768,19641,19516,4033,23549,149
2022-07-02,Imperial,025,180216,59404,58768,11906,70674,944
2022-07-02,Inyo,027,18085,4297,4261,686,4947,56
2022-07-02,Kern,029,883053,204026,202502,51787,254289,2352
2022-07-02,Kings,031,150075,54525,54262,3678,57940,449
2022-07-02,Lake,033,64148,11685,11595,1024,12619,140
2022-07-02,Lassen,035,31185,9353,9336,931,10267,64
2022-07-02,Los Angeles,037,10098052,3001632,2969395,148286,3117681,32089
2022-07-02,Madera,039,155013,39973,39738,6855,46593,372
2022-07-02,Marin,041,260295,41186,40653,4645,45298,297
2022-07-02,Mariposa,043,17540,2808,2780,274,3054,30
2022-07-02,Mendocino,045,87422,14584,14464,3812,18276,127
2022-07-02,Merced,047,269075,66966,66093,9933,76026,832
2022-07-02,Modoc,049,8938,792,787,278,1065,8
2022-07-02,Mono,051,14174,3120,3099,191,3290,7
2022-07-02,Monterey,053,433212,86864,86212,17283,103495,744
2022-07-02,Napa,055,140530,29719,29486,1278,30764,145
2022-07-02,Nevada,057,99092,17699,17546,1507,19053,131
2022-07-02,Orange,059,3164182,608613,603511,51232,654743,7114
2022-07-02,Placer,061,380077,70344,69606,8604,78210,631
2022-07-02,Plumas,063,18699,3316,3294,402,3696,13
2022-07-02,Riverside,065,2383286,637435,632038,30872,662910,6502
2022-07-02,Sacramento,067,1510023,317994,315165,30871,346036,3100
2022-07-02,San Benito,069,59416,14655,14420,731,15151,100
2022-07-02,San Bernardino,071,2135413,615169,604093,27047,631140,7860
2022-07-02,San Diego,073,3302833,841097,834116,62759,896875,5341
2022-07-02,San Francisco,075,870044,161147,158871,10617,169488,910
2022-07-02,San Joaquin,077,732212,182130,180368,12108,192476,2256
2022-07-02,San Luis Obispo,079,281455,58617,58079,5686,63765,489
2022-07-02,San Mateo,081,765935,152157,149812,9477,159289,723
2022-07-02,Santa Barbara,083,443738,96006,95214,5647,100861,699
2022-07-02,Santa Clara,085,1922200,390673,381630,16716,398346,2355
2022-07-02,Santa Cruz,087,273765,56472,55757,2815,58572,267
2022-07-02,Shasta,089,179085,32512,32280,6568,38848,570
2022-07-02,Sierra,091,2930,288,283,57,340,4
2022-07-02,Siskiyou,093,43540,4813,4808,3016,7824,82
2022-07-02,Solano,095,438530,95691,94437,6885,101322,455
2022-07-02,Sonoma,097,501317,98281,97379,4442,101821,495
2022-07-02,Stanislaus,099,539301,126787,125788,19448,145236,1681
2022-07-02,Sutter,101,95872,22064,21935,2331,24266,228
2022-07-02,Tehama,103,63373,12723,12615,2747,15362,205
2022-07-02,Trinity,105,12862,1273,1256,308,1564,20
2022-07-02,Tulare,107,460477,112623,112118,30628,142746,1500
2022-07-02,Tuolumne,109,53932,14043,13886,763,14649,189
2022-07-02,Ventura,111,848112,191086,189493,12246,201739,1517
2022-07-02,Yolo,113,214977,44137,42760,3585,46345,324
2022-07-02,Yuba,115,75493,17281,17168,1468,18636,124
2022-07-01,Alameda,001,1643700,311631,307672,17287,324959,1898
2022-07-01,Alpine,003,1148,129,129,1,130,0
2022-07-01,Amador,005,37829,9313,9243,775,10018,87
2022-07-01,Butte,007,227075,36220,35846,8031,43877,436
2022-07-01,Calaveras,009,45235,7870,7836,423,8259,124
2022-07-01,Colusa,011,21464,3583,3566,1132,4698,22
2022-07-01,Contra Costa,013,1133247,227653,221545,17557,239102,1343
2022-07-01,Del Norte,015,27424,6680,6543,315,6858,53
2022-07-01,El Dorado,017,186661,29974,29764,3792,33556,217
2022-07-01,Fresno,019,978130,252286,247952,26976,274928,2783
2022-07-01,Glenn,021,27897,5248,5211,1737,6948,48
2022-07-01,Humboldt,023,135768,19619,19516,4024,23540,149
2022-07-01,Imperial,025,180216,59328,58768,11879,70647,944
2022-07-01,Inyo,027,18085,4290,4261,680,4941,56
2022-07-01,Kern,029,883053,203820,202502,51652,254154,2352
2022-07-01,Kings,031,150075,54492,54262,3674,57936,449
2022-07-01,Lake,033,64148,11674,11595,1023,12618,140
2022-07-01,Lassen,035,31185,9350,9336,931,10267,64
2022-07-01,Los Angeles,037,10098052,2998144,2969395,147770,3117165,32089
2022-07-01,Madera,039,155013,39930,39738,6841,46579,372
2022-07-01,Marin,041,260295,41113,40653,4632,45285,297
2022-07-01,Mariposa,043,17540,2806,2780,273,3053,30
2022-07-01,Mendocino,045,87422,14564,14464,3808,18272,127
2022-07-01,Merced,047,269075,66881,66093,9929,76022,832
2022-07-01,Modoc,049,8938,792,787,277,1064,8
2022-07-01,Mono,051,14174,3112,3099,190,3289,7
2022-07-01,Monterey,053,433212,86781,86212,17252,103464,744
2022-07-01,Napa,055,140530,29675,29486,1278,30764,145
2022-07-01,Nevada,057,99092,17679,17546,1502,19048,131
2022-07-01,Orange,059,3164182,607898,603511,51071,654582,7114
2022-07-01,Placer,061,380077,70277,69606,8584,78190,631
2022-07-01,Plumas,063,18699,3313,3294,402,3696,13
2022-07-01,Riverside,065,2383286,636719,632038,30819,662857,6502
2022-07-01,Sacramento,067,1510023,317612,315165,30848,346013,3100
2022-07-01,San Benito,069,59416,14637,14420,730,15150,100
2022-07-01,San Bernardino,071,2135413,614528,604093,27013,631106,7860
2022-07-01,San Diego,073,3302833,840063,834116,62618,896734,5341
2022-07-01,San Francisco,075,870044,160872,158871,10578,169449,910
2022-07-01,San Joaquin,077,732212,181985,180368,12075,192443,2256
2022-07-01,San Luis Obispo,079,281455,58588,58079,5674,63753,489
2022-07-01,San Mateo,081,765935,151875,149812,9461,159273,723
2022-07-01,Santa Barbara,083,443738,95890,95214,5638,100852,699
2022-07-01,Santa Clara,085,1922200,389967,381630,16680,398310,2355
2022-07-01,Santa Cruz,087,273765,56406,55757,2802,58559,267
2022-07-01,Shasta,089,179085,32492,32280,6558,38838,570
2022-07-01,Sierra,091,2930,288,283,57,340,4
2022-07-01,Siskiyou,093,43540,4813,4808,3014,7822,82
2022-07-01,Solano,095,438530,95521,94437,6868,101305,455
2022-07-01,Sonoma,097,501317,98160,97379,4423,101802,495
2022-07-01,Stanislaus,099,539301,126658,125788,19421,145209,1681
2022-07-01,Sutter,101,95872,22035,21935,2331,24266,228
2022-07-01,Tehama,103,63373,12714,12615,2745,15360,205
2022-07-01,Trinity,105,12862,1272,1256,308,1564,20
2022-07-01,Tulare,107,460477,112526,112118,30586,142704,1500
2022-07-01,Tuolumne,109,53932,14024,13886,756,14642,189
2022-07-01,Ventura,111,848112,190875,189493,12210,201703,1517
2022-07-01,Yolo,113,214977,44101,42760,3570,46330,324
2022-07-01,Yuba,115,75493,17260,17168,1468,18636,124
2022-06-30,Alameda,001,1643700,310808,307672,17232,324904,1898
2022-06-30,Alpine,003,1148,129,129,1,130,0
2022-06-30,Amador,005,37829,9303,9243,772,10015,87
2022-06-30,Butte,007,227075,36170,35846,8014,43860,436
2022-06-30,Calaveras,009,45235,7859,7836,422,8258,124
2022-06-30,Colusa,011,21464,3579,3566,1130,4696,22
2022-06-30,Contra Costa,013,1133247,227103,221545,17486,239031,1343
2022-06-30,Del Norte,015,27424,6663,6543,312,6855,53
2022-06-30,El Dorado,017,186661,29929,29764,3782,33546,217
2022-06-30,Fresno,019,978130,251887,247952,26928,274880,2783
2022-06-30,Glenn,021,27897,5245,5211,1737,6948,48
2022-06-30,Humboldt,023,135768,19582,19516,4018,23534,149
2022-06-30,Imperial,025,180216,59214,58768,11847,70615,944
2022-06-30,Inyo,027,18085,4284,4261,680,4941,56
2022-06-30,Kern,029,883053,203502,202502,51466,253968,2352
2022-06-30,Kings,031,150075,54416,54262,3671,57933,449
2022-06-30,Lake,033,64148,11655,11595,1020,12615,140
2022-06-30,Lassen,035,31185,9347,9336,930,10266,64
2022-06-30,Los Angeles,037,10098052,2992740,2969395,147170,3116565,32089
2022-06-30,Madera,039,155013,39864,39738,6814,46552,372
2022-06-30,Marin,041,260295,41029,40653,4625,45278,297
2022-06-30,Mariposa,043,17540,2799,2780,271,3051,30
2022-06-30,Mendocino,045,87422,14547,14464,3802,18266,127
2022-06-30,Merced,047,269075,66782,66093,9912,76005,832
2022-06-30,Modoc,049,8938,791,787,276,1063,8
2022-06-30,Mono,051,14174,3110,3099,189,3288,7
2022-06-30,Monterey,053,433212,86632,86212,17189,103401,744
2022-06-30,Napa,055,140530,29617,29486,1272,30758,145
2022-06-30,Nevada,057,99092,17651,17546,1495,19041,131
2022-06-30,Orange,059,3164182,606731,603511,50869,654380,7114
2022-06-30,Placer,061,380077,70127,69606,8556,78162,631
2022-06-30,Plumas,063,18699,3308,3294,401,3695,13
2022-06-30,Riverside,065,2383286,635620,632038,30749,662787,6502
2022-06-30,Sacramento,067,1510023,317018,315165,30810,345975,3100
2022-06-30,San Benito,069,59416,14601,14420,727,15147,100
2022-06-30,San Bernardino,071,2135413,613481,604093,26971,631064,7860
2022-06-30,San Diego,073,3302833,838545,834116,62406,896522,5341
2022-06-30,San Francisco,075,870044,160448,158871,10548,169419,910
2022-06-30,San Joaquin,077,732212,181705,180368,12044,192412,2256
2022-06-30,San Luis Obispo,079,281455,58488,58079,5646,63725,489
2022-06-30,San Mateo,081,765935,151451,149812,9430,159242,723
2022-06-30,Santa Barbara,083,443738,95692,95214,5626,100840,699
2022-06-30,Santa Clara,085,1922200,388873,381630,16635,398265,2355
2022-06-30,Santa Cruz,087,273765,56287,55757,2788,58545,267
2022-06-30,Shasta,089,179085,32452,32280,6539,38819,570
2022-06-30,Sierra,091,2930,288,283,57,340,4
2022-06-30,Siskiyou,093,43540,4808,4808,3007,7815,82
2022-06-30,Solano,095,438530,95319,94437,6837,101274,455
2022-06-30,Sonoma,097,501317,97996,97379,4402,101781,495
2022-06-30,Stanislaus,099,539301,126463,125788,19390,145178,1681
2022-06-30,Sutter,101,95872,22002,21935,2329,24264,228
2022-06-30,Tehama,103,63373,12693,12615,2742,15357,205
2022-06-30,Trinity,105,12862,1266,1256,306,1562,20
2022-06-30,Tulare,107,460477,112379,112118,30511,142629,1500
2022-06-30,Tuolumne,109,53932,14005,13886,750,14636,189
2022-06-30,Ventura,111,848112,190531,189493,12135,201628,1517
2022-06-30,Yolo,113,214977,44029,42760,3552,46312,324
2022-06-30,Yuba,115,75493,17232,17168,1462,18630,124
2022-06-29,Alameda,001,1643700,310005,305288,17191,322479,1895
2022-06-29,Alpine,003,1148,129,129,1,130,0
2022-06-29,Amador,005,37829,9296,9205,772,9977,87
2022-06-29,Butte,007,227075,36122,35651,7998,43649,434
2022-06-29,Calaveras,009,45235,7848,7798,419,8217,124
2022-06-29,Colusa,011,21464,3576,3548,1128,4676,22
2022-06-29,Contra Costa,013,1133247,226620,219921,17432,237353,1339
2022-06-29,Del Norte,015,27424,6637,6484,308,6792,53
2022-06-29,El Dorado,017,186661,29871,29549,3766,33315,216
2022-06-29,Fresno,019,978130,251493,246740,26862,273602,2777
2022-06-29,Glenn,021,27897,5244,5192,1735,6927,48
2022-06-29,Humboldt,023,135768,19556,19411,4008,23419,149
2022-06-29,Imperial,025,180216,59095,58498,11801,70299,944
2022-06-29,Inyo,027,18085,4280,4243,675,4918,56
2022-06-29,Kern,029,883053,203217,201537,51285,252822,2343
2022-06-29,Kings,031,150075,54326,54031,3669,57700,448
2022-06-29,Lake,033,64148,11628,11548,1016,12564,140
2022-06-29,Lassen,035,31185,9342,9310,930,10240,64
2022-06-29,Los Angeles,037,10098052,2987104,2955489,146575,3102064,32062
2022-06-29,Madera,039,155013,39813,39554,6805,46359,372
2022-06-29,Marin,041,260295,40925,40397,4619,45016,297
2022-06-29,Mariposa,043,17540,2797,2753,271,3024,30
2022-06-29,Mendocino,045,87422,14518,14383,3786,18169,127
2022-06-29,Merced,047,269075,66688,65733,9900,75633,830
2022-06-29,Modoc,049,8938,789,780,275,1055,8
2022-06-29,Mono,051,14174,3110,3081,187,3268,7
2022-06-29,Monterey,053,433212,86500,85711,17139,102850,743
2022-06-29,Napa,055,140530,29565,29285,1268,30553,144
2022-06-29,Nevada,057,99092,17617,17439,1491,18930,129
2022-06-29,Orange,059,3164182,605569,599951,50695,650646,7095
2022-06-29,Placer,061,380077,69991,69244,8547,77791,629
2022-06-29,Plumas,063,18699,3305,3267,399,3666,13
2022-06-29,Riverside,065,2383286,634563,629035,30682,659717,6493
2022-06-29,Sacramento,067,1510023,316421,313224,30766,343990,3082
2022-06-29,San Benito,069,59416,14565,14302,719,15021,100
2022-06-29,San Bernardino,071,2135413,612488,600960,26875,627835,7825
2022-06-29,San Diego,073,3302833,836818,828907,62172,891079,5336
2022-06-29,San Francisco,075,870044,159954,157419,10513,167932,902
2022-06-29,San Joaquin,077,732212,181411,179476,12006,191482,2252
2022-06-29,San Luis Obispo,079,281455,58353,57783,5608,63391,486
2022-06-29,San Mateo,081,765935,151065,148533,9410,157943,723
2022-06-29,Santa Barbara,083,443738,95541,94683,5615,100298,699
2022-06-29,Santa Clara,085,1922200,387876,378000,16574,394574,2348
2022-06-29,Santa Cruz,087,273765,56162,55432,2774,58206,266
2022-06-29,Shasta,089,179085,32405,32106,6523,38629,570
2022-06-29,Sierra,091,2930,286,283,57,340,4
2022-06-29,Siskiyou,093,43540,4802,4773,3007,7780,82
2022-06-29,Solano,095,438530,95086,92975,6818,99793,455
2022-06-29,Sonoma,097,501317,97813,96854,4390,101244,493
2022-06-29,Stanislaus,099,539301,126287,125189,19360,144549,1674
2022-06-29,Sutter,101,95872,21949,21836,2324,24160,227
2022-06-29,Tehama,103,63373,12674,12561,2741,15302,205
2022-06-29,Trinity,105,12862,1264,1245,305,1550,20
2022-06-29,Tulare,107,460477,112245,111707,30438,142145,1499
2022-06-29,Tuolumne,109,53932,13980,13779,734,14513,189
2022-06-29,Ventura,111,848112,190224,188519,12071,200590,1514
2022-06-29,Yolo,113,214977,43927,42410,3541,45951,323
2022-06-29,Yuba,115,75493,17203,17082,1460,18542,124
2022-06-28,Alameda,001,1643700,309156,305288,17154,322442,1895
2022-06-28,Alpine,003,1148,129,129,1,130,0
2022-06-28,Amador,005,37829,9291,9205,771,9976,87
2022-06-28,Butte,007,227075,36056,35651,7980,43631,434
2022-06-28,Calaveras,009,45235,7836,7798,419,8217,124
2022-06-28,Colusa,011,21464,3575,3548,1127,4675,22
2022-06-28,Contra Costa,013,1133247,226015,219921,17369,237290,1339
2022-06-28,Del Norte,015,27424,6600,6484,306,6790,53
2022-06-28,El Dorado,017,186661,29823,29549,3755,33304,216
2022-06-28,Fresno,019,978130,251059,246740,26806,273546,2777
2022-06-28,Glenn,021,27897,5236,5192,1730,6922,48
2022-06-28,Humboldt,023,135768,19536,19411,4001,23412,149
2022-06-28,Imperial,025,180216,59000,58498,11724,70222,944
2022-06-28,Inyo,027,18085,4274,4243,669,4912,56
2022-06-28,Kern,029,883053,202922,201537,51071,252608,2343
2022-06-28,Kings,031,150075,54244,54031,3664,57695,448
2022-06-28,Lake,033,64148,11617,11548,1014,12562,140
2022-06-28,Lassen,035,31185,9335,9310,930,10240,64
2022-06-28,Los Angeles,037,10098052,2981169,2955489,145964,3101453,32062
2022-06-28,Madera,039,155013,39754,39554,6788,46342,372
2022-06-28,Marin,041,260295,40817,40397,4612,45009,297
2022-06-28,Mariposa,043,17540,2789,2753,269,3022,30
2022-06-28,Mendocino,045,87422,14490,14383,3774,18157,127
2022-06-28,Merced,047,269075,66585,65733,9882,75615,830
2022-06-28,Modoc,049,8938,787,780,274,1054,8
2022-06-28,Mono,051,14174,3103,3081,185,3266,7
2022-06-28,Monterey,053,433212,86375,85711,17092,102803,743
2022-06-28,Napa,055,140530,29497,29285,1265,30550,144
2022-06-28,Nevada,057,99092,17586,17439,1487,18926,129
2022-06-28,Orange,059,3164182,604220,599951,50512,650463,7095
2022-06-28,Placer,061,380077,69829,69244,8538,77782,629
2022-06-28,Plumas,063,18699,3305,3267,398,3665,13
2022-06-28,Riverside,065,2383286,633366,629035,30635,659670,6493
2022-06-28,Sacramento,067,1510023,315747,313224,30704,343928,3082
2022-06-28,San Benito,069,59416,14526,14302,718,15020,100
2022-06-28,San Bernardino,071,2135413,611359,600960,26829,627789,7825
2022-06-28,San Diego,073,3302833,834957,828907,61931,890838,5336
2022-06-28,San Francisco,075,870044,159421,157419,10489,167908,902
2022-06-28,San Joaquin,077,732212,181101,179476,11970,191446,2252
2022-06-28,San Luis Obispo,079,281455,58234,57783,5571,63354,486
2022-06-28,San Mateo,081,765935,150602,148533,9385,157918,723
2022-06-28,Santa Barbara,083,443738,95371,94683,5598,100281,699
2022-06-28,Santa Clara,085,1922200,386756,378000,16516,394516,2348
2022-06-28,Santa Cruz,087,273765,56030,55432,2766,58198,266
2022-06-28,Shasta,089,179085,32358,32106,6510,38616,570
2022-06-28,Sierra,091,2930,286,283,57,340,4
2022-06-28,Siskiyou,093,43540,4796,4773,3001,7774,82
2022-06-28,Solano,095,438530,94816,92975,6800,99775,455
2022-06-28,Sonoma,097,501317,97604,96854,4374,101228,493
2022-06-28,Stanislaus,099,539301,126085,125189,19337,144526,1674
2022-06-28,Sutter,101,95872,21914,21836,2322,24158,227
2022-06-28,Tehama,103,63373,12654,12561,2737,15298,205
2022-06-28,Trinity,105,12862,1261,1245,303,1548,20
2022-06-28,Tulare,107,460477,112059,111707,30364,142071,1499
2022-06-28,Tuolumne,109,53932,13949,13779,728,14507,189
2022-06-28,Ventura,111,848112,189901,188519,11992,200511,1514
2022-06-28,Yolo,113,214977,43816,42410,3535,45945,323
2022-06-28,Yuba,115,75493,17167,17082,1456,18538,124
2022-06-27,Alameda,001,1643700,308217,305288,17102,322390,1895
2022-06-27,Alpine,003,1148,129,129,1,130,0
2022-06-27,Amador,005,37829,9276,9205,769,9974,87
2022-06-27,Butte,007,227075,36002,35651,7960,43611,434
2022-06-27,Calaveras,009,45235,7822,7798,419,8217,124
2022-06-27,Colusa,011,21464,3571,3548,1125,4673,22
2022-06-27,Contra Costa,013,1133247,225334,219921,17305,237226,1339
2022-06-27,Del Norte,015,27424,6580,6484,300,6784,53
2022-06-27,El Dorado,017,186661,29758,29549,3737,33286,216
2022-06-27,Fresno,019,978130,250589,246740,26736,273476,2777
2022-06-27,Glenn,021,27897,5230,5192,1723,6915,48
2022-06-27,Humboldt,023,135768,19501,19411,3989,23400,149
2022-06-27,Imperial,025,180216,58862,58498,11658,70156,944
2022-06-27,Inyo,027,18085,4264,4243,660,4903,56
2022-06-27,Kern,029,883053,202564,201537,50863,252400,2343
2022-06-27,Kings,031,150075,54157,54031,3661,57692,448
2022-06-27,Lake,033,64148,11598,11548,1009,12557,140
2022-06-27,Lassen,035,31185,9326,9310,930,10240,64
2022-06-27,Los Angeles,037,10098052,2974969,2955489,145396,3100885,32062
2022-06-27,Madera,039,155013,39689,39554,6776,46330,372
2022-06-27,Marin,041,260295,40710,40397,4599,44996,297
2022-06-27,Mariposa,043,17540,2780,2753,267,3020,30
2022-06-27,Mendocino,045,87422,14460,14383,3768,18151,127
2022-06-27,Merced,047,269075,66475,65733,9847,75580,830
2022-06-27,Modoc,049,8938,782,780,273,1053,8
2022-06-27,Mono,051,14174,3102,3081,185,3266,7
2022-06-27,Monterey,053,433212,86225,85711,17031,102742,743
2022-06-27,Napa,055,140530,29428,29285,1262,30547,144
2022-06-27,Nevada,057,99092,17556,17439,1473,18912,129
2022-06-27,Orange,059,3164182,602855,599951,50292,650243,7095
2022-06-27,Placer,061,380077,69716,69244,8514,77758,629
2022-06-27,Plumas,063,18699,3300,3267,397,3664,13
2022-06-27,Riverside,065,2383286,632214,629035,30569,659604,6493
2022-06-27,Sacramento,067,1510023,315021,313224,30652,343876,3082
2022-06-27,San Benito,069,59416,14471,14302,715,15017,100
2022-06-27,San Bernardino,071,2135413,610249,600960,26782,627742,7825
2022-06-27,San Diego,073,3302833,833033,828907,61701,890608,5336
2022-06-27,San Francisco,075,870044,158865,157419,10463,167882,902
2022-06-27,San Joaquin,077,732212,180758,179476,11928,191404,2252
2022-06-27,San Luis Obispo,079,281455,58119,57783,5534,63317,486
2022-06-27,San Mateo,081,765935,150124,148533,9351,157884,723
2022-06-27,Santa Barbara,083,443738,95184,94683,5584,100267,699
2022-06-27,Santa Clara,085,1922200,385336,378000,16462,394462,2348
2022-06-27,Santa Cruz,087,273765,55860,55432,2758,58190,266
2022-06-27,Shasta,089,179085,32297,32106,6492,38598,570
2022-06-27,Sierra,091,2930,286,283,57,340,4
2022-06-27,Siskiyou,093,43540,4786,4773,2994,7767,82
2022-06-27,Solano,095,438530,94506,92975,6768,99743,455
2022-06-27,Sonoma,097,501317,97411,96854,4355,101209,493
2022-06-27,Stanislaus,099,539301,125858,125189,19316,144505,1674
2022-06-27,Sutter,101,95872,21874,21836,2319,24155,227
2022-06-27,Tehama,103,63373,12632,12561,2735,15296,205
2022-06-27,Trinity,105,12862,1259,1245,301,1546,20
2022-06-27,Tulare,107,460477,111883,111707,30277,141984,1499
2022-06-27,Tuolumne,109,53932,13914,13779,720,14499,189
2022-06-27,Ventura,111,848112,189521,188519,11930,200449,1514
2022-06-27,Yolo,113,214977,43690,42410,3527,45937,323
2022-06-27,Yuba,115,75493,17139,17082,1453,18535,124
2022-06-26,Alameda,001,1643700,307137,302071,17047,319118,1891
2022-06-26,Alpine,003,1148,129,129,1,130,0
2022-06-26,Amador,005,37829,9237,9135,767,9902,87
2022-06-26,Butte,007,227075,35929,35406,7935,43341,433
2022-06-26,Calaveras,009,45235,7807,7754,416,8170,124
2022-06-26,Colusa,011,21464,3562,3540,1121,4661,22
2022-06-26,Contra Costa,013,1133247,224709,218053,17221,235274,1335
2022-06-26,Del Norte,015,27424,6558,6398,296,6694,52
2022-06-26,El Dorado,017,186661,29675,29313,3712,33025,216
2022-06-26,Fresno,019,978130,250051,245118,26670,271788,2777
2022-06-26,Glenn,021,27897,5225,5178,1720,6898,48
2022-06-26,Humboldt,023,135768,19466,19234,3978,23212,149
2022-06-26,Imperial,025,180216,58716,58127,11565,69692,944
2022-06-26,Inyo,027,18085,4253,4228,647,4875,56
2022-06-26,Kern,029,883053,202256,200556,50656,251212,2344
2022-06-26,Kings,031,150075,54049,53783,3657,57440,448
2022-06-26,Lake,033,64148,11579,11471,1007,12478,140
2022-06-26,Lassen,035,31185,9317,9287,930,10217,64
2022-06-26,Los Angeles,037,10098052,2968380,2936815,144753,3081568,32036
2022-06-26,Madera,039,155013,39620,39319,6756,46075,372
2022-06-26,Marin,041,260295,40589,39979,4578,44557,297
2022-06-26,Mariposa,043,17540,2772,2713,267,2980,30
2022-06-26,Mendocino,045,87422,14431,14292,3741,18033,127
2022-06-26,Merced,047,269075,66344,65408,9820,75228,828
2022-06-26,Modoc,049,8938,781,777,271,1048,8
2022-06-26,Mono,051,14174,3092,3076,185,3261,7
2022-06-26,Monterey,053,433212,86052,85275,16970,102245,743
2022-06-26,Napa,055,140530,29348,29054,1259,30313,144
2022-06-26,Nevada,057,99092,17512,17339,1469,18808,129
2022-06-26,Orange,059,3164182,601370,595761,50083,645844,7090
2022-06-26,Placer,061,380077,69582,68785,8491,77276,628
2022-06-26,Plumas,063,18699,3288,3241,397,3638,13
2022-06-26,Riverside,065,2383286,630990,625794,30512,656306,6493
2022-06-26,Sacramento,067,1510023,314198,310837,30586,341423,3077
2022-06-26,San Benito,069,59416,14426,14192,712,14904,99
2022-06-26,San Bernardino,071,2135413,609039,598062,26723,624785,7803
2022-06-26,San Diego,073,3302833,830850,822848,61528,884376,5332
2022-06-26,San Francisco,075,870044,158233,155609,10411,166020,899
2022-06-26,San Joaquin,077,732212,180380,178447,11883,190330,2252
2022-06-26,San Luis Obispo,079,281455,57984,57472,5483,62955,485
2022-06-26,San Mateo,081,765935,149606,146955,9321,156276,723
2022-06-26,Santa Barbara,083,443738,94976,94017,5556,99573,699
2022-06-26,Santa Clara,085,1922200,383954,373961,16381,390342,2338
2022-06-26,Santa Cruz,087,273765,55703,54874,2749,57623,265
2022-06-26,Shasta,089,179085,32215,31921,6474,38395,570
2022-06-26,Sierra,091,2930,285,283,57,340,4
2022-06-26,Siskiyou,093,43540,4768,4744,2987,7731,81
2022-06-26,Solano,095,438530,94235,92248,6730,98978,455
2022-06-26,Sonoma,097,501317,97177,95981,4319,100300,493
2022-06-26,Stanislaus,099,539301,125657,124493,19287,143780,1672
2022-06-26,Sutter,101,95872,21834,21733,2318,24051,227
2022-06-26,Tehama,103,63373,12615,12510,2729,15239,205
2022-06-26,Trinity,105,12862,1254,1233,299,1532,20
2022-06-26,Tulare,107,460477,111702,111188,30196,141384,1496
2022-06-26,Tuolumne,109,53932,13886,13688,713,14401,189
2022-06-26,Ventura,111,848112,189126,187389,11851,199240,1514
2022-06-26,Yolo,113,214977,43575,41932,3513,45445,323
2022-06-26,Yuba,115,75493,17102,16994,1444,18438,124
2022-06-25,Alameda,001,1643700,306667,302071,17034,319105,1891
2022-06-25,Alpine,003,1148,129,129,1,130,0
2022-06-25,Amador,005,37829,9227,9135,766,9901,87
2022-06-25,Butte,007,227075,35890,35406,7913,43319,433
2022-06-25,Calaveras,009,45235,7798,7754,416,8170,124
2022-06-25,Colusa,011,21464,3557,3540,1121,4661,22
2022-06-25,Contra Costa,013,1133247,224349,218053,17178,235231,1335
2022-06-25,Del Norte,015,27424,6544,6398,293,6691,52
2022-06-25,El Dorado,017,186661,29636,29313,3706,33019,216
2022-06-25,Fresno,019,978130,249819,245118,26644,271762,2777
2022-06-25,Glenn,021,27897,5220,5178,1718,6896,48
2022-06-25,Humboldt,023,135768,19445,19234,3967,23201,149
2022-06-25,Imperial,025,180216,58634,58127,11540,69667,944
2022-06-25,Inyo,027,18085,4251,4228,643,4871,56
2022-06-25,Kern,029,883053,202097,200556,50551,251107,2344
2022-06-25,Kings,031,150075,54011,53783,3657,57440,448
2022-06-25,Lake,033,64148,11570,11471,1006,12477,140
2022-06-25,Lassen,035,31185,9311,9287,928,10215,64
2022-06-25,Los Angeles,037,10098052,2965365,2936815,144370,3081185,32036
2022-06-25,Madera,039,155013,39587,39319,6753,46072,372
2022-06-25,Marin,041,260295,40536,39979,4571,44550,297
2022-06-25,Mariposa,043,17540,2770,2713,267,2980,30
2022-06-25,Mendocino,045,87422,14419,14292,3736,18028,127
2022-06-25,Merced,047,269075,66267,65408,9817,75225,828
2022-06-25,Modoc,049,8938,781,777,271,1048,8
2022-06-25,Mono,051,14174,3087,3076,185,3261,7
2022-06-25,Monterey,053,433212,85951,85275,16941,102216,743
2022-06-25,Napa,055,140530,29317,29054,1255,30309,144
2022-06-25,Nevada,057,99092,17488,17339,1465,18804,129
2022-06-25,Orange,059,3164182,600671,595761,49945,645706,7090
2022-06-25,Placer,061,380077,69485,68785,8471,77256,628
2022-06-25,Plumas,063,18699,3284,3241,397,3638,13
2022-06-25,Riverside,065,2383286,630345,625794,30470,656264,6493
2022-06-25,Sacramento,067,1510023,313887,310837,30558,341395,3077
2022-06-25,San Benito,069,59416,14401,14192,711,14903,99
2022-06-25,San Bernardino,071,2135413,608441,598062,26695,624757,7803
2022-06-25,San Diego,073,3302833,829944,822848,61464,884312,5332
2022-06-25,San Francisco,075,870044,157939,155609,10393,166002,899
2022-06-25,San Joaquin,077,732212,180231,178447,11868,190315,2252
2022-06-25,San Luis Obispo,079,281455,57913,57472,5473,62945,485
2022-06-25,San Mateo,081,765935,149330,146955,9300,156255,723
2022-06-25,Santa Barbara,083,443738,94833,94017,5543,99560,699
2022-06-25,Santa Clara,085,1922200,383100,373961,16353,390314,2338
2022-06-25,Santa Cruz,087,273765,55633,54874,2746,57620,265
2022-06-25,Shasta,089,179085,32179,31921,6460,38381,570
2022-06-25,Sierra,091,2930,285,283,57,340,4
2022-06-25,Siskiyou,093,43540,4765,4744,2984,7728,81
2022-06-25,Solano,095,438530,94150,92248,6709,98957,455
2022-06-25,Sonoma,097,501317,97066,95981,4308,100289,493
2022-06-25,Stanislaus,099,539301,125527,124493,19268,143761,1672
2022-06-25,Sutter,101,95872,21813,21733,2317,24050,227
2022-06-25,Tehama,103,63373,12604,12510,2724,15234,205
2022-06-25,Trinity,105,12862,1253,1233,297,1530,20
2022-06-25,Tulare,107,460477,111620,111188,30158,141346,1496
2022-06-25,Tuolumne,109,53932,13867,13688,710,14398,189
2022-06-25,Ventura,111,848112,188918,187389,11822,199211,1514
2022-06-25,Yolo,113,214977,43511,41932,3507,45439,323
2022-06-25,Yuba,115,75493,17081,16994,1443,18437,124
2022-06-24,Alameda,001,1643700,306091,302071,16999,319070,1891
2022-06-24,Alpine,003,1148,129,129,1,130,0
2022-06-24,Amador,005,37829,9220,9135,764,9899,87
2022-06-24,Butte,007,227075,35860,35406,7899,43305,433
2022-06-24,Calaveras,009,45235,7793,7754,415,8169,124
2022-06-24,Colusa,011,21464,3556,3540,1118,4658,22
2022-06-24,Contra Costa,013,1133247,224007,218053,17152,235205,1335
2022-06-24,Del Norte,015,27424,6533,6398,291,6689,52
2022-06-24,El Dorado,017,186661,29593,29313,3702,33015,216
2022-06-24,Fresno,019,978130,249530,245118,26608,271726,2777
2022-06-24,Glenn,021,27897,5218,5178,1718,6896,48
2022-06-24,Humboldt,023,135768,19414,19234,3962,23196,149
2022-06-24,Imperial,025,180216,58562,58127,11510,69637,944
2022-06-24,Inyo,027,18085,4249,4228,639,4867,56
2022-06-24,Kern,029,883053,201924,200556,50455,251011,2344
2022-06-24,Kings,031,150075,53967,53783,3653,57436,448
2022-06-24,Lake,033,64148,11559,11471,1006,12477,140
2022-06-24,Lassen,035,31185,9308,9287,927,10214,64
2022-06-24,Los Angeles,037,10098052,2962083,2936815,144043,3080858,32036
2022-06-24,Madera,039,155013,39541,39319,6747,46066,372
2022-06-24,Marin,041,260295,40460,39979,4559,44538,297
2022-06-24,Mariposa,043,17540,2763,2713,267,2980,30
2022-06-24,Mendocino,045,87422,14410,14292,3733,18025,127
2022-06-24,Merced,047,269075,66229,65408,9808,75216,828
2022-06-24,Modoc,049,8938,781,777,271,1048,8
2022-06-24,Mono,051,14174,3083,3076,184,3260,7
2022-06-24,Monterey,053,433212,85870,85275,16914,102189,743
2022-06-24,Napa,055,140530,29289,29054,1254,30308,144
2022-06-24,Nevada,057,99092,17472,17339,1459,18798,129
2022-06-24,Orange,059,3164182,599982,595761,49799,645560,7090
2022-06-24,Placer,061,380077,69409,68785,8459,77244,628
2022-06-24,Plumas,063,18699,3280,3241,397,3638,13
2022-06-24,Riverside,065,2383286,629700,625794,30426,656220,6493
2022-06-24,Sacramento,067,1510023,313491,310837,30535,341372,3077
2022-06-24,San Benito,069,59416,14388,14192,710,14902,99
2022-06-24,San Bernardino,071,2135413,607853,598062,26670,624732,7803
2022-06-24,San Diego,073,3302833,828906,822848,61382,884230,5332
2022-06-24,San Francisco,075,870044,157626,155609,10366,165975,899
2022-06-24,San Joaquin,077,732212,180052,178447,11842,190289,2252
2022-06-24,San Luis Obispo,079,281455,57868,57472,5468,62940,485
2022-06-24,San Mateo,081,765935,148994,146955,9287,156242,723
2022-06-24,Santa Barbara,083,443738,94702,94017,5540,99557,699
2022-06-24,Santa Clara,085,1922200,382268,373961,16300,390261,2338
2022-06-24,Santa Cruz,087,273765,55532,54874,2735,57609,265
2022-06-24,Shasta,089,179085,32149,31921,6451,38372,570
2022-06-24,Sierra,091,2930,285,283,57,340,4
2022-06-24,Siskiyou,093,43540,4757,4744,2983,7727,81
2022-06-24,Solano,095,438530,93998,92248,6695,98943,455
2022-06-24,Sonoma,097,501317,96927,95981,4291,100272,493
2022-06-24,Stanislaus,099,539301,125402,124493,19246,143739,1672
2022-06-24,Sutter,101,95872,21798,21733,2316,24049,227
2022-06-24,Tehama,103,63373,12589,12510,2718,15228,205
2022-06-24,Trinity,105,12862,1250,1233,297,1530,20
2022-06-24,Tulare,107,460477,111519,111188,30101,141289,1496
2022-06-24,Tuolumne,109,53932,13848,13688,704,14392,189
2022-06-24,Ventura,111,848112,188691,187389,11793,199182,1514
2022-06-24,Yolo,113,214977,43419,41932,3498,45430,323
2022-06-24,Yuba,115,75493,17063,16994,1443,18437,124
2022-06-23,Alameda,001,1643700,305267,302071,16940,319011,1891
2022-06-23,Alpine,003,1148,129,129,1,130,0
2022-06-23,Amador,005,37829,9211,9135,763,9898,87
2022-06-23,Butte,007,227075,35800,35406,7880,43286,433
2022-06-23,Calaveras,009,45235,7782,7754,414,8168,124
2022-06-23,Colusa,011,21464,3549,3540,1116,4656,22
2022-06-23,Contra Costa,013,1133247,223496,218053,17058,235111,1335
2022-06-23,Del Norte,015,27424,6501,6398,289,6687,52
2022-06-23,El Dorado,017,186661,29536,29313,3690,33003,216
2022-06-23,Fresno,019,978130,249124,245118,26547,271665,2777
2022-06-23,Glenn,021,27897,5215,5178,1709,6887,48
2022-06-23,Humboldt,023,135768,19392,19234,3958,23192,149
2022-06-23,Imperial,025,180216,58488,58127,11457,69584,944
2022-06-23,Inyo,027,18085,4246,4228,636,4864,56
2022-06-23,Kern,029,883053,201642,200556,50305,250861,2344
2022-06-23,Kings,031,150075,53908,53783,3650,57433,448
2022-06-23,Lake,033,64148,11538,11471,1006,12477,140
2022-06-23,Lassen,035,31185,9298,9287,926,10213,64
2022-06-23,Los Angeles,037,10098052,2957415,2936815,143500,3080315,32036
2022-06-23,Madera,039,155013,39479,39319,6732,46051,372
2022-06-23,Marin,041,260295,40346,39979,4535,44514,297
2022-06-23,Mariposa,043,17540,2751,2713,267,2980,30
2022-06-23,Mendocino,045,87422,14381,14292,3729,18021,127
2022-06-23,Merced,047,269075,66151,65408,9792,75200,828
2022-06-23,Modoc,049,8938,780,777,271,1048,8
2022-06-23,Mono,051,14174,3081,3076,183,3259,7
2022-06-23,Monterey,053,433212,85724,85275,16861,102136,743
2022-06-23,Napa,055,140530,29232,29054,1253,30307,144
2022-06-23,Nevada,057,99092,17439,17339,1459,18798,129
2022-06-23,Orange,059,3164182,598969,595761,49615,645376,7090
2022-06-23,Placer,061,380077,69271,68785,8438,77223,628
2022-06-23,Plumas,063,18699,3275,3241,395,3636,13
2022-06-23,Riverside,065,2383286,628779,625794,30377,656171,6493
2022-06-23,Sacramento,067,1510023,312888,310837,30491,341328,3077
2022-06-23,San Benito,069,59416,14357,14192,708,14900,99
2022-06-23,San Bernardino,071,2135413,607058,598062,26636,624698,7803
2022-06-23,San Diego,073,3302833,827434,822848,61183,884031,5332
2022-06-23,San Francisco,075,870044,157164,155609,10333,165942,899
2022-06-23,San Joaquin,077,732212,179775,178447,11815,190262,2252
2022-06-23,San Luis Obispo,079,281455,57779,57472,5436,62908,485
2022-06-23,San Mateo,081,765935,148645,146955,9252,156207,723
2022-06-23,Santa Barbara,083,443738,94536,94017,5512,99529,699
2022-06-23,Santa Clara,085,1922200,381273,373961,16252,390213,2338
2022-06-23,Santa Cruz,087,273765,55421,54874,2723,57597,265
2022-06-23,Shasta,089,179085,32107,31921,6439,38360,570
2022-06-23,Sierra,091,2930,284,283,57,340,4
2022-06-23,Siskiyou,093,43540,4751,4744,2976,7720,81
2022-06-23,Solano,095,438530,93751,92248,6652,98900,455
2022-06-23,Sonoma,097,501317,96730,95981,4271,100252,493
2022-06-23,Stanislaus,099,539301,125221,124493,19215,143708,1672
2022-06-23,Sutter,101,95872,21764,21733,2316,24049,227
2022-06-23,Tehama,103,63373,12580,12510,2715,15225,205
2022-06-23,Trinity,105,12862,1248,1233,297,1530,20
2022-06-23,Tulare,107,460477,111394,111188,30032,141220,1496
2022-06-23,Tuolumne,109,53932,13821,13688,692,14380,189
2022-06-23,Ventura,111,848112,188395,187389,11756,199145,1514
2022-06-23,Yolo,113,214977,43315,41932,3487,45419,323
2022-06-23,Yuba,115,75493,17042,16994,1437,18431,124
2022-06-22,Alameda,001,1643700,304443,299567,16881,316448,1888
2022-06-22,Alpine,003,1148,129,129,1,130,0
2022-06-22,Amador,005,37829,9205,9049,762,9811,87
2022-06-22,Butte,007,227075,35734,35203,7862,43065,433
2022-06-22,Calaveras,009,45235,7770,7716,414,8130,122
2022-06-22,Colusa,011,21464,3546,3529,1116,4645,21
2022-06-22,Contra Costa,013,1133247,222975,216355,17003,233358,1328
2022-06-22,Del Norte,015,27424,6483,6367,288,6655,52
2022-06-22,El Dorado,017,186661,29473,29139,3677,32816,215
2022-06-22,Fresno,019,978130,248702,244129,26492,270621,2772
2022-06-22,Glenn,021,27897,5213,5161,1704,6865,48
2022-06-22,Humboldt,023,135768,19340,19111,3938,23049,148
2022-06-22,Imperial,025,180216,58387,57866,11424,69290,944
2022-06-22,Inyo,027,18085,4241,4222,635,4857,56
2022-06-22,Kern,029,883053,201369,199721,50171,249892,2341
2022-06-22,Kings,031,150075,53844,53568,3646,57214,448
2022-06-22,Lake,033,64148,11521,11426,1000,12426,140
2022-06-22,Lassen,035,31185,9290,9259,924,10183,64
2022-06-22,Los Angeles,037,10098052,2952453,2925667,143035,3068702,32015
2022-06-22,Madera,039,155013,39422,39139,6713,45852,372
2022-06-22,Marin,041,260295,40243,39687,4529,44216,297
2022-06-22,Mariposa,043,17540,2745,2695,264,2959,30
2022-06-22,Mendocino,045,87422,14365,14201,3708,17909,127
2022-06-22,Merced,047,269075,66054,65120,9768,74888,827
2022-06-22,Modoc,049,8938,779,773,267,1040,8
2022-06-22,Mono,051,14174,3080,3073,181,3254,7
2022-06-22,Monterey,053,433212,85597,84752,16818,101570,742
2022-06-22,Napa,055,140530,29162,28894,1249,30143,144
2022-06-22,Nevada,057,99092,17420,17280,1449,18729,129
2022-06-22,Orange,059,3164182,597779,592215,49424,641639,7084
2022-06-22,Placer,061,380077,69155,68447,8428,76875,628
2022-06-22,Plumas,063,18699,3265,3220,395,3615,13
2022-06-22,Riverside,065,2383286,627930,623584,30321,653905,6491
2022-06-22,Sacramento,067,1510023,312261,309105,30457,339562,3071
2022-06-22,San Benito,069,59416,14332,14128,705,14833,99
2022-06-22,San Bernardino,071,2135413,606257,595517,26606,622123,7774
2022-06-22,San Diego,073,3302833,825830,815124,60994,876118,5318
2022-06-22,San Francisco,075,870044,156683,154213,10303,164516,897
2022-06-22,San Joaquin,077,732212,179512,177637,11790,189427,2251
2022-06-22,San Luis Obispo,079,281455,57689,57177,5401,62578,485
2022-06-22,San Mateo,081,765935,148236,145781,9229,155010,723
2022-06-22,Santa Barbara,083,443738,94389,93576,5498,99074,700
2022-06-22,Santa Clara,085,1922200,380173,370678,16142,386820,2340
2022-06-22,Santa Cruz,087,273765,55302,54525,2710,57235,265
2022-06-22,Shasta,089,179085,32062,31786,6424,38210,570
2022-06-22,Sierra,091,2930,284,283,57,340,4
2022-06-22,Siskiyou,093,43540,4744,4711,2973,7684,81
2022-06-22,Solano,095,438530,93502,91528,6586,98114,454
2022-06-22,Sonoma,097,501317,96519,95363,4250,99613,493
2022-06-22,Stanislaus,099,539301,125025,124023,19158,143181,1670
2022-06-22,Sutter,101,95872,21732,21649,2315,23964,227
2022-06-22,Tehama,103,63373,12570,12465,2713,15178,205
2022-06-22,Trinity,105,12862,1246,1223,297,1520,20
2022-06-22,Tulare,107,460477,111259,110768,29952,140720,1496
2022-06-22,Tuolumne,109,53932,13802,13596,686,14282,189
2022-06-22,Ventura,111,848112,188090,186601,11704,198305,1514
2022-06-22,Yolo,113,214977,43194,41689,3476,45165,323
2022-06-22,Yuba,115,75493,17022,16912,1433,18345,124
2022-06-21,Alameda,001,1643700,303643,299567,16844,316411,1888
2022-06-21,Alpine,003,1148,129,129,1,130,0
2022-06-21,Amador,005,37829,9198,9049,759,9808,87
2022-06-21,Butte,007,227075,35662,35203,7850,43053,433
2022-06-21,Calaveras,009,45235,7761,7716,413,8129,122
2022-06-21,Colusa,011,21464,3544,3529,1114,4643,21
2022-06-21,Contra Costa,013,1133247,222411,216355,16954,233309,1328
2022-06-21,Del Norte,015,27424,6452,6367,286,6653,52
2022-06-21,El Dorado,017,186661,29401,29139,3670,32809,215
2022-06-21,Fresno,019,978130,248263,244129,26426,270555,2772
2022-06-21,Glenn,021,27897,5206,5161,1702,6863,48
2022-06-21,Humboldt,023,135768,19288,19111,3925,23036,148
2022-06-21,Imperial,025,180216,58292,57866,11389,69255,944
2022-06-21,Inyo,027,18085,4236,4222,629,4851,56
2022-06-21,Kern,029,883053,201047,199721,49986,249707,2341
2022-06-21,Kings,031,150075,53769,53568,3645,57213,448
2022-06-21,Lake,033,64148,11498,11426,997,12423,140
2022-06-21,Lassen,035,31185,9280,9259,921,10180,64
2022-06-21,Los Angeles,037,10098052,2947631,2925667,142526,3068193,32015
2022-06-21,Madera,039,155013,39338,39139,6702,45841,372
2022-06-21,Marin,041,260295,40153,39687,4517,44204,297
2022-06-21,Mariposa,043,17540,2739,2695,263,2958,30
2022-06-21,Mendocino,045,87422,14336,14201,3699,17900,127
2022-06-21,Merced,047,269075,65954,65120,9736,74856,827
2022-06-21,Modoc,049,8938,776,773,266,1039,8
2022-06-21,Mono,051,14174,3078,3073,180,3253,7
2022-06-21,Monterey,053,433212,85441,84752,16776,101528,742
2022-06-21,Napa,055,140530,29109,28894,1248,30142,144
2022-06-21,Nevada,057,99092,17392,17280,1446,18726,129
2022-06-21,Orange,059,3164182,596588,592215,49275,641490,7084
2022-06-21,Placer,061,380077,69028,68447,8416,76863,628
2022-06-21,Plumas,063,18699,3256,3220,394,3614,13
2022-06-21,Riverside,065,2383286,626967,623584,30261,653845,6491
2022-06-21,Sacramento,067,1510023,311567,309105,30411,339516,3071
2022-06-21,San Benito,069,59416,14296,14128,702,14830,99
2022-06-21,San Bernardino,071,2135413,605432,595517,26559,622076,7774
2022-06-21,San Diego,073,3302833,824150,815124,60790,875914,5318
2022-06-21,San Francisco,075,870044,156205,154213,10271,164484,897
2022-06-21,San Joaquin,077,732212,179193,177637,11760,189397,2251
2022-06-21,San Luis Obispo,079,281455,57578,57177,5356,62533,485
2022-06-21,San Mateo,081,765935,147744,145781,9209,154990,723
2022-06-21,Santa Barbara,083,443738,94222,93576,5484,99060,700
2022-06-21,Santa Clara,085,1922200,379007,370678,16093,386771,2340
2022-06-21,Santa Cruz,087,273765,55172,54525,2702,57227,265
2022-06-21,Shasta,089,179085,32016,31786,6406,38192,570
2022-06-21,Sierra,091,2930,284,283,57,340,4
2022-06-21,Siskiyou,093,43540,4736,4711,2965,7676,81
2022-06-21,Solano,095,438530,93241,91528,6568,98096,454
2022-06-21,Sonoma,097,501317,96284,95363,4226,99589,493
2022-06-21,Stanislaus,099,539301,124832,124023,19128,143151,1670
2022-06-21,Sutter,101,95872,21708,21649,2313,23962,227
2022-06-21,Tehama,103,63373,12556,12465,2713,15178,205
2022-06-21,Trinity,105,12862,1240,1223,297,1520,20
2022-06-21,Tulare,107,460477,111118,110768,29893,140661,1496
2022-06-21,Tuolumne,109,53932,13778,13596,680,14276,189
2022-06-21,Ventura,111,848112,187767,186601,11649,198250,1514
2022-06-21,Yolo,113,214977,43062,41689,3464,45153,323
2022-06-21,Yuba,115,75493,16993,16912,1432,18344,124
2022-06-20,Alameda,001,1643700,302743,299567,16782,316349,1888
2022-06-20,Alpine,003,1148,129,129,1,130,0
2022-06-20,Amador,005,37829,9188,9049,757,9806,87
2022-06-20,Butte,007,227075,35592,35203,7836,43039,433
2022-06-20,Calaveras,009,45235,7754,7716,413,8129,122
2022-06-20,Colusa,011,21464,3543,3529,1113,4642,21
2022-06-20,Contra Costa,013,1133247,221810,216355,16886,233241,1328
2022-06-20,Del Norte,015,27424,6440,6367,282,6649,52
2022-06-20,El Dorado,017,186661,29331,29139,3651,32790,215
2022-06-20,Fresno,019,978130,247774,244129,26362,270491,2772
2022-06-20,Glenn,021,27897,5202,5161,1699,6860,48
2022-06-20,Humboldt,023,135768,19240,19111,3908,23019,148
2022-06-20,Imperial,025,180216,58159,57866,11356,69222,944
2022-06-20,Inyo,027,18085,4232,4222,624,4846,56
2022-06-20,Kern,029,883053,200750,199721,49837,249558,2341
2022-06-20,Kings,031,150075,53688,53568,3643,57211,448
2022-06-20,Lake,033,64148,11477,11426,995,12421,140
2022-06-20,Lassen,035,31185,9275,9259,920,10179,64
2022-06-20,Los Angeles,037,10098052,2942224,2925667,142045,3067712,32015
2022-06-20,Madera,039,155013,39276,39139,6684,45823,372
2022-06-20,Marin,041,260295,40051,39687,4494,44181,297
2022-06-20,Mariposa,043,17540,2725,2695,263,2958,30
2022-06-20,Mendocino,045,87422,14307,14201,3694,17895,127
2022-06-20,Merced,047,269075,65861,65120,9710,74830,827
2022-06-20,Modoc,049,8938,775,773,265,1038,8
2022-06-20,Mono,051,14174,3077,3073,177,3250,7
2022-06-20,Monterey,053,433212,85292,84752,16711,101463,742
2022-06-20,Napa,055,140530,29037,28894,1245,30139,144
2022-06-20,Nevada,057,99092,17367,17280,1437,18717,129
2022-06-20,Orange,059,3164182,595324,592215,49115,641330,7084
2022-06-20,Placer,061,380077,68909,68447,8403,76850,628
2022-06-20,Plumas,063,18699,3250,3220,394,3614,13
2022-06-20,Riverside,065,2383286,626029,623584,30193,653777,6491
2022-06-20,Sacramento,067,1510023,310860,309105,30339,339444,3071
2022-06-20,San Benito,069,59416,14250,14128,696,14824,99
2022-06-20,San Bernardino,071,2135413,604529,595517,26521,622038,7774
2022-06-20,San Diego,073,3302833,822163,815124,60535,875659,5318
2022-06-20,San Francisco,075,870044,155587,154213,10232,164445,897
2022-06-20,San Joaquin,077,732212,178867,177637,11714,189351,2251
2022-06-20,San Luis Obispo,079,281455,57474,57177,5308,62485,485
2022-06-20,San Mateo,081,765935,147237,145781,9184,154965,723
2022-06-20,Santa Barbara,083,443738,94038,93576,5459,99035,700
2022-06-20,Santa Clara,085,1922200,377802,370678,16032,386710,2340
2022-06-20,Santa Cruz,087,273765,54999,54525,2695,57220,265
2022-06-20,Shasta,089,179085,31960,31786,6394,38180,570
2022-06-20,Sierra,091,2930,284,283,56,339,4
2022-06-20,Siskiyou,093,43540,4723,4711,2953,7664,81
2022-06-20,Solano,095,438530,92912,91528,6546,98074,454
2022-06-20,Sonoma,097,501317,96044,95363,4200,99563,493
2022-06-20,Stanislaus,099,539301,124647,124023,19099,143122,1670
2022-06-20,Sutter,101,95872,21677,21649,2294,23943,227
2022-06-20,Tehama,103,63373,12541,12465,2710,15175,205
2022-06-20,Trinity,105,12862,1235,1223,297,1520,20
2022-06-20,Tulare,107,460477,110973,110768,29831,140599,1496
2022-06-20,Tuolumne,109,53932,13742,13596,680,14276,189
2022-06-20,Ventura,111,848112,187431,186601,11609,198210,1514
2022-06-20,Yolo,113,214977,42901,41689,3446,45135,323
2022-06-20,Yuba,115,75493,16968,16912,1426,18338,124
2022-06-19,Alameda,001,1643700,301818,296062,16750,312812,1883
2022-06-19,Alpine,003,1148,129,129,1,130,0
2022-06-19,Amador,005,37829,9138,8985,744,9729,87
2022-06-19,Butte,007,227075,35531,34920,7813,42733,432
2022-06-19,Calaveras,009,45235,7736,7664,412,8076,122
2022-06-19,Colusa,011,21464,3539,3519,1109,4628,21
2022-06-19,Contra Costa,013,1133247,221122,213994,16821,230815,1323
2022-06-19,Del Norte,015,27424,6423,6307,279,6586,52
2022-06-19,El Dorado,017,186661,29250,28904,3636,32540,215
2022-06-19,Fresno,019,978130,247325,242214,26292,268506,2768
2022-06-19,Glenn,021,27897,5193,5131,1697,6828,48
2022-06-19,Humboldt,023,135768,19195,18885,3883,22768,148
2022-06-19,Imperial,025,180216,58036,57450,11323,68773,944
2022-06-19,Inyo,027,18085,4231,4209,623,4832,56
2022-06-19,Kern,029,883053,200385,198567,49665,248232,2340
2022-06-19,Kings,031,150075,53594,53242,3640,56882,448
2022-06-19,Lake,033,64148,11463,11318,994,12312,140
2022-06-19,Lassen,035,31185,9262,9225,920,10145,64
2022-06-19,Los Angeles,037,10098052,2937360,2909197,141486,3050683,31999
2022-06-19,Madera,039,155013,39184,38859,6663,45522,372
2022-06-19,Marin,041,260295,39923,39214,4484,43698,294
2022-06-19,Mariposa,043,17540,2718,2662,262,2924,30
2022-06-19,Mendocino,045,87422,14280,14090,3681,17771,127
2022-06-19,Merced,047,269075,65760,64734,9680,74414,827
2022-06-19,Modoc,049,8938,772,771,264,1035,8
2022-06-19,Mono,051,14174,3075,3066,176,3242,6
2022-06-19,Monterey,053,433212,85144,84032,16665,100697,744
2022-06-19,Napa,055,140530,28976,28619,1241,29860,144
2022-06-19,Nevada,057,99092,17337,17134,1429,18563,129
2022-06-19,Orange,059,3164182,594069,587176,48922,636098,7074
2022-06-19,Placer,061,380077,68791,67961,8382,76343,628
2022-06-19,Plumas,063,18699,3242,3201,394,3595,13
2022-06-19,Riverside,065,2383286,625156,619760,30144,649904,6488
2022-06-19,Sacramento,067,1510023,310129,306215,30285,336500,3072
2022-06-19,San Benito,069,59416,14231,13985,694,14679,99
2022-06-19,San Bernardino,071,2135413,603705,591926,26484,618410,7765
2022-06-19,San Diego,073,3302833,820633,815124,60412,875536,5318
2022-06-19,San Francisco,075,870044,155070,151898,10193,162091,897
2022-06-19,San Joaquin,077,732212,178545,176323,11676,187999,2251
2022-06-19,San Luis Obispo,079,281455,57336,56767,5251,62018,485
2022-06-19,San Mateo,081,765935,146782,143879,9151,153030,723
2022-06-19,Santa Barbara,083,443738,93868,92906,5443,98349,699
2022-06-19,Santa Clara,085,1922200,376626,365638,15969,381607,2328
2022-06-19,Santa Cruz,087,273765,54836,53866,2676,56542,264
2022-06-19,Shasta,089,179085,31901,31647,6383,38030,568
2022-06-19,Sierra,091,2930,284,281,56,337,4
2022-06-19,Siskiyou,093,43540,4711,4672,2947,7619,81
2022-06-19,Solano,095,438530,92655,90548,6533,97081,454
2022-06-19,Sonoma,097,501317,95801,94318,4179,98497,493
2022-06-19,Stanislaus,099,539301,124461,123264,19050,142314,1668
2022-06-19,Sutter,101,95872,21642,21501,2286,23787,227
2022-06-19,Tehama,103,63373,12532,12410,2704,15114,205
2022-06-19,Trinity,105,12862,1232,1220,297,1517,20
2022-06-19,Tulare,107,460477,110788,110041,29778,139819,1496
2022-06-19,Tuolumne,109,53932,13715,13487,680,14167,189
2022-06-19,Ventura,111,848112,187079,185219,11564,196783,1513
2022-06-19,Yolo,113,214977,42813,41135,3433,44568,323
2022-06-19,Yuba,115,75493,16936,16786,1423,18209,124
2022-06-18,Alameda,001,1643700,301350,296062,16729,312791,1883
2022-06-18,Alpine,003,1148,129,129,1,130,0
2022-06-18,Amador,005,37829,9131,8985,740,9725,87
2022-06-18,Butte,007,227075,35481,34920,7802,42722,432
2022-06-18,Calaveras,009,45235,7724,7664,412,8076,122
2022-06-18,Colusa,011,21464,3536,3519,1109,4628,21
2022-06-18,Contra Costa,013,1133247,220807,213994,16793,230787,1323
2022-06-18,Del Norte,015,27424,6417,6307,278,6585,52
2022-06-18,El Dorado,017,186661,29221,28904,3633,32537,215
2022-06-18,Fresno,019,978130,247123,242214,26275,268489,2768
2022-06-18,Glenn,021,27897,5190,5131,1696,6827,48
2022-06-18,Humboldt,023,135768,19166,18885,3876,22761,148
2022-06-18,Imperial,025,180216,57966,57450,11310,68760,944
2022-06-18,Inyo,027,18085,4230,4209,622,4831,56
2022-06-18,Kern,029,883053,200262,198567,49579,248146,2340
2022-06-18,Kings,031,150075,53558,53242,3639,56881,448
2022-06-18,Lake,033,64148,11452,11318,992,12310,140
2022-06-18,Lassen,035,31185,9258,9225,920,10145,64
2022-06-18,Los Angeles,037,10098052,2934919,2909197,141196,3050393,31999
2022-06-18,Madera,039,155013,39161,38859,6657,45516,372
2022-06-18,Marin,041,260295,39859,39214,4474,43688,294
2022-06-18,Mariposa,043,17540,2713,2662,262,2924,30
2022-06-18,Mendocino,045,87422,14258,14090,3678,17768,127
2022-06-18,Merced,047,269075,65695,64734,9670,74404,827
2022-06-18,Modoc,049,8938,772,771,264,1035,8
2022-06-18,Mono,051,14174,3074,3066,176,3242,6
2022-06-18,Monterey,053,433212,85053,84032,16637,100669,744
2022-06-18,Napa,055,140530,28951,28619,1240,29859,144
2022-06-18,Nevada,057,99092,17325,17134,1428,18562,129
2022-06-18,Orange,059,3164182,593446,587176,48808,635984,7074
2022-06-18,Placer,061,380077,68726,67961,8368,76329,628
2022-06-18,Plumas,063,18699,3234,3201,394,3595,13
2022-06-18,Riverside,065,2383286,624622,619760,30129,649889,6488
2022-06-18,Sacramento,067,1510023,309809,306215,30261,336476,3072
2022-06-18,San Benito,069,59416,14216,13985,687,14672,99
2022-06-18,San Bernardino,071,2135413,603275,591926,26462,618388,7765
2022-06-18,San Diego,073,3302833,819915,815124,60351,875475,5318
2022-06-18,San Francisco,075,870044,154737,151898,10174,162072,897
2022-06-18,San Joaquin,077,732212,178382,176323,11667,187990,2251
2022-06-18,San Luis Obispo,079,281455,57291,56767,5242,62009,485
2022-06-18,San Mateo,081,765935,146512,143879,9129,153008,723
2022-06-18,Santa Barbara,083,443738,93757,92906,5433,98339,699
2022-06-18,Santa Clara,085,1922200,375873,365638,15923,381561,2328
2022-06-18,Santa Cruz,087,273765,54760,53866,2666,56532,264
2022-06-18,Shasta,089,179085,31880,31647,6380,38027,568
2022-06-18,Sierra,091,2930,284,281,56,337,4
2022-06-18,Siskiyou,093,43540,4703,4672,2943,7615,81
2022-06-18,Solano,095,438530,92572,90548,6524,97072,454
2022-06-18,Sonoma,097,501317,95662,94318,4161,98479,493
2022-06-18,Stanislaus,099,539301,124353,123264,19029,142293,1668
2022-06-18,Sutter,101,95872,21621,21501,2283,23784,227
2022-06-18,Tehama,103,63373,12523,12410,2700,15110,205
2022-06-18,Trinity,105,12862,1231,1220,297,1517,20
2022-06-18,Tulare,107,460477,110705,110041,29738,139779,1496
2022-06-18,Tuolumne,109,53932,13693,13487,677,14164,189
2022-06-18,Ventura,111,848112,186904,185219,11541,196760,1513
2022-06-18,Yolo,113,214977,42744,41135,3428,44563,323
2022-06-18,Yuba,115,75493,16923,16786,1423,18209,124
2022-06-17,Alameda,001,1643700,300875,296062,16715,312777,1883
2022-06-17,Alpine,003,1148,129,129,1,130,0
2022-06-17,Amador,005,37829,9122,8985,740,9725,87
2022-06-17,Butte,007,227075,35450,34920,7792,42712,432
2022-06-17,Calaveras,009,45235,7716,7664,412,8076,122
2022-06-17,Colusa,011,21464,3535,3519,1104,4623,21
2022-06-17,Contra Costa,013,1133247,220508,213994,16768,230762,1323
2022-06-17,Del Norte,015,27424,6403,6307,278,6585,52
2022-06-17,El Dorado,017,186661,29188,28904,3629,32533,215
2022-06-17,Fresno,019,978130,246879,242214,26249,268463,2768
2022-06-17,Glenn,021,27897,5189,5131,1690,6821,48
2022-06-17,Humboldt,023,135768,19139,18885,3872,22757,148
2022-06-17,Imperial,025,180216,57913,57450,11298,68748,944
2022-06-17,Inyo,027,18085,4226,4209,616,4825,56
2022-06-17,Kern,029,883053,200108,198567,49537,248104,2340
2022-06-17,Kings,031,150075,53531,53242,3638,56880,448
2022-06-17,Lake,033,64148,11444,11318,991,12309,140
2022-06-17,Lassen,035,31185,9257,9225,919,10144,64
2022-06-17,Los Angeles,037,10098052,2932077,2909197,140898,3050095,31999
2022-06-17,Madera,039,155013,39136,38859,6651,45510,372
2022-06-17,Marin,041,260295,39764,39214,4461,43675,294
2022-06-17,Mariposa,043,17540,2709,2662,262,2924,30
2022-06-17,Mendocino,045,87422,14241,14090,3674,17764,127
2022-06-17,Merced,047,269075,65638,64734,9665,74399,827
2022-06-17,Modoc,049,8938,772,771,264,1035,8
2022-06-17,Mono,051,14174,3074,3066,176,3242,6
2022-06-17,Monterey,053,433212,84963,84032,16607,100639,744
2022-06-17,Napa,055,140530,28912,28619,1237,29856,144
2022-06-17,Nevada,057,99092,17307,17134,1423,18557,129
2022-06-17,Orange,059,3164182,592769,587176,48672,635848,7074
2022-06-17,Placer,061,380077,68666,67961,8356,76317,628
2022-06-17,Plumas,063,18699,3233,3201,393,3594,13
2022-06-17,Riverside,065,2383286,624071,619760,30093,649853,6488
2022-06-17,Sacramento,067,1510023,309420,306215,30241,336456,3072
2022-06-17,San Benito,069,59416,14204,13985,687,14672,99
2022-06-17,San Bernardino,071,2135413,602837,591926,26431,618357,7765
2022-06-17,San Diego,073,3302833,818953,815124,60247,875371,5318
2022-06-17,San Francisco,075,870044,154423,151898,10141,162039,897
2022-06-17,San Joaquin,077,732212,178230,176323,11656,187979,2251
2022-06-17,San Luis Obispo,079,281455,57254,56767,5236,62003,485
2022-06-17,San Mateo,081,765935,146208,143879,9110,152989,723
2022-06-17,Santa Barbara,083,443738,93651,92906,5421,98327,699
2022-06-17,Santa Clara,085,1922200,375047,365638,15891,381529,2328
2022-06-17,Santa Cruz,087,273765,54694,53866,2661,56527,264
2022-06-17,Shasta,089,179085,31853,31647,6372,38019,568
2022-06-17,Sierra,091,2930,284,281,56,337,4
2022-06-17,Siskiyou,093,43540,4696,4672,2943,7615,81
2022-06-17,Solano,095,438530,92428,90548,6512,97060,454
2022-06-17,Sonoma,097,501317,95497,94318,4144,98462,493
2022-06-17,Stanislaus,099,539301,124256,123264,19019,142283,1668
2022-06-17,Sutter,101,95872,21599,21501,2277,23778,227
2022-06-17,Tehama,103,63373,12508,12410,2697,15107,205
2022-06-17,Trinity,105,12862,1231,1220,297,1517,20
2022-06-17,Tulare,107,460477,110617,110041,29707,139748,1496
2022-06-17,Tuolumne,109,53932,13680,13487,676,14163,189
2022-06-17,Ventura,111,848112,186724,185219,11520,196739,1513
2022-06-17,Yolo,113,214977,42661,41135,3415,44550,323
2022-06-17,Yuba,115,75493,16916,16786,1420,18206,124
2022-06-16,Alameda,001,1643700,300093,296062,16666,312728,1883
2022-06-16,Alpine,003,1148,129,129,1,130,0
2022-06-16,Amador,005,37829,9115,8985,735,9720,87
2022-06-16,Butte,007,227075,35375,34920,7776,42696,432
2022-06-16,Calaveras,009,45235,7704,7664,410,8074,122
2022-06-16,Colusa,011,21464,3533,3519,1103,4622,21
2022-06-16,Contra Costa,013,1133247,220044,213994,16717,230711,1323
2022-06-16,Del Norte,015,27424,6389,6307,277,6584,52
2022-06-16,El Dorado,017,186661,29136,28904,3617,32521,215
2022-06-16,Fresno,019,978130,246505,242214,26187,268401,2768
2022-06-16,Glenn,021,27897,5180,5131,1689,6820,48
2022-06-16,Humboldt,023,135768,19109,18885,3858,22743,148
2022-06-16,Imperial,025,180216,57814,57450,11269,68719,944
2022-06-16,Inyo,027,18085,4225,4209,613,4822,56
2022-06-16,Kern,029,883053,199897,198567,49421,247988,2340
2022-06-16,Kings,031,150075,53464,53242,3635,56877,448
2022-06-16,Lake,033,64148,11428,11318,991,12309,140
2022-06-16,Lassen,035,31185,9250,9225,919,10144,64
2022-06-16,Los Angeles,037,10098052,2928090,2909197,140538,3049735,31999
2022-06-16,Madera,039,155013,39105,38859,6641,45500,372
2022-06-16,Marin,041,260295,39665,39214,4448,43662,294
2022-06-16,Mariposa,043,17540,2701,2662,260,2922,30
2022-06-16,Mendocino,045,87422,14212,14090,3664,17754,127
2022-06-16,Merced,047,269075,65559,64734,9646,74380,827
2022-06-16,Modoc,049,8938,772,771,264,1035,8
2022-06-16,Mono,051,14174,3073,3066,175,3241,6
2022-06-16,Monterey,053,433212,84814,84032,16552,100584,744
2022-06-16,Napa,055,140530,28868,28619,1234,29853,144
2022-06-16,Nevada,057,99092,17284,17134,1418,18552,129
2022-06-16,Orange,059,3164182,591746,587176,48534,635710,7074
2022-06-16,Placer,061,380077,68581,67961,8333,76294,628
2022-06-16,Plumas,063,18699,3226,3201,392,3593,13
2022-06-16,Riverside,065,2383286,623325,619760,30049,649809,6488
2022-06-16,Sacramento,067,1510023,308838,306215,30207,336422,3072
2022-06-16,San Benito,069,59416,14180,13985,684,14669,99
2022-06-16,San Bernardino,071,2135413,602180,591926,26393,618319,7765
2022-06-16,San Diego,073,3302833,817433,815124,60087,875211,5318
2022-06-16,San Francisco,075,870044,153976,151898,10101,161999,897
2022-06-16,San Joaquin,077,732212,177976,176323,11636,187959,2251
2022-06-16,San Luis Obispo,079,281455,57176,56767,5216,61983,485
2022-06-16,San Mateo,081,765935,145841,143879,9094,152973,723
2022-06-16,Santa Barbara,083,443738,93502,92906,5407,98313,699
2022-06-16,Santa Clara,085,1922200,374102,365638,15843,381481,2328
2022-06-16,Santa Cruz,087,273765,54561,53866,2649,56515,264
2022-06-16,Shasta,089,179085,31823,31647,6361,38008,568
2022-06-16,Sierra,091,2930,283,281,56,337,4
2022-06-16,Siskiyou,093,43540,4687,4672,2934,7606,81
2022-06-16,Solano,095,438530,92233,90548,6500,97048,454
2022-06-16,Sonoma,097,501317,95310,94318,4127,98445,493
2022-06-16,Stanislaus,099,539301,124095,123264,19002,142266,1668
2022-06-16,Sutter,101,95872,21574,21501,2275,23776,227
2022-06-16,Tehama,103,63373,12489,12410,2695,15105,205
2022-06-16,Trinity,105,12862,1229,1220,294,1514,20
2022-06-16,Tulare,107,460477,110486,110041,29666,139707,1496
2022-06-16,Tuolumne,109,53932,13656,13487,672,14159,189
2022-06-16,Ventura,111,848112,186453,185219,11475,196694,1513
2022-06-16,Yolo,113,214977,42571,41135,3404,44539,323
2022-06-16,Yuba,115,75493,16892,16786,1416,18202,124
2022-06-15,Alameda,001,1643700,299308,295002,16640,311642,1880
2022-06-15,Alpine,003,1148,129,129,1,130,0
2022-06-15,Amador,005,37829,9107,8972,735,9707,87
2022-06-15,Butte,007,227075,35312,34841,7757,42598,430
2022-06-15,Calaveras,009,45235,7701,7648,408,8056,122
2022-06-15,Colusa,011,21464,3529,3515,1101,4616,21
2022-06-15,Contra Costa,013,1133247,219581,213219,16673,229892,1321
2022-06-15,Del Norte,015,27424,6378,6298,276,6574,52
2022-06-15,El Dorado,017,186661,29082,28829,3605,32434,215
2022-06-15,Fresno,019,978130,246133,241768,26141,267909,2767
2022-06-15,Glenn,021,27897,5174,5128,1681,6809,48
2022-06-15,Humboldt,023,135768,19071,18836,3833,22669,148
2022-06-15,Imperial,025,180216,57731,57373,11246,68619,941
2022-06-15,Inyo,027,18085,4223,4205,612,4817,56
2022-06-15,Kern,029,883053,199632,198216,49314,247530,2338
2022-06-15,Kings,031,150075,53410,53170,3632,56802,448
2022-06-15,Lake,033,64148,11408,11303,986,12289,140
2022-06-15,Lassen,035,31185,9246,9209,918,10127,64
2022-06-15,Los Angeles,037,10098052,2923804,2897298,140176,3037474,31971
2022-06-15,Madera,039,155013,39061,38776,6624,45400,372
2022-06-15,Marin,041,260295,39575,39027,4442,43469,294
2022-06-15,Mariposa,043,17540,2697,2651,258,2909,30
2022-06-15,Mendocino,045,87422,14180,14052,3654,17706,127
2022-06-15,Merced,047,269075,65478,64595,9634,74229,825
2022-06-15,Modoc,049,8938,771,772,264,1036,8
2022-06-15,Mono,051,14174,3073,3060,174,3234,6
2022-06-15,Monterey,053,433212,84673,83837,16512,100349,741
2022-06-15,Napa,055,140530,28808,28518,1225,29743,144
2022-06-15,Nevada,057,99092,17259,17107,1414,18521,127
2022-06-15,Orange,059,3164182,590719,585496,48363,633859,7067
2022-06-15,Placer,061,380077,68458,67805,8317,76122,628
2022-06-15,Plumas,063,18699,3221,3185,390,3575,13
2022-06-15,Riverside,065,2383286,622600,618584,29997,648581,6482
2022-06-15,Sacramento,067,1510023,308242,305361,30161,335522,3059
2022-06-15,San Benito,069,59416,14140,13953,677,14630,99
2022-06-15,San Bernardino,071,2135413,601526,590328,26353,616681,7735
2022-06-15,San Diego,073,3302833,815884,811093,59919,871012,5316
2022-06-15,San Francisco,075,870044,153548,151170,10076,161246,890
2022-06-15,San Joaquin,077,732212,177732,175966,11602,187568,2244
2022-06-15,San Luis Obispo,079,281455,57090,56535,5179,61714,486
2022-06-15,San Mateo,081,765935,145442,143277,9078,152355,722
2022-06-15,Santa Barbara,083,443738,93369,92710,5400,98110,698
2022-06-15,Santa Clara,085,1922200,373092,364014,15807,379821,2323
2022-06-15,Santa Cruz,087,273765,54446,53718,2644,56362,265
2022-06-15,Shasta,089,179085,31783,31598,6354,37952,568
2022-06-15,Sierra,091,2930,281,280,56,336,4
2022-06-15,Siskiyou,093,43540,4676,4656,2924,7580,81
2022-06-15,Solano,095,438530,92004,90265,6488,96753,453
2022-06-15,Sonoma,097,501317,95117,94041,4115,98156,492
2022-06-15,Stanislaus,099,539301,123952,122944,18977,141921,1668
2022-06-15,Sutter,101,95872,21547,21448,2270,23718,227
2022-06-15,Tehama,103,63373,12481,12392,2689,15081,205
2022-06-15,Trinity,105,12862,1228,1217,292,1509,20
2022-06-15,Tulare,107,460477,110382,109930,29629,139559,1495
2022-06-15,Tuolumne,109,53932,13645,13459,672,14131,189
2022-06-15,Ventura,111,848112,186181,184750,11426,196176,1509
2022-06-15,Yolo,113,214977,42467,40756,3389,44145,322
2022-06-15,Yuba,115,75493,16867,16754,1411,18165,124
2022-06-14,Alameda,001,1643700,298607,295002,16596,311598,1880
2022-06-14,Alpine,003,1148,129,129,1,130,0
2022-06-14,Amador,005,37829,9091,8972,730,9702,87
2022-06-14,Butte,007,227075,35257,34841,7741,42582,430
2022-06-14,Calaveras,009,45235,7690,7648,407,8055,122
2022-06-14,Colusa,011,21464,3527,3515,1100,4615,21
2022-06-14,Contra Costa,013,1133247,219045,213219,16614,229833,1321
2022-06-14,Del Norte,015,27424,6370,6298,273,6571,52
2022-06-14,El Dorado,017,186661,29030,28829,3597,32426,215
2022-06-14,Fresno,019,978130,245734,241768,26079,267847,2767
2022-06-14,Glenn,021,27897,5165,5128,1678,6806,48
2022-06-14,Humboldt,023,135768,19021,18836,3816,22652,148
2022-06-14,Imperial,025,180216,57657,57373,11216,68589,941
2022-06-14,Inyo,027,18085,4218,4205,611,4816,56
2022-06-14,Kern,029,883053,199370,198216,49198,247414,2338
2022-06-14,Kings,031,150075,53340,53170,3630,56800,448
2022-06-14,Lake,033,64148,11382,11303,985,12288,140
2022-06-14,Lassen,035,31185,9240,9209,915,10124,64
2022-06-14,Los Angeles,037,10098052,2919284,2897298,139755,3037053,31971
2022-06-14,Madera,039,155013,39007,38776,6615,45391,372
2022-06-14,Marin,041,260295,39466,39027,4431,43458,294
2022-06-14,Mariposa,043,17540,2686,2651,255,2906,30
2022-06-14,Mendocino,045,87422,14152,14052,3641,17693,127
2022-06-14,Merced,047,269075,65396,64595,9609,74204,825
2022-06-14,Modoc,049,8938,771,772,263,1035,8
2022-06-14,Mono,051,14174,3073,3060,173,3233,6
2022-06-14,Monterey,053,433212,84534,83837,16466,100303,741
2022-06-14,Napa,055,140530,28744,28518,1224,29742,144
2022-06-14,Nevada,057,99092,17228,17107,1409,18516,127
2022-06-14,Orange,059,3164182,589592,585496,48196,633692,7067
2022-06-14,Placer,061,380077,68335,67805,8302,76107,628
2022-06-14,Plumas,063,18699,3217,3185,390,3575,13
2022-06-14,Riverside,065,2383286,621818,618584,29962,648546,6482
2022-06-14,Sacramento,067,1510023,307610,305361,30078,335439,3059
2022-06-14,San Benito,069,59416,14105,13953,675,14628,99
2022-06-14,San Bernardino,071,2135413,600809,590328,26309,616637,7735
2022-06-14,San Diego,073,3302833,814175,811093,59770,870863,5316
2022-06-14,San Francisco,075,870044,153066,151170,10048,161218,890
2022-06-14,San Joaquin,077,732212,177463,175966,11566,187532,2244
2022-06-14,San Luis Obispo,079,281455,56981,56535,5131,61666,486
2022-06-14,San Mateo,081,765935,145056,143277,9064,152341,722
2022-06-14,Santa Barbara,083,443738,93233,92710,5384,98094,698
2022-06-14,Santa Clara,085,1922200,372025,364014,15763,379777,2323
2022-06-14,Santa Cruz,087,273765,54319,53718,2633,56351,265
2022-06-14,Shasta,089,179085,31753,31598,6346,37944,568
2022-06-14,Sierra,091,2930,281,280,56,336,4
2022-06-14,Siskiyou,093,43540,4666,4656,2918,7574,81
2022-06-14,Solano,095,438530,91744,90265,6466,96731,453
2022-06-14,Sonoma,097,501317,94901,94041,4101,98142,492
2022-06-14,Stanislaus,099,539301,123775,122944,18948,141892,1668
2022-06-14,Sutter,101,95872,21509,21448,2266,23714,227
2022-06-14,Tehama,103,63373,12463,12392,2688,15080,205
2022-06-14,Trinity,105,12862,1227,1217,292,1509,20
2022-06-14,Tulare,107,460477,110240,109930,29585,139515,1495
2022-06-14,Tuolumne,109,53932,13624,13459,668,14127,189
2022-06-14,Ventura,111,848112,185888,184750,11388,196138,1509
2022-06-14,Yolo,113,214977,42360,40756,3378,44134,322
2022-06-14,Yuba,115,75493,16837,16754,1408,18162,124
2022-06-13,Alameda,001,1643700,297780,295002,16544,311546,1880
2022-06-13,Alpine,003,1148,129,129,1,130,0
2022-06-13,Amador,005,37829,9084,8972,728,9700,87
2022-06-13,Butte,007,227075,35179,34841,7716,42557,430
2022-06-13,Calaveras,009,45235,7672,7648,407,8055,122
2022-06-13,Colusa,011,21464,3527,3515,1097,4612,21
2022-06-13,Contra Costa,013,1133247,218470,213219,16547,229766,1321
2022-06-13,Del Norte,015,27424,6358,6298,269,6567,52
2022-06-13,El Dorado,017,186661,28980,28829,3585,32414,215
2022-06-13,Fresno,019,978130,245307,241768,26024,267792,2767
2022-06-13,Glenn,021,27897,5161,5128,1674,6802,48
2022-06-13,Humboldt,023,135768,18968,18836,3792,22628,148
2022-06-13,Imperial,025,180216,57557,57373,11172,68545,941
2022-06-13,Inyo,027,18085,4214,4205,606,4811,56
2022-06-13,Kern,029,883053,199102,198216,49062,247278,2338
2022-06-13,Kings,031,150075,53275,53170,3626,56796,448
2022-06-13,Lake,033,64148,11357,11303,984,12287,140
2022-06-13,Lassen,035,31185,9232,9209,912,10121,64
2022-06-13,Los Angeles,037,10098052,2914716,2897298,139365,3036663,31971
2022-06-13,Madera,039,155013,38940,38776,6597,45373,372
2022-06-13,Marin,041,260295,39359,39027,4403,43430,294
2022-06-13,Mariposa,043,17540,2672,2651,254,2905,30
2022-06-13,Mendocino,045,87422,14128,14052,3625,17677,127
2022-06-13,Merced,047,269075,65320,64595,9581,74176,825
2022-06-13,Modoc,049,8938,770,772,263,1035,8
2022-06-13,Mono,051,14174,3071,3060,173,3233,6
2022-06-13,Monterey,053,433212,84399,83837,16415,100252,741
2022-06-13,Napa,055,140530,28673,28518,1220,29738,144
2022-06-13,Nevada,057,99092,17197,17107,1406,18513,127
2022-06-13,Orange,059,3164182,588357,585496,48013,633509,7067
2022-06-13,Placer,061,380077,68238,67805,8280,76085,628
2022-06-13,Plumas,063,18699,3212,3185,389,3574,13
2022-06-13,Riverside,065,2383286,621074,618584,29927,648511,6482
2022-06-13,Sacramento,067,1510023,306931,305361,30009,335370,3059
2022-06-13,San Benito,069,59416,14078,13953,669,14622,99
2022-06-13,San Bernardino,071,2135413,600013,590328,26278,616606,7735
2022-06-13,San Diego,073,3302833,812471,811093,59662,870755,5316
2022-06-13,San Francisco,075,870044,152531,151170,10030,161200,890
2022-06-13,San Joaquin,077,732212,177199,175966,11529,187495,2244
2022-06-13,San Luis Obispo,079,281455,56878,56535,5079,61614,486
2022-06-13,San Mateo,081,765935,144616,143277,9042,152319,722
2022-06-13,Santa Barbara,083,443738,93104,92710,5371,98081,698
2022-06-13,Santa Clara,085,1922200,371000,364014,15712,379726,2323
2022-06-13,Santa Cruz,087,273765,54181,53718,2626,56344,265
2022-06-13,Shasta,089,179085,31720,31598,6339,37937,568
2022-06-13,Sierra,091,2930,281,280,56,336,4
2022-06-13,Siskiyou,093,43540,4662,4656,2910,7566,81
2022-06-13,Solano,095,438530,91503,90265,6442,96707,453
2022-06-13,Sonoma,097,501317,94644,94041,4082,98123,492
2022-06-13,Stanislaus,099,539301,123607,122944,18923,141867,1668
2022-06-13,Sutter,101,95872,21481,21448,2262,23710,227
2022-06-13,Tehama,103,63373,12444,12392,2685,15077,205
2022-06-13,Trinity,105,12862,1225,1217,292,1509,20
2022-06-13,Tulare,107,460477,110088,109930,29538,139468,1495
2022-06-13,Tuolumne,109,53932,13601,13459,665,14124,189
2022-06-13,Ventura,111,848112,185596,184750,11336,196086,1509
2022-06-13,Yolo,113,214977,42223,40756,3366,44122,322
2022-06-13,Yuba,115,75493,16819,16754,1404,18158,124
2022-06-12,Alameda,001,1643700,296962,292112,16485,308597,1877
2022-06-12,Alpine,003,1148,129,129,1,130,0
2022-06-12,Amador,005,37829,9061,8869,727,9596,87
2022-06-12,Butte,007,227075,35122,34596,7695,42291,427
2022-06-12,Calaveras,009,45235,7658,7604,404,8008,122
2022-06-12,Colusa,011,21464,3526,3505,1096,4601,21
2022-06-12,Contra Costa,013,1133247,217881,211229,16476,227705,1315
2022-06-12,Del Norte,015,27424,6344,6253,269,6522,52
2022-06-12,El Dorado,017,186661,28919,28641,3568,32209,215
2022-06-12,Fresno,019,978130,244843,240345,25970,266315,2766
2022-06-12,Glenn,021,27897,5158,5104,1672,6776,48
2022-06-12,Humboldt,023,135768,18903,18696,3756,22452,148
2022-06-12,Imperial,025,180216,57480,57129,11128,68257,941
2022-06-12,Inyo,027,18085,4212,4194,605,4799,56
2022-06-12,Kern,029,883053,198820,197353,48941,246294,2338
2022-06-12,Kings,031,150075,53197,52978,3621,56599,447
2022-06-12,Lake,033,64148,11333,11202,983,12185,139
2022-06-12,Lassen,035,31185,9214,9172,910,10082,64
2022-06-12,Los Angeles,037,10098052,2909770,2878981,138883,3017864,31947
2022-06-12,Madera,039,155013,38847,38567,6571,45138,372
2022-06-12,Marin,041,260295,39250,38593,4379,42972,294
2022-06-12,Mariposa,043,17540,2666,2625,253,2878,30
2022-06-12,Mendocino,045,87422,14105,13945,3619,17564,127
2022-06-12,Merced,047,269075,65205,64286,9552,73838,825
2022-06-12,Modoc,049,8938,770,767,263,1030,8
2022-06-12,Mono,051,14174,3067,3052,172,3224,6
2022-06-12,Monterey,053,433212,84241,83391,16337,99728,739
2022-06-12,Napa,055,140530,28611,28202,1211,29413,143
2022-06-12,Nevada,057,99092,17153,16989,1400,18389,127
2022-06-12,Orange,059,3164182,587083,581624,47821,629445,7057
2022-06-12,Placer,061,380077,68124,67306,8257,75563,628
2022-06-12,Plumas,063,18699,3206,3172,388,3560,13
2022-06-12,Riverside,065,2383286,620130,615556,29859,645415,6481
2022-06-12,Sacramento,067,1510023,306186,302721,29904,332625,3058
2022-06-12,San Benito,069,59416,14044,13832,663,14495,99
2022-06-12,San Bernardino,071,2135413,599090,587385,26228,613613,7708
2022-06-12,San Diego,073,3302833,810735,805360,59526,864886,5315
2022-06-12,San Francisco,075,870044,151977,149278,9985,159263,890
2022-06-12,San Joaquin,077,732212,176843,174822,11503,186325,2244
2022-06-12,San Luis Obispo,079,281455,56741,56160,5018,61178,485
2022-06-12,San Mateo,081,765935,144150,141719,9001,150720,715
2022-06-12,Santa Barbara,083,443738,92931,92177,5356,97533,694
2022-06-12,Santa Clara,085,1922200,369818,359925,15666,375591,2322
2022-06-12,Santa Cruz,087,273765,54021,53171,2621,55792,264
2022-06-12,Shasta,089,179085,31673,31483,6325,37808,566
2022-06-12,Sierra,091,2930,281,278,56,334,4
2022-06-12,Siskiyou,093,43540,4654,4633,2905,7538,81
2022-06-12,Solano,095,438530,91211,89424,6423,95847,453
2022-06-12,Sonoma,097,501317,94388,93218,4058,97276,492
2022-06-12,Stanislaus,099,539301,123407,122267,18882,141149,1665
2022-06-12,Sutter,101,95872,21441,21333,2247,23580,227
2022-06-12,Tehama,103,63373,12425,12343,2680,15023,205
2022-06-12,Trinity,105,12862,1222,1213,292,1505,20
2022-06-12,Tulare,107,460477,109889,109467,29475,138942,1495
2022-06-12,Tuolumne,109,53932,13573,13382,663,14045,189
2022-06-12,Ventura,111,848112,185242,183680,11289,194969,1508
2022-06-12,Yolo,113,214977,42102,40202,3361,43563,323
2022-06-12,Yuba,115,75493,16791,16653,1396,18049,123
2022-06-11,Alameda,001,1643700,296546,292112,16464,308576,1877
2022-06-11,Alpine,003,1148,129,129,1,130,0
2022-06-11,Amador,005,37829,9047,8869,727,9596,87
2022-06-11,Butte,007,227075,35087,34596,7679,42275,427
2022-06-11,Calaveras,009,45235,7651,7604,403,8007,122
2022-06-11,Colusa,011,21464,3524,3505,1095,4600,21
2022-06-11,Contra Costa,013,1133247,217569,211229,16441,227670,1315
2022-06-11,Del Norte,015,27424,6336,6253,269,6522,52
2022-06-11,El Dorado,017,186661,28900,28641,3566,32207,215
2022-06-11,Fresno,019,978130,244647,240345,25950,266295,2766
2022-06-11,Glenn,021,27897,5156,5104,1672,6776,48
2022-06-11,Humboldt,023,135768,18883,18696,3748,22444,148
2022-06-11,Imperial,025,180216,57424,57129,11114,68243,941
2022-06-11,Inyo,027,18085,4212,4194,603,4797,56
2022-06-11,Kern,029,883053,198698,197353,48868,246221,2338
2022-06-11,Kings,031,150075,53165,52978,3620,56598,447
2022-06-11,Lake,033,64148,11325,11202,980,12182,139
2022-06-11,Lassen,035,31185,9209,9172,909,10081,64
2022-06-11,Los Angeles,037,10098052,2907423,2878981,138592,3017573,31947
2022-06-11,Madera,039,155013,38826,38567,6569,45136,372
2022-06-11,Marin,041,260295,39173,38593,4345,42938,294
2022-06-11,Mariposa,043,17540,2662,2625,252,2877,30
2022-06-11,Mendocino,045,87422,14094,13945,3615,17560,127
2022-06-11,Merced,047,269075,65156,64286,9548,73834,825
2022-06-11,Modoc,049,8938,770,767,263,1030,8
2022-06-11,Mono,051,14174,3067,3052,172,3224,6
2022-06-11,Monterey,053,433212,84158,83391,16305,99696,739
2022-06-11,Napa,055,140530,28572,28202,1207,29409,143
2022-06-11,Nevada,057,99092,17139,16989,1398,18387,127
2022-06-11,Orange,059,3164182,586443,581624,47683,629307,7057
2022-06-11,Placer,061,380077,68037,67306,8248,75554,628
2022-06-11,Plumas,063,18699,3203,3172,388,3560,13
2022-06-11,Riverside,065,2383286,619604,615556,29830,645386,6481
2022-06-11,Sacramento,067,1510023,305878,302721,29869,332590,3058
2022-06-11,San Benito,069,59416,14034,13832,660,14492,99
2022-06-11,San Bernardino,071,2135413,598668,587385,26205,613590,7708
2022-06-11,San Diego,073,3302833,810034,805360,59480,864840,5315
2022-06-11,San Francisco,075,870044,151656,149278,9965,159243,890
2022-06-11,San Joaquin,077,732212,176689,174822,11484,186306,2244
2022-06-11,San Luis Obispo,079,281455,56707,56160,5008,61168,485
2022-06-11,San Mateo,081,765935,143927,141719,8978,150697,715
2022-06-11,Santa Barbara,083,443738,92865,92177,5342,97519,694
2022-06-11,Santa Clara,085,1922200,369055,359925,15629,375554,2322
2022-06-11,Santa Cruz,087,273765,53966,53171,2607,55778,264
2022-06-11,Shasta,089,179085,31657,31483,6319,37802,566
2022-06-11,Sierra,091,2930,281,278,56,334,4
2022-06-11,Siskiyou,093,43540,4648,4633,2897,7530,81
2022-06-11,Solano,095,438530,91122,89424,6413,95837,453
2022-06-11,Sonoma,097,501317,94280,93218,4033,97251,492
2022-06-11,Stanislaus,099,539301,123305,122267,18859,141126,1665
2022-06-11,Sutter,101,95872,21423,21333,2246,23579,227
2022-06-11,Tehama,103,63373,12418,12343,2680,15023,205
2022-06-11,Trinity,105,12862,1221,1213,292,1505,20
2022-06-11,Tulare,107,460477,109807,109467,29447,138914,1495
2022-06-11,Tuolumne,109,53932,13547,13382,662,14044,189
2022-06-11,Ventura,111,848112,185064,183680,11257,194937,1508
2022-06-11,Yolo,113,214977,42037,40202,3354,43556,323
2022-06-11,Yuba,115,75493,16772,16653,1392,18045,123
2022-06-10,Alameda,001,1643700,296071,292112,16441,308553,1877
2022-06-10,Alpine,003,1148,129,129,1,130,0
2022-06-10,Amador,005,37829,9034,8869,726,9595,87
2022-06-10,Butte,007,227075,35055,34596,7665,42261,427
2022-06-10,Calaveras,009,45235,7646,7604,402,8006,122
2022-06-10,Colusa,011,21464,3519,3505,1094,4599,21
2022-06-10,Contra Costa,013,1133247,217301,211229,16410,227639,1315
2022-06-10,Del Norte,015,27424,6330,6253,268,6521,52
2022-06-10,El Dorado,017,186661,28872,28641,3563,32204,215
2022-06-10,Fresno,019,978130,244418,240345,25927,266272,2766
2022-06-10,Glenn,021,27897,5154,5104,1669,6773,48
2022-06-10,Humboldt,023,135768,18861,18696,3741,22437,148
2022-06-10,Imperial,025,180216,57378,57129,11111,68240,941
2022-06-10,Inyo,027,18085,4211,4194,600,4794,56
2022-06-10,Kern,029,883053,198552,197353,48776,246129,2338
2022-06-10,Kings,031,150075,53144,52978,3619,56597,447
2022-06-10,Lake,033,64148,11310,11202,979,12181,139
2022-06-10,Lassen,035,31185,9206,9172,907,10079,64
2022-06-10,Los Angeles,037,10098052,2904695,2878981,138323,3017304,31947
2022-06-10,Madera,039,155013,38798,38567,6561,45128,372
2022-06-10,Marin,041,260295,39077,38593,4318,42911,294
2022-06-10,Mariposa,043,17540,2658,2625,251,2876,30
2022-06-10,Mendocino,045,87422,14076,13945,3607,17552,127
2022-06-10,Merced,047,269075,65113,64286,9543,73829,825
2022-06-10,Modoc,049,8938,770,767,263,1030,8
2022-06-10,Mono,051,14174,3067,3052,171,3223,6
2022-06-10,Monterey,053,433212,84066,83391,16265,99656,739
2022-06-10,Napa,055,140530,28542,28202,1206,29408,143
2022-06-10,Nevada,057,99092,17126,16989,1397,18386,127
2022-06-10,Orange,059,3164182,585781,581624,47563,629187,7057
2022-06-10,Placer,061,380077,67965,67306,8230,75536,628
2022-06-10,Plumas,063,18699,3199,3172,388,3560,13
2022-06-10,Riverside,065,2383286,619082,615556,29801,645357,6481
2022-06-10,Sacramento,067,1510023,305482,302721,29846,332567,3058
2022-06-10,San Benito,069,59416,14021,13832,659,14491,99
2022-06-10,San Bernardino,071,2135413,598258,587385,26174,613559,7708
2022-06-10,San Diego,073,3302833,809119,805360,59444,864804,5315
2022-06-10,San Francisco,075,870044,151338,149278,9927,159205,890
2022-06-10,San Joaquin,077,732212,176574,174822,11468,186290,2244
2022-06-10,San Luis Obispo,079,281455,56672,56160,5001,61161,485
2022-06-10,San Mateo,081,765935,143671,141719,8965,150684,715
2022-06-10,Santa Barbara,083,443738,92766,92177,5338,97515,694
2022-06-10,Santa Clara,085,1922200,368309,359925,15595,375520,2322
2022-06-10,Santa Cruz,087,273765,53867,53171,2597,55768,264
2022-06-10,Shasta,089,179085,31637,31483,6310,37793,566
2022-06-10,Sierra,091,2930,280,278,56,334,4
2022-06-10,Siskiyou,093,43540,4641,4633,2891,7524,81
2022-06-10,Solano,095,438530,90960,89424,6399,95823,453
2022-06-10,Sonoma,097,501317,94119,93218,4010,97228,492
2022-06-10,Stanislaus,099,539301,123186,122267,18845,141112,1665
2022-06-10,Sutter,101,95872,21408,21333,2244,23577,227
2022-06-10,Tehama,103,63373,12410,12343,2679,15022,205
2022-06-10,Trinity,105,12862,1219,1213,292,1505,20
2022-06-10,Tulare,107,460477,109740,109467,29426,138893,1495
2022-06-10,Tuolumne,109,53932,13533,13382,660,14042,189
2022-06-10,Ventura,111,848112,184878,183680,11223,194903,1508
2022-06-10,Yolo,113,214977,41947,40202,3346,43548,323
2022-06-10,Yuba,115,75493,16751,16653,1389,18042,123
2022-06-09,Alameda,001,1643700,295161,292112,16390,308502,1877
2022-06-09,Alpine,003,1148,129,129,1,130,0
2022-06-09,Amador,005,37829,9023,8869,723,9592,87
2022-06-09,Butte,007,227075,34995,34596,7654,42250,427
2022-06-09,Calaveras,009,45235,7636,7604,402,8006,122
2022-06-09,Colusa,011,21464,3518,3505,1092,4597,21
2022-06-09,Contra Costa,013,1133247,216787,211229,16365,227594,1315
2022-06-09,Del Norte,015,27424,6317,6253,265,6518,52
2022-06-09,El Dorado,017,186661,28815,28641,3553,32194,215
2022-06-09,Fresno,019,978130,244062,240345,25880,266225,2766
2022-06-09,Glenn,021,27897,5148,5104,1667,6771,48
2022-06-09,Humboldt,023,135768,18812,18696,3730,22426,148
2022-06-09,Imperial,025,180216,57320,57129,11094,68223,941
2022-06-09,Inyo,027,18085,4208,4194,595,4789,56
2022-06-09,Kern,029,883053,198350,197353,48678,246031,2338
2022-06-09,Kings,031,150075,53104,52978,3616,56594,447
2022-06-09,Lake,033,64148,11285,11202,977,12179,139
2022-06-09,Lassen,035,31185,9187,9172,905,10077,64
2022-06-09,Los Angeles,037,10098052,2900301,2878981,137941,3016922,31947
2022-06-09,Madera,039,155013,38744,38567,6547,45114,372
2022-06-09,Marin,041,260295,38975,38593,4293,42886,294
2022-06-09,Mariposa,043,17540,2654,2625,250,2875,30
2022-06-09,Mendocino,045,87422,14048,13945,3605,17550,127
2022-06-09,Merced,047,269075,65036,64286,9534,73820,825
2022-06-09,Modoc,049,8938,769,767,263,1030,8
2022-06-09,Mono,051,14174,3061,3052,169,3221,6
2022-06-09,Monterey,053,433212,83944,83391,16196,99587,739
2022-06-09,Napa,055,140530,28482,28202,1204,29406,143
2022-06-09,Nevada,057,99092,17092,16989,1396,18385,127
2022-06-09,Orange,059,3164182,584716,581624,47410,629034,7057
2022-06-09,Placer,061,380077,67844,67306,8217,75523,628
2022-06-09,Plumas,063,18699,3193,3172,388,3560,13
2022-06-09,Riverside,065,2383286,618390,615556,29761,645317,6481
2022-06-09,Sacramento,067,1510023,304900,302721,29758,332479,3058
2022-06-09,San Benito,069,59416,14003,13832,657,14489,99
2022-06-09,San Bernardino,071,2135413,597590,587385,26141,613526,7708
2022-06-09,San Diego,073,3302833,807714,805360,59304,864664,5315
2022-06-09,San Francisco,075,870044,150946,149278,9897,159175,890
2022-06-09,San Joaquin,077,732212,176280,174822,11448,186270,2244
2022-06-09,San Luis Obispo,079,281455,56585,56160,4972,61132,485
2022-06-09,San Mateo,081,765935,143286,141719,8938,150657,715
2022-06-09,Santa Barbara,083,443738,92635,92177,5333,97510,694
2022-06-09,Santa Clara,085,1922200,367342,359925,15528,375453,2322
2022-06-09,Santa Cruz,087,273765,53735,53171,2587,55758,264
2022-06-09,Shasta,089,179085,31605,31483,6300,37783,566
2022-06-09,Sierra,091,2930,280,278,56,334,4
2022-06-09,Siskiyou,093,43540,4634,4633,2877,7510,81
2022-06-09,Solano,095,438530,90714,89424,6384,95808,453
2022-06-09,Sonoma,097,501317,93962,93218,3991,97209,492
2022-06-09,Stanislaus,099,539301,123018,122267,18831,141098,1665
2022-06-09,Sutter,101,95872,21371,21333,2244,23577,227
2022-06-09,Tehama,103,63373,12391,12343,2678,15021,205
2022-06-09,Trinity,105,12862,1218,1213,292,1505,20
2022-06-09,Tulare,107,460477,109619,109467,29390,138857,1495
2022-06-09,Tuolumne,109,53932,13502,13382,657,14039,189
2022-06-09,Ventura,111,848112,184610,183680,11189,194869,1508
2022-06-09,Yolo,113,214977,41835,40202,3331,43533,323
2022-06-09,Yuba,115,75493,16728,16653,1386,18039,123
2022-06-08,Alameda,001,1643700,294396,289661,16339,306000,1873
2022-06-08,Alpine,003,1148,129,128,1,129,0
2022-06-08,Amador,005,37829,9015,8818,721,9539,87
2022-06-08,Butte,007,227075,34928,34380,7636,42016,427
2022-06-08,Calaveras,009,45235,7622,7564,402,7966,122
2022-06-08,Colusa,011,21464,3516,3495,1089,4584,21
2022-06-08,Contra Costa,013,1133247,216274,209384,16301,225685,1310
2022-06-08,Del Norte,015,27424,6295,6229,265,6494,52
2022-06-08,El Dorado,017,186661,28764,28478,3544,32022,215
2022-06-08,Fresno,019,978130,243721,239376,25809,265185,2766
2022-06-08,Glenn,021,27897,5144,5095,1664,6759,48
2022-06-08,Humboldt,023,135768,18782,18598,3704,22302,147
2022-06-08,Imperial,025,180216,57245,56912,11074,67986,941
2022-06-08,Inyo,027,18085,4206,4189,594,4783,56
2022-06-08,Kern,029,883053,198081,196763,48568,245331,2338
2022-06-08,Kings,031,150075,53034,52821,3612,56433,447
2022-06-08,Lake,033,64148,11264,11158,974,12132,137
2022-06-08,Lassen,035,31185,9174,9148,905,10053,64
2022-06-08,Los Angeles,037,10098052,2895688,2865901,137550,3003451,31920
2022-06-08,Madera,039,155013,38699,38408,6534,44942,372
2022-06-08,Marin,041,260295,38883,38338,4276,42614,294
2022-06-08,Mariposa,043,17540,2644,2614,249,2863,30
2022-06-08,Mendocino,045,87422,14028,13859,3593,17452,127
2022-06-08,Merced,047,269075,64970,64080,9512,73592,825
2022-06-08,Modoc,049,8938,765,761,263,1024,8
2022-06-08,Mono,051,14174,3057,3044,169,3213,6
2022-06-08,Monterey,053,433212,83833,83063,16146,99209,740
2022-06-08,Napa,055,140530,28393,27996,1199,29195,143
2022-06-08,Nevada,057,99092,17066,16907,1392,18299,127
2022-06-08,Orange,059,3164182,583611,578530,47218,625748,7044
2022-06-08,Placer,061,380077,67713,66951,8205,75156,627
2022-06-08,Plumas,063,18699,3190,3150,387,3537,13
2022-06-08,Riverside,065,2383286,617704,613469,29726,643195,6480
2022-06-08,Sacramento,067,1510023,304258,300875,29675,330550,3054
2022-06-08,San Benito,069,59416,13969,13734,655,14389,99
2022-06-08,San Bernardino,071,2135413,596896,585029,26097,611126,7685
2022-06-08,San Diego,073,3302833,806219,800840,59128,859968,5308
2022-06-08,San Francisco,075,870044,150523,147960,9871,157831,885
2022-06-08,San Joaquin,077,732212,176002,173887,11418,185305,2241
2022-06-08,San Luis Obispo,079,281455,56429,55822,4909,60731,484
2022-06-08,San Mateo,081,765935,142887,140569,8889,149458,710
2022-06-08,Santa Barbara,083,443738,92496,91747,5322,97069,693
2022-06-08,Santa Clara,085,1922200,366369,356452,15480,371932,2321
2022-06-08,Santa Cruz,087,273765,53595,52753,2576,55329,264
2022-06-08,Shasta,089,179085,31572,31394,6289,37683,565
2022-06-08,Sierra,091,2930,280,278,56,334,4
2022-06-08,Siskiyou,093,43540,4629,4609,2875,7484,81
2022-06-08,Solano,095,438530,90446,88522,6363,94885,453
2022-06-08,Sonoma,097,501317,93777,92644,3957,96601,491
2022-06-08,Stanislaus,099,539301,122835,121787,18796,140583,1662
2022-06-08,Sutter,101,95872,21347,21256,2238,23494,227
2022-06-08,Tehama,103,63373,12384,12306,2677,14983,205
2022-06-08,Trinity,105,12862,1217,1211,291,1502,20
2022-06-08,Tulare,107,460477,109533,109091,29336,138427,1494
2022-06-08,Tuolumne,109,53932,13487,13335,656,13991,189
2022-06-08,Ventura,111,848112,184334,182847,11139,193986,1506
2022-06-08,Yolo,113,214977,41730,39962,3317,43279,321
2022-06-08,Yuba,115,75493,16703,16558,1378,17936,122
2022-06-07,Alameda,001,1643700,293587,289661,16295,305956,1873
2022-06-07,Alpine,003,1148,129,128,1,129,0
2022-06-07,Amador,005,37829,9005,8818,718,9536,87
2022-06-07,Butte,007,227075,34849,34380,7611,41991,427
2022-06-07,Calaveras,009,45235,7614,7564,400,7964,122
2022-06-07,Colusa,011,21464,3516,3495,1086,4581,21
2022-06-07,Contra Costa,013,1133247,215714,209384,16248,225632,1310
2022-06-07,Del Norte,015,27424,6287,6229,262,6491,52
2022-06-07,El Dorado,017,186661,28703,28478,3533,32011,215
2022-06-07,Fresno,019,978130,243336,239376,25743,265119,2766
2022-06-07,Glenn,021,27897,5137,5095,1664,6759,48
2022-06-07,Humboldt,023,135768,18744,18598,3688,22286,147
2022-06-07,Imperial,025,180216,57186,56912,11041,67953,941
2022-06-07,Inyo,027,18085,4205,4189,586,4775,56
2022-06-07,Kern,029,883053,197826,196763,48458,245221,2338
2022-06-07,Kings,031,150075,52976,52821,3608,56429,447
2022-06-07,Lake,033,64148,11239,11158,968,12126,137
2022-06-07,Lassen,035,31185,9165,9148,904,10052,64
2022-06-07,Los Angeles,037,10098052,2890374,2865901,137114,3003015,31920
2022-06-07,Madera,039,155013,38627,38408,6518,44926,372
2022-06-07,Marin,041,260295,38799,38338,4249,42587,294
2022-06-07,Mariposa,043,17540,2637,2614,247,2861,30
2022-06-07,Mendocino,045,87422,13996,13859,3562,17421,127
2022-06-07,Merced,047,269075,64878,64080,9496,73576,825
2022-06-07,Modoc,049,8938,765,761,261,1022,8
2022-06-07,Mono,051,14174,3055,3044,167,3211,6
2022-06-07,Monterey,053,433212,83705,83063,16092,99155,740
2022-06-07,Napa,055,140530,28319,27996,1192,29188,143
2022-06-07,Nevada,057,99092,17039,16907,1386,18293,127
2022-06-07,Orange,059,3164182,582491,578530,47056,625586,7044
2022-06-07,Placer,061,380077,67561,66951,8173,75124,627
2022-06-07,Plumas,063,18699,3185,3150,386,3536,13
2022-06-07,Riverside,065,2383286,616828,613469,29675,643144,6480
2022-06-07,Sacramento,067,1510023,303534,300875,29573,330448,3054
2022-06-07,San Benito,069,59416,13926,13734,651,14385,99
2022-06-07,San Bernardino,071,2135413,596124,585029,26069,611098,7685
2022-06-07,San Diego,073,3302833,804642,800840,58917,859757,5308
2022-06-07,San Francisco,075,870044,150009,147960,9849,157809,885
2022-06-07,San Joaquin,077,732212,175666,173887,11381,185268,2241
2022-06-07,San Luis Obispo,079,281455,56326,55822,4864,60686,484
2022-06-07,San Mateo,081,765935,142468,140569,8834,149403,710
2022-06-07,Santa Barbara,083,443738,92350,91747,5309,97056,693
2022-06-07,Santa Clara,085,1922200,365226,356452,15400,371852,2321
2022-06-07,Santa Cruz,087,273765,53494,52753,2569,55322,264
2022-06-07,Shasta,089,179085,31535,31394,6282,37676,565
2022-06-07,Sierra,091,2930,279,278,56,334,4
2022-06-07,Siskiyou,093,43540,4622,4609,2871,7480,81
2022-06-07,Solano,095,438530,90120,88522,6345,94867,453
2022-06-07,Sonoma,097,501317,93548,92644,3925,96569,491
2022-06-07,Stanislaus,099,539301,122662,121787,18776,140563,1662
2022-06-07,Sutter,101,95872,21318,21256,2236,23492,227
2022-06-07,Tehama,103,63373,12368,12306,2673,14979,205
2022-06-07,Trinity,105,12862,1216,1211,291,1502,20
2022-06-07,Tulare,107,460477,109407,109091,29286,138377,1494
2022-06-07,Tuolumne,109,53932,13472,13335,654,13989,189
2022-06-07,Ventura,111,848112,183969,182847,11095,193942,1506
2022-06-07,Yolo,113,214977,41613,39962,3308,43270,321
2022-06-07,Yuba,115,75493,16674,16558,1377,17935,122
2022-06-06,Alameda,001,1643700,292702,289661,16240,305901,1873
2022-06-06,Alpine,003,1148,129,128,1,129,0
2022-06-06,Amador,005,37829,8954,8818,716,9534,87
2022-06-06,Butte,007,227075,34785,34380,7597,41977,427
2022-06-06,Calaveras,009,45235,7603,7564,400,7964,122
2022-06-06,Colusa,011,21464,3515,3495,1082,4577,21
2022-06-06,Contra Costa,013,1133247,215059,209384,16166,225550,1310
2022-06-06,Del Norte,015,27424,6279,6229,261,6490,52
2022-06-06,El Dorado,017,186661,28656,28478,3521,31999,215
2022-06-06,Fresno,019,978130,242912,239376,25675,265051,2766
2022-06-06,Glenn,021,27897,5129,5095,1662,6757,48
2022-06-06,Humboldt,023,135768,18706,18598,3675,22273,147
2022-06-06,Imperial,025,180216,57113,56912,11009,67921,941
2022-06-06,Inyo,027,18085,4201,4189,583,4772,56
2022-06-06,Kern,029,883053,197543,196763,48323,245086,2338
2022-06-06,Kings,031,150075,52918,52821,3605,56426,447
2022-06-06,Lake,033,64148,11219,11158,962,12120,137
2022-06-06,Lassen,035,31185,9155,9148,903,10051,64
2022-06-06,Los Angeles,037,10098052,2884735,2865901,136697,3002598,31920
2022-06-06,Madera,039,155013,38559,38408,6490,44898,372
2022-06-06,Marin,041,260295,38674,38338,4212,42550,294
2022-06-06,Mariposa,043,17540,2627,2614,245,2859,30
2022-06-06,Mendocino,045,87422,13967,13859,3551,17410,127
2022-06-06,Merced,047,269075,64758,64080,9472,73552,825
2022-06-06,Modoc,049,8938,763,761,259,1020,8
2022-06-06,Mono,051,14174,3052,3044,166,3210,6
2022-06-06,Monterey,053,433212,83562,83063,16027,99090,740
2022-06-06,Napa,055,140530,28240,27996,1183,29179,143
2022-06-06,Nevada,057,99092,17011,16907,1382,18289,127
2022-06-06,Orange,059,3164182,581363,578530,46895,625425,7044
2022-06-06,Placer,061,380077,67445,66951,8141,75092,627
2022-06-06,Plumas,063,18699,3178,3150,385,3535,13
2022-06-06,Riverside,065,2383286,616035,613469,29625,643094,6480
2022-06-06,Sacramento,067,1510023,302758,300875,29470,330345,3054
2022-06-06,San Benito,069,59416,13878,13734,647,14381,99
2022-06-06,San Bernardino,071,2135413,595352,585029,26027,611056,7685
2022-06-06,San Diego,073,3302833,802854,800840,58681,859521,5308
2022-06-06,San Francisco,075,870044,149491,147960,9827,157787,885
2022-06-06,San Joaquin,077,732212,175282,173887,11350,185237,2241
2022-06-06,San Luis Obispo,079,281455,56217,55822,4831,60653,484
2022-06-06,San Mateo,081,765935,141983,140569,8797,149366,710
2022-06-06,Santa Barbara,083,443738,92173,91747,5291,97038,693
2022-06-06,Santa Clara,085,1922200,363964,356452,15316,371768,2321
2022-06-06,Santa Cruz,087,273765,53339,52753,2557,55310,264
2022-06-06,Shasta,089,179085,31500,31394,6270,37664,565
2022-06-06,Sierra,091,2930,279,278,56,334,4
2022-06-06,Siskiyou,093,43540,4612,4609,2861,7470,81
2022-06-06,Solano,095,438530,89827,88522,6325,94847,453
2022-06-06,Sonoma,097,501317,93307,92644,3897,96541,491
2022-06-06,Stanislaus,099,539301,122474,121787,18750,140537,1662
2022-06-06,Sutter,101,95872,21288,21256,2230,23486,227
2022-06-06,Tehama,103,63373,12356,12306,2671,14977,205
2022-06-06,Trinity,105,12862,1214,1211,291,1502,20
2022-06-06,Tulare,107,460477,109267,109091,29231,138322,1494
2022-06-06,Tuolumne,109,53932,13453,13335,653,13988,189
2022-06-06,Ventura,111,848112,183662,182847,11052,193899,1506
2022-06-06,Yolo,113,214977,41457,39962,3297,43259,321
2022-06-06,Yuba,115,75493,16631,16558,1370,17928,122
2022-06-05,Alameda,001,1643700,291651,285785,16178,301963,1873
2022-06-05,Alpine,003,1148,128,128,1,129,0
2022-06-05,Amador,005,37829,8916,8775,713,9488,87
2022-06-05,Butte,007,227075,34706,34129,7579,41708,427
2022-06-05,Calaveras,009,45235,7587,7525,394,7919,121
2022-06-05,Colusa,011,21464,3509,3484,1082,4566,21
2022-06-05,Contra Costa,013,1133247,214349,206711,16057,222768,1310
2022-06-05,Del Norte,015,27424,6268,6206,257,6463,52
2022-06-05,El Dorado,017,186661,28579,28241,3512,31753,214
2022-06-05,Fresno,019,978130,242444,237945,25586,263531,2766
2022-06-05,Glenn,021,27897,5122,5063,1662,6725,48
2022-06-05,Humboldt,023,135768,18656,18433,3653,22086,147
2022-06-05,Imperial,025,180216,57017,56690,10961,67651,941
2022-06-05,Inyo,027,18085,4197,4176,578,4754,56
2022-06-05,Kern,029,883053,197232,195863,48206,244069,2338
2022-06-05,Kings,031,150075,52842,52597,3599,56196,447
2022-06-05,Lake,033,64148,11200,11064,958,12022,137
2022-06-05,Lassen,035,31185,9147,9106,899,10005,64
2022-06-05,Los Angeles,037,10098052,2878649,2846989,136166,2983155,31899
2022-06-05,Madera,039,155013,38497,38188,6474,44662,372
2022-06-05,Marin,041,260295,38560,37879,4179,42058,294
2022-06-05,Mariposa,043,17540,2625,2557,244,2801,30
2022-06-05,Mendocino,045,87422,13931,13738,3504,17242,125
2022-06-05,Merced,047,269075,64667,63756,9438,73194,825
2022-06-05,Modoc,049,8938,762,759,259,1018,8
2022-06-05,Mono,051,14174,3049,3037,164,3201,6
2022-06-05,Monterey,053,433212,83400,82451,15946,98397,738
2022-06-05,Napa,055,140530,28111,27686,1174,28860,143
2022-06-05,Nevada,057,99092,16967,16728,1366,18094,127
2022-06-05,Orange,059,3164182,580099,574146,46707,620853,7038
2022-06-05,Placer,061,380077,67304,66428,8108,74536,627
2022-06-05,Plumas,063,18699,3170,3138,385,3523,13
2022-06-05,Riverside,065,2383286,615098,610369,29562,639931,6481
2022-06-05,Sacramento,067,1510023,301848,297787,29327,327114,3052
2022-06-05,San Benito,069,59416,13833,13572,641,14213,99
2022-06-05,San Bernardino,071,2135413,594367,582305,25983,608288,7664
2022-06-05,San Diego,073,3302833,800958,794822,58489,853311,5303
2022-06-05,San Francisco,075,870044,148903,145876,9774,155650,881
2022-06-05,San Joaquin,077,732212,174844,172621,11302,183923,2242
2022-06-05,San Luis Obispo,079,281455,56055,55333,4758,60091,484
2022-06-05,San Mateo,081,765935,141468,138536,8749,147285,710
2022-06-05,Santa Barbara,083,443738,91981,90911,5272,96183,693
2022-06-05,Santa Clara,085,1922200,362542,351492,15227,366719,2317
2022-06-05,Santa Cruz,087,273765,53147,52333,2544,54877,263
2022-06-05,Shasta,089,179085,31460,31272,6259,37531,565
2022-06-05,Sierra,091,2930,279,278,56,334,4
2022-06-05,Siskiyou,093,43540,4607,4591,2849,7440,81
2022-06-05,Solano,095,438530,89485,87571,6308,93879,452
2022-06-05,Sonoma,097,501317,93027,91518,3868,95386,491
2022-06-05,Stanislaus,099,539301,122276,121001,18722,139723,1661
2022-06-05,Sutter,101,95872,21256,21125,2223,23348,227
2022-06-05,Tehama,103,63373,12337,12262,2668,14930,204
2022-06-05,Trinity,105,12862,1214,1204,291,1495,20
2022-06-05,Tulare,107,460477,109080,108598,29156,137754,1490
2022-06-05,Tuolumne,109,53932,13424,13251,640,13891,189
2022-06-05,Ventura,111,848112,183309,181709,10995,192704,1505
2022-06-05,Yolo,113,214977,41326,39561,3285,42846,321
2022-06-05,Yuba,115,75493,16591,16467,1362,17829,122
2022-06-04,Alameda,001,1643700,291146,285785,16158,301943,1873
2022-06-04,Alpine,003,1148,128,128,1,129,0
2022-06-04,Amador,005,37829,8907,8775,711,9486,87
2022-06-04,Butte,007,227075,34667,34129,7574,41703,427
2022-06-04,Calaveras,009,45235,7573,7525,394,7919,121
2022-06-04,Colusa,011,21464,3506,3484,1077,4561,21
2022-06-04,Contra Costa,013,1133247,213960,206711,16017,222728,1310
2022-06-04,Del Norte,015,27424,6267,6206,257,6463,52
2022-06-04,El Dorado,017,186661,28540,28241,3508,31749,214
2022-06-04,Fresno,019,978130,242273,237945,25569,263514,2766
2022-06-04,Glenn,021,27897,5118,5063,1661,6724,48
2022-06-04,Humboldt,023,135768,18634,18433,3647,22080,147
2022-06-04,Imperial,025,180216,56965,56690,10949,67639,941
2022-06-04,Inyo,027,18085,4197,4176,577,4753,56
2022-06-04,Kern,029,883053,197109,195863,48138,244001,2338
2022-06-04,Kings,031,150075,52801,52597,3599,56196,447
2022-06-04,Lake,033,64148,11185,11064,952,12016,137
2022-06-04,Lassen,035,31185,9142,9106,898,10004,64
2022-06-04,Los Angeles,037,10098052,2876190,2846989,135891,2982880,31899
2022-06-04,Madera,039,155013,38463,38188,6470,44658,372
2022-06-04,Marin,041,260295,38483,37879,4138,42017,294
2022-06-04,Mariposa,043,17540,2622,2557,244,2801,30
2022-06-04,Mendocino,045,87422,13918,13738,3503,17241,125
2022-06-04,Merced,047,269075,64617,63756,9429,73185,825
2022-06-04,Modoc,049,8938,761,759,258,1017,8
2022-06-04,Mono,051,14174,3049,3037,164,3201,6
2022-06-04,Monterey,053,433212,83315,82451,15911,98362,738
2022-06-04,Napa,055,140530,28069,27686,1172,28858,143
2022-06-04,Nevada,057,99092,16954,16728,1365,18093,127
2022-06-04,Orange,059,3164182,579458,574146,46580,620726,7038
2022-06-04,Placer,061,380077,67222,66428,8091,74519,627
2022-06-04,Plumas,063,18699,3166,3138,384,3522,13
2022-06-04,Riverside,065,2383286,614563,610369,29537,639906,6481
2022-06-04,Sacramento,067,1510023,301488,297787,29298,327085,3052
2022-06-04,San Benito,069,59416,13807,13572,638,14210,99
2022-06-04,San Bernardino,071,2135413,593918,582305,25954,608259,7664
2022-06-04,San Diego,073,3302833,800230,794822,58442,853264,5303
2022-06-04,San Francisco,075,870044,148573,145876,9753,155629,881
2022-06-04,San Joaquin,077,732212,174699,172621,11265,183886,2242
2022-06-04,San Luis Obispo,079,281455,56016,55333,4752,60085,484
2022-06-04,San Mateo,081,765935,141162,138536,8721,147257,710
2022-06-04,Santa Barbara,083,443738,91883,90911,5251,96162,693
2022-06-04,Santa Clara,085,1922200,361672,351492,15186,366678,2317
2022-06-04,Santa Cruz,087,273765,53062,52333,2531,54864,263
2022-06-04,Shasta,089,179085,31437,31272,6256,37528,565
2022-06-04,Sierra,091,2930,279,278,56,334,4
2022-06-04,Siskiyou,093,43540,4603,4591,2843,7434,81
2022-06-04,Solano,095,438530,89401,87571,6291,93862,452
2022-06-04,Sonoma,097,501317,92874,91518,3854,95372,491
2022-06-04,Stanislaus,099,539301,122138,121001,18707,139708,1661
2022-06-04,Sutter,101,95872,21229,21125,2220,23345,227
2022-06-04,Tehama,103,63373,12323,12262,2667,14929,204
2022-06-04,Trinity,105,12862,1214,1204,291,1495,20
2022-06-04,Tulare,107,460477,109014,108598,29114,137712,1490
2022-06-04,Tuolumne,109,53932,13414,13251,637,13888,189
2022-06-04,Ventura,111,848112,183124,181709,10978,192687,1505
2022-06-04,Yolo,113,214977,41243,39561,3280,42841,321
2022-06-04,Yuba,115,75493,16575,16467,1358,17825,122
2022-06-03,Alameda,001,1643700,290609,285785,16132,301917,1873
2022-06-03,Alpine,003,1148,128,128,1,129,0
2022-06-03,Amador,005,37829,8901,8775,709,9484,87
2022-06-03,Butte,007,227075,34616,34129,7564,41693,427
2022-06-03,Calaveras,009,45235,7568,7525,394,7919,121
2022-06-03,Colusa,011,21464,3506,3484,1075,4559,21
2022-06-03,Contra Costa,013,1133247,213649,206711,15988,222699,1310
2022-06-03,Del Norte,015,27424,6263,6206,254,6460,52
2022-06-03,El Dorado,017,186661,28511,28241,3505,31746,214
2022-06-03,Fresno,019,978130,242045,237945,25536,263481,2766
2022-06-03,Glenn,021,27897,5112,5063,1659,6722,48
2022-06-03,Humboldt,023,135768,18614,18433,3642,22075,147
2022-06-03,Imperial,025,180216,56919,56690,10939,67629,941
2022-06-03,Inyo,027,18085,4196,4176,577,4753,56
2022-06-03,Kern,029,883053,196968,195863,48070,243933,2338
2022-06-03,Kings,031,150075,52777,52597,3599,56196,447
2022-06-03,Lake,033,64148,11174,11064,949,12013,137
2022-06-03,Lassen,035,31185,9137,9106,898,10004,64
2022-06-03,Los Angeles,037,10098052,2873284,2846989,135605,2982594,31899
2022-06-03,Madera,039,155013,38419,38188,6461,44649,372
2022-06-03,Marin,041,260295,38414,37879,4103,41982,294
2022-06-03,Mariposa,043,17540,2618,2557,244,2801,30
2022-06-03,Mendocino,045,87422,13896,13738,3502,17240,125
2022-06-03,Merced,047,269075,64566,63756,9426,73182,825
2022-06-03,Modoc,049,8938,761,759,258,1017,8
2022-06-03,Mono,051,14174,3046,3037,164,3201,6
2022-06-03,Monterey,053,433212,83216,82451,15864,98315,738
2022-06-03,Napa,055,140530,28019,27686,1164,28850,143
2022-06-03,Nevada,057,99092,16933,16728,1364,18092,127
2022-06-03,Orange,059,3164182,578773,574146,46476,620622,7038
2022-06-03,Placer,061,380077,67141,66428,8074,74502,627
2022-06-03,Plumas,063,18699,3164,3138,383,3521,13
2022-06-03,Riverside,065,2383286,614035,610369,29507,639876,6481
2022-06-03,Sacramento,067,1510023,301017,297787,29263,327050,3052
2022-06-03,San Benito,069,59416,13794,13572,634,14206,99
2022-06-03,San Bernardino,071,2135413,593466,582305,25919,608224,7664
2022-06-03,San Diego,073,3302833,799282,794822,58319,853141,5303
2022-06-03,San Francisco,075,870044,148203,145876,9721,155597,881
2022-06-03,San Joaquin,077,732212,174534,172621,11246,183867,2242
2022-06-03,San Luis Obispo,079,281455,55971,55333,4743,60076,484
2022-06-03,San Mateo,081,765935,140878,138536,8709,147245,710
2022-06-03,Santa Barbara,083,443738,91764,90911,5249,96160,693
2022-06-03,Santa Clara,085,1922200,360779,351492,15139,366631,2317
2022-06-03,Santa Cruz,087,273765,52930,52333,2518,54851,263
2022-06-03,Shasta,089,179085,31425,31272,6255,37527,565
2022-06-03,Sierra,091,2930,279,278,56,334,4
2022-06-03,Siskiyou,093,43540,4599,4591,2842,7433,81
2022-06-03,Solano,095,438530,89285,87571,6280,93851,452
2022-06-03,Sonoma,097,501317,92729,91518,3845,95363,491
2022-06-03,Stanislaus,099,539301,122031,121001,18686,139687,1661
2022-06-03,Sutter,101,95872,21206,21125,2219,23344,227
2022-06-03,Tehama,103,63373,12317,12262,2666,14928,204
2022-06-03,Trinity,105,12862,1212,1204,291,1495,20
2022-06-03,Tulare,107,460477,108946,108598,29079,137677,1490
2022-06-03,Tuolumne,109,53932,13403,13251,634,13885,189
2022-06-03,Ventura,111,848112,182936,181709,10953,192662,1505
2022-06-03,Yolo,113,214977,41181,39561,3266,42827,321
2022-06-03,Yuba,115,75493,16550,16467,1356,17823,122
2022-06-02,Alameda,001,1643700,289708,285785,16068,301853,1873
2022-06-02,Alpine,003,1148,128,128,1,129,0
2022-06-02,Amador,005,37829,8878,8775,707,9482,87
2022-06-02,Butte,007,227075,34540,34129,7548,41677,427
2022-06-02,Calaveras,009,45235,7555,7525,393,7918,121
2022-06-02,Colusa,011,21464,3503,3484,1075,4559,21
2022-06-02,Contra Costa,013,1133247,213062,206711,15896,222607,1310
2022-06-02,Del Norte,015,27424,6253,6206,253,6459,52
2022-06-02,El Dorado,017,186661,28443,28241,3493,31734,214
2022-06-02,Fresno,019,978130,241698,237945,25481,263426,2766
2022-06-02,Glenn,021,27897,5106,5063,1656,6719,48
2022-06-02,Humboldt,023,135768,18573,18433,3621,22054,147
2022-06-02,Imperial,025,180216,56859,56690,10928,67618,941
2022-06-02,Inyo,027,18085,4196,4176,574,4750,56
2022-06-02,Kern,029,883053,196685,195863,47966,243829,2338
2022-06-02,Kings,031,150075,52724,52597,3594,56191,447
2022-06-02,Lake,033,64148,11152,11064,947,12011,137
2022-06-02,Lassen,035,31185,9126,9106,898,10004,64
2022-06-02,Los Angeles,037,10098052,2868355,2846989,135178,2982167,31899
2022-06-02,Madera,039,155013,38365,38188,6448,44636,372
2022-06-02,Marin,041,260295,38316,37879,4076,41955,294
2022-06-02,Mariposa,043,17540,2613,2557,243,2800,30
2022-06-02,Mendocino,045,87422,13867,13738,3494,17232,125
2022-06-02,Merced,047,269075,64490,63756,9416,73172,825
2022-06-02,Modoc,049,8938,760,759,258,1017,8
2022-06-02,Mono,051,14174,3046,3037,164,3201,6
2022-06-02,Monterey,053,433212,83064,82451,15800,98251,738
2022-06-02,Napa,055,140530,27943,27686,1161,28847,143
2022-06-02,Nevada,057,99092,16896,16728,1359,18087,127
2022-06-02,Orange,059,3164182,577743,574146,46328,620474,7038
2022-06-02,Placer,061,380077,67020,66428,8050,74478,627
2022-06-02,Plumas,063,18699,3155,3138,383,3521,13
2022-06-02,Riverside,065,2383286,613351,610369,29448,639817,6481
2022-06-02,Sacramento,067,1510023,300376,297787,29158,326945,3052
2022-06-02,San Benito,069,59416,13761,13572,632,14204,99
2022-06-02,San Bernardino,071,2135413,592796,582305,25873,608178,7664
2022-06-02,San Diego,073,3302833,797909,794822,58147,852969,5303
2022-06-02,San Francisco,075,870044,147785,145876,9672,155548,881
2022-06-02,San Joaquin,077,732212,174223,172621,11213,183834,2242
2022-06-02,San Luis Obispo,079,281455,55841,55333,4708,60041,484
2022-06-02,San Mateo,081,765935,140496,138536,8657,147193,710
2022-06-02,Santa Barbara,083,443738,91590,90911,5234,96145,693
2022-06-02,Santa Clara,085,1922200,359689,351492,15019,366511,2317
2022-06-02,Santa Cruz,087,273765,52814,52333,2507,54840,263
2022-06-02,Shasta,089,179085,31395,31272,6248,37520,565
2022-06-02,Sierra,091,2930,279,278,56,334,4
2022-06-02,Siskiyou,093,43540,4592,4591,2833,7424,81
2022-06-02,Solano,095,438530,89010,87571,6270,93841,452
2022-06-02,Sonoma,097,501317,92503,91518,3819,95337,491
2022-06-02,Stanislaus,099,539301,121872,121001,18657,139658,1661
2022-06-02,Sutter,101,95872,21179,21125,2213,23338,227
2022-06-02,Tehama,103,63373,12305,12262,2659,14921,204
2022-06-02,Trinity,105,12862,1210,1204,291,1495,20
2022-06-02,Tulare,107,460477,108816,108598,29013,137611,1490
2022-06-02,Tuolumne,109,53932,13384,13251,632,13883,189
2022-06-02,Ventura,111,848112,182665,181709,10919,192628,1505
2022-06-02,Yolo,113,214977,41072,39561,3256,42817,321
2022-06-02,Yuba,115,75493,16529,16467,1349,17816,122
2022-06-01,Alameda,001,1643700,288699,284051,16014,300065,1868
2022-06-01,Alpine,003,1148,128,128,1,129,0
2022-06-01,Amador,005,37829,8872,8741,705,9446,87
2022-06-01,Butte,007,227075,34471,34059,7534,41593,427
2022-06-01,Calaveras,009,45235,7550,7502,390,7892,120
2022-06-01,Colusa,011,21464,3500,3476,1075,4551,21
2022-06-01,Contra Costa,013,1133247,212417,205699,15819,221518,1310
2022-06-01,Del Norte,015,27424,6243,6188,252,6440,51
2022-06-01,El Dorado,017,186661,28381,28133,3475,31608,214
2022-06-01,Fresno,019,978130,241339,237367,25426,262793,2765
2022-06-01,Glenn,021,27897,5101,5059,1655,6714,48
2022-06-01,Humboldt,023,135768,18530,18371,3598,21969,147
2022-06-01,Imperial,025,180216,56792,56445,10901,67346,938
2022-06-01,Inyo,027,18085,4192,4171,568,4739,56
2022-06-01,Kern,029,883053,196460,195438,47884,243322,2336
2022-06-01,Kings,031,150075,52667,52491,3590,56081,447
2022-06-01,Lake,033,64148,11131,11024,942,11966,137
2022-06-01,Lassen,035,31185,9113,9083,897,9980,64
2022-06-01,Los Angeles,037,10098052,2862946,2836856,134747,2971603,31882
2022-06-01,Madera,039,155013,38327,38115,6434,44549,372
2022-06-01,Marin,041,260295,38200,37654,4036,41690,293
2022-06-01,Mariposa,043,17540,2598,2549,242,2791,30
2022-06-01,Mendocino,045,87422,13840,13692,3478,17170,125
2022-06-01,Merced,047,269075,64411,63637,9396,73033,824
2022-06-01,Modoc,049,8938,757,755,257,1012,8
2022-06-01,Mono,051,14174,3044,3035,163,3198,6
2022-06-01,Monterey,053,433212,82910,82215,15737,97952,737
2022-06-01,Napa,055,140530,27867,27580,1151,28731,143
2022-06-01,Nevada,057,99092,16857,16693,1350,18043,127
2022-06-01,Orange,059,3164182,576494,571973,46173,618146,7032
2022-06-01,Placer,061,380077,66877,66199,8017,74216,627
2022-06-01,Plumas,063,18699,3148,3117,382,3499,13
2022-06-01,Riverside,065,2383286,612613,608913,29402,638315,6480
2022-06-01,Sacramento,067,1510023,299621,296457,29054,325511,3045
2022-06-01,San Benito,069,59416,13723,13510,621,14131,98
2022-06-01,San Bernardino,071,2135413,592088,580767,25835,606602,7641
2022-06-01,San Diego,073,3302833,796216,791557,57948,849505,5292
2022-06-01,San Francisco,075,870044,147266,144476,9634,154110,879
2022-06-01,San Joaquin,077,732212,173924,172170,11183,183353,2241
2022-06-01,San Luis Obispo,079,281455,55674,55099,4675,59774,482
2022-06-01,San Mateo,081,765935,140013,137566,8582,146148,710
2022-06-01,Santa Barbara,083,443738,91407,90531,5219,95750,693
2022-06-01,Santa Clara,085,1922200,358528,348742,14928,363670,2317
2022-06-01,Santa Cruz,087,273765,52701,52141,2497,54638,263
2022-06-01,Shasta,089,179085,31364,31247,6245,37492,564
2022-06-01,Sierra,091,2930,279,280,56,336,4
2022-06-01,Siskiyou,093,43540,4587,4574,2828,7402,81
2022-06-01,Solano,095,438530,88776,87206,6242,93448,452
2022-06-01,Sonoma,097,501317,92250,91174,3795,94969,491
2022-06-01,Stanislaus,099,539301,121681,120778,18635,139413,1656
2022-06-01,Sutter,101,95872,21150,21065,2209,23274,227
2022-06-01,Tehama,103,63373,12298,12245,2655,14900,204
2022-06-01,Trinity,105,12862,1209,1200,290,1490,20
2022-06-01,Tulare,107,460477,108705,108401,28957,137358,1490
2022-06-01,Tuolumne,109,53932,13370,13221,631,13852,189
2022-06-01,Ventura,111,848112,182382,181163,10888,192051,1503
2022-06-01,Yolo,113,214977,40989,39371,3245,42616,320
2022-06-01,Yuba,115,75493,16505,16406,1341,17747,122
2022-05-31,Alameda,001,1643700,287592,284051,15959,300010,1868
2022-05-31,Alpine,003,1148,128,128,1,129,0
2022-05-31,Amador,005,37829,8854,8741,699,9440,87
2022-05-31,Butte,007,227075,34410,34059,7516,41575,427
2022-05-31,Calaveras,009,45235,7539,7502,390,7892,120
2022-05-31,Colusa,011,21464,3495,3476,1074,4550,21
2022-05-31,Contra Costa,013,1133247,211665,205699,15724,221423,1310
2022-05-31,Del Norte,015,27424,6234,6188,250,6438,51
2022-05-31,El Dorado,017,186661,28320,28133,3455,31588,214
2022-05-31,Fresno,019,978130,240936,237367,25357,262724,2765
2022-05-31,Glenn,021,27897,5093,5059,1653,6712,48
2022-05-31,Humboldt,023,135768,18499,18371,3578,21949,147
2022-05-31,Imperial,025,180216,56728,56445,10877,67322,938
2022-05-31,Inyo,027,18085,4186,4171,566,4737,56
2022-05-31,Kern,029,883053,196216,195438,47788,243226,2336
2022-05-31,Kings,031,150075,52616,52491,3584,56075,447
2022-05-31,Lake,033,64148,11112,11024,938,11962,137
2022-05-31,Lassen,035,31185,9101,9083,896,9979,64
2022-05-31,Los Angeles,037,10098052,2856860,2836856,134283,2971139,31882
2022-05-31,Madera,039,155013,38263,38115,6414,44529,372
2022-05-31,Marin,041,260295,38062,37654,4000,41654,293
2022-05-31,Mariposa,043,17540,2592,2549,237,2786,30
2022-05-31,Mendocino,045,87422,13805,13692,3461,17153,125
2022-05-31,Merced,047,269075,64324,63637,9373,73010,824
2022-05-31,Modoc,049,8938,755,755,257,1012,8
2022-05-31,Mono,051,14174,3040,3035,163,3198,6
2022-05-31,Monterey,053,433212,82750,82215,15671,97886,737
2022-05-31,Napa,055,140530,27774,27580,1148,28728,143
2022-05-31,Nevada,057,99092,16810,16693,1348,18041,127
2022-05-31,Orange,059,3164182,575267,571973,45990,617963,7032
2022-05-31,Placer,061,380077,66717,66199,7987,74186,627
2022-05-31,Plumas,063,18699,3144,3117,381,3498,13
2022-05-31,Riverside,065,2383286,611693,608913,29340,638253,6480
2022-05-31,Sacramento,067,1510023,298771,296457,28913,325370,3045
2022-05-31,San Benito,069,59416,13668,13510,616,14126,98
2022-05-31,San Bernardino,071,2135413,591206,580767,25800,606567,7641
2022-05-31,San Diego,073,3302833,794340,791557,57743,849300,5292
2022-05-31,San Francisco,075,870044,146626,144476,9592,154068,879
2022-05-31,San Joaquin,077,732212,173547,172170,11141,183311,2241
2022-05-31,San Luis Obispo,079,281455,55524,55099,4610,59709,482
2022-05-31,San Mateo,081,765935,139453,137566,8540,146106,710
2022-05-31,Santa Barbara,083,443738,91183,90531,5196,95727,693
2022-05-31,Santa Clara,085,1922200,357016,348742,14851,363593,2317
2022-05-31,Santa Cruz,087,273765,52581,52141,2477,54618,263
2022-05-31,Shasta,089,179085,31330,31247,6234,37481,564
2022-05-31,Sierra,091,2930,278,280,55,335,4
2022-05-31,Siskiyou,093,43540,4582,4574,2822,7396,81
2022-05-31,Solano,095,438530,88444,87206,6218,93424,452
2022-05-31,Sonoma,097,501317,91961,91174,3756,94930,491
2022-05-31,Stanislaus,099,539301,121477,120778,18610,139388,1656
2022-05-31,Sutter,101,95872,21121,21065,2203,23268,227
2022-05-31,Tehama,103,63373,12289,12245,2650,14895,204
2022-05-31,Trinity,105,12862,1208,1200,290,1490,20
2022-05-31,Tulare,107,460477,108566,108401,28897,137298,1490
2022-05-31,Tuolumne,109,53932,13355,13221,628,13849,189
2022-05-31,Ventura,111,848112,182062,181163,10839,192002,1503
2022-05-31,Yolo,113,214977,40815,39371,3234,42605,320
2022-05-31,Yuba,115,75493,16473,16406,1335,17741,122
2022-05-30,Alameda,001,1643700,286218,284051,15869,299920,1868
2022-05-30,Alpine,003,1148,128,128,1,129,0
2022-05-30,Amador,005,37829,8839,8741,698,9439,87
2022-05-30,Butte,007,227075,34333,34059,7493,41552,427
2022-05-30,Calaveras,009,45235,7530,7502,390,7892,120
2022-05-30,Colusa,011,21464,3493,3476,1073,4549,21
2022-05-30,Contra Costa,013,1133247,210822,205699,15588,221287,1310
2022-05-30,Del Norte,015,27424,6216,6188,249,6437,51
2022-05-30,El Dorado,017,186661,28242,28133,3435,31568,214
2022-05-30,Fresno,019,978130,240464,237367,25282,262649,2765
2022-05-30,Glenn,021,27897,5088,5059,1650,6709,48
2022-05-30,Humboldt,023,135768,18445,18371,3550,21921,147
2022-05-30,Imperial,025,180216,56647,56445,10850,67295,938
2022-05-30,Inyo,027,18085,4181,4171,565,4736,56
2022-05-30,Kern,029,883053,195936,195438,47672,243110,2336
2022-05-30,Kings,031,150075,52520,52491,3583,56074,447
2022-05-30,Lake,033,64148,11083,11024,929,11953,137
2022-05-30,Lassen,035,31185,9086,9083,893,9976,64
2022-05-30,Los Angeles,037,10098052,2849529,2836856,133775,2970631,31882
2022-05-30,Madera,039,155013,38207,38115,6374,44489,372
2022-05-30,Marin,041,260295,37937,37654,3958,41612,293
2022-05-30,Mariposa,043,17540,2569,2549,233,2782,30
2022-05-30,Mendocino,045,87422,13758,13692,3443,17135,125
2022-05-30,Merced,047,269075,64227,63637,9336,72973,824
2022-05-30,Modoc,049,8938,752,755,255,1010,8
2022-05-30,Mono,051,14174,3037,3035,163,3198,6
2022-05-30,Monterey,053,433212,82561,82215,15583,97798,737
2022-05-30,Napa,055,140530,27697,27580,1140,28720,143
2022-05-30,Nevada,057,99092,16763,16693,1343,18036,127
2022-05-30,Orange,059,3164182,573801,571973,45774,617747,7032
2022-05-30,Placer,061,380077,66576,66199,7957,74156,627
2022-05-30,Plumas,063,18699,3138,3117,378,3495,13
2022-05-30,Riverside,065,2383286,610683,608913,29262,638175,6480
2022-05-30,Sacramento,067,1510023,297819,296457,28756,325213,3045
2022-05-30,San Benito,069,59416,13606,13510,608,14118,98
2022-05-30,San Bernardino,071,2135413,590233,580767,25764,606531,7641
2022-05-30,San Diego,073,3302833,792069,791557,57449,849006,5292
2022-05-30,San Francisco,075,870044,145970,144476,9538,154014,879
2022-05-30,San Joaquin,077,732212,173149,172170,11099,183269,2241
2022-05-30,San Luis Obispo,079,281455,55317,55099,4539,59638,482
2022-05-30,San Mateo,081,765935,138771,137566,8488,146054,710
2022-05-30,Santa Barbara,083,443738,90927,90531,5162,95693,693
2022-05-30,Santa Clara,085,1922200,355462,348742,14763,363505,2317
2022-05-30,Santa Cruz,087,273765,52443,52141,2467,54608,263
2022-05-30,Shasta,089,179085,31292,31247,6227,37474,564
2022-05-30,Sierra,091,2930,278,280,55,335,4
2022-05-30,Siskiyou,093,43540,4573,4574,2810,7384,81
2022-05-30,Solano,095,438530,88098,87206,6162,93368,452
2022-05-30,Sonoma,097,501317,91674,91174,3712,94886,491
2022-05-30,Stanislaus,099,539301,121286,120778,18581,139359,1656
2022-05-30,Sutter,101,95872,21082,21065,2197,23262,227
2022-05-30,Tehama,103,63373,12273,12245,2646,14891,204
2022-05-30,Trinity,105,12862,1207,1200,290,1490,20
2022-05-30,Tulare,107,460477,108407,108401,28808,137209,1490
2022-05-30,Tuolumne,109,53932,13330,13221,624,13845,189
2022-05-30,Ventura,111,848112,181689,181163,10787,191950,1503
2022-05-30,Yolo,113,214977,40628,39371,3224,42595,320
2022-05-30,Yuba,115,75493,16445,16406,1331,17737,122
2022-05-29,Alameda,001,1643700,285734,280775,15845,296620,1863
2022-05-29,Alpine,003,1148,128,126,1,127,0
2022-05-29,Amador,005,37829,8834,8696,695,9391,86
2022-05-29,Butte,007,227075,34317,33876,7486,41362,426
2022-05-29,Calaveras,009,45235,7519,7469,390,7859,120
2022-05-29,Colusa,011,21464,3492,3474,1072,4546,21
2022-05-29,Contra Costa,013,1133247,210477,203528,15563,219091,1306
2022-05-29,Del Norte,015,27424,6214,6166,248,6414,51
2022-05-29,El Dorado,017,186661,28216,27898,3432,31330,214
2022-05-29,Fresno,019,978130,240334,236250,25262,261512,2764
2022-05-29,Glenn,021,27897,5083,5048,1650,6698,48
2022-05-29,Humboldt,023,135768,18424,18257,3539,21796,147
2022-05-29,Imperial,025,180216,56609,56323,10836,67159,939
2022-05-29,Inyo,027,18085,4180,4161,565,4726,56
2022-05-29,Kern,029,883053,195838,194687,47607,242294,2334
2022-05-29,Kings,031,150075,52495,52292,3583,55875,447
2022-05-29,Lake,033,64148,11074,10958,927,11885,137
2022-05-29,Lassen,035,31185,9082,9049,893,9942,64
2022-05-29,Los Angeles,037,10098052,2847322,2819145,133506,2952651,31862
2022-05-29,Madera,039,155013,38184,37955,6369,44324,371
2022-05-29,Marin,041,260295,37868,37215,3926,41141,293
2022-05-29,Mariposa,043,17540,2564,2526,233,2759,31
2022-05-29,Mendocino,045,87422,13737,13612,3442,17054,124
2022-05-29,Merced,047,269075,64206,63389,9333,72722,824
2022-05-29,Modoc,049,8938,752,751,255,1006,8
2022-05-29,Mono,051,14174,3036,3030,163,3193,6
2022-05-29,Monterey,053,433212,82496,81875,15539,97414,737
2022-05-29,Napa,055,140530,27669,27376,1139,28515,144
2022-05-29,Nevada,057,99092,16748,16568,1341,17909,127
2022-05-29,Orange,059,3164182,573225,568369,45598,613967,7028
2022-05-29,Placer,061,380077,66507,65672,7948,73620,626
2022-05-29,Plumas,063,18699,3131,3096,378,3474,13
2022-05-29,Riverside,065,2383286,610337,606444,29227,635671,6480
2022-05-29,Sacramento,067,1510023,297361,294000,28730,322730,3032
2022-05-29,San Benito,069,59416,13600,13402,606,14008,98
2022-05-29,San Bernardino,071,2135413,589939,578656,25748,604404,7610
2022-05-29,San Diego,073,3302833,791330,786243,57369,843612,5288
2022-05-29,San Francisco,075,870044,145542,142456,9529,151985,879
2022-05-29,San Joaquin,077,732212,172987,171282,11081,182363,2241
2022-05-29,San Luis Obispo,079,281455,55265,54701,4527,59228,481
2022-05-29,San Mateo,081,765935,138517,135746,8475,144221,710
2022-05-29,Santa Barbara,083,443738,90798,89940,5161,95101,693
2022-05-29,Santa Clara,085,1922200,354667,344223,14724,358947,2304
2022-05-29,Santa Cruz,087,273765,52367,51819,2460,54279,263
2022-05-29,Shasta,089,179085,31280,31165,6223,37388,564
2022-05-29,Sierra,091,2930,278,278,55,333,4
2022-05-29,Siskiyou,093,43540,4568,4537,2808,7345,81
2022-05-29,Solano,095,438530,88045,86565,6151,92716,452
2022-05-29,Sonoma,097,501317,91582,90364,3697,94061,490
2022-05-29,Stanislaus,099,539301,121187,120241,18562,138803,1657
2022-05-29,Sutter,101,95872,21062,20976,2197,23173,227
2022-05-29,Tehama,103,63373,12263,12210,2645,14855,204
2022-05-29,Trinity,105,12862,1206,1196,290,1486,20
2022-05-29,Tulare,107,460477,108323,108029,28763,136792,1484
2022-05-29,Tuolumne,109,53932,13315,13141,624,13765,189
2022-05-29,Ventura,111,848112,181544,179953,10777,190730,1503
2022-05-29,Yolo,113,214977,40576,39016,3221,42237,319
2022-05-29,Yuba,115,75493,16429,16314,1327,17641,122
2022-05-28,Alameda,001,1643700,285359,280775,15820,296595,1863
2022-05-28,Alpine,003,1148,128,126,1,127,0
2022-05-28,Amador,005,37829,8825,8696,695,9391,86
2022-05-28,Butte,007,227075,34293,33876,7470,41346,426
2022-05-28,Calaveras,009,45235,7515,7469,390,7859,120
2022-05-28,Colusa,011,21464,3487,3474,1071,4545,21
2022-05-28,Contra Costa,013,1133247,210209,203528,15539,219067,1306
2022-05-28,Del Norte,015,27424,6210,6166,246,6412,51
2022-05-28,El Dorado,017,186661,28186,27898,3431,31329,214
2022-05-28,Fresno,019,978130,240176,236250,25231,261481,2764
2022-05-28,Glenn,021,27897,5080,5048,1650,6698,48
2022-05-28,Humboldt,023,135768,18400,18257,3529,21786,147
2022-05-28,Imperial,025,180216,56583,56323,10826,67149,939
2022-05-28,Inyo,027,18085,4180,4161,563,4724,56
2022-05-28,Kern,029,883053,195739,194687,47557,242244,2334
2022-05-28,Kings,031,150075,52471,52292,3582,55874,447
2022-05-28,Lake,033,64148,11064,10958,927,11885,137
2022-05-28,Lassen,035,31185,9077,9049,893,9942,64
2022-05-28,Los Angeles,037,10098052,2845343,2819145,133238,2952383,31862
2022-05-28,Madera,039,155013,38167,37955,6366,44321,371
2022-05-28,Marin,041,260295,37801,37215,3896,41111,293
2022-05-28,Mariposa,043,17540,2560,2526,233,2759,31
2022-05-28,Mendocino,045,87422,13725,13612,3442,17054,124
2022-05-28,Merced,047,269075,64173,63389,9327,72716,824
2022-05-28,Modoc,049,8938,752,751,255,1006,8
2022-05-28,Mono,051,14174,3036,3030,162,3192,6
2022-05-28,Monterey,053,433212,82428,81875,15507,97382,737
2022-05-28,Napa,055,140530,27624,27376,1138,28514,144
2022-05-28,Nevada,057,99092,16736,16568,1339,17907,127
2022-05-28,Orange,059,3164182,572710,568369,45478,613847,7028
2022-05-28,Placer,061,380077,66432,65672,7934,73606,626
2022-05-28,Plumas,063,18699,3125,3096,377,3473,13
2022-05-28,Riverside,065,2383286,609958,606444,29199,635643,6480
2022-05-28,Sacramento,067,1510023,297088,294000,28710,322710,3032
2022-05-28,San Benito,069,59416,13585,13402,606,14008,98
2022-05-28,San Bernardino,071,2135413,589575,578656,25721,604377,7610
2022-05-28,San Diego,073,3302833,790671,786243,57317,843560,5288
2022-05-28,San Francisco,075,870044,145235,142456,9508,151964,879
2022-05-28,San Joaquin,077,732212,172883,171282,11065,182347,2241
2022-05-28,San Luis Obispo,079,281455,55230,54701,4524,59225,481
2022-05-28,San Mateo,081,765935,138239,135746,8448,144194,710
2022-05-28,Santa Barbara,083,443738,90698,89940,5151,95091,693
2022-05-28,Santa Clara,085,1922200,353881,344223,14697,358920,2304
2022-05-28,Santa Cruz,087,273765,52327,51819,2452,54271,263
2022-05-28,Shasta,089,179085,31269,31165,6218,37383,564
2022-05-28,Sierra,091,2930,278,278,54,332,4
2022-05-28,Siskiyou,093,43540,4560,4537,2804,7341,81
2022-05-28,Solano,095,438530,87971,86565,6141,92706,452
2022-05-28,Sonoma,097,501317,91441,90364,3686,94050,490
2022-05-28,Stanislaus,099,539301,121087,120241,18554,138795,1657
2022-05-28,Sutter,101,95872,21047,20976,2195,23171,227
2022-05-28,Tehama,103,63373,12251,12210,2642,14852,204
2022-05-28,Trinity,105,12862,1205,1196,290,1486,20
2022-05-28,Tulare,107,460477,108267,108029,28730,136759,1484
2022-05-28,Tuolumne,109,53932,13300,13141,623,13764,189
2022-05-28,Ventura,111,848112,181378,179953,10757,190710,1503
2022-05-28,Yolo,113,214977,40522,39016,3214,42230,319
2022-05-28,Yuba,115,75493,16415,16314,1325,17639,122
2022-05-27,Alameda,001,1643700,284882,280775,15783,296558,1863
2022-05-27,Alpine,003,1148,127,126,1,127,0
2022-05-27,Amador,005,37829,8820,8696,695,9391,86
2022-05-27,Butte,007,227075,34267,33876,7454,41330,426
2022-05-27,Calaveras,009,45235,7508,7469,390,7859,120
2022-05-27,Colusa,011,21464,3487,3474,1071,4545,21
2022-05-27,Contra Costa,013,1133247,209928,203528,15507,219035,1306
2022-05-27,Del Norte,015,27424,6204,6166,246,6412,51
2022-05-27,El Dorado,017,186661,28162,27898,3423,31321,214
2022-05-27,Fresno,019,978130,240003,236250,25199,261449,2764
2022-05-27,Glenn,021,27897,5078,5048,1649,6697,48
2022-05-27,Humboldt,023,135768,18390,18257,3523,21780,147
2022-05-27,Imperial,025,180216,56499,56323,10821,67144,939
2022-05-27,Inyo,027,18085,4178,4161,562,4723,56
2022-05-27,Kern,029,883053,195630,194687,47489,242176,2334
2022-05-27,Kings,031,150075,52443,52292,3579,55871,447
2022-05-27,Lake,033,64148,11058,10958,925,11883,137
2022-05-27,Lassen,035,31185,9073,9049,893,9942,64
2022-05-27,Los Angeles,037,10098052,2842995,2819145,132991,2952136,31862
2022-05-27,Madera,039,155013,38133,37955,6357,44312,371
2022-05-27,Marin,041,260295,37734,37215,3862,41077,293
2022-05-27,Mariposa,043,17540,2554,2526,233,2759,31
2022-05-27,Mendocino,045,87422,13708,13612,3438,17050,124
2022-05-27,Merced,047,269075,64132,63389,9322,72711,824
2022-05-27,Modoc,049,8938,752,751,255,1006,8
2022-05-27,Mono,051,14174,3035,3030,162,3192,6
2022-05-27,Monterey,053,433212,82369,81875,15462,97337,737
2022-05-27,Napa,055,140530,27591,27376,1135,28511,144
2022-05-27,Nevada,057,99092,16725,16568,1335,17903,127
2022-05-27,Orange,059,3164182,572156,568369,45368,613737,7028
2022-05-27,Placer,061,380077,66362,65672,7925,73597,626
2022-05-27,Plumas,063,18699,3122,3096,377,3473,13
2022-05-27,Riverside,065,2383286,609544,606444,29167,635611,6480
2022-05-27,Sacramento,067,1510023,296712,294000,28670,322670,3032
2022-05-27,San Benito,069,59416,13573,13402,606,14008,98
2022-05-27,San Bernardino,071,2135413,589238,578656,25696,604352,7610
2022-05-27,San Diego,073,3302833,789793,786243,57225,843468,5288
2022-05-27,San Francisco,075,870044,144903,142456,9468,151924,879
2022-05-27,San Joaquin,077,732212,172751,171282,11045,182327,2241
2022-05-27,San Luis Obispo,079,281455,55167,54701,4513,59214,481
2022-05-27,San Mateo,081,765935,137988,135746,8423,144169,710
2022-05-27,Santa Barbara,083,443738,90609,89940,5150,95090,693
2022-05-27,Santa Clara,085,1922200,353137,344223,14681,358904,2304
2022-05-27,Santa Cruz,087,273765,52272,51819,2440,54259,263
2022-05-27,Shasta,089,179085,31259,31165,6212,37377,564
2022-05-27,Sierra,091,2930,278,278,54,332,4
2022-05-27,Siskiyou,093,43540,4558,4537,2802,7339,81
2022-05-27,Solano,095,438530,87843,86565,6130,92695,452
2022-05-27,Sonoma,097,501317,91296,90364,3674,94038,490
2022-05-27,Stanislaus,099,539301,121004,120241,18539,138780,1657
2022-05-27,Sutter,101,95872,21030,20976,2194,23170,227
2022-05-27,Tehama,103,63373,12248,12210,2641,14851,204
2022-05-27,Trinity,105,12862,1205,1196,290,1486,20
2022-05-27,Tulare,107,460477,108201,108029,28693,136722,1484
2022-05-27,Tuolumne,109,53932,13290,13141,622,13763,189
2022-05-27,Ventura,111,848112,181202,179953,10734,190687,1503
2022-05-27,Yolo,113,214977,40451,39016,3206,42222,319
2022-05-27,Yuba,115,75493,16401,16314,1324,17638,122
2022-05-26,Alameda,001,1643700,284031,280775,15706,296481,1863
2022-05-26,Alpine,003,1148,127,126,1,127,0
2022-05-26,Amador,005,37829,8807,8696,695,9391,86
2022-05-26,Butte,007,227075,34212,33876,7432,41308,426
2022-05-26,Calaveras,009,45235,7498,7469,390,7859,120
2022-05-26,Colusa,011,21464,3484,3474,1068,4542,21
2022-05-26,Contra Costa,013,1133247,209450,203528,15434,218962,1306
2022-05-26,Del Norte,015,27424,6196,6166,242,6408,51
2022-05-26,El Dorado,017,186661,28112,27898,3412,31310,214
2022-05-26,Fresno,019,978130,239748,236250,25143,261393,2764
2022-05-26,Glenn,021,27897,5072,5048,1649,6697,48
2022-05-26,Humboldt,023,135768,18349,18257,3510,21767,147
2022-05-26,Imperial,025,180216,56467,56323,10806,67129,939
2022-05-26,Inyo,027,18085,4177,4161,559,4720,56
2022-05-26,Kern,029,883053,195466,194687,47414,242101,2334
2022-05-26,Kings,031,150075,52397,52292,3576,55868,447
2022-05-26,Lake,033,64148,11043,10958,925,11883,137
2022-05-26,Lassen,035,31185,9064,9049,893,9942,64
2022-05-26,Los Angeles,037,10098052,2838816,2819145,132656,2951801,31862
2022-05-26,Madera,039,155013,38089,37955,6346,44301,371
2022-05-26,Marin,041,260295,37639,37215,3821,41036,293
2022-05-26,Mariposa,043,17540,2549,2526,231,2757,31
2022-05-26,Mendocino,045,87422,13682,13612,3429,17041,124
2022-05-26,Merced,047,269075,64067,63389,9312,72701,824
2022-05-26,Modoc,049,8938,751,751,255,1006,8
2022-05-26,Mono,051,14174,3034,3030,161,3191,6
2022-05-26,Monterey,053,433212,82290,81875,15409,97284,737
2022-05-26,Napa,055,140530,27539,27376,1133,28509,144
2022-05-26,Nevada,057,99092,16694,16568,1326,17894,127
2022-05-26,Orange,059,3164182,571253,568369,45242,613611,7028
2022-05-26,Placer,061,380077,66225,65672,7905,73577,626
2022-05-26,Plumas,063,18699,3118,3096,376,3472,13
2022-05-26,Riverside,065,2383286,608929,606444,29115,635559,6480
2022-05-26,Sacramento,067,1510023,296057,294000,28581,322581,3032
2022-05-26,San Benito,069,59416,13557,13402,604,14006,98
2022-05-26,San Bernardino,071,2135413,588692,578656,25681,604337,7610
2022-05-26,San Diego,073,3302833,788489,786243,57082,843325,5288
2022-05-26,San Francisco,075,870044,144446,142456,9421,151877,879
2022-05-26,San Joaquin,077,732212,172527,171282,11021,182303,2241
2022-05-26,San Luis Obispo,079,281455,55070,54701,4481,59182,481
2022-05-26,San Mateo,081,765935,137596,135746,8385,144131,710
2022-05-26,Santa Barbara,083,443738,90461,89940,5130,95070,693
2022-05-26,Santa Clara,085,1922200,352176,344223,14595,358818,2304
2022-05-26,Santa Cruz,087,273765,52181,51819,2432,54251,263
2022-05-26,Shasta,089,179085,31232,31165,6209,37374,564
2022-05-26,Sierra,091,2930,278,278,54,332,4
2022-05-26,Siskiyou,093,43540,4554,4537,2800,7337,81
2022-05-26,Solano,095,438530,87640,86565,6121,92686,452
2022-05-26,Sonoma,097,501317,91105,90364,3647,94011,490
2022-05-26,Stanislaus,099,539301,120900,120241,18520,138761,1657
2022-05-26,Sutter,101,95872,21010,20976,2190,23166,227
2022-05-26,Tehama,103,63373,12238,12210,2640,14850,204
2022-05-26,Trinity,105,12862,1203,1196,290,1486,20
2022-05-26,Tulare,107,460477,108135,108029,28638,136667,1484
2022-05-26,Tuolumne,109,53932,13270,13141,618,13759,189
2022-05-26,Ventura,111,848112,180940,179953,10697,190650,1503
2022-05-26,Yolo,113,214977,40348,39016,3197,42213,319
2022-05-26,Yuba,115,75493,16385,16314,1322,17636,122
2022-05-25,Alameda,001,1643700,283124,278228,15647,293875,1860
2022-05-25,Alpine,003,1148,126,126,1,127,0
2022-05-25,Amador,005,37829,8790,8654,693,9347,86
2022-05-25,Butte,007,227075,34150,33755,7409,41164,426
2022-05-25,Calaveras,009,45235,7490,7450,388,7838,120
2022-05-25,Colusa,011,21464,3483,3471,1066,4537,21
2022-05-25,Contra Costa,013,1133247,208898,201866,15361,217227,1306
2022-05-25,Del Norte,015,27424,6190,6145,236,6381,50
2022-05-25,El Dorado,017,186661,28061,27715,3403,31118,213
2022-05-25,Fresno,019,978130,239460,235569,25091,260660,2763
2022-05-25,Glenn,021,27897,5067,5030,1647,6677,48
2022-05-25,Humboldt,023,135768,18323,18133,3491,21624,147
2022-05-25,Imperial,025,180216,56411,56203,10795,66998,923
2022-05-25,Inyo,027,18085,4174,4152,559,4711,56
2022-05-25,Kern,029,883053,195272,194251,47327,241578,2336
2022-05-25,Kings,031,150075,52344,52178,3572,55750,447
2022-05-25,Lake,033,64148,11030,10908,924,11832,137
2022-05-25,Lassen,035,31185,9057,9028,893,9921,64
2022-05-25,Los Angeles,037,10098052,2834193,2806770,132285,2939055,31845
2022-05-25,Madera,039,155013,38050,37867,6333,44200,370
2022-05-25,Marin,041,260295,37539,36890,3793,40683,293
2022-05-25,Mariposa,043,17540,2539,2514,229,2743,30
2022-05-25,Mendocino,045,87422,13667,13545,3423,16968,124
2022-05-25,Merced,047,269075,64001,63220,9282,72502,823
2022-05-25,Modoc,049,8938,750,750,254,1004,8
2022-05-25,Mono,051,14174,3034,3024,160,3184,6
2022-05-25,Monterey,053,433212,82224,81592,15366,96958,737
2022-05-25,Napa,055,140530,27490,27240,1127,28367,143
2022-05-25,Nevada,057,99092,16659,16517,1320,17837,127
2022-05-25,Orange,059,3164182,570247,565564,45086,610650,7026
2022-05-25,Placer,061,380077,66074,65309,7884,73193,626
2022-05-25,Plumas,063,18699,3112,3065,375,3440,13
2022-05-25,Riverside,065,2383286,608248,604465,29063,633528,6480
2022-05-25,Sacramento,067,1510023,295413,292211,28473,320684,3028
2022-05-25,San Benito,069,59416,13523,13338,597,13935,98
2022-05-25,San Bernardino,071,2135413,588163,576982,25655,602637,7568
2022-05-25,San Diego,073,3302833,787024,782420,56893,839313,5284
2022-05-25,San Francisco,075,870044,143944,141015,9394,150409,872
2022-05-25,San Joaquin,077,732212,172290,170626,11000,181626,2238
2022-05-25,San Luis Obispo,079,281455,54963,54342,4429,58771,481
2022-05-25,San Mateo,081,765935,137138,134441,8319,142760,710
2022-05-25,Santa Barbara,083,443738,90294,89426,5115,94541,693
2022-05-25,Santa Clara,085,1922200,351106,340868,14489,355357,2304
2022-05-25,Santa Cruz,087,273765,52097,51644,2417,54061,263
2022-05-25,Shasta,089,179085,31207,31072,6200,37272,564
2022-05-25,Sierra,091,2930,278,277,54,331,4
2022-05-25,Siskiyou,093,43540,4544,4516,2797,7313,81
2022-05-25,Solano,095,438530,87430,86024,6102,92126,451
2022-05-25,Sonoma,097,501317,90912,89810,3608,93418,490
2022-05-25,Stanislaus,099,539301,120764,119894,18497,138391,1654
2022-05-25,Sutter,101,95872,20985,20904,2187,23091,226
2022-05-25,Tehama,103,63373,12232,12189,2636,14825,201
2022-05-25,Trinity,105,12862,1203,1194,290,1484,20
2022-05-25,Tulare,107,460477,108053,107790,28595,136385,1482
2022-05-25,Tuolumne,109,53932,13248,13086,615,13701,182
2022-05-25,Ventura,111,848112,180650,179116,10660,189776,1499
2022-05-25,Yolo,113,214977,40254,38782,3187,41969,319
2022-05-25,Yuba,115,75493,16358,16260,1316,17576,122
2022-05-24,Alameda,001,1643700,282241,278228,15589,293817,1860
2022-05-24,Alpine,003,1148,126,126,1,127,0
2022-05-24,Amador,005,37829,8784,8654,689,9343,86
2022-05-24,Butte,007,227075,34106,33755,7387,41142,426
2022-05-24,Calaveras,009,45235,7483,7450,386,7836,120
2022-05-24,Colusa,011,21464,3481,3471,1064,4535,21
2022-05-24,Contra Costa,013,1133247,208247,201866,15261,217127,1306
2022-05-24,Del Norte,015,27424,6185,6145,234,6379,50
2022-05-24,El Dorado,017,186661,27992,27715,3396,31111,213
2022-05-24,Fresno,019,978130,239142,235569,25055,260624,2763
2022-05-24,Glenn,021,27897,5065,5030,1647,6677,48
2022-05-24,Humboldt,023,135768,18291,18133,3473,21606,147
2022-05-24,Imperial,025,180216,56358,56203,10782,66985,923
2022-05-24,Inyo,027,18085,4166,4152,556,4708,56
2022-05-24,Kern,029,883053,195076,194251,47221,241472,2336
2022-05-24,Kings,031,150075,52278,52178,3567,55745,447
2022-05-24,Lake,033,64148,11013,10908,922,11830,137
2022-05-24,Lassen,035,31185,9044,9028,889,9917,64
2022-05-24,Los Angeles,037,10098052,2828933,2806770,131897,2938667,31845
2022-05-24,Madera,039,155013,38003,37867,6318,44185,370
2022-05-24,Marin,041,260295,37430,36890,3744,40634,293
2022-05-24,Mariposa,043,17540,2532,2514,227,2741,30
2022-05-24,Mendocino,045,87422,13643,13545,3413,16958,124
2022-05-24,Merced,047,269075,63940,63220,9251,72471,823
2022-05-24,Modoc,049,8938,749,750,253,1003,8
2022-05-24,Mono,051,14174,3031,3024,160,3184,6
2022-05-24,Monterey,053,433212,82134,81592,15305,96897,737
2022-05-24,Napa,055,140530,27442,27240,1115,28355,143
2022-05-24,Nevada,057,99092,16617,16517,1313,17830,127
2022-05-24,Orange,059,3164182,569215,565564,44914,610478,7026
2022-05-24,Placer,061,380077,65973,65309,7868,73177,626
2022-05-24,Plumas,063,18699,3106,3065,375,3440,13
2022-05-24,Riverside,065,2383286,607552,604465,29014,633479,6480
2022-05-24,Sacramento,067,1510023,294728,292211,28352,320563,3028
2022-05-24,San Benito,069,59416,13488,13338,595,13933,98
2022-05-24,San Bernardino,071,2135413,587537,576982,25626,602608,7568
2022-05-24,San Diego,073,3302833,785374,782420,56676,839096,5284
2022-05-24,San Francisco,075,870044,143407,141015,9367,150382,872
2022-05-24,San Joaquin,077,732212,172022,170626,10968,181594,2238
2022-05-24,San Luis Obispo,079,281455,54812,54342,4376,58718,481
2022-05-24,San Mateo,081,765935,136602,134441,8265,142706,710
2022-05-24,Santa Barbara,083,443738,90132,89426,5088,94514,693
2022-05-24,Santa Clara,085,1922200,349817,340868,14399,355267,2304
2022-05-24,Santa Cruz,087,273765,52020,51644,2407,54051,263
2022-05-24,Shasta,089,179085,31182,31072,6188,37260,564
2022-05-24,Sierra,091,2930,278,277,54,331,4
2022-05-24,Siskiyou,093,43540,4534,4516,2789,7305,81
2022-05-24,Solano,095,438530,87199,86024,6072,92096,451
2022-05-24,Sonoma,097,501317,90704,89810,3570,93380,490
2022-05-24,Stanislaus,099,539301,120625,119894,18461,138355,1654
2022-05-24,Sutter,101,95872,20964,20904,2183,23087,226
2022-05-24,Tehama,103,63373,12223,12189,2634,14823,201
2022-05-24,Trinity,105,12862,1200,1194,290,1484,20
2022-05-24,Tulare,107,460477,107935,107790,28541,136331,1482
2022-05-24,Tuolumne,109,53932,13233,13086,615,13701,182
2022-05-24,Ventura,111,848112,180339,179116,10610,189726,1499
2022-05-24,Yolo,113,214977,40150,38782,3182,41964,319
2022-05-24,Yuba,115,75493,16330,16260,1308,17568,122
2022-05-23,Alameda,001,1643700,281305,278228,15501,293729,1860
2022-05-23,Alpine,003,1148,126,126,1,127,0
2022-05-23,Amador,005,37829,8751,8654,686,9340,86
2022-05-23,Butte,007,227075,34058,33755,7359,41114,426
2022-05-23,Calaveras,009,45235,7476,7450,384,7834,120
2022-05-23,Colusa,011,21464,3480,3471,1062,4533,21
2022-05-23,Contra Costa,013,1133247,207508,201866,15179,217045,1306
2022-05-23,Del Norte,015,27424,6180,6145,230,6375,50
2022-05-23,El Dorado,017,186661,27908,27715,3387,31102,213
2022-05-23,Fresno,019,978130,238792,235569,24988,260557,2763
2022-05-23,Glenn,021,27897,5061,5030,1643,6673,48
2022-05-23,Humboldt,023,135768,18264,18133,3451,21584,147
2022-05-23,Imperial,025,180216,56315,56203,10762,66965,923
2022-05-23,Inyo,027,18085,4163,4152,555,4707,56
2022-05-23,Kern,029,883053,194858,194251,47135,241386,2336
2022-05-23,Kings,031,150075,52230,52178,3562,55740,447
2022-05-23,Lake,033,64148,10994,10908,920,11828,137
2022-05-23,Lassen,035,31185,9036,9028,886,9914,64
2022-05-23,Los Angeles,037,10098052,2823547,2806770,131532,2938302,31845
2022-05-23,Madera,039,155013,37972,37867,6295,44162,370
2022-05-23,Marin,041,260295,37288,36890,3699,40589,293
2022-05-23,Mariposa,043,17540,2530,2514,225,2739,30
2022-05-23,Mendocino,045,87422,13621,13545,3399,16944,124
2022-05-23,Merced,047,269075,63861,63220,9223,72443,823
2022-05-23,Modoc,049,8938,748,750,253,1003,8
2022-05-23,Mono,051,14174,3031,3024,160,3184,6
2022-05-23,Monterey,053,433212,82034,81592,15241,96833,737
2022-05-23,Napa,055,140530,27385,27240,1108,28348,143
2022-05-23,Nevada,057,99092,16582,16517,1310,17827,127
2022-05-23,Orange,059,3164182,568208,565564,44766,610330,7026
2022-05-23,Placer,061,380077,65827,65309,7836,73145,626
2022-05-23,Plumas,063,18699,3103,3065,374,3439,13
2022-05-23,Riverside,065,2383286,606821,604465,28961,633426,6480
2022-05-23,Sacramento,067,1510023,293980,292211,28226,320437,3028
2022-05-23,San Benito,069,59416,13453,13338,592,13930,98
2022-05-23,San Bernardino,071,2135413,586901,576982,25592,602574,7568
2022-05-23,San Diego,073,3302833,783658,782420,56462,838882,5284
2022-05-23,San Francisco,075,870044,142838,141015,9334,150349,872
2022-05-23,San Joaquin,077,732212,171749,170626,10934,181560,2238
2022-05-23,San Luis Obispo,079,281455,54666,54342,4329,58671,481
2022-05-23,San Mateo,081,765935,136022,134441,8215,142656,710
2022-05-23,Santa Barbara,083,443738,89897,89426,5064,94490,693
2022-05-23,Santa Clara,085,1922200,348434,340868,14311,355179,2304
2022-05-23,Santa Cruz,087,273765,51917,51644,2392,54036,263
2022-05-23,Shasta,089,179085,31159,31072,6182,37254,564
2022-05-23,Sierra,091,2930,278,277,54,331,4
2022-05-23,Siskiyou,093,43540,4520,4516,2785,7301,81
2022-05-23,Solano,095,438530,86928,86024,6052,92076,451
2022-05-23,Sonoma,097,501317,90476,89810,3521,93331,490
2022-05-23,Stanislaus,099,539301,120485,119894,18421,138315,1654
2022-05-23,Sutter,101,95872,20924,20904,2178,23082,226
2022-05-23,Tehama,103,63373,12211,12189,2633,14822,201
2022-05-23,Trinity,105,12862,1199,1194,290,1484,20
2022-05-23,Tulare,107,460477,107813,107790,28471,136261,1482
2022-05-23,Tuolumne,109,53932,13209,13086,611,13697,182
2022-05-23,Ventura,111,848112,180008,179116,10579,189695,1499
2022-05-23,Yolo,113,214977,40017,38782,3166,41948,319
2022-05-23,Yuba,115,75493,16301,16260,1304,17564,122
2022-05-22,Alameda,001,1643700,280216,274996,15395,290391,1858
2022-05-22,Alpine,003,1148,126,126,1,127,0
2022-05-22,Amador,005,37829,8734,8628,680,9308,86
2022-05-22,Butte,007,227075,34006,33606,7332,40938,426
2022-05-22,Calaveras,009,45235,7465,7424,380,7804,120
2022-05-22,Colusa,011,21464,3476,3468,1059,4527,21
2022-05-22,Contra Costa,013,1133247,206778,199703,15045,214748,1305
2022-05-22,Del Norte,015,27424,6164,6045,219,6264,50
2022-05-22,El Dorado,017,186661,27832,27517,3371,30888,213
2022-05-22,Fresno,019,978130,238447,234657,24935,259592,2760
2022-05-22,Glenn,021,27897,5051,5020,1642,6662,48
2022-05-22,Humboldt,023,135768,18211,17984,3424,21408,146
2022-05-22,Imperial,025,180216,56247,56014,10747,66761,923
2022-05-22,Inyo,027,18085,4155,4135,553,4688,56
2022-05-22,Kern,029,883053,194621,193705,47035,240740,2334
2022-05-22,Kings,031,150075,52167,52038,3556,55594,447
2022-05-22,Lake,033,64148,10962,10867,918,11785,137
2022-05-22,Lassen,035,31185,9020,9011,883,9894,64
2022-05-22,Los Angeles,037,10098052,2817727,2791671,131105,2922776,31815
2022-05-22,Madera,039,155013,37925,37744,6260,44004,370
2022-05-22,Marin,041,260295,37142,36394,3655,40049,293
2022-05-22,Mariposa,043,17540,2526,2490,224,2714,30
2022-05-22,Mendocino,045,87422,13593,13461,3370,16831,124
2022-05-22,Merced,047,269075,63784,62969,9192,72161,823
2022-05-22,Modoc,049,8938,747,750,253,1003,8
2022-05-22,Mono,051,14174,3030,3012,160,3172,6
2022-05-22,Monterey,053,433212,81877,81224,15141,96365,735
2022-05-22,Napa,055,140530,27314,27034,1100,28134,143
2022-05-22,Nevada,057,99092,16548,16410,1299,17709,127
2022-05-22,Orange,059,3164182,567114,562531,44581,607112,7025
2022-05-22,Placer,061,380077,65668,64802,7804,72606,626
2022-05-22,Plumas,063,18699,3096,3052,372,3424,13
2022-05-22,Riverside,065,2383286,605981,601808,28895,630703,6476
2022-05-22,Sacramento,067,1510023,293176,289972,28067,318039,3027
2022-05-22,San Benito,069,59416,13421,13234,586,13820,98
2022-05-22,San Bernardino,071,2135413,586189,575194,25553,600747,7523
2022-05-22,San Diego,073,3302833,782039,777404,56267,833671,5282
2022-05-22,San Francisco,075,870044,142154,138922,9317,148239,871
2022-05-22,San Joaquin,077,732212,171440,169745,10890,180635,2237
2022-05-22,San Luis Obispo,079,281455,54511,54012,4268,58280,481
2022-05-22,San Mateo,081,765935,135450,132636,8161,140797,711
2022-05-22,Santa Barbara,083,443738,89665,88783,5029,93812,692
2022-05-22,Santa Clara,085,1922200,346991,336488,14234,350722,2301
2022-05-22,Santa Cruz,087,273765,51824,51333,2378,53711,263
2022-05-22,Shasta,089,179085,31110,30966,6170,37136,564
2022-05-22,Sierra,091,2930,278,276,54,330,4
2022-05-22,Siskiyou,093,43540,4511,4501,2784,7285,81
2022-05-22,Solano,095,438530,86644,85038,6019,91057,451
2022-05-22,Sonoma,097,501317,90189,88889,3466,92355,489
2022-05-22,Stanislaus,099,539301,120311,119396,18396,137792,1653
2022-05-22,Sutter,101,95872,20895,20809,2170,22979,226
2022-05-22,Tehama,103,63373,12203,12162,2628,14790,201
2022-05-22,Trinity,105,12862,1199,1191,289,1480,20
2022-05-22,Tulare,107,460477,107709,107485,28388,135873,1477
2022-05-22,Tuolumne,109,53932,13189,12977,609,13586,182
2022-05-22,Ventura,111,848112,179661,178024,10527,188551,1499
2022-05-22,Yolo,113,214977,39892,38377,3142,41519,319
2022-05-22,Yuba,115,75493,16274,16180,1295,17475,122
2022-05-21,Alameda,001,1643700,279753,274996,15374,290370,1858
2022-05-21,Alpine,003,1148,126,126,1,127,0
2022-05-21,Amador,005,37829,8723,8628,680,9308,86
2022-05-21,Butte,007,227075,33985,33606,7318,40924,426
2022-05-21,Calaveras,009,45235,7459,7424,380,7804,120
2022-05-21,Colusa,011,21464,3476,3468,1058,4526,21
2022-05-21,Contra Costa,013,1133247,206419,199703,15012,214715,1305
2022-05-21,Del Norte,015,27424,6160,6045,217,6262,50
2022-05-21,El Dorado,017,186661,27795,27517,3369,30886,213
2022-05-21,Fresno,019,978130,238317,234657,24914,259571,2760
2022-05-21,Glenn,021,27897,5048,5020,1641,6661,48
2022-05-21,Humboldt,023,135768,18186,17984,3416,21400,146
2022-05-21,Imperial,025,180216,56213,56014,10745,66759,923
2022-05-21,Inyo,027,18085,4153,4135,551,4686,56
2022-05-21,Kern,029,883053,194524,193705,46975,240680,2334
2022-05-21,Kings,031,150075,52144,52038,3555,55593,447
2022-05-21,Lake,033,64148,10954,10867,918,11785,137
2022-05-21,Lassen,035,31185,9017,9011,883,9894,64
2022-05-21,Los Angeles,037,10098052,2815433,2791671,130859,2922530,31815
2022-05-21,Madera,039,155013,37907,37744,6254,43998,370
2022-05-21,Marin,041,260295,37047,36394,3611,40005,293
2022-05-21,Mariposa,043,17540,2524,2490,224,2714,30
2022-05-21,Mendocino,045,87422,13582,13461,3365,16826,124
2022-05-21,Merced,047,269075,63749,62969,9186,72155,823
2022-05-21,Modoc,049,8938,746,750,253,1003,8
2022-05-21,Mono,051,14174,3030,3012,160,3172,6
2022-05-21,Monterey,053,433212,81811,81224,15086,96310,735
2022-05-21,Napa,055,140530,27281,27034,1097,28131,143
2022-05-21,Nevada,057,99092,16542,16410,1299,17709,127
2022-05-21,Orange,059,3164182,566600,562531,44468,606999,7025
2022-05-21,Placer,061,380077,65560,64802,7791,72593,626
2022-05-21,Plumas,063,18699,3089,3052,372,3424,13
2022-05-21,Riverside,065,2383286,605506,601808,28870,630678,6476
2022-05-21,Sacramento,067,1510023,292847,289972,28038,318010,3027
2022-05-21,San Benito,069,59416,13409,13234,578,13812,98
2022-05-21,San Bernardino,071,2135413,585849,575194,25528,600722,7523
2022-05-21,San Diego,073,3302833,781344,777404,56203,833607,5282
2022-05-21,San Francisco,075,870044,141847,138922,9304,148226,871
2022-05-21,San Joaquin,077,732212,171322,169745,10871,180616,2237
2022-05-21,San Luis Obispo,079,281455,54432,54012,4254,58266,481
2022-05-21,San Mateo,081,765935,135137,132636,8135,140771,711
2022-05-21,Santa Barbara,083,443738,89573,88783,5016,93799,692
2022-05-21,Santa Clara,085,1922200,346140,336488,14191,350679,2301
2022-05-21,Santa Cruz,087,273765,51779,51333,2359,53692,263
2022-05-21,Shasta,089,179085,31099,30966,6168,37134,564
2022-05-21,Sierra,091,2930,277,276,54,330,4
2022-05-21,Siskiyou,093,43540,4507,4501,2782,7283,81
2022-05-21,Solano,095,438530,86560,85038,6013,91051,451
2022-05-21,Sonoma,097,501317,90063,88889,3457,92346,489
2022-05-21,Stanislaus,099,539301,120232,119396,18372,137768,1653
2022-05-21,Sutter,101,95872,20885,20809,2165,22974,226
2022-05-21,Tehama,103,63373,12201,12162,2627,14789,201
2022-05-21,Trinity,105,12862,1199,1191,289,1480,20
2022-05-21,Tulare,107,460477,107647,107485,28352,135837,1477
2022-05-21,Tuolumne,109,53932,13182,12977,609,13586,182
2022-05-21,Ventura,111,848112,179486,178024,10508,188532,1499
2022-05-21,Yolo,113,214977,39830,38377,3131,41508,319
2022-05-21,Yuba,115,75493,16261,16180,1293,17473,122
2022-05-20,Alameda,001,1643700,279212,274996,15348,290344,1858
2022-05-20,Alpine,003,1148,126,126,1,127,0
2022-05-20,Amador,005,37829,8716,8628,680,9308,86
2022-05-20,Butte,007,227075,33963,33606,7306,40912,426
2022-05-20,Calaveras,009,45235,7451,7424,380,7804,120
2022-05-20,Colusa,011,21464,3476,3468,1058,4526,21
2022-05-20,Contra Costa,013,1133247,206061,199703,14995,214698,1305
2022-05-20,Del Norte,015,27424,6155,6045,216,6261,50
2022-05-20,El Dorado,017,186661,27761,27517,3366,30883,213
2022-05-20,Fresno,019,978130,238158,234657,24884,259541,2760
2022-05-20,Glenn,021,27897,5045,5020,1641,6661,48
2022-05-20,Humboldt,023,135768,18164,17984,3408,21392,146
2022-05-20,Imperial,025,180216,56189,56014,10742,66756,923
2022-05-20,Inyo,027,18085,4150,4135,547,4682,56
2022-05-20,Kern,029,883053,194420,193705,46927,240632,2334
2022-05-20,Kings,031,150075,52129,52038,3554,55592,447
2022-05-20,Lake,033,64148,10937,10867,918,11785,137
2022-05-20,Lassen,035,31185,9015,9011,883,9894,64
2022-05-20,Los Angeles,037,10098052,2813081,2791671,130631,2922302,31815
2022-05-20,Madera,039,155013,37888,37744,6246,43990,370
2022-05-20,Marin,041,260295,36973,36394,3572,39966,293
2022-05-20,Mariposa,043,17540,2519,2490,224,2714,30
2022-05-20,Mendocino,045,87422,13567,13461,3361,16822,124
2022-05-20,Merced,047,269075,63715,62969,9183,72152,823
2022-05-20,Modoc,049,8938,746,750,253,1003,8
2022-05-20,Mono,051,14174,3026,3012,160,3172,6
2022-05-20,Monterey,053,433212,81753,81224,15046,96270,735
2022-05-20,Napa,055,140530,27251,27034,1093,28127,143
2022-05-20,Nevada,057,99092,16534,16410,1297,17707,127
2022-05-20,Orange,059,3164182,566028,562531,44369,606900,7025
2022-05-20,Placer,061,380077,65485,64802,7775,72577,626
2022-05-20,Plumas,063,18699,3087,3052,372,3424,13
2022-05-20,Riverside,065,2383286,605055,601808,28847,630655,6476
2022-05-20,Sacramento,067,1510023,292472,289972,28015,317987,3027
2022-05-20,San Benito,069,59416,13393,13234,577,13811,98
2022-05-20,San Bernardino,071,2135413,585528,575194,25509,600703,7523
2022-05-20,San Diego,073,3302833,780546,777404,56111,833515,5282
2022-05-20,San Francisco,075,870044,141512,138922,9273,148195,871
2022-05-20,San Joaquin,077,732212,171201,169745,10863,180608,2237
2022-05-20,San Luis Obispo,079,281455,54396,54012,4249,58261,481
2022-05-20,San Mateo,081,765935,134817,132636,8112,140748,711
2022-05-20,Santa Barbara,083,443738,89489,88783,5011,93794,692
2022-05-20,Santa Clara,085,1922200,345343,336488,14140,350628,2301
2022-05-20,Santa Cruz,087,273765,51734,51333,2341,53674,263
2022-05-20,Shasta,089,179085,31086,30966,6165,37131,564
2022-05-20,Sierra,091,2930,277,276,54,330,4
2022-05-20,Siskiyou,093,43540,4504,4501,2780,7281,81
2022-05-20,Solano,095,438530,86418,85038,6005,91043,451
2022-05-20,Sonoma,097,501317,89936,88889,3444,92333,489
2022-05-20,Stanislaus,099,539301,120150,119396,18359,137755,1653
2022-05-20,Sutter,101,95872,20876,20809,2164,22973,226
2022-05-20,Tehama,103,63373,12197,12162,2626,14788,201
2022-05-20,Trinity,105,12862,1199,1191,289,1480,20
2022-05-20,Tulare,107,460477,107590,107485,28313,135798,1477
2022-05-20,Tuolumne,109,53932,13163,12977,607,13584,182
2022-05-20,Ventura,111,848112,179289,178024,10490,188514,1499
2022-05-20,Yolo,113,214977,39761,38377,3125,41502,319
2022-05-20,Yuba,115,75493,16246,16180,1289,17469,122
2022-05-19,Alameda,001,1643700,278388,274996,15280,290276,1858
2022-05-19,Alpine,003,1148,126,126,1,127,0
2022-05-19,Amador,005,37829,8708,8628,680,9308,86
2022-05-19,Butte,007,227075,33925,33606,7297,40903,426
2022-05-19,Calaveras,009,45235,7445,7424,377,7801,120
2022-05-19,Colusa,011,21464,3475,3468,1057,4525,21
2022-05-19,Contra Costa,013,1133247,205517,199703,14921,214624,1305
2022-05-19,Del Norte,015,27424,6151,6045,211,6256,50
2022-05-19,El Dorado,017,186661,27709,27517,3351,30868,213
2022-05-19,Fresno,019,978130,237934,234657,24844,259501,2760
2022-05-19,Glenn,021,27897,5044,5020,1637,6657,48
2022-05-19,Humboldt,023,135768,18130,17984,3393,21377,146
2022-05-19,Imperial,025,180216,56141,56014,10741,66755,923
2022-05-19,Inyo,027,18085,4146,4135,546,4681,56
2022-05-19,Kern,029,883053,194279,193705,46852,240557,2334
2022-05-19,Kings,031,150075,52102,52038,3553,55591,447
2022-05-19,Lake,033,64148,10929,10867,916,11783,137
2022-05-19,Lassen,035,31185,9011,9011,883,9894,64
2022-05-19,Los Angeles,037,10098052,2809133,2791671,130302,2921973,31815
2022-05-19,Madera,039,155013,37852,37744,6230,43974,370
2022-05-19,Marin,041,260295,36877,36394,3539,39933,293
2022-05-19,Mariposa,043,17540,2511,2490,224,2714,30
2022-05-19,Mendocino,045,87422,13544,13461,3354,16815,124
2022-05-19,Merced,047,269075,63653,62969,9167,72136,823
2022-05-19,Modoc,049,8938,746,750,253,1003,8
2022-05-19,Mono,051,14174,3025,3012,156,3168,6
2022-05-19,Monterey,053,433212,81673,81224,14981,96205,735
2022-05-19,Napa,055,140530,27194,27034,1090,28124,143
2022-05-19,Nevada,057,99092,16500,16410,1290,17700,127
2022-05-19,Orange,059,3164182,565195,562531,44240,606771,7025
2022-05-19,Placer,061,380077,65366,64802,7759,72561,626
2022-05-19,Plumas,063,18699,3081,3052,372,3424,13
2022-05-19,Riverside,065,2383286,604422,601808,28804,630612,6476
2022-05-19,Sacramento,067,1510023,291909,289972,27931,317903,3027
2022-05-19,San Benito,069,59416,13365,13234,574,13808,98
2022-05-19,San Bernardino,071,2135413,585012,575194,25488,600682,7523
2022-05-19,San Diego,073,3302833,779309,777404,55946,833350,5282
2022-05-19,San Francisco,075,870044,141042,138922,9239,148161,871
2022-05-19,San Joaquin,077,732212,170956,169745,10846,180591,2237
2022-05-19,San Luis Obispo,079,281455,54293,54012,4217,58229,481
2022-05-19,San Mateo,081,765935,134345,132636,8054,140690,711
2022-05-19,Santa Barbara,083,443738,89336,88783,4984,93767,692
2022-05-19,Santa Clara,085,1922200,344261,336488,14053,350541,2301
2022-05-19,Santa Cruz,087,273765,51656,51333,2327,53660,263
2022-05-19,Shasta,089,179085,31057,30966,6159,37125,564
2022-05-19,Sierra,091,2930,277,276,54,330,4
2022-05-19,Siskiyou,093,43540,4501,4501,2778,7279,81
2022-05-19,Solano,095,438530,86231,85038,5980,91018,451
2022-05-19,Sonoma,097,501317,89731,88889,3410,92299,489
2022-05-19,Stanislaus,099,539301,120020,119396,18337,137733,1653
2022-05-19,Sutter,101,95872,20840,20809,2161,22970,226
2022-05-19,Tehama,103,63373,12187,12162,2623,14785,201
2022-05-19,Trinity,105,12862,1198,1191,289,1480,20
2022-05-19,Tulare,107,460477,107496,107485,28267,135752,1477
2022-05-19,Tuolumne,109,53932,13139,12977,604,13581,182
2022-05-19,Ventura,111,848112,179014,178024,10451,188475,1499
2022-05-19,Yolo,113,214977,39671,38377,3117,41494,319
2022-05-19,Yuba,115,75493,16226,16180,1281,17461,122
2022-05-18,Alameda,001,1643700,277543,272530,15210,287740,1859
2022-05-18,Alpine,003,1148,126,126,1,127,0
2022-05-18,Amador,005,37829,8690,8592,680,9272,86
2022-05-18,Butte,007,227075,33884,33486,7282,40768,426
2022-05-18,Calaveras,009,45235,7437,7400,377,7777,120
2022-05-18,Colusa,011,21464,3475,3467,1057,4524,21
2022-05-18,Contra Costa,013,1133247,204958,198207,14834,213041,1303
2022-05-18,Del Norte,015,27424,6143,6001,207,6208,50
2022-05-18,El Dorado,017,186661,27657,27388,3343,30731,212
2022-05-18,Fresno,019,978130,237671,234055,24803,258858,2759
2022-05-18,Glenn,021,27897,5043,5012,1637,6649,48
2022-05-18,Humboldt,023,135768,18105,17868,3372,21240,146
2022-05-18,Imperial,025,180216,56079,55915,10735,66650,918
2022-05-18,Inyo,027,18085,4142,4120,540,4660,56
2022-05-18,Kern,029,883053,194162,193338,46792,240130,2327
2022-05-18,Kings,031,150075,52073,51903,3550,55453,447
2022-05-18,Lake,033,64148,10920,10831,915,11746,137
2022-05-18,Lassen,035,31185,9005,8994,883,9877,65
2022-05-18,Los Angeles,037,10098052,2804816,2780354,130019,2910373,31789
2022-05-18,Madera,039,155013,37814,37644,6221,43865,365
2022-05-18,Marin,041,260295,36787,36024,3498,39522,293
2022-05-18,Mariposa,043,17540,2504,2481,224,2705,30
2022-05-18,Mendocino,045,87422,13523,13403,3339,16742,124
2022-05-18,Merced,047,269075,63588,62802,9140,71942,818
2022-05-18,Modoc,049,8938,746,748,253,1001,8
2022-05-18,Mono,051,14174,3024,3010,154,3164,6
2022-05-18,Monterey,053,433212,81564,80955,14925,95880,735
2022-05-18,Napa,055,140530,27153,26912,1083,27995,143
2022-05-18,Nevada,057,99092,16480,16361,1285,17646,127
2022-05-18,Orange,059,3164182,564390,560094,44131,604225,7021
2022-05-18,Placer,061,380077,65221,64432,7744,72176,626
2022-05-18,Plumas,063,18699,3073,3022,369,3391,13
2022-05-18,Riverside,065,2383286,603774,599947,28752,628699,6471
2022-05-18,Sacramento,067,1510023,291386,288335,27848,316183,3022
2022-05-18,San Benito,069,59416,13341,13186,570,13756,98
2022-05-18,San Bernardino,071,2135413,584543,573790,25461,599251,7455
2022-05-18,San Diego,073,3302833,777875,773934,55782,829716,5277
2022-05-18,San Francisco,075,870044,140515,137341,9212,146553,869
2022-05-18,San Joaquin,077,732212,170721,169045,10760,179805,2236
2022-05-18,San Luis Obispo,079,281455,54194,53756,4183,57939,478
2022-05-18,San Mateo,081,765935,133914,131330,7987,139317,709
2022-05-18,Santa Barbara,083,443738,89176,88317,4963,93280,693
2022-05-18,Santa Clara,085,1922200,343112,333230,13960,347190,2300
2022-05-18,Santa Cruz,087,273765,51568,51020,2314,53334,263
2022-05-18,Shasta,089,179085,31034,30899,6154,37053,558
2022-05-18,Sierra,091,2930,277,275,54,329,4
2022-05-18,Siskiyou,093,43540,4496,4495,2776,7271,81
2022-05-18,Solano,095,438530,85968,84476,5962,90438,451
2022-05-18,Sonoma,097,501317,89532,88195,3371,91566,489
2022-05-18,Stanislaus,099,539301,119910,119025,18304,137329,1645
2022-05-18,Sutter,101,95872,20818,20763,2152,22915,226
2022-05-18,Tehama,103,63373,12181,12133,2620,14753,201
2022-05-18,Trinity,105,12862,1198,1189,289,1478,20
2022-05-18,Tulare,107,460477,107426,107292,28209,135501,1477
2022-05-18,Tuolumne,109,53932,13120,12917,602,13519,182
2022-05-18,Ventura,111,848112,178745,177233,10407,187640,1497
2022-05-18,Yolo,113,214977,39559,38139,3105,41244,316
2022-05-18,Yuba,115,75493,16202,16109,1272,17381,122
2022-05-17,Alameda,001,1643700,276702,272530,15141,287671,1859
2022-05-17,Alpine,003,1148,126,126,1,127,0
2022-05-17,Amador,005,37829,8681,8592,678,9270,86
2022-05-17,Butte,007,227075,33832,33486,7261,40747,426
2022-05-17,Calaveras,009,45235,7430,7400,377,7777,120
2022-05-17,Colusa,011,21464,3474,3467,1056,4523,21
2022-05-17,Contra Costa,013,1133247,204320,198207,14749,212956,1303
2022-05-17,Del Norte,015,27424,6129,6001,207,6208,50
2022-05-17,El Dorado,017,186661,27602,27388,3337,30725,212
2022-05-17,Fresno,019,978130,237418,234055,24772,258827,2759
2022-05-17,Glenn,021,27897,5040,5012,1636,6648,48
2022-05-17,Humboldt,023,135768,18065,17868,3355,21223,146
2022-05-17,Imperial,025,180216,56036,55915,10725,66640,918
2022-05-17,Inyo,027,18085,4140,4120,531,4651,56
2022-05-17,Kern,029,883053,194005,193338,46736,240074,2327
2022-05-17,Kings,031,150075,52030,51903,3546,55449,447
2022-05-17,Lake,033,64148,10905,10831,913,11744,137
2022-05-17,Lassen,035,31185,9000,8994,882,9876,65
2022-05-17,Los Angeles,037,10098052,2800299,2780354,129707,2910061,31789
2022-05-17,Madera,039,155013,37788,37644,6206,43850,365
2022-05-17,Marin,041,260295,36654,36024,3437,39461,293
2022-05-17,Mariposa,043,17540,2499,2481,223,2704,30
2022-05-17,Mendocino,045,87422,13497,13403,3329,16732,124
2022-05-17,Merced,047,269075,63523,62802,9121,71923,818
2022-05-17,Modoc,049,8938,746,748,253,1001,8
2022-05-17,Mono,051,14174,3020,3010,154,3164,6
2022-05-17,Monterey,053,433212,81447,80955,14860,95815,735
2022-05-17,Napa,055,140530,27105,26912,1075,27987,143
2022-05-17,Nevada,057,99092,16451,16361,1277,17638,127
2022-05-17,Orange,059,3164182,563487,560094,43991,604085,7021
2022-05-17,Placer,061,380077,65057,64432,7706,72138,626
2022-05-17,Plumas,063,18699,3067,3022,368,3390,13
2022-05-17,Riverside,065,2383286,603087,599947,28708,628655,6471
2022-05-17,Sacramento,067,1510023,290752,288335,27748,316083,3022
2022-05-17,San Benito,069,59416,13304,13186,569,13755,98
2022-05-17,San Bernardino,071,2135413,584054,573790,25447,599237,7455
2022-05-17,San Diego,073,3302833,776362,773934,55615,829549,5277
2022-05-17,San Francisco,075,870044,139937,137341,9181,146522,869
2022-05-17,San Joaquin,077,732212,170482,169045,10719,179764,2236
2022-05-17,San Luis Obispo,079,281455,54101,53756,4139,57895,478
2022-05-17,San Mateo,081,765935,133415,131330,7948,139278,709
2022-05-17,Santa Barbara,083,443738,88978,88317,4945,93262,693
2022-05-17,Santa Clara,085,1922200,341931,333230,13887,347117,2300
2022-05-17,Santa Cruz,087,273765,51491,51020,2306,53326,263
2022-05-17,Shasta,089,179085,30996,30899,6151,37050,558
2022-05-17,Sierra,091,2930,277,275,54,329,4
2022-05-17,Siskiyou,093,43540,4494,4495,2774,7269,81
2022-05-17,Solano,095,438530,85687,84476,5932,90408,451
2022-05-17,Sonoma,097,501317,89289,88195,3326,91521,489
2022-05-17,Stanislaus,099,539301,119761,119025,18275,137300,1645
2022-05-17,Sutter,101,95872,20798,20763,2148,22911,226
2022-05-17,Tehama,103,63373,12169,12133,2617,14750,201
2022-05-17,Trinity,105,12862,1197,1189,289,1478,20
2022-05-17,Tulare,107,460477,107332,107292,28169,135461,1477
2022-05-17,Tuolumne,109,53932,13106,12917,602,13519,182
2022-05-17,Ventura,111,848112,178422,177233,10353,187586,1497
2022-05-17,Yolo,113,214977,39422,38139,3098,41237,316
2022-05-17,Yuba,115,75493,16177,16109,1269,17378,122
2022-05-16,Alameda,001,1643700,275694,272530,15062,287592,1859
2022-05-16,Alpine,003,1148,126,126,1,127,0
2022-05-16,Amador,005,37829,8671,8592,677,9269,86
2022-05-16,Butte,007,227075,33774,33486,7245,40731,426
2022-05-16,Calaveras,009,45235,7424,7400,375,7775,120
2022-05-16,Colusa,011,21464,3473,3467,1056,4523,21
2022-05-16,Contra Costa,013,1133247,203677,198207,14668,212875,1303
2022-05-16,Del Norte,015,27424,6116,6001,204,6205,50
2022-05-16,El Dorado,017,186661,27546,27388,3329,30717,212
2022-05-16,Fresno,019,978130,237154,234055,24730,258785,2759
2022-05-16,Glenn,021,27897,5035,5012,1631,6643,48
2022-05-16,Humboldt,023,135768,18019,17868,3341,21209,146
2022-05-16,Imperial,025,180216,55972,55915,10712,66627,918
2022-05-16,Inyo,027,18085,4136,4120,528,4648,56
2022-05-16,Kern,029,883053,193853,193338,46670,240008,2327
2022-05-16,Kings,031,150075,51980,51903,3545,55448,447
2022-05-16,Lake,033,64148,10898,10831,912,11743,137
2022-05-16,Lassen,035,31185,8995,8994,880,9874,65
2022-05-16,Los Angeles,037,10098052,2795883,2780354,129420,2909774,31789
2022-05-16,Madera,039,155013,37757,37644,6184,43828,365
2022-05-16,Marin,041,260295,36490,36024,3389,39413,293
2022-05-16,Mariposa,043,17540,2498,2481,222,2703,30
2022-05-16,Mendocino,045,87422,13471,13403,3317,16720,124
2022-05-16,Merced,047,269075,63452,62802,9085,71887,818
2022-05-16,Modoc,049,8938,746,748,253,1001,8
2022-05-16,Mono,051,14174,3017,3010,154,3164,6
2022-05-16,Monterey,053,433212,81335,80955,14774,95729,735
2022-05-16,Napa,055,140530,27054,26912,1070,27982,143
2022-05-16,Nevada,057,99092,16432,16361,1271,17632,127
2022-05-16,Orange,059,3164182,562634,560094,43864,603958,7021
2022-05-16,Placer,061,380077,64949,64432,7675,72107,626
2022-05-16,Plumas,063,18699,3057,3022,367,3389,13
2022-05-16,Riverside,065,2383286,602372,599947,28652,628599,6471
2022-05-16,Sacramento,067,1510023,290087,288335,27653,315988,3022
2022-05-16,San Benito,069,59416,13286,13186,564,13750,98
2022-05-16,San Bernardino,071,2135413,583582,573790,25417,599207,7455
2022-05-16,San Diego,073,3302833,774821,773934,55447,829381,5277
2022-05-16,San Francisco,075,870044,139234,137341,9149,146490,869
2022-05-16,San Joaquin,077,732212,170202,169045,10534,179579,2236
2022-05-16,San Luis Obispo,079,281455,53998,53756,4110,57866,478
2022-05-16,San Mateo,081,765935,132866,131330,7893,139223,709
2022-05-16,Santa Barbara,083,443738,88833,88317,4934,93251,693
2022-05-16,Santa Clara,085,1922200,340607,333230,13800,347030,2300
2022-05-16,Santa Cruz,087,273765,51412,51020,2291,53311,263
2022-05-16,Shasta,089,179085,30963,30899,6143,37042,558
2022-05-16,Sierra,091,2930,277,275,53,328,4
2022-05-16,Siskiyou,093,43540,4491,4495,2767,7262,81
2022-05-16,Solano,095,438530,85425,84476,5906,90382,451
2022-05-16,Sonoma,097,501317,88989,88195,3288,91483,489
2022-05-16,Stanislaus,099,539301,119617,119025,18242,137267,1645
2022-05-16,Sutter,101,95872,20784,20763,2141,22904,226
2022-05-16,Tehama,103,63373,12161,12133,2614,14747,201
2022-05-16,Trinity,105,12862,1196,1189,289,1478,20
2022-05-16,Tulare,107,460477,107251,107292,28123,135415,1477
2022-05-16,Tuolumne,109,53932,13073,12917,599,13516,182
2022-05-16,Ventura,111,848112,178091,177233,10295,187528,1497
2022-05-16,Yolo,113,214977,39287,38139,3089,41228,316
2022-05-16,Yuba,115,75493,16150,16109,1266,17375,122
2022-05-15,Alameda,001,1643700,274623,268944,14993,283937,1857
2022-05-15,Alpine,003,1148,126,125,1,126,0
2022-05-15,Amador,005,37829,8655,8574,672,9246,86
2022-05-15,Butte,007,227075,33716,33377,7224,40601,424
2022-05-15,Calaveras,009,45235,7405,7378,373,7751,120
2022-05-15,Colusa,011,21464,3470,3463,1054,4517,21
2022-05-15,Contra Costa,013,1133247,202913,195925,14586,210511,1301
2022-05-15,Del Norte,015,27424,6043,5919,202,6121,50
2022-05-15,El Dorado,017,186661,27485,27216,3314,30530,212
2022-05-15,Fresno,019,978130,236887,233305,24695,258000,2757
2022-05-15,Glenn,021,27897,5032,5004,1630,6634,48
2022-05-15,Humboldt,023,135768,17969,17633,3301,20934,146
2022-05-15,Imperial,025,180216,55936,55756,10691,66447,917
2022-05-15,Inyo,027,18085,4132,4114,524,4638,56
2022-05-15,Kern,029,883053,193675,192939,46587,239526,2314
2022-05-15,Kings,031,150075,51920,51779,3541,55320,447
2022-05-15,Lake,033,64148,10881,10790,909,11699,137
2022-05-15,Lassen,035,31185,8987,8987,879,9866,65
2022-05-15,Los Angeles,037,10098052,2791304,2768726,129049,2897775,31768
2022-05-15,Madera,039,155013,37715,37520,6166,43686,365
2022-05-15,Marin,041,260295,36319,35486,3350,38836,293
2022-05-15,Mariposa,043,17540,2493,2463,221,2684,30
2022-05-15,Mendocino,045,87422,13451,13349,3290,16639,124
2022-05-15,Merced,047,269075,63367,62627,9039,71666,818
2022-05-15,Modoc,049,8938,745,747,253,1000,8
2022-05-15,Mono,051,14174,3014,3002,152,3154,6
2022-05-15,Monterey,053,433212,81225,80620,14686,95306,735
2022-05-15,Napa,055,140530,26999,26698,1066,27764,143
2022-05-15,Nevada,057,99092,16402,16240,1268,17508,127
2022-05-15,Orange,059,3164182,561688,557134,43726,600860,7017
2022-05-15,Placer,061,380077,64767,63963,7645,71608,626
2022-05-15,Plumas,063,18699,3051,3006,367,3373,13
2022-05-15,Riverside,065,2383286,601655,597914,28584,626498,6471
2022-05-15,Sacramento,067,1510023,289370,286403,27517,313920,3022
2022-05-15,San Benito,069,59416,13261,13106,562,13668,98
2022-05-15,San Bernardino,071,2135413,583036,572057,25388,597445,7423
2022-05-15,San Diego,073,3302833,773317,770323,55248,825571,5271
2022-05-15,San Francisco,075,870044,138520,134916,9115,144031,866
2022-05-15,San Joaquin,077,732212,169959,168174,10457,178631,2236
2022-05-15,San Luis Obispo,079,281455,53871,53502,4068,57570,478
2022-05-15,San Mateo,081,765935,132331,129480,7823,137303,709
2022-05-15,Santa Barbara,083,443738,88603,87773,4899,92672,693
2022-05-15,Santa Clara,085,1922200,339188,328609,13708,342317,2297
2022-05-15,Santa Cruz,087,273765,51307,50268,2275,52543,263
2022-05-15,Shasta,089,179085,30923,30799,6137,36936,557
2022-05-15,Sierra,091,2930,277,275,53,328,4
2022-05-15,Siskiyou,093,43540,4489,4482,2764,7246,81
2022-05-15,Solano,095,438530,85105,83669,5872,89541,451
2022-05-15,Sonoma,097,501317,88664,87070,3263,90333,488
2022-05-15,Stanislaus,099,539301,119448,118586,18210,136796,1645
2022-05-15,Sutter,101,95872,20757,20690,2131,22821,226
2022-05-15,Tehama,103,63373,12143,12115,2608,14723,201
2022-05-15,Trinity,105,12862,1195,1188,289,1477,20
2022-05-15,Tulare,107,460477,107149,107077,28077,135154,1469
2022-05-15,Tuolumne,109,53932,13018,12851,597,13448,182
2022-05-15,Ventura,111,848112,177745,176317,10233,186550,1497
2022-05-15,Yolo,113,214977,39172,37737,3077,40814,316
2022-05-15,Yuba,115,75493,16116,16028,1257,17285,122
2022-05-14,Alameda,001,1643700,274195,268944,14973,283917,1857
2022-05-14,Alpine,003,1148,125,125,1,126,0
2022-05-14,Amador,005,37829,8649,8574,672,9246,86
2022-05-14,Butte,007,227075,33696,33377,7216,40593,424
2022-05-14,Calaveras,009,45235,7403,7378,373,7751,120
2022-05-14,Colusa,011,21464,3470,3463,1054,4517,21
2022-05-14,Contra Costa,013,1133247,202534,195925,14556,210481,1301
2022-05-14,Del Norte,015,27424,6035,5919,200,6119,50
2022-05-14,El Dorado,017,186661,27455,27216,3309,30525,212
2022-05-14,Fresno,019,978130,236763,233305,24686,257991,2757
2022-05-14,Glenn,021,27897,5031,5004,1626,6630,48
2022-05-14,Humboldt,023,135768,17943,17633,3294,20927,146
2022-05-14,Imperial,025,180216,55905,55756,10688,66444,917
2022-05-14,Inyo,027,18085,4127,4114,524,4638,56
2022-05-14,Kern,029,883053,193605,192939,46541,239480,2314
2022-05-14,Kings,031,150075,51893,51779,3541,55320,447
2022-05-14,Lake,033,64148,10871,10790,904,11694,137
2022-05-14,Lassen,035,31185,8985,8987,879,9866,65
2022-05-14,Los Angeles,037,10098052,2789374,2768726,128834,2897560,31768
2022-05-14,Madera,039,155013,37700,37520,6166,43686,365
2022-05-14,Marin,041,260295,36212,35486,3301,38787,293
2022-05-14,Mariposa,043,17540,2492,2463,221,2684,30
2022-05-14,Mendocino,045,87422,13441,13349,3286,16635,124
2022-05-14,Merced,047,269075,63331,62627,9036,71663,818
2022-05-14,Modoc,049,8938,744,747,253,1000,8
2022-05-14,Mono,051,14174,3014,3002,151,3153,6
2022-05-14,Monterey,053,433212,81160,80620,14633,95253,735
2022-05-14,Napa,055,140530,26975,26698,1059,27757,143
2022-05-14,Nevada,057,99092,16387,16240,1267,17507,127
2022-05-14,Orange,059,3164182,561244,557134,43642,600776,7017
2022-05-14,Placer,061,380077,64660,63963,7623,71586,626
2022-05-14,Plumas,063,18699,3047,3006,367,3373,13
2022-05-14,Riverside,065,2383286,601243,597914,28549,626463,6471
2022-05-14,Sacramento,067,1510023,289098,286403,27495,313898,3022
2022-05-14,San Benito,069,59416,13251,13106,559,13665,98
2022-05-14,San Bernardino,071,2135413,582758,572057,25376,597433,7423
2022-05-14,San Diego,073,3302833,772717,770323,55201,825524,5271
2022-05-14,San Francisco,075,870044,138162,134916,9091,144007,866
2022-05-14,San Joaquin,077,732212,169816,168174,10440,178614,2236
2022-05-14,San Luis Obispo,079,281455,53844,53502,4065,57567,478
2022-05-14,San Mateo,081,765935,132006,129480,7795,137275,709
2022-05-14,Santa Barbara,083,443738,88496,87773,4894,92667,693
2022-05-14,Santa Clara,085,1922200,338356,328609,13669,342278,2297
2022-05-14,Santa Cruz,087,273765,51260,50268,2261,52529,263
2022-05-14,Shasta,089,179085,30919,30799,6136,36935,557
2022-05-14,Sierra,091,2930,277,275,53,328,4
2022-05-14,Siskiyou,093,43540,4486,4482,2762,7244,81
2022-05-14,Solano,095,438530,85043,83669,5862,89531,451
2022-05-14,Sonoma,097,501317,88520,87070,3251,90321,488
2022-05-14,Stanislaus,099,539301,119364,118586,18198,136784,1645
2022-05-14,Sutter,101,95872,20750,20690,2130,22820,226
2022-05-14,Tehama,103,63373,12137,12115,2607,14722,201
2022-05-14,Trinity,105,12862,1195,1188,289,1477,20
2022-05-14,Tulare,107,460477,107100,107077,28053,135130,1469
2022-05-14,Tuolumne,109,53932,13007,12851,597,13448,182
2022-05-14,Ventura,111,848112,177583,176317,10208,186525,1497
2022-05-14,Yolo,113,214977,39103,37737,3070,40807,316
2022-05-14,Yuba,115,75493,16109,16028,1256,17284,122
2022-05-13,Alameda,001,1643700,273712,268944,14940,283884,1857
2022-05-13,Alpine,003,1148,125,125,1,126,0
2022-05-13,Amador,005,37829,8644,8574,671,9245,86
2022-05-13,Butte,007,227075,33679,33377,7214,40591,424
2022-05-13,Calaveras,009,45235,7400,7378,373,7751,120
2022-05-13,Colusa,011,21464,3469,3463,1054,4517,21
2022-05-13,Contra Costa,013,1133247,202192,195925,14526,210451,1301
2022-05-13,Del Norte,015,27424,6032,5919,200,6119,50
2022-05-13,El Dorado,017,186661,27427,27216,3309,30525,212
2022-05-13,Fresno,019,978130,236654,233305,24667,257972,2757
2022-05-13,Glenn,021,27897,5029,5004,1625,6629,48
2022-05-13,Humboldt,023,135768,17919,17633,3286,20919,146
2022-05-13,Imperial,025,180216,55886,55756,10687,66443,917
2022-05-13,Inyo,027,18085,4127,4114,523,4637,56
2022-05-13,Kern,029,883053,193530,192939,46512,239451,2314
2022-05-13,Kings,031,150075,51869,51779,3541,55320,447
2022-05-13,Lake,033,64148,10868,10790,904,11694,137
2022-05-13,Lassen,035,31185,8984,8987,879,9866,65
2022-05-13,Los Angeles,037,10098052,2787433,2768726,128642,2897368,31768
2022-05-13,Madera,039,155013,37680,37520,6157,43677,365
2022-05-13,Marin,041,260295,36109,35486,3258,38744,293
2022-05-13,Mariposa,043,17540,2490,2463,221,2684,30
2022-05-13,Mendocino,045,87422,13427,13349,3279,16628,124
2022-05-13,Merced,047,269075,63296,62627,9027,71654,818
2022-05-13,Modoc,049,8938,744,747,253,1000,8
2022-05-13,Mono,051,14174,3012,3002,150,3152,6
2022-05-13,Monterey,053,433212,81104,80620,14594,95214,735
2022-05-13,Napa,055,140530,26939,26698,1057,27755,143
2022-05-13,Nevada,057,99092,16372,16240,1266,17506,127
2022-05-13,Orange,059,3164182,560776,557134,43569,600703,7017
2022-05-13,Placer,061,380077,64581,63963,7614,71577,626
2022-05-13,Plumas,063,18699,3040,3006,367,3373,13
2022-05-13,Riverside,065,2383286,600855,597914,28520,626434,6471
2022-05-13,Sacramento,067,1510023,288760,286403,27469,313872,3022
2022-05-13,San Benito,069,59416,13247,13106,559,13665,98
2022-05-13,San Bernardino,071,2135413,582517,572057,25368,597425,7423
2022-05-13,San Diego,073,3302833,772079,770323,55121,825444,5271
2022-05-13,San Francisco,075,870044,137812,134916,9071,143987,866
2022-05-13,San Joaquin,077,732212,169696,168174,10428,178602,2236
2022-05-13,San Luis Obispo,079,281455,53808,53502,4061,57563,478
2022-05-13,San Mateo,081,765935,131713,129480,7774,137254,709
2022-05-13,Santa Barbara,083,443738,88402,87773,4891,92664,693
2022-05-13,Santa Clara,085,1922200,337554,328609,13636,342245,2297
2022-05-13,Santa Cruz,087,273765,51173,50268,2253,52521,263
2022-05-13,Shasta,089,179085,30915,30799,6136,36935,557
2022-05-13,Sierra,091,2930,276,275,50,325,4
2022-05-13,Siskiyou,093,43540,4485,4482,2762,7244,81
2022-05-13,Solano,095,438530,84919,83669,5855,89524,451
2022-05-13,Sonoma,097,501317,88343,87070,3237,90307,488
2022-05-13,Stanislaus,099,539301,119270,118586,18184,136770,1645
2022-05-13,Sutter,101,95872,20738,20690,2129,22819,226
2022-05-13,Tehama,103,63373,12135,12115,2605,14720,201
2022-05-13,Trinity,105,12862,1194,1188,289,1477,20
2022-05-13,Tulare,107,460477,107054,107077,28019,135096,1469
2022-05-13,Tuolumne,109,53932,12991,12851,597,13448,182
2022-05-13,Ventura,111,848112,177403,176317,10194,186511,1497
2022-05-13,Yolo,113,214977,39040,37737,3067,40804,316
2022-05-13,Yuba,115,75493,16096,16028,1253,17281,122
2022-05-12,Alameda,001,1643700,272962,268944,14887,283831,1857
2022-05-12,Alpine,003,1148,125,125,1,126,0
2022-05-12,Amador,005,37829,8635,8574,671,9245,86
2022-05-12,Butte,007,227075,33652,33377,7200,40577,424
2022-05-12,Calaveras,009,45235,7396,7378,372,7750,120
2022-05-12,Colusa,011,21464,3469,3463,1053,4516,21
2022-05-12,Contra Costa,013,1133247,201672,195925,14463,210388,1301
2022-05-12,Del Norte,015,27424,6015,5919,199,6118,50
2022-05-12,El Dorado,017,186661,27387,27216,3300,30516,212
2022-05-12,Fresno,019,978130,236501,233305,24647,257952,2757
2022-05-12,Glenn,021,27897,5025,5004,1623,6627,48
2022-05-12,Humboldt,023,135768,17877,17633,3273,20906,146
2022-05-12,Imperial,025,180216,55859,55756,10674,66430,917
2022-05-12,Inyo,027,18085,4123,4114,518,4632,56
2022-05-12,Kern,029,883053,193464,192939,46464,239403,2314
2022-05-12,Kings,031,150075,51848,51779,3539,55318,447
2022-05-12,Lake,033,64148,10850,10790,898,11688,137
2022-05-12,Lassen,035,31185,8983,8987,879,9866,65
2022-05-12,Los Angeles,037,10098052,2784230,2768726,128375,2897101,31768
2022-05-12,Madera,039,155013,37655,37520,6145,43665,365
2022-05-12,Marin,041,260295,36009,35486,3235,38721,293
2022-05-12,Mariposa,043,17540,2485,2463,220,2683,30
2022-05-12,Mendocino,045,87422,13410,13349,3267,16616,124
2022-05-12,Merced,047,269075,63264,62627,9016,71643,818
2022-05-12,Modoc,049,8938,743,747,253,1000,8
2022-05-12,Mono,051,14174,3012,3002,149,3151,6
2022-05-12,Monterey,053,433212,81047,80620,14551,95171,735
2022-05-12,Napa,055,140530,26894,26698,1055,27753,143
2022-05-12,Nevada,057,99092,16350,16240,1265,17505,127
2022-05-12,Orange,059,3164182,560136,557134,43460,600594,7017
2022-05-12,Placer,061,380077,64483,63963,7591,71554,626
2022-05-12,Plumas,063,18699,3034,3006,367,3373,13
2022-05-12,Riverside,065,2383286,600398,597914,28487,626401,6471
2022-05-12,Sacramento,067,1510023,288303,286403,27405,313808,3022
2022-05-12,San Benito,069,59416,13232,13106,558,13664,98
2022-05-12,San Bernardino,071,2135413,582166,572057,25351,597408,7423
2022-05-12,San Diego,073,3302833,771128,770323,55031,825354,5271
2022-05-12,San Francisco,075,870044,137433,134916,9033,143949,866
2022-05-12,San Joaquin,077,732212,169517,168174,10388,178562,2236
2022-05-12,San Luis Obispo,079,281455,53749,53502,4032,57534,478
2022-05-12,San Mateo,081,765935,131301,129480,7723,137203,709
2022-05-12,Santa Barbara,083,443738,88296,87773,4880,92653,693
2022-05-12,Santa Clara,085,1922200,336580,328609,13552,342161,2297
2022-05-12,Santa Cruz,087,273765,51029,50268,2247,52515,263
2022-05-12,Shasta,089,179085,30902,30799,6134,36933,557
2022-05-12,Sierra,091,2930,275,275,50,325,4
2022-05-12,Siskiyou,093,43540,4480,4482,2760,7242,81
2022-05-12,Solano,095,438530,84700,83669,5842,89511,451
2022-05-12,Sonoma,097,501317,88125,87070,3211,90281,488
2022-05-12,Stanislaus,099,539301,119168,118586,18155,136741,1645
2022-05-12,Sutter,101,95872,20722,20690,2128,22818,226
2022-05-12,Tehama,103,63373,12128,12115,2602,14717,201
2022-05-12,Trinity,105,12862,1193,1188,288,1476,20
2022-05-12,Tulare,107,460477,107000,107077,27971,135048,1469
2022-05-12,Tuolumne,109,53932,12971,12851,595,13446,182
2022-05-12,Ventura,111,848112,177173,176317,10151,186468,1497
2022-05-12,Yolo,113,214977,38927,37737,3057,40794,316
2022-05-12,Yuba,115,75493,16080,16028,1250,17278,122
2022-05-11,Alameda,001,1643700,272251,267982,14834,282816,1853
2022-05-11,Alpine,003,1148,125,125,1,126,0
2022-05-11,Amador,005,37829,8627,8564,671,9235,86
2022-05-11,Butte,007,227075,33620,33339,7194,40533,423
2022-05-11,Calaveras,009,45235,7391,7368,368,7736,120
2022-05-11,Colusa,011,21464,3468,3462,1053,4515,21
2022-05-11,Contra Costa,013,1133247,201153,195153,14408,209561,1302
2022-05-11,Del Norte,015,27424,6005,5911,199,6110,50
2022-05-11,El Dorado,017,186661,27351,27172,3293,30465,212
2022-05-11,Fresno,019,978130,236336,233021,24615,257636,2754
2022-05-11,Glenn,021,27897,5025,5001,1621,6622,48
2022-05-11,Humboldt,023,135768,17834,17585,3257,20842,146
2022-05-11,Imperial,025,180216,55834,55751,10664,66415,917
2022-05-11,Inyo,027,18085,4122,4093,517,4610,56
2022-05-11,Kern,029,883053,193366,192795,46419,239214,2292
2022-05-11,Kings,031,150075,51821,51752,3537,55289,447
2022-05-11,Lake,033,64148,10837,10786,897,11683,137
2022-05-11,Lassen,035,31185,8982,8984,878,9862,65
2022-05-11,Los Angeles,037,10098052,2781115,2761410,128146,2889556,31747
2022-05-11,Madera,039,155013,37623,37496,6134,43630,365
2022-05-11,Marin,041,260295,35908,35336,3194,38530,292
2022-05-11,Mariposa,043,17540,2480,2461,220,2681,30
2022-05-11,Mendocino,045,87422,13395,13320,3250,16570,124
2022-05-11,Merced,047,269075,63221,62567,8995,71562,818
2022-05-11,Modoc,049,8938,742,747,253,1000,8
2022-05-11,Mono,051,14174,3012,2999,148,3147,6
2022-05-11,Monterey,053,433212,80984,80534,14500,95034,733
2022-05-11,Napa,055,140530,26843,26660,1053,27713,143
2022-05-11,Nevada,057,99092,16334,16230,1260,17490,127
2022-05-11,Orange,059,3164182,559461,556265,43380,599645,7009
2022-05-11,Placer,061,380077,64385,63823,7575,71398,625
2022-05-11,Plumas,063,18699,3026,2998,367,3365,13
2022-05-11,Riverside,065,2383286,599948,597302,28451,625753,6468
2022-05-11,Sacramento,067,1510023,287885,285799,27355,313154,3020
2022-05-11,San Benito,069,59416,13212,13088,554,13642,98
2022-05-11,San Bernardino,071,2135413,581803,571372,25342,596714,7354
2022-05-11,San Diego,073,3302833,770147,768135,54900,823035,5257
2022-05-11,San Francisco,075,870044,136936,134027,9008,143035,864
2022-05-11,San Joaquin,077,732212,169344,167949,10367,178316,2233
2022-05-11,San Luis Obispo,079,281455,53702,53420,4015,57435,478
2022-05-11,San Mateo,081,765935,130899,128821,7680,136501,711
2022-05-11,Santa Barbara,083,443738,88167,87593,4868,92461,693
2022-05-11,Santa Clara,085,1922200,335577,327177,13504,340681,2294
2022-05-11,Santa Cruz,087,273765,50871,50031,2233,52264,263
2022-05-11,Shasta,089,179085,30870,30768,6131,36899,564
2022-05-11,Sierra,091,2930,275,275,50,325,4
2022-05-11,Siskiyou,093,43540,4478,4478,2760,7238,81
2022-05-11,Solano,095,438530,84500,83464,5829,89293,450
2022-05-11,Sonoma,097,501317,87921,86798,3198,89996,488
2022-05-11,Stanislaus,099,539301,119065,118445,18133,136578,1644
2022-05-11,Sutter,101,95872,20707,20668,2127,22795,225
2022-05-11,Tehama,103,63373,12128,12106,2602,14708,201
2022-05-11,Trinity,105,12862,1191,1188,288,1476,20
2022-05-11,Tulare,107,460477,106942,107068,27938,135006,1468
2022-05-11,Tuolumne,109,53932,12954,12829,595,13424,181
2022-05-11,Ventura,111,848112,176974,175955,10109,186064,1491
2022-05-11,Yolo,113,214977,38812,37654,3052,40706,316
2022-05-11,Yuba,115,75493,16061,15997,1240,17237,122
2022-05-10,Alameda,001,1643700,271468,267982,14779,282761,1853
2022-05-10,Alpine,003,1148,125,125,1,126,0
2022-05-10,Amador,005,37829,8623,8564,670,9234,86
2022-05-10,Butte,007,227075,33594,33339,7190,40529,423
2022-05-10,Calaveras,009,45235,7387,7368,367,7735,120
2022-05-10,Colusa,011,21464,3468,3462,1052,4514,21
2022-05-10,Contra Costa,013,1133247,200668,195153,14366,209519,1302
2022-05-10,Del Norte,015,27424,5953,5911,199,6110,50
2022-05-10,El Dorado,017,186661,27314,27172,3287,30459,212
2022-05-10,Fresno,019,978130,236174,233021,24586,257607,2754
2022-05-10,Glenn,021,27897,5022,5001,1621,6622,48
2022-05-10,Humboldt,023,135768,17796,17585,3240,20825,146
2022-05-10,Imperial,025,180216,55799,55751,10646,66397,917
2022-05-10,Inyo,027,18085,4120,4093,511,4604,56
2022-05-10,Kern,029,883053,193264,192795,46378,239173,2292
2022-05-10,Kings,031,150075,51790,51752,3537,55289,447
2022-05-10,Lake,033,64148,10832,10786,897,11683,137
2022-05-10,Lassen,035,31185,8977,8984,878,9862,65
2022-05-10,Los Angeles,037,10098052,2777830,2761410,127913,2889323,31747
2022-05-10,Madera,039,155013,37590,37496,6121,43617,365
2022-05-10,Marin,041,260295,35792,35336,3151,38487,292
2022-05-10,Mariposa,043,17540,2480,2461,220,2681,30
2022-05-10,Mendocino,045,87422,13383,13320,3237,16557,124
2022-05-10,Merced,047,269075,63176,62567,8976,71543,818
2022-05-10,Modoc,049,8938,742,747,253,1000,8
2022-05-10,Mono,051,14174,3008,2999,145,3144,6
2022-05-10,Monterey,053,433212,80918,80534,14452,94986,733
2022-05-10,Napa,055,140530,26805,26660,1051,27711,143
2022-05-10,Nevada,057,99092,16314,16230,1257,17487,127
2022-05-10,Orange,059,3164182,558759,556265,43285,599550,7009
2022-05-10,Placer,061,380077,64272,63823,7559,71382,625
2022-05-10,Plumas,063,18699,3018,2998,366,3364,13
2022-05-10,Riverside,065,2383286,599521,597302,28422,625724,6468
2022-05-10,Sacramento,067,1510023,287379,285799,27289,313088,3020
2022-05-10,San Benito,069,59416,13195,13088,549,13637,98
2022-05-10,San Bernardino,071,2135413,581454,571372,25316,596688,7354
2022-05-10,San Diego,073,3302833,769132,768135,54778,822913,5257
2022-05-10,San Francisco,075,870044,136380,134027,8981,143008,864
2022-05-10,San Joaquin,077,732212,169190,167949,10305,178254,2233
2022-05-10,San Luis Obispo,079,281455,53626,53420,3990,57410,478
2022-05-10,San Mateo,081,765935,130517,128821,7642,136463,711
2022-05-10,Santa Barbara,083,443738,88051,87593,4853,92446,693
2022-05-10,Santa Clara,085,1922200,334545,327177,13424,340601,2294
2022-05-10,Santa Cruz,087,273765,50745,50031,2222,52253,263
2022-05-10,Shasta,089,179085,30850,30768,6130,36898,564
2022-05-10,Sierra,091,2930,275,275,49,324,4
2022-05-10,Siskiyou,093,43540,4474,4478,2760,7238,81
2022-05-10,Solano,095,438530,84313,83464,5810,89274,450
2022-05-10,Sonoma,097,501317,87681,86798,3160,89958,488
2022-05-10,Stanislaus,099,539301,118971,118445,18114,136559,1644
2022-05-10,Sutter,101,95872,20688,20668,2124,22792,225
2022-05-10,Tehama,103,63373,12125,12106,2595,14701,201
2022-05-10,Trinity,105,12862,1191,1188,288,1476,20
2022-05-10,Tulare,107,460477,106898,107068,27911,134979,1468
2022-05-10,Tuolumne,109,53932,12942,12829,595,13424,181
2022-05-10,Ventura,111,848112,176756,175955,10071,186026,1491
2022-05-10,Yolo,113,214977,38708,37654,3041,40695,316
2022-05-10,Yuba,115,75493,16040,15997,1237,17234,122
2022-05-09,Alameda,001,1643700,270688,267982,14736,282718,1853
2022-05-09,Alpine,003,1148,125,125,1,126,0
2022-05-09,Amador,005,37829,8617,8564,670,9234,86
2022-05-09,Butte,007,227075,33568,33339,7181,40520,423
2022-05-09,Calaveras,009,45235,7381,7368,367,7735,120
2022-05-09,Colusa,011,21464,3466,3462,1050,4512,21
2022-05-09,Contra Costa,013,1133247,200196,195153,14308,209461,1302
2022-05-09,Del Norte,015,27424,5944,5911,198,6109,50
2022-05-09,El Dorado,017,186661,27279,27172,3279,30451,212
2022-05-09,Fresno,019,978130,236015,233021,24564,257585,2754
2022-05-09,Glenn,021,27897,5020,5001,1620,6621,48
2022-05-09,Humboldt,023,135768,17745,17585,3218,20803,146
2022-05-09,Imperial,025,180216,55765,55751,10633,66384,917
2022-05-09,Inyo,027,18085,4117,4093,508,4601,56
2022-05-09,Kern,029,883053,193167,192795,46321,239116,2292
2022-05-09,Kings,031,150075,51759,51752,3536,55288,447
2022-05-09,Lake,033,64148,10824,10786,896,11682,137
2022-05-09,Lassen,035,31185,8975,8984,878,9862,65
2022-05-09,Los Angeles,037,10098052,2774484,2761410,127668,2889078,31747
2022-05-09,Madera,039,155013,37558,37496,6112,43608,365
2022-05-09,Marin,041,260295,35675,35336,3116,38452,292
2022-05-09,Mariposa,043,17540,2475,2461,220,2681,30
2022-05-09,Mendocino,045,87422,13372,13320,3226,16546,124
2022-05-09,Merced,047,269075,63136,62567,8957,71524,818
2022-05-09,Modoc,049,8938,742,747,253,1000,8
2022-05-09,Mono,051,14174,3006,2999,143,3142,6
2022-05-09,Monterey,053,433212,80826,80534,14399,94933,733
2022-05-09,Napa,055,140530,26755,26660,1049,27709,143
2022-05-09,Nevada,057,99092,16286,16230,1251,17481,127
2022-05-09,Orange,059,3164182,558089,556265,43203,599468,7009
2022-05-09,Placer,061,380077,64211,63823,7543,71366,625
2022-05-09,Plumas,063,18699,3009,2998,366,3364,13
2022-05-09,Riverside,065,2383286,599030,597302,28386,625688,6468
2022-05-09,Sacramento,067,1510023,286949,285799,27217,313016,3020
2022-05-09,San Benito,069,59416,13176,13088,547,13635,98
2022-05-09,San Bernardino,071,2135413,581116,571372,25305,596677,7354
2022-05-09,San Diego,073,3302833,768157,768135,54636,822771,5257
2022-05-09,San Francisco,075,870044,135819,134027,8956,142983,864
2022-05-09,San Joaquin,077,732212,169007,167949,10283,178232,2233
2022-05-09,San Luis Obispo,079,281455,53573,53420,3969,57389,478
2022-05-09,San Mateo,081,765935,130090,128821,7604,136425,711
2022-05-09,Santa Barbara,083,443738,87921,87593,4842,92435,693
2022-05-09,Santa Clara,085,1922200,333405,327177,13360,340537,2294
2022-05-09,Santa Cruz,087,273765,50604,50031,2214,52245,263
2022-05-09,Shasta,089,179085,30837,30768,6128,36896,564
2022-05-09,Sierra,091,2930,275,275,49,324,4
2022-05-09,Siskiyou,093,43540,4472,4478,2760,7238,81
2022-05-09,Solano,095,438530,84156,83464,5797,89261,450
2022-05-09,Sonoma,097,501317,87421,86798,3134,89932,488
2022-05-09,Stanislaus,099,539301,118875,118445,18096,136541,1644
2022-05-09,Sutter,101,95872,20675,20668,2123,22791,225
2022-05-09,Tehama,103,63373,12123,12106,2593,14699,201
2022-05-09,Trinity,105,12862,1191,1188,288,1476,20
2022-05-09,Tulare,107,460477,106852,107068,27875,134943,1468
2022-05-09,Tuolumne,109,53932,12934,12829,595,13424,181
2022-05-09,Ventura,111,848112,176539,175955,10021,185976,1491
2022-05-09,Yolo,113,214977,38599,37654,3032,40686,316
2022-05-09,Yuba,115,75493,16031,15997,1236,17233,122
2022-05-08,Alameda,001,1643700,269795,265198,14669,279867,1855
2022-05-08,Alpine,003,1148,125,125,1,126,0
2022-05-08,Amador,005,37829,8606,8556,667,9223,86
2022-05-08,Butte,007,227075,33545,33269,7170,40439,421
2022-05-08,Calaveras,009,45235,7374,7353,366,7719,120
2022-05-08,Colusa,011,21464,3465,3459,1050,4509,21
2022-05-08,Contra Costa,013,1133247,199681,193961,14227,208188,1302
2022-05-08,Del Norte,015,27424,5928,5884,198,6082,50
2022-05-08,El Dorado,017,186661,27241,27081,3274,30355,210
2022-05-08,Fresno,019,978130,235847,232655,24541,257196,2754
2022-05-08,Glenn,021,27897,5018,4996,1620,6616,48
2022-05-08,Humboldt,023,135768,17692,17410,3179,20589,146
2022-05-08,Imperial,025,180216,55731,55683,10624,66307,917
2022-05-08,Inyo,027,18085,4110,4087,508,4595,56
2022-05-08,Kern,029,883053,193073,192590,46275,238865,2287
2022-05-08,Kings,031,150075,51742,51702,3536,55238,447
2022-05-08,Lake,033,64148,10817,10766,896,11662,137
2022-05-08,Lassen,035,31185,8971,8978,878,9856,65
2022-05-08,Los Angeles,037,10098052,2770896,2751478,127379,2878857,31738
2022-05-08,Madera,039,155013,37536,37420,6093,43513,365
2022-05-08,Marin,041,260295,35549,34934,3069,38003,292
2022-05-08,Mariposa,043,17540,2468,2438,219,2657,30
2022-05-08,Mendocino,045,87422,13353,13270,3200,16470,124
2022-05-08,Merced,047,269075,63087,62471,8928,71399,818
2022-05-08,Modoc,049,8938,742,745,253,998,8
2022-05-08,Mono,051,14174,3005,2997,141,3138,6
2022-05-08,Monterey,053,433212,80733,80246,14317,94563,733
2022-05-08,Napa,055,140530,26714,26524,1046,27570,143
2022-05-08,Nevada,057,99092,16262,16171,1249,17420,127
2022-05-08,Orange,059,3164182,557408,554411,43098,597509,7007
2022-05-08,Placer,061,380077,64094,63577,7516,71093,625
2022-05-08,Plumas,063,18699,3005,2996,366,3362,13
2022-05-08,Riverside,065,2383286,598542,596022,28350,624372,6467
2022-05-08,Sacramento,067,1510023,286438,284564,27147,311711,3016
2022-05-08,San Benito,069,59416,13161,13047,544,13591,98
2022-05-08,San Bernardino,071,2135413,580683,570381,25270,595651,7306
2022-05-08,San Diego,073,3302833,767129,765377,54531,819908,5244
2022-05-08,San Francisco,075,870044,135166,132659,8924,141583,861
2022-05-08,San Joaquin,077,732212,168822,167568,10250,177818,2229
2022-05-08,San Luis Obispo,079,281455,53502,53273,3949,57222,477
2022-05-08,San Mateo,081,765935,129627,127615,7552,135167,709
2022-05-08,Santa Barbara,083,443738,87787,87305,4833,92138,692
2022-05-08,Santa Clara,085,1922200,332332,324946,13287,338233,2287
2022-05-08,Santa Cruz,087,273765,50424,49605,2210,51815,262
2022-05-08,Shasta,089,179085,30809,30721,6124,36845,563
2022-05-08,Sierra,091,2930,275,275,49,324,4
2022-05-08,Siskiyou,093,43540,4469,4470,2755,7225,81
2022-05-08,Solano,095,438530,83985,83038,5772,88810,450
2022-05-08,Sonoma,097,501317,87202,86150,3099,89249,488
2022-05-08,Stanislaus,099,539301,118767,118235,18071,136306,1643
2022-05-08,Sutter,101,95872,20654,20694,2119,22813,225
2022-05-08,Tehama,103,63373,12117,12098,2590,14688,201
2022-05-08,Trinity,105,12862,1190,1180,288,1468,20
2022-05-08,Tulare,107,460477,106811,106987,27840,134827,1468
2022-05-08,Tuolumne,109,53932,12921,12793,591,13384,181
2022-05-08,Ventura,111,848112,176303,175454,9975,185429,1491
2022-05-08,Yolo,113,214977,38492,37456,3018,40474,315
2022-05-08,Yuba,115,75493,16009,15964,1232,17196,122
2022-05-07,Alameda,001,1643700,269415,265198,14652,279850,1855
2022-05-07,Alpine,003,1148,125,125,1,126,0
2022-05-07,Amador,005,37829,8604,8556,667,9223,86
2022-05-07,Butte,007,227075,33537,33269,7164,40433,421
2022-05-07,Calaveras,009,45235,7367,7353,366,7719,120
2022-05-07,Colusa,011,21464,3465,3459,1050,4509,21
2022-05-07,Contra Costa,013,1133247,199439,193961,14210,208171,1302
2022-05-07,Del Norte,015,27424,5926,5884,198,6082,50
2022-05-07,El Dorado,017,186661,27222,27081,3273,30354,210
2022-05-07,Fresno,019,978130,235789,232655,24535,257190,2754
2022-05-07,Glenn,021,27897,5017,4996,1620,6616,48
2022-05-07,Humboldt,023,135768,17664,17410,3171,20581,146
2022-05-07,Imperial,025,180216,55708,55683,10618,66301,917
2022-05-07,Inyo,027,18085,4107,4087,508,4595,56
2022-05-07,Kern,029,883053,193038,192590,46254,238844,2287
2022-05-07,Kings,031,150075,51731,51702,3536,55238,447
2022-05-07,Lake,033,64148,10813,10766,896,11662,137
2022-05-07,Lassen,035,31185,8971,8978,878,9856,65
2022-05-07,Los Angeles,037,10098052,2769319,2751478,127208,2878686,31738
2022-05-07,Madera,039,155013,37529,37420,6093,43513,365
2022-05-07,Marin,041,260295,35475,34934,3037,37971,292
2022-05-07,Mariposa,043,17540,2465,2438,219,2657,30
2022-05-07,Mendocino,045,87422,13344,13270,3197,16467,124
2022-05-07,Merced,047,269075,63074,62471,8928,71399,818
2022-05-07,Modoc,049,8938,742,745,253,998,8
2022-05-07,Mono,051,14174,3004,2997,140,3137,6
2022-05-07,Monterey,053,433212,80673,80246,14291,94537,733
2022-05-07,Napa,055,140530,26684,26524,1045,27569,143
2022-05-07,Nevada,057,99092,16252,16171,1244,17415,127
2022-05-07,Orange,059,3164182,557079,554411,43044,597455,7007
2022-05-07,Placer,061,380077,64030,63577,7508,71085,625
2022-05-07,Plumas,063,18699,3005,2996,365,3361,13
2022-05-07,Riverside,065,2383286,598287,596022,28323,624345,6467
2022-05-07,Sacramento,067,1510023,286243,284564,27135,311699,3016
2022-05-07,San Benito,069,59416,13152,13047,539,13586,98
2022-05-07,San Bernardino,071,2135413,580471,570381,25265,595646,7306
2022-05-07,San Diego,073,3302833,766643,765377,54501,819878,5244
2022-05-07,San Francisco,075,870044,134837,132659,8904,141563,861
2022-05-07,San Joaquin,077,732212,168717,167568,10241,177809,2229
2022-05-07,San Luis Obispo,079,281455,53490,53273,3938,57211,477
2022-05-07,San Mateo,081,765935,129342,127615,7531,135146,709
2022-05-07,Santa Barbara,083,443738,87707,87305,4830,92135,692
2022-05-07,Santa Clara,085,1922200,331711,324946,13257,338203,2287
2022-05-07,Santa Cruz,087,273765,50371,49605,2200,51805,262
2022-05-07,Shasta,089,179085,30801,30721,6124,36845,563
2022-05-07,Sierra,091,2930,275,275,49,324,4
2022-05-07,Siskiyou,093,43540,4467,4470,2755,7225,81
2022-05-07,Solano,095,438530,83927,83038,5767,88805,450
2022-05-07,Sonoma,097,501317,87077,86150,3090,89240,488
2022-05-07,Stanislaus,099,539301,118720,118235,18062,136297,1643
2022-05-07,Sutter,101,95872,20645,20694,2119,22813,225
2022-05-07,Tehama,103,63373,12115,12098,2589,14687,201
2022-05-07,Trinity,105,12862,1190,1180,288,1468,20
2022-05-07,Tulare,107,460477,106786,106987,27828,134815,1468
2022-05-07,Tuolumne,109,53932,12914,12793,591,13384,181
2022-05-07,Ventura,111,848112,176192,175454,9951,185405,1491
2022-05-07,Yolo,113,214977,38447,37456,3016,40472,315
2022-05-07,Yuba,115,75493,16000,15964,1232,17196,122
2022-05-06,Alameda,001,1643700,269032,265198,14629,279827,1855
2022-05-06,Alpine,003,1148,125,125,1,126,0
2022-05-06,Amador,005,37829,8603,8556,666,9222,86
2022-05-06,Butte,007,227075,33528,33269,7161,40430,421
2022-05-06,Calaveras,009,45235,7365,7353,366,7719,120
2022-05-06,Colusa,011,21464,3465,3459,1050,4509,21
2022-05-06,Contra Costa,013,1133247,199207,193961,14198,208159,1302
2022-05-06,Del Norte,015,27424,5916,5884,198,6082,50
2022-05-06,El Dorado,017,186661,27197,27081,3270,30351,210
2022-05-06,Fresno,019,978130,235713,232655,24526,257181,2754
2022-05-06,Glenn,021,27897,5017,4996,1620,6616,48
2022-05-06,Humboldt,023,135768,17637,17410,3164,20574,146
2022-05-06,Imperial,025,180216,55699,55683,10615,66298,917
2022-05-06,Inyo,027,18085,4098,4087,505,4592,56
2022-05-06,Kern,029,883053,192986,192590,46225,238815,2287
2022-05-06,Kings,031,150075,51723,51702,3536,55238,447
2022-05-06,Lake,033,64148,10811,10766,896,11662,137
2022-05-06,Lassen,035,31185,8971,8978,878,9856,65
2022-05-06,Los Angeles,037,10098052,2767503,2751478,127059,2878537,31738
2022-05-06,Madera,039,155013,37515,37420,6090,43510,365
2022-05-06,Marin,041,260295,35397,34934,2991,37925,292
2022-05-06,Mariposa,043,17540,2464,2438,212,2650,30
2022-05-06,Mendocino,045,87422,13332,13270,3195,16465,124
2022-05-06,Merced,047,269075,63057,62471,8927,71398,818
2022-05-06,Modoc,049,8938,742,745,253,998,8
2022-05-06,Mono,051,14174,3003,2997,140,3137,6
2022-05-06,Monterey,053,433212,80634,80246,14254,94500,733
2022-05-06,Napa,055,140530,26667,26524,1045,27569,143
2022-05-06,Nevada,057,99092,16240,16171,1242,17413,127
2022-05-06,Orange,059,3164182,556736,554411,42977,597388,7007
2022-05-06,Placer,061,380077,63969,63577,7496,71073,625
2022-05-06,Plumas,063,18699,3003,2996,365,3361,13
2022-05-06,Riverside,065,2383286,598058,596022,28303,624325,6467
2022-05-06,Sacramento,067,1510023,285987,284564,27115,311679,3016
2022-05-06,San Benito,069,59416,13147,13047,539,13586,98
2022-05-06,San Bernardino,071,2135413,580294,570381,25259,595640,7306
2022-05-06,San Diego,073,3302833,766133,765377,54464,819841,5244
2022-05-06,San Francisco,075,870044,134511,132659,8883,141542,861
2022-05-06,San Joaquin,077,732212,168627,167568,10229,177797,2229
2022-05-06,San Luis Obispo,079,281455,53464,53273,3933,57206,477
2022-05-06,San Mateo,081,765935,129113,127615,7523,135138,709
2022-05-06,Santa Barbara,083,443738,87653,87305,4828,92133,692
2022-05-06,Santa Clara,085,1922200,331118,324946,13242,338188,2287
2022-05-06,Santa Cruz,087,273765,50306,49605,2196,51801,262
2022-05-06,Shasta,089,179085,30795,30721,6123,36844,563
2022-05-06,Sierra,091,2930,275,275,49,324,4
2022-05-06,Siskiyou,093,43540,4465,4470,2753,7223,81
2022-05-06,Solano,095,438530,83837,83038,5759,88797,450
2022-05-06,Sonoma,097,501317,86955,86150,3075,89225,488
2022-05-06,Stanislaus,099,539301,118663,118235,18055,136290,1643
2022-05-06,Sutter,101,95872,20639,20694,2119,22813,225
2022-05-06,Tehama,103,63373,12110,12098,2589,14687,201
2022-05-06,Trinity,105,12862,1189,1180,288,1468,20
2022-05-06,Tulare,107,460477,106767,106987,27817,134804,1468
2022-05-06,Tuolumne,109,53932,12907,12793,590,13383,181
2022-05-06,Ventura,111,848112,176075,175454,9921,185375,1491
2022-05-06,Yolo,113,214977,38400,37456,3012,40468,315
2022-05-06,Yuba,115,75493,15989,15964,1231,17195,122
2022-05-05,Alameda,001,1643700,268443,265198,14588,279786,1855
2022-05-05,Alpine,003,1148,125,125,1,126,0
2022-05-05,Amador,005,37829,8601,8556,665,9221,86
2022-05-05,Butte,007,227075,33509,33269,7154,40423,421
2022-05-05,Calaveras,009,45235,7361,7353,364,7717,120
2022-05-05,Colusa,011,21464,3465,3459,1047,4506,21
2022-05-05,Contra Costa,013,1133247,198813,193961,14154,208115,1302
2022-05-05,Del Norte,015,27424,5915,5884,198,6082,50
2022-05-05,El Dorado,017,186661,27172,27081,3263,30344,210
2022-05-05,Fresno,019,978130,235612,232655,24503,257158,2754
2022-05-05,Glenn,021,27897,5017,4996,1619,6615,48
2022-05-05,Humboldt,023,135768,17599,17410,3150,20560,146
2022-05-05,Imperial,025,180216,55692,55683,10604,66287,917
2022-05-05,Inyo,027,18085,4094,4087,504,4591,56
2022-05-05,Kern,029,883053,192928,192590,46188,238778,2287
2022-05-05,Kings,031,150075,51715,51702,3536,55238,447
2022-05-05,Lake,033,64148,10807,10766,896,11662,137
2022-05-05,Lassen,035,31185,8971,8978,878,9856,65
2022-05-05,Los Angeles,037,10098052,2764927,2751478,126839,2878317,31738
2022-05-05,Madera,039,155013,37498,37420,6085,43505,365
2022-05-05,Marin,041,260295,35287,34934,2969,37903,292
2022-05-05,Mariposa,043,17540,2462,2438,211,2649,30
2022-05-05,Mendocino,045,87422,13321,13270,3187,16457,124
2022-05-05,Merced,047,269075,63025,62471,8923,71394,818
2022-05-05,Modoc,049,8938,742,745,251,996,8
2022-05-05,Mono,051,14174,3002,2997,139,3136,6
2022-05-05,Monterey,053,433212,80579,80246,14225,94471,733
2022-05-05,Napa,055,140530,26634,26524,1044,27568,143
2022-05-05,Nevada,057,99092,16230,16171,1239,17410,127
2022-05-05,Orange,059,3164182,556227,554411,42919,597330,7007
2022-05-05,Placer,061,380077,63908,63577,7487,71064,625
2022-05-05,Plumas,063,18699,3002,2996,365,3361,13
2022-05-05,Riverside,065,2383286,597721,596022,28276,624298,6467
2022-05-05,Sacramento,067,1510023,285648,284564,27064,311628,3016
2022-05-05,San Benito,069,59416,13136,13047,537,13584,98
2022-05-05,San Bernardino,071,2135413,580004,570381,25243,595624,7306
2022-05-05,San Diego,073,3302833,765393,765377,54394,819771,5244
2022-05-05,San Francisco,075,870044,134095,132659,8848,141507,861
2022-05-05,San Joaquin,077,732212,168537,167568,10201,177769,2229
2022-05-05,San Luis Obispo,079,281455,53428,53273,3918,57191,477
2022-05-05,San Mateo,081,765935,128775,127615,7498,135113,709
2022-05-05,Santa Barbara,083,443738,87578,87305,4823,92128,692
2022-05-05,Santa Clara,085,1922200,330321,324946,13180,338126,2287
2022-05-05,Santa Cruz,087,273765,50208,49605,2192,51797,262
2022-05-05,Shasta,089,179085,30785,30721,6121,36842,563
2022-05-05,Sierra,091,2930,275,275,49,324,4
2022-05-05,Siskiyou,093,43540,4463,4470,2753,7223,81
2022-05-05,Solano,095,438530,83716,83038,5741,88779,450
2022-05-05,Sonoma,097,501317,86782,86150,3057,89207,488
2022-05-05,Stanislaus,099,539301,118605,118235,18041,136276,1643
2022-05-05,Sutter,101,95872,20637,20694,2117,22811,225
2022-05-05,Tehama,103,63373,12106,12098,2587,14685,201
2022-05-05,Trinity,105,12862,1189,1180,288,1468,20
2022-05-05,Tulare,107,460477,106737,106987,27799,134786,1468
2022-05-05,Tuolumne,109,53932,12889,12793,587,13380,181
2022-05-05,Ventura,111,848112,175888,175454,9878,185332,1491
2022-05-05,Yolo,113,214977,38329,37456,3001,40457,315
2022-05-05,Yuba,115,75493,15979,15964,1228,17192,122
2022-05-04,Alameda,001,1643700,267772,263736,14547,278283,1850
2022-05-04,Alpine,003,1148,125,124,1,125,0
2022-05-04,Amador,005,37829,8598,8546,664,9210,86
2022-05-04,Butte,007,227075,33492,33220,7149,40369,417
2022-05-04,Calaveras,009,45235,7356,7344,364,7708,120
2022-05-04,Colusa,011,21464,3464,3460,1047,4507,21
2022-05-04,Contra Costa,013,1133247,198446,193175,14099,207274,1302
2022-05-04,Del Norte,015,27424,5907,5866,198,6064,50
2022-05-04,El Dorado,017,186661,27147,27021,3256,30277,210
2022-05-04,Fresno,019,978130,235494,232332,24493,256825,2751
2022-05-04,Glenn,021,27897,5015,4995,1619,6614,48
2022-05-04,Humboldt,023,135768,17559,17316,3140,20456,146
2022-05-04,Imperial,025,180216,55669,55548,10596,66144,910
2022-05-04,Inyo,027,18085,4094,4085,501,4586,56
2022-05-04,Kern,029,883053,192862,192432,46152,238584,2281
2022-05-04,Kings,031,150075,51697,51663,3535,55198,447
2022-05-04,Lake,033,64148,10802,10758,896,11654,137
2022-05-04,Lassen,035,31185,8970,8972,876,9848,65
2022-05-04,Los Angeles,037,10098052,2762151,2744894,126649,2871543,31722
2022-05-04,Madera,039,155013,37474,37395,6080,43475,365
2022-05-04,Marin,041,260295,35200,34727,2947,37674,291
2022-05-04,Mariposa,043,17540,2456,2435,206,2641,30
2022-05-04,Mendocino,045,87422,13313,13247,3179,16426,123
2022-05-04,Merced,047,269075,62998,62419,8912,71331,818
2022-05-04,Modoc,049,8938,742,746,251,997,8
2022-05-04,Mono,051,14174,3001,2993,136,3129,6
2022-05-04,Monterey,053,433212,80517,80038,14201,94239,732
2022-05-04,Napa,055,140530,26597,26434,1041,27475,143
2022-05-04,Nevada,057,99092,16214,16136,1235,17371,127
2022-05-04,Orange,059,3164182,555643,553177,42843,596020,7006
2022-05-04,Placer,061,380077,63825,63410,7482,70892,625
2022-05-04,Plumas,063,18699,3000,2947,365,3312,13
2022-05-04,Riverside,065,2383286,597387,594981,28250,623231,6457
2022-05-04,Sacramento,067,1510023,285317,283939,27028,310967,3013
2022-05-04,San Benito,069,59416,13127,13019,531,13550,98
2022-05-04,San Bernardino,071,2135413,579740,569570,25230,594800,7240
2022-05-04,San Diego,073,3302833,764645,763453,54301,817754,5239
2022-05-04,San Francisco,075,870044,133686,131599,8827,140426,860
2022-05-04,San Joaquin,077,732212,168433,167280,10172,177452,2225
2022-05-04,San Luis Obispo,079,281455,53384,53156,3907,57063,477
2022-05-04,San Mateo,081,765935,128450,126800,7464,134264,710
2022-05-04,Santa Barbara,083,443738,87473,87058,4808,91866,688
2022-05-04,Santa Clara,085,1922200,329514,322805,13127,335932,2285
2022-05-04,Santa Cruz,087,273765,50093,49230,2189,51419,262
2022-05-04,Shasta,089,179085,30769,30681,6119,36800,556
2022-05-04,Sierra,091,2930,275,275,49,324,4
2022-05-04,Siskiyou,093,43540,4460,4463,2751,7214,81
2022-05-04,Solano,095,438530,83570,82796,5730,88526,449
2022-05-04,Sonoma,097,501317,86606,85694,3032,88726,488
2022-05-04,Stanislaus,099,539301,118542,118123,18030,136153,1643
2022-05-04,Sutter,101,95872,20626,20672,2115,22787,224
2022-05-04,Tehama,103,63373,12104,12090,2582,14672,201
2022-05-04,Trinity,105,12862,1189,1180,288,1468,20
2022-05-04,Tulare,107,460477,106718,106935,27784,134719,1464
2022-05-04,Tuolumne,109,53932,12882,12757,585,13342,181
2022-05-04,Ventura,111,848112,175720,175066,9836,184902,1486
2022-05-04,Yolo,113,214977,38253,37344,2996,40340,315
2022-05-04,Yuba,115,75493,15970,15940,1225,17165,122
2022-05-03,Alameda,001,1643700,267169,263736,14503,278239,1850
2022-05-03,Alpine,003,1148,125,124,1,125,0
2022-05-03,Amador,005,37829,8595,8546,663,9209,86
2022-05-03,Butte,007,227075,33476,33220,7144,40364,417
2022-05-03,Calaveras,009,45235,7349,7344,364,7708,120
2022-05-03,Colusa,011,21464,3463,3460,1047,4507,21
2022-05-03,Contra Costa,013,1133247,198053,193175,14056,207231,1302
2022-05-03,Del Norte,015,27424,5900,5866,196,6062,50
2022-05-03,El Dorado,017,186661,27125,27021,3252,30273,210
2022-05-03,Fresno,019,978130,235383,232332,24474,256806,2751
2022-05-03,Glenn,021,27897,5014,4995,1617,6612,48
2022-05-03,Humboldt,023,135768,17523,17316,3121,20437,146
2022-05-03,Imperial,025,180216,55647,55548,10590,66138,910
2022-05-03,Inyo,027,18085,4092,4085,501,4586,56
2022-05-03,Kern,029,883053,192784,192432,46120,238552,2281
2022-05-03,Kings,031,150075,51685,51663,3535,55198,447
2022-05-03,Lake,033,64148,10798,10758,895,11653,137
2022-05-03,Lassen,035,31185,8970,8972,876,9848,65
2022-05-03,Los Angeles,037,10098052,2759091,2744894,126416,2871310,31722
2022-05-03,Madera,039,155013,37443,37395,6075,43470,365
2022-05-03,Marin,041,260295,35090,34727,2924,37651,291
2022-05-03,Mariposa,043,17540,2448,2435,206,2641,30
2022-05-03,Mendocino,045,87422,13298,13247,3161,16408,123
2022-05-03,Merced,047,269075,62970,62419,8888,71307,818
2022-05-03,Modoc,049,8938,741,746,251,997,8
2022-05-03,Mono,051,14174,2999,2993,135,3128,6
2022-05-03,Monterey,053,433212,80465,80038,14167,94205,732
2022-05-03,Napa,055,140530,26562,26434,1034,27468,143
2022-05-03,Nevada,057,99092,16203,16136,1235,17371,127
2022-05-03,Orange,059,3164182,555119,553177,42764,595941,7006
2022-05-03,Placer,061,380077,63731,63410,7467,70877,625
2022-05-03,Plumas,063,18699,2996,2947,365,3312,13
2022-05-03,Riverside,065,2383286,597020,594981,28226,623207,6457
2022-05-03,Sacramento,067,1510023,285000,283939,26983,310922,3013
2022-05-03,San Benito,069,59416,13114,13019,528,13547,98
2022-05-03,San Bernardino,071,2135413,579471,569570,25218,594788,7240
2022-05-03,San Diego,073,3302833,763803,763453,54201,817654,5239
2022-05-03,San Francisco,075,870044,133209,131599,8797,140396,860
2022-05-03,San Joaquin,077,732212,168350,167280,10146,177426,2225
2022-05-03,San Luis Obispo,079,281455,53337,53156,3898,57054,477
2022-05-03,San Mateo,081,765935,128101,126800,7431,134231,710
2022-05-03,Santa Barbara,083,443738,87384,87058,4806,91864,688
2022-05-03,Santa Clara,085,1922200,328696,322805,13077,335882,2285
2022-05-03,Santa Cruz,087,273765,50001,49230,2183,51413,262
2022-05-03,Shasta,089,179085,30750,30681,6118,36799,556
2022-05-03,Sierra,091,2930,275,275,49,324,4
2022-05-03,Siskiyou,093,43540,4459,4463,2751,7214,81
2022-05-03,Solano,095,438530,83380,82796,5718,88514,449
2022-05-03,Sonoma,097,501317,86425,85694,3008,88702,488
2022-05-03,Stanislaus,099,539301,118488,118123,18017,136140,1643
2022-05-03,Sutter,101,95872,20621,20672,2113,22785,224
2022-05-03,Tehama,103,63373,12100,12090,2581,14671,201
2022-05-03,Trinity,105,12862,1188,1180,288,1468,20
2022-05-03,Tulare,107,460477,106690,106935,27770,134705,1464
2022-05-03,Tuolumne,109,53932,12869,12757,585,13342,181
2022-05-03,Ventura,111,848112,175551,175066,9793,184859,1486
2022-05-03,Yolo,113,214977,38185,37344,2995,40339,315
2022-05-03,Yuba,115,75493,15959,15940,1217,17157,122
2022-05-02,Alameda,001,1643700,266532,263736,14458,278194,1850
2022-05-02,Alpine,003,1148,125,124,1,125,0
2022-05-02,Amador,005,37829,8592,8546,660,9206,86
2022-05-02,Butte,007,227075,33453,33220,7141,40361,417
2022-05-02,Calaveras,009,45235,7348,7344,363,7707,120
2022-05-02,Colusa,011,21464,3463,3460,1047,4507,21
2022-05-02,Contra Costa,013,1133247,197680,193175,14018,207193,1302
2022-05-02,Del Norte,015,27424,5895,5866,191,6057,50
2022-05-02,El Dorado,017,186661,27101,27021,3246,30267,210
2022-05-02,Fresno,019,978130,235271,232332,24446,256778,2751
2022-05-02,Glenn,021,27897,5012,4995,1617,6612,48
2022-05-02,Humboldt,023,135768,17472,17316,3107,20423,146
2022-05-02,Imperial,025,180216,55634,55548,10583,66131,910
2022-05-02,Inyo,027,18085,4091,4085,499,4584,56
2022-05-02,Kern,029,883053,192700,192432,46091,238523,2281
2022-05-02,Kings,031,150075,51668,51663,3535,55198,447
2022-05-02,Lake,033,64148,10794,10758,895,11653,137
2022-05-02,Lassen,035,31185,8969,8972,876,9848,65
2022-05-02,Los Angeles,037,10098052,2756068,2744894,126198,2871092,31722
2022-05-02,Madera,039,155013,37426,37395,6068,43463,365
2022-05-02,Marin,041,260295,34964,34727,2901,37628,291
2022-05-02,Mariposa,043,17540,2443,2435,206,2641,30
2022-05-02,Mendocino,045,87422,13280,13247,3148,16395,123
2022-05-02,Merced,047,269075,62938,62419,8881,71300,818
2022-05-02,Modoc,049,8938,740,746,251,997,8
2022-05-02,Mono,051,14174,2997,2993,134,3127,6
2022-05-02,Monterey,053,433212,80387,80038,14126,94164,732
2022-05-02,Napa,055,140530,26523,26434,1032,27466,143
2022-05-02,Nevada,057,99092,16185,16136,1233,17369,127
2022-05-02,Orange,059,3164182,554579,553177,42667,595844,7006
2022-05-02,Placer,061,380077,63674,63410,7460,70870,625
2022-05-02,Plumas,063,18699,2996,2947,365,3312,13
2022-05-02,Riverside,065,2383286,596629,594981,28199,623180,6457
2022-05-02,Sacramento,067,1510023,284694,283939,26944,310883,3013
2022-05-02,San Benito,069,59416,13102,13019,528,13547,98
2022-05-02,San Bernardino,071,2135413,579184,569570,25200,594770,7240
2022-05-02,San Diego,073,3302833,762940,763453,54105,817558,5239
2022-05-02,San Francisco,075,870044,132773,131599,8770,140369,860
2022-05-02,San Joaquin,077,732212,168234,167280,10134,177414,2225
2022-05-02,San Luis Obispo,079,281455,53284,53156,3889,57045,477
2022-05-02,San Mateo,081,765935,127777,126800,7416,134216,710
2022-05-02,Santa Barbara,083,443738,87283,87058,4802,91860,688
2022-05-02,Santa Clara,085,1922200,327782,322805,13031,335836,2285
2022-05-02,Santa Cruz,087,273765,49875,49230,2179,51409,262
2022-05-02,Shasta,089,179085,30731,30681,6117,36798,556
2022-05-02,Sierra,091,2930,275,275,49,324,4
2022-05-02,Siskiyou,093,43540,4456,4463,2749,7212,81
2022-05-02,Solano,095,438530,83239,82796,5708,88504,449
2022-05-02,Sonoma,097,501317,86242,85694,2987,88681,488
2022-05-02,Stanislaus,099,539301,118415,118123,18003,136126,1643
2022-05-02,Sutter,101,95872,20614,20672,2110,22782,224
2022-05-02,Tehama,103,63373,12095,12090,2578,14668,201
2022-05-02,Trinity,105,12862,1187,1180,288,1468,20
2022-05-02,Tulare,107,460477,106668,106935,27754,134689,1464
2022-05-02,Tuolumne,109,53932,12863,12757,585,13342,181
2022-05-02,Ventura,111,848112,175388,175066,9761,184827,1486
2022-05-02,Yolo,113,214977,38107,37344,2989,40333,315
2022-05-02,Yuba,115,75493,15954,15940,1215,17155,122
2022-05-01,Alameda,001,1643700,265828,262027,14408,276435,1851
2022-05-01,Alpine,003,1148,125,124,1,125,0
2022-05-01,Amador,005,37829,8592,8533,660,9193,86
2022-05-01,Butte,007,227075,33426,33172,7136,40308,418
2022-05-01,Calaveras,009,45235,7344,7328,357,7685,120
2022-05-01,Colusa,011,21464,3463,3457,1047,4504,21
2022-05-01,Contra Costa,013,1133247,197294,192136,13947,206083,1301
2022-05-01,Del Norte,015,27424,5887,5841,191,6032,50
2022-05-01,El Dorado,017,186661,27069,26946,3242,30188,210
2022-05-01,Fresno,019,978130,235166,232067,24426,256493,2748
2022-05-01,Glenn,021,27897,5012,4995,1617,6612,48
2022-05-01,Humboldt,023,135768,17408,17194,3082,20276,145
2022-05-01,Imperial,025,180216,55610,55503,10580,66083,910
2022-05-01,Inyo,027,18085,4090,4084,498,4582,56
2022-05-01,Kern,029,883053,192637,192250,46045,238295,2265
2022-05-01,Kings,031,150075,51647,51640,3531,55171,447
2022-05-01,Lake,033,64148,10787,10742,893,11635,137
2022-05-01,Lassen,035,31185,8969,8966,876,9842,65
2022-05-01,Los Angeles,037,10098052,2753064,2736900,125964,2862864,31712
2022-05-01,Madera,039,155013,37408,37360,6057,43417,365
2022-05-01,Marin,041,260295,34877,34519,2868,37387,291
2022-05-01,Mariposa,043,17540,2442,2430,206,2636,30
2022-05-01,Mendocino,045,87422,13261,13219,3132,16351,123
2022-05-01,Merced,047,269075,62906,62357,8865,71222,818
2022-05-01,Modoc,049,8938,740,745,251,996,8
2022-05-01,Mono,051,14174,2994,2989,132,3121,6
2022-05-01,Monterey,053,433212,80308,79881,14084,93965,731
2022-05-01,Napa,055,140530,26478,26319,1028,27347,143
2022-05-01,Nevada,057,99092,16166,16100,1232,17332,127
2022-05-01,Orange,059,3164182,554025,551822,42563,594385,6998
2022-05-01,Placer,061,380077,63600,63273,7446,70719,625
2022-05-01,Plumas,063,18699,2995,2946,365,3311,13
2022-05-01,Riverside,065,2383286,596168,593965,28165,622130,6457
2022-05-01,Sacramento,067,1510023,284361,283048,26885,309933,3007
2022-05-01,San Benito,069,59416,13094,12988,528,13516,98
2022-05-01,San Bernardino,071,2135413,578865,568758,25183,593941,7191
2022-05-01,San Diego,073,3302833,762059,761253,54013,815266,5238
2022-05-01,San Francisco,075,870044,132279,130241,8739,138980,860
2022-05-01,San Joaquin,077,732212,168090,167028,10104,177132,2225
2022-05-01,San Luis Obispo,079,281455,53212,53040,3873,56913,477
2022-05-01,San Mateo,081,765935,127411,125807,7377,133184,705
2022-05-01,Santa Barbara,083,443738,87179,86768,4792,91560,688
2022-05-01,Santa Clara,085,1922200,326835,320709,12981,333690,2281
2022-05-01,Santa Cruz,087,273765,49723,48798,2171,50969,262
2022-05-01,Shasta,089,179085,30715,30649,6115,36764,554
2022-05-01,Sierra,091,2930,275,274,49,323,4
2022-05-01,Siskiyou,093,43540,4455,4458,2743,7201,81
2022-05-01,Solano,095,438530,83107,82459,5693,88152,449
2022-05-01,Sonoma,097,501317,86022,85290,2959,88249,488
2022-05-01,Stanislaus,099,539301,118360,117943,17987,135930,1643
2022-05-01,Sutter,101,95872,20606,20644,2103,22747,224
2022-05-01,Tehama,103,63373,12094,12078,2577,14655,202
2022-05-01,Trinity,105,12862,1187,1179,288,1467,20
2022-05-01,Tulare,107,460477,106635,106856,27734,134590,1458
2022-05-01,Tuolumne,109,53932,12844,12713,579,13292,181
2022-05-01,Ventura,111,848112,175216,174679,9708,184387,1486
2022-05-01,Yolo,113,214977,38042,37173,2979,40152,314
2022-05-01,Yuba,115,75493,15944,15917,1213,17130,121
2022-04-30,Alameda,001,1643700,265419,262027,14391,276418,1851
2022-04-30,Alpine,003,1148,125,124,1,125,0
2022-04-30,Amador,005,37829,8590,8533,660,9193,86
2022-04-30,Butte,007,227075,33420,33172,7132,40304,418
2022-04-30,Calaveras,009,45235,7341,7328,356,7684,120
2022-04-30,Colusa,011,21464,3462,3457,1047,4504,21
2022-04-30,Contra Costa,013,1133247,197048,192136,13937,206073,1301
2022-04-30,Del Norte,015,27424,5882,5841,191,6032,50
2022-04-30,El Dorado,017,186661,27051,26946,3238,30184,210
2022-04-30,Fresno,019,978130,235119,232067,24419,256486,2748
2022-04-30,Glenn,021,27897,5011,4995,1616,6611,48
2022-04-30,Humboldt,023,135768,17366,17194,3073,20267,145
2022-04-30,Imperial,025,180216,55597,55503,10578,66081,910
2022-04-30,Inyo,027,18085,4090,4084,498,4582,56
2022-04-30,Kern,029,883053,192601,192250,46027,238277,2265
2022-04-30,Kings,031,150075,51641,51640,3530,55170,447
2022-04-30,Lake,033,64148,10784,10742,893,11635,137
2022-04-30,Lassen,035,31185,8969,8966,876,9842,65
2022-04-30,Los Angeles,037,10098052,2751685,2736900,125787,2862687,31712
2022-04-30,Madera,039,155013,37397,37360,6056,43416,365
2022-04-30,Marin,041,260295,34831,34519,2838,37357,291
2022-04-30,Mariposa,043,17540,2440,2430,205,2635,30
2022-04-30,Mendocino,045,87422,13257,13219,3132,16351,123
2022-04-30,Merced,047,269075,62892,62357,8863,71220,818
2022-04-30,Modoc,049,8938,740,745,251,996,8
2022-04-30,Mono,051,14174,2993,2989,130,3119,6
2022-04-30,Monterey,053,433212,80240,79881,14061,93942,731
2022-04-30,Napa,055,140530,26455,26319,1027,27346,143
2022-04-30,Nevada,057,99092,16151,16100,1231,17331,127
2022-04-30,Orange,059,3164182,553758,551822,42520,594342,6998
2022-04-30,Placer,061,380077,63555,63273,7438,70711,625
2022-04-30,Plumas,063,18699,2992,2946,365,3311,13
2022-04-30,Riverside,065,2383286,595924,593965,28147,622112,6457
2022-04-30,Sacramento,067,1510023,284239,283048,26872,309920,3007
2022-04-30,San Benito,069,59416,13091,12988,528,13516,98
2022-04-30,San Bernardino,071,2135413,578690,568758,25174,593932,7191
2022-04-30,San Diego,073,3302833,761686,761253,53981,815234,5238
2022-04-30,San Francisco,075,870044,131992,130241,8716,138957,860
2022-04-30,San Joaquin,077,732212,168035,167028,10099,177127,2225
2022-04-30,San Luis Obispo,079,281455,53201,53040,3870,56910,477
2022-04-30,San Mateo,081,765935,127192,125807,7359,133166,705
2022-04-30,Santa Barbara,083,443738,87123,86768,4789,91557,688
2022-04-30,Santa Clara,085,1922200,326260,320709,12957,333666,2281
2022-04-30,Santa Cruz,087,273765,49677,48798,2171,50969,262
2022-04-30,Shasta,089,179085,30708,30649,6113,36762,554
2022-04-30,Sierra,091,2930,275,274,49,323,4
2022-04-30,Siskiyou,093,43540,4453,4458,2742,7200,81
2022-04-30,Solano,095,438530,83089,82459,5691,88150,449
2022-04-30,Sonoma,097,501317,85905,85290,2947,88237,488
2022-04-30,Stanislaus,099,539301,118329,117943,17981,135924,1643
2022-04-30,Sutter,101,95872,20601,20644,2103,22747,224
2022-04-30,Tehama,103,63373,12090,12078,2575,14653,202
2022-04-30,Trinity,105,12862,1187,1179,288,1467,20
2022-04-30,Tulare,107,460477,106615,106856,27722,134578,1458
2022-04-30,Tuolumne,109,53932,12835,12713,579,13292,181
2022-04-30,Ventura,111,848112,175132,174679,9676,184355,1486
2022-04-30,Yolo,113,214977,37996,37173,2978,40151,314
2022-04-30,Yuba,115,75493,15938,15917,1212,17129,121
2022-04-29,Alameda,001,1643700,265108,262027,14378,276405,1851
2022-04-29,Alpine,003,1148,124,124,1,125,0
2022-04-29,Amador,005,37829,8583,8533,658,9191,86
2022-04-29,Butte,007,227075,33415,33172,7126,40298,418
2022-04-29,Calaveras,009,45235,7339,7328,356,7684,120
2022-04-29,Colusa,011,21464,3461,3457,1047,4504,21
2022-04-29,Contra Costa,013,1133247,196852,192136,13918,206054,1301
2022-04-29,Del Norte,015,27424,5878,5841,191,6032,50
2022-04-29,El Dorado,017,186661,27039,26946,3236,30182,210
2022-04-29,Fresno,019,978130,235069,232067,24411,256478,2748
2022-04-29,Glenn,021,27897,5011,4995,1615,6610,48
2022-04-29,Humboldt,023,135768,17341,17194,3065,20259,145
2022-04-29,Imperial,025,180216,55581,55503,10577,66080,910
2022-04-29,Inyo,027,18085,4090,4084,496,4580,56
2022-04-29,Kern,029,883053,192574,192250,46015,238265,2265
2022-04-29,Kings,031,150075,51636,51640,3530,55170,447
2022-04-29,Lake,033,64148,10783,10742,893,11635,137
2022-04-29,Lassen,035,31185,8968,8966,876,9842,65
2022-04-29,Los Angeles,037,10098052,2750393,2736900,125639,2862539,31712
2022-04-29,Madera,039,155013,37387,37360,6055,43415,365
2022-04-29,Marin,041,260295,34766,34519,2818,37337,291
2022-04-29,Mariposa,043,17540,2438,2430,205,2635,30
2022-04-29,Mendocino,045,87422,13252,13219,3131,16350,123
2022-04-29,Merced,047,269075,62880,62357,8861,71218,818
2022-04-29,Modoc,049,8938,740,745,251,996,8
2022-04-29,Mono,051,14174,2993,2989,130,3119,6
2022-04-29,Monterey,053,433212,80206,79881,14047,93928,731
2022-04-29,Napa,055,140530,26427,26319,1025,27344,143
2022-04-29,Nevada,057,99092,16144,16100,1230,17330,127
2022-04-29,Orange,059,3164182,553491,551822,42466,594288,6998
2022-04-29,Placer,061,380077,63526,63273,7431,70704,625
2022-04-29,Plumas,063,18699,2991,2946,365,3311,13
2022-04-29,Riverside,065,2383286,595705,593965,28126,622091,6457
2022-04-29,Sacramento,067,1510023,284092,283048,26864,309912,3007
2022-04-29,San Benito,069,59416,13086,12988,528,13516,98
2022-04-29,San Bernardino,071,2135413,578532,568758,25164,593922,7191
2022-04-29,San Diego,073,3302833,761270,761253,53955,815208,5238
2022-04-29,San Francisco,075,870044,131770,130241,8696,138937,860
2022-04-29,San Joaquin,077,732212,167980,167028,10095,177123,2225
2022-04-29,San Luis Obispo,079,281455,53186,53040,3865,56905,477
2022-04-29,San Mateo,081,765935,126993,125807,7346,133153,705
2022-04-29,Santa Barbara,083,443738,87083,86768,4787,91555,688
2022-04-29,Santa Clara,085,1922200,325749,320709,12927,333636,2281
2022-04-29,Santa Cruz,087,273765,49621,48798,2167,50965,262
2022-04-29,Shasta,089,179085,30706,30649,6112,36761,554
2022-04-29,Sierra,091,2930,275,274,49,323,4
2022-04-29,Siskiyou,093,43540,4452,4458,2742,7200,81
2022-04-29,Solano,095,438530,83032,82459,5686,88145,449
2022-04-29,Sonoma,097,501317,85797,85290,2934,88224,488
2022-04-29,Stanislaus,099,539301,118306,117943,17975,135918,1643
2022-04-29,Sutter,101,95872,20594,20644,2102,22746,224
2022-04-29,Tehama,103,63373,12088,12078,2575,14653,202
2022-04-29,Trinity,105,12862,1187,1179,288,1467,20
2022-04-29,Tulare,107,460477,106597,106856,27706,134562,1458
2022-04-29,Tuolumne,109,53932,12828,12713,576,13289,181
2022-04-29,Ventura,111,848112,175056,174679,9654,184333,1486
2022-04-29,Yolo,113,214977,37963,37173,2975,40148,314
2022-04-29,Yuba,115,75493,15933,15917,1212,17129,121
2022-04-28,Alameda,001,1643700,264668,262027,14341,276368,1851
2022-04-28,Alpine,003,1148,124,124,1,125,0
2022-04-28,Amador,005,37829,8580,8533,658,9191,86
2022-04-28,Butte,007,227075,33406,33172,7120,40292,418
2022-04-28,Calaveras,009,45235,7335,7328,356,7684,120
2022-04-28,Colusa,011,21464,3461,3457,1047,4504,21
2022-04-28,Contra Costa,013,1133247,196592,192136,13877,206013,1301
2022-04-28,Del Norte,015,27424,5874,5841,191,6032,50
2022-04-28,El Dorado,017,186661,27017,26946,3232,30178,210
2022-04-28,Fresno,019,978130,235010,232067,24402,256469,2748
2022-04-28,Glenn,021,27897,5008,4995,1615,6610,48
2022-04-28,Humboldt,023,135768,17307,17194,3049,20243,145
2022-04-28,Imperial,025,180216,55569,55503,10572,66075,910
2022-04-28,Inyo,027,18085,4090,4084,496,4580,56
2022-04-28,Kern,029,883053,192535,192250,46001,238251,2265
2022-04-28,Kings,031,150075,51630,51640,3530,55170,447
2022-04-28,Lake,033,64148,10779,10742,893,11635,137
2022-04-28,Lassen,035,31185,8968,8966,876,9842,65
2022-04-28,Los Angeles,037,10098052,2748334,2736900,125453,2862353,31712
2022-04-28,Madera,039,155013,37381,37360,6052,43412,365
2022-04-28,Marin,041,260295,34716,34519,2803,37322,291
2022-04-28,Mariposa,043,17540,2438,2430,205,2635,30
2022-04-28,Mendocino,045,87422,13241,13219,3114,16333,123
2022-04-28,Merced,047,269075,62859,62357,8852,71209,818
2022-04-28,Modoc,049,8938,740,745,251,996,8
2022-04-28,Mono,051,14174,2991,2989,130,3119,6
2022-04-28,Monterey,053,433212,80167,79881,14023,93904,731
2022-04-28,Napa,055,140530,26396,26319,1022,27341,143
2022-04-28,Nevada,057,99092,16136,16100,1227,17327,127
2022-04-28,Orange,059,3164182,553132,551822,42399,594221,6998
2022-04-28,Placer,061,380077,63479,63273,7423,70696,625
2022-04-28,Plumas,063,18699,2990,2946,365,3311,13
2022-04-28,Riverside,065,2383286,595422,593965,28104,622069,6457
2022-04-28,Sacramento,067,1510023,283906,283048,26828,309876,3007
2022-04-28,San Benito,069,59416,13076,12988,526,13514,98
2022-04-28,San Bernardino,071,2135413,578332,568758,25156,593914,7191
2022-04-28,San Diego,073,3302833,760730,761253,53891,815144,5238
2022-04-28,San Francisco,075,870044,131467,130241,8661,138902,860
2022-04-28,San Joaquin,077,732212,167910,167028,10079,177107,2225
2022-04-28,San Luis Obispo,079,281455,53158,53040,3847,56887,477
2022-04-28,San Mateo,081,765935,126743,125807,7325,133132,705
2022-04-28,Santa Barbara,083,443738,87030,86768,4784,91552,688
2022-04-28,Santa Clara,085,1922200,325205,320709,12893,333602,2281
2022-04-28,Santa Cruz,087,273765,49524,48798,2161,50959,262
2022-04-28,Shasta,089,179085,30698,30649,6112,36761,554
2022-04-28,Sierra,091,2930,275,274,49,323,4
2022-04-28,Siskiyou,093,43540,4449,4458,2742,7200,81
2022-04-28,Solano,095,438530,82948,82459,5681,88140,449
2022-04-28,Sonoma,097,501317,85682,85290,2920,88210,488
2022-04-28,Stanislaus,099,539301,118268,117943,17968,135911,1643
2022-04-28,Sutter,101,95872,20584,20644,2099,22743,224
2022-04-28,Tehama,103,63373,12087,12078,2574,14652,202
2022-04-28,Trinity,105,12862,1187,1179,288,1467,20
2022-04-28,Tulare,107,460477,106576,106856,27696,134552,1458
2022-04-28,Tuolumne,109,53932,12816,12713,575,13288,181
2022-04-28,Ventura,111,848112,174967,174679,9618,184297,1486
2022-04-28,Yolo,113,214977,37926,37173,2972,40145,314
2022-04-28,Yuba,115,75493,15924,15917,1210,17127,121
2022-04-27,Alameda,001,1643700,264187,260871,14298,275169,1843
2022-04-27,Alpine,003,1148,124,124,1,125,0
2022-04-27,Amador,005,37829,8579,8518,658,9176,86
2022-04-27,Butte,007,227075,33395,33118,7115,40233,411
2022-04-27,Calaveras,009,45235,7332,7307,356,7663,119
2022-04-27,Colusa,011,21464,3461,3457,1047,4504,21
2022-04-27,Contra Costa,013,1133247,196328,191412,13847,205259,1300
2022-04-27,Del Norte,015,27424,5869,5833,191,6024,50
2022-04-27,El Dorado,017,186661,27005,26898,3227,30125,209
2022-04-27,Fresno,019,978130,234943,231951,24389,256340,2744
2022-04-27,Glenn,021,27897,5008,4993,1615,6608,48
2022-04-27,Humboldt,023,135768,17277,17138,3038,20176,145
2022-04-27,Imperial,025,180216,55551,55480,10569,66049,910
2022-04-27,Inyo,027,18085,4089,4080,495,4575,56
2022-04-27,Kern,029,883053,192499,192157,45982,238139,2271
2022-04-27,Kings,031,150075,51625,51617,3529,55146,444
2022-04-27,Lake,033,64148,10775,10732,893,11625,135
2022-04-27,Lassen,035,31185,8967,8965,876,9841,65
2022-04-27,Los Angeles,037,10098052,2746026,2731988,125270,2857258,31691
2022-04-27,Madera,039,155013,37372,37339,6051,43390,354
2022-04-27,Marin,041,260295,34655,34354,2789,37143,288
2022-04-27,Mariposa,043,17540,2436,2427,205,2632,30
2022-04-27,Mendocino,045,87422,13234,13188,3106,16294,123
2022-04-27,Merced,047,269075,62845,62315,8847,71162,815
2022-04-27,Modoc,049,8938,740,745,251,996,8
2022-04-27,Mono,051,14174,2991,2989,130,3119,6
2022-04-27,Monterey,053,433212,80125,79695,13983,93678,729
2022-04-27,Napa,055,140530,26367,26210,1017,27227,143
2022-04-27,Nevada,057,99092,16120,16080,1224,17304,127
2022-04-27,Orange,059,3164182,552759,550859,42337,593196,6991
2022-04-27,Placer,061,380077,63438,63154,7408,70562,623
2022-04-27,Plumas,063,18699,2989,2934,365,3299,13
2022-04-27,Riverside,065,2383286,595156,593397,28088,621485,6453
2022-04-27,Sacramento,067,1510023,283706,281802,26795,308597,3001
2022-04-27,San Benito,069,59416,13063,12989,524,13513,98
2022-04-27,San Bernardino,071,2135413,578134,568018,25149,593167,7105
2022-04-27,San Diego,073,3302833,760156,759873,53828,813701,5236
2022-04-27,San Francisco,075,870044,131113,129284,8636,137920,857
2022-04-27,San Joaquin,077,732212,167834,166848,10064,176912,2225
2022-04-27,San Luis Obispo,079,281455,53113,52911,3836,56747,476
2022-04-27,San Mateo,081,765935,126509,125018,7274,132292,702
2022-04-27,Santa Barbara,083,443738,86966,86557,4777,91334,685
2022-04-27,Santa Clara,085,1922200,324634,319077,12848,331925,2282
2022-04-27,Santa Cruz,087,273765,49439,48500,2154,50654,262
2022-04-27,Shasta,089,179085,30687,30633,6109,36742,554
2022-04-27,Sierra,091,2930,274,276,49,325,4
2022-04-27,Siskiyou,093,43540,4449,4455,2738,7193,81
2022-04-27,Solano,095,438530,82835,82220,5673,87893,448
2022-04-27,Sonoma,097,501317,85573,84983,2902,87885,487
2022-04-27,Stanislaus,099,539301,118226,117841,17958,135799,1643
2022-04-27,Sutter,101,95872,20580,20627,2095,22722,224
2022-04-27,Tehama,103,63373,12087,12073,2574,14647,201
2022-04-27,Trinity,105,12862,1187,1179,288,1467,20
2022-04-27,Tulare,107,460477,106558,106580,27687,134267,1453
2022-04-27,Tuolumne,109,53932,12799,12684,574,13258,181
2022-04-27,Ventura,111,848112,174864,174425,9603,184028,1480
2022-04-27,Yolo,113,214977,37877,37096,2967,40063,314
2022-04-27,Yuba,115,75493,15920,15902,1205,17107,121
2022-04-26,Alameda,001,1643700,263666,260871,14257,275128,1843
2022-04-26,Alpine,003,1148,124,124,1,125,0
2022-04-26,Amador,005,37829,8576,8518,657,9175,86
2022-04-26,Butte,007,227075,33378,33118,7108,40226,411
2022-04-26,Calaveras,009,45235,7328,7307,355,7662,119
2022-04-26,Colusa,011,21464,3461,3457,1047,4504,21
2022-04-26,Contra Costa,013,1133247,196066,191412,13810,205222,1300
2022-04-26,Del Norte,015,27424,5861,5833,191,6024,50
2022-04-26,El Dorado,017,186661,26983,26898,3223,30121,209
2022-04-26,Fresno,019,978130,234864,231951,24379,256330,2744
2022-04-26,Glenn,021,27897,5008,4993,1614,6607,48
2022-04-26,Humboldt,023,135768,17246,17138,3032,20170,145
2022-04-26,Imperial,025,180216,55531,55480,10564,66044,910
2022-04-26,Inyo,027,18085,4089,4080,495,4575,56
2022-04-26,Kern,029,883053,192452,192157,45957,238114,2271
2022-04-26,Kings,031,150075,51619,51617,3529,55146,444
2022-04-26,Lake,033,64148,10768,10732,893,11625,135
2022-04-26,Lassen,035,31185,8962,8965,876,9841,65
2022-04-26,Los Angeles,037,10098052,2743647,2731988,125086,2857074,31691
2022-04-26,Madera,039,155013,37364,37339,6044,43383,354
2022-04-26,Marin,041,260295,34601,34354,2770,37124,288
2022-04-26,Mariposa,043,17540,2436,2427,205,2632,30
2022-04-26,Mendocino,045,87422,13230,13188,3100,16288,123
2022-04-26,Merced,047,269075,62822,62315,8830,71145,815
2022-04-26,Modoc,049,8938,740,745,251,996,8
2022-04-26,Mono,051,14174,2991,2989,129,3118,6
2022-04-26,Monterey,053,433212,80071,79695,13944,93639,729
2022-04-26,Napa,055,140530,26336,26210,1013,27223,143
2022-04-26,Nevada,057,99092,16111,16080,1224,17304,127
2022-04-26,Orange,059,3164182,552350,550859,42278,593137,6991
2022-04-26,Placer,061,380077,63407,63154,7404,70558,623
2022-04-26,Plumas,063,18699,2989,2934,365,3299,13
2022-04-26,Riverside,065,2383286,594847,593397,28062,621459,6453
2022-04-26,Sacramento,067,1510023,283469,281802,26774,308576,3001
2022-04-26,San Benito,069,59416,13059,12989,523,13512,98
2022-04-26,San Bernardino,071,2135413,577926,568018,25135,593153,7105
2022-04-26,San Diego,073,3302833,759496,759873,53723,813596,5236
2022-04-26,San Francisco,075,870044,130713,129284,8611,137895,857
2022-04-26,San Joaquin,077,732212,167773,166848,10054,176902,2225
2022-04-26,San Luis Obispo,079,281455,53084,52911,3825,56736,476
2022-04-26,San Mateo,081,765935,126232,125018,7245,132263,702
2022-04-26,Santa Barbara,083,443738,86905,86557,4772,91329,685
2022-04-26,Santa Clara,085,1922200,324072,319077,12804,331881,2282
2022-04-26,Santa Cruz,087,273765,49339,48500,2151,50651,262
2022-04-26,Shasta,089,179085,30675,30633,6109,36742,554
2022-04-26,Sierra,091,2930,274,276,49,325,4
2022-04-26,Siskiyou,093,43540,4447,4455,2736,7191,81
2022-04-26,Solano,095,438530,82736,82220,5662,87882,448
2022-04-26,Sonoma,097,501317,85467,84983,2886,87869,487
2022-04-26,Stanislaus,099,539301,118191,117841,17948,135789,1643
2022-04-26,Sutter,101,95872,20570,20627,2095,22722,224
2022-04-26,Tehama,103,63373,12078,12073,2574,14647,201
2022-04-26,Trinity,105,12862,1187,1179,288,1467,20
2022-04-26,Tulare,107,460477,106531,106580,27673,134253,1453
2022-04-26,Tuolumne,109,53932,12780,12684,572,13256,181
2022-04-26,Ventura,111,848112,174755,174425,9577,184002,1480
2022-04-26,Yolo,113,214977,37818,37096,2962,40058,314
2022-04-26,Yuba,115,75493,15918,15902,1205,17107,121
2022-04-25,Alameda,001,1643700,263154,260871,14216,275087,1843
2022-04-25,Alpine,003,1148,124,124,1,125,0
2022-04-25,Amador,005,37829,8573,8518,657,9175,86
2022-04-25,Butte,007,227075,33363,33118,7099,40217,411
2022-04-25,Calaveras,009,45235,7325,7307,355,7662,119
2022-04-25,Colusa,011,21464,3461,3457,1047,4504,21
2022-04-25,Contra Costa,013,1133247,195800,191412,13773,205185,1300
2022-04-25,Del Norte,015,27424,5855,5833,189,6022,50
2022-04-25,El Dorado,017,186661,26962,26898,3221,30119,209
2022-04-25,Fresno,019,978130,234772,231951,24367,256318,2744
2022-04-25,Glenn,021,27897,5008,4993,1614,6607,48
2022-04-25,Humboldt,023,135768,17204,17138,3024,20162,145
2022-04-25,Imperial,025,180216,55511,55480,10559,66039,910
2022-04-25,Inyo,027,18085,4089,4080,495,4575,56
2022-04-25,Kern,029,883053,192408,192157,45939,238096,2271
2022-04-25,Kings,031,150075,51610,51617,3528,55145,444
2022-04-25,Lake,033,64148,10765,10732,892,11624,135
2022-04-25,Lassen,035,31185,8961,8965,876,9841,65
2022-04-25,Los Angeles,037,10098052,2741269,2731988,124921,2856909,31691
2022-04-25,Madera,039,155013,37351,37339,6040,43379,354
2022-04-25,Marin,041,260295,34537,34354,2746,37100,288
2022-04-25,Mariposa,043,17540,2436,2427,204,2631,30
2022-04-25,Mendocino,045,87422,13220,13188,3083,16271,123
2022-04-25,Merced,047,269075,62809,62315,8828,71143,815
2022-04-25,Modoc,049,8938,740,745,251,996,8
2022-04-25,Mono,051,14174,2991,2989,129,3118,6
2022-04-25,Monterey,053,433212,80033,79695,13919,93614,729
2022-04-25,Napa,055,140530,26295,26210,1011,27221,143
2022-04-25,Nevada,057,99092,16105,16080,1222,17302,127
2022-04-25,Orange,059,3164182,551943,550859,42215,593074,6991
2022-04-25,Placer,061,380077,63372,63154,7400,70554,623
2022-04-25,Plumas,063,18699,2987,2934,365,3299,13
2022-04-25,Riverside,065,2383286,594583,593397,28045,621442,6453
2022-04-25,Sacramento,067,1510023,283304,281802,26743,308545,3001
2022-04-25,San Benito,069,59416,13052,12989,523,13512,98
2022-04-25,San Bernardino,071,2135413,577695,568018,25118,593136,7105
2022-04-25,San Diego,073,3302833,758817,759873,53645,813518,5236
2022-04-25,San Francisco,075,870044,130352,129284,8589,137873,857
2022-04-25,San Joaquin,077,732212,167689,166848,10040,176888,2225
2022-04-25,San Luis Obispo,079,281455,53035,52911,3817,56728,476
2022-04-25,San Mateo,081,765935,125958,125018,7227,132245,702
2022-04-25,Santa Barbara,083,443738,86844,86557,4766,91323,685
2022-04-25,Santa Clara,085,1922200,323426,319077,12760,331837,2282
2022-04-25,Santa Cruz,087,273765,49197,48500,2142,50642,262
2022-04-25,Shasta,089,179085,30663,30633,6106,36739,554
2022-04-25,Sierra,091,2930,274,276,49,325,4
2022-04-25,Siskiyou,093,43540,4447,4455,2735,7190,81
2022-04-25,Solano,095,438530,82617,82220,5651,87871,448
2022-04-25,Sonoma,097,501317,85343,84983,2867,87850,487
2022-04-25,Stanislaus,099,539301,118146,117841,17941,135782,1643
2022-04-25,Sutter,101,95872,20567,20627,2095,22722,224
2022-04-25,Tehama,103,63373,12078,12073,2574,14647,201
2022-04-25,Trinity,105,12862,1186,1179,288,1467,20
2022-04-25,Tulare,107,460477,106506,106580,27663,134243,1453
2022-04-25,Tuolumne,109,53932,12770,12684,572,13256,181
2022-04-25,Ventura,111,848112,174645,174425,9553,183978,1480
2022-04-25,Yolo,113,214977,37755,37096,2958,40054,314
2022-04-25,Yuba,115,75493,15908,15902,1204,17106,121
2022-04-24,Alameda,001,1643700,262570,259619,14172,273791,1837
2022-04-24,Alpine,003,1148,124,124,1,125,0
2022-04-24,Amador,005,37829,8564,8509,656,9165,86
2022-04-24,Butte,007,227075,33346,33105,7092,40197,411
2022-04-24,Calaveras,009,45235,7316,7296,353,7649,119
2022-04-24,Colusa,011,21464,3460,3453,1047,4500,21
2022-04-24,Contra Costa,013,1133247,195495,190611,13740,204351,1298
2022-04-24,Del Norte,015,27424,5846,5827,187,6014,50
2022-04-24,El Dorado,017,186661,26944,26837,3219,30056,209
2022-04-24,Fresno,019,978130,234691,231751,24354,256105,2744
2022-04-24,Glenn,021,27897,5008,4989,1612,6601,48
2022-04-24,Humboldt,023,135768,17179,17033,3010,20043,145
2022-04-24,Imperial,025,180216,55499,55434,10551,65985,910
2022-04-24,Inyo,027,18085,4085,4079,494,4573,56
2022-04-24,Kern,029,883053,192355,192012,45925,237937,2267
2022-04-24,Kings,031,150075,51601,51588,3528,55116,444
2022-04-24,Lake,033,64148,10757,10720,889,11609,134
2022-04-24,Lassen,035,31185,8960,8966,876,9842,65
2022-04-24,Los Angeles,037,10098052,2738930,2725630,124776,2850406,31667
2022-04-24,Madera,039,155013,37336,37333,6034,43367,354
2022-04-24,Marin,041,260295,34483,34150,2712,36862,288
2022-04-24,Mariposa,043,17540,2433,2422,204,2626,30
2022-04-24,Mendocino,045,87422,13215,13158,3071,16229,122
2022-04-24,Merced,047,269075,62785,62286,8819,71105,815
2022-04-24,Modoc,049,8938,740,745,251,996,8
2022-04-24,Mono,051,14174,2989,2986,129,3115,6
2022-04-24,Monterey,053,433212,79980,79560,13886,93446,729
2022-04-24,Napa,055,140530,26258,26093,1010,27103,143
2022-04-24,Nevada,057,99092,16089,16052,1220,17272,127
2022-04-24,Orange,059,3164182,551521,549765,42152,591917,6989
2022-04-24,Placer,061,380077,63317,63037,7392,70429,622
2022-04-24,Plumas,063,18699,2985,2934,365,3299,13
2022-04-24,Riverside,065,2383286,594305,592683,28010,620693,6450
2022-04-24,Sacramento,067,1510023,283096,280551,26710,307261,2993
2022-04-24,San Benito,069,59416,13048,12966,523,13489,98
2022-04-24,San Bernardino,071,2135413,577461,566806,25096,591902,7047
2022-04-24,San Diego,073,3302833,758187,758311,53582,811893,5233
2022-04-24,San Francisco,075,870044,129908,128323,8563,136886,857
2022-04-24,San Joaquin,077,732212,167603,166626,10004,176630,2224
2022-04-24,San Luis Obispo,079,281455,52959,52826,3807,56633,476
2022-04-24,San Mateo,081,765935,125641,124106,7198,131304,703
2022-04-24,Santa Barbara,083,443738,86775,86376,4764,91140,685
2022-04-24,Santa Clara,085,1922200,322740,317487,12709,330196,2277
2022-04-24,Santa Cruz,087,273765,49083,48255,2136,50391,261
2022-04-24,Shasta,089,179085,30652,30607,6104,36711,557
2022-04-24,Sierra,091,2930,274,276,49,325,4
2022-04-24,Siskiyou,093,43540,4445,4453,2733,7186,81
2022-04-24,Solano,095,438530,82508,81982,5642,87624,448
2022-04-24,Sonoma,097,501317,85207,84581,2845,87426,486
2022-04-24,Stanislaus,099,539301,118095,117737,17935,135672,1632
2022-04-24,Sutter,101,95872,20558,20605,2092,22697,224
2022-04-24,Tehama,103,63373,12074,12064,2574,14638,201
2022-04-24,Trinity,105,12862,1186,1177,288,1465,20
2022-04-24,Tulare,107,460477,106479,106354,27652,134006,1446
2022-04-24,Tuolumne,109,53932,12757,12664,571,13235,181
2022-04-24,Ventura,111,848112,174533,174091,9532,183623,1479
2022-04-24,Yolo,113,214977,37715,36990,2955,39945,314
2022-04-24,Yuba,115,75493,15904,15888,1204,17092,121
2022-04-23,Alameda,001,1643700,262323,259619,14159,273778,1837
2022-04-23,Alpine,003,1148,124,124,1,125,0
2022-04-23,Amador,005,37829,8558,8509,656,9165,86
2022-04-23,Butte,007,227075,33337,33105,7089,40194,411
2022-04-23,Calaveras,009,45235,7308,7296,353,7649,119
2022-04-23,Colusa,011,21464,3460,3453,1047,4500,21
2022-04-23,Contra Costa,013,1133247,195339,190611,13722,204333,1298
2022-04-23,Del Norte,015,27424,5844,5827,186,6013,50
2022-04-23,El Dorado,017,186661,26934,26837,3218,30055,209
2022-04-23,Fresno,019,978130,234658,231751,24348,256099,2744
2022-04-23,Glenn,021,27897,5008,4989,1612,6601,48
2022-04-23,Humboldt,023,135768,17163,17033,3007,20040,145
2022-04-23,Imperial,025,180216,55488,55434,10550,65984,910
2022-04-23,Inyo,027,18085,4085,4079,493,4572,56
2022-04-23,Kern,029,883053,192327,192012,45911,237923,2267
2022-04-23,Kings,031,150075,51596,51588,3527,55115,444
2022-04-23,Lake,033,64148,10756,10720,889,11609,134
2022-04-23,Lassen,035,31185,8960,8966,876,9842,65
2022-04-23,Los Angeles,037,10098052,2737984,2725630,124674,2850304,31667
2022-04-23,Madera,039,155013,37329,37333,6033,43366,354
2022-04-23,Marin,041,260295,34448,34150,2666,36816,288
2022-04-23,Mariposa,043,17540,2433,2422,204,2626,30
2022-04-23,Mendocino,045,87422,13208,13158,3071,16229,122
2022-04-23,Merced,047,269075,62775,62286,8819,71105,815
2022-04-23,Modoc,049,8938,740,745,251,996,8
2022-04-23,Mono,051,14174,2989,2986,129,3115,6
2022-04-23,Monterey,053,433212,79911,79560,13871,93431,729
2022-04-23,Napa,055,140530,26237,26093,1008,27101,143
2022-04-23,Nevada,057,99092,16083,16052,1218,17270,127
2022-04-23,Orange,059,3164182,551305,549765,42103,591868,6989
2022-04-23,Placer,061,380077,63287,63037,7391,70428,622
2022-04-23,Plumas,063,18699,2985,2934,365,3299,13
2022-04-23,Riverside,065,2383286,594169,592683,28000,620683,6450
2022-04-23,Sacramento,067,1510023,282996,280551,26707,307258,2993
2022-04-23,San Benito,069,59416,13047,12966,523,13489,98
2022-04-23,San Bernardino,071,2135413,577339,566806,25093,591899,7047
2022-04-23,San Diego,073,3302833,757925,758311,53563,811874,5233
2022-04-23,San Francisco,075,870044,129703,128323,8537,136860,857
2022-04-23,San Joaquin,077,732212,167562,166626,9996,176622,2224
2022-04-23,San Luis Obispo,079,281455,52944,52826,3803,56629,476
2022-04-23,San Mateo,081,765935,125478,124106,7192,131298,703
2022-04-23,Santa Barbara,083,443738,86739,86376,4763,91139,685
2022-04-23,Santa Clara,085,1922200,322358,317487,12682,330169,2277
2022-04-23,Santa Cruz,087,273765,49033,48255,2134,50389,261
2022-04-23,Shasta,089,179085,30649,30607,6104,36711,557
2022-04-23,Sierra,091,2930,274,276,49,325,4
2022-04-23,Siskiyou,093,43540,4443,4453,2733,7186,81
2022-04-23,Solano,095,438530,82481,81982,5638,87620,448
2022-04-23,Sonoma,097,501317,85139,84581,2836,87417,486
2022-04-23,Stanislaus,099,539301,118059,117737,17933,135670,1632
2022-04-23,Sutter,101,95872,20552,20605,2092,22697,224
2022-04-23,Tehama,103,63373,12073,12064,2574,14638,201
2022-04-23,Trinity,105,12862,1186,1177,288,1465,20
2022-04-23,Tulare,107,460477,106471,106354,27643,133997,1446
2022-04-23,Tuolumne,109,53932,12752,12664,571,13235,181
2022-04-23,Ventura,111,848112,174470,174091,9524,183615,1479
2022-04-23,Yolo,113,214977,37687,36990,2951,39941,314
2022-04-23,Yuba,115,75493,15902,15888,1204,17092,121
2022-04-22,Alameda,001,1643700,262093,259619,14140,273759,1837
2022-04-22,Alpine,003,1148,124,124,1,125,0
2022-04-22,Amador,005,37829,8557,8509,654,9163,86
2022-04-22,Butte,007,227075,33331,33105,7084,40189,411
2022-04-22,Calaveras,009,45235,7307,7296,353,7649,119
2022-04-22,Colusa,011,21464,3460,3453,1047,4500,21
2022-04-22,Contra Costa,013,1133247,195203,190611,13706,204317,1298
2022-04-22,Del Norte,015,27424,5844,5827,186,6013,50
2022-04-22,El Dorado,017,186661,26921,26837,3214,30051,209
2022-04-22,Fresno,019,978130,234628,231751,24344,256095,2744
2022-04-22,Glenn,021,27897,5006,4989,1612,6601,48
2022-04-22,Humboldt,023,135768,17147,17033,3001,20034,145
2022-04-22,Imperial,025,180216,55482,55434,10550,65984,910
2022-04-22,Inyo,027,18085,4085,4079,492,4571,56
2022-04-22,Kern,029,883053,192306,192012,45908,237920,2267
2022-04-22,Kings,031,150075,51592,51588,3526,55114,444
2022-04-22,Lake,033,64148,10755,10720,889,11609,134
2022-04-22,Lassen,035,31185,8960,8966,876,9842,65
2022-04-22,Los Angeles,037,10098052,2736905,2725630,124615,2850245,31667
2022-04-22,Madera,039,155013,37324,37333,6032,43365,354
2022-04-22,Marin,041,260295,34411,34150,2655,36805,288
2022-04-22,Mariposa,043,17540,2432,2422,204,2626,30
2022-04-22,Mendocino,045,87422,13203,13158,3066,16224,122
2022-04-22,Merced,047,269075,62768,62286,8807,71093,815
2022-04-22,Modoc,049,8938,740,745,251,996,8
2022-04-22,Mono,051,14174,2989,2986,128,3114,6
2022-04-22,Monterey,053,433212,79876,79560,13857,93417,729
2022-04-22,Napa,055,140530,26220,26093,1006,27099,143
2022-04-22,Nevada,057,99092,16083,16052,1218,17270,127
2022-04-22,Orange,059,3164182,551120,549765,42050,591815,6989
2022-04-22,Placer,061,380077,63264,63037,7388,70425,622
2022-04-22,Plumas,063,18699,2985,2934,365,3299,13
2022-04-22,Riverside,065,2383286,594025,592683,27985,620668,6450
2022-04-22,Sacramento,067,1510023,282908,280551,26695,307246,2993
2022-04-22,San Benito,069,59416,13042,12966,523,13489,98
2022-04-22,San Bernardino,071,2135413,577226,566806,25085,591891,7047
2022-04-22,San Diego,073,3302833,757606,758311,53535,811846,5233
2022-04-22,San Francisco,075,870044,129536,128323,8511,136834,857
2022-04-22,San Joaquin,077,732212,167531,166626,9994,176620,2224
2022-04-22,San Luis Obispo,079,281455,52938,52826,3802,56628,476
2022-04-22,San Mateo,081,765935,125311,124106,7181,131287,703
2022-04-22,Santa Barbara,083,443738,86693,86376,4762,91138,685
2022-04-22,Santa Clara,085,1922200,322011,317487,12668,330155,2277
2022-04-22,Santa Cruz,087,273765,48993,48255,2133,50388,261
2022-04-22,Shasta,089,179085,30644,30607,6103,36710,557
2022-04-22,Sierra,091,2930,274,276,48,324,4
2022-04-22,Siskiyou,093,43540,4443,4453,2733,7186,81
2022-04-22,Solano,095,438530,82424,81982,5635,87617,448
2022-04-22,Sonoma,097,501317,85074,84581,2832,87413,486
2022-04-22,Stanislaus,099,539301,118037,117737,17928,135665,1632
2022-04-22,Sutter,101,95872,20546,20605,2092,22697,224
2022-04-22,Tehama,103,63373,12068,12064,2573,14637,201
2022-04-22,Trinity,105,12862,1186,1177,287,1464,20
2022-04-22,Tulare,107,460477,106461,106354,27635,133989,1446
2022-04-22,Tuolumne,109,53932,12746,12664,569,13233,181
2022-04-22,Ventura,111,848112,174395,174091,9513,183604,1479
2022-04-22,Yolo,113,214977,37666,36990,2949,39939,314
2022-04-22,Yuba,115,75493,15899,15888,1203,17091,121
2022-04-21,Alameda,001,1643700,261729,259619,14104,273723,1837
2022-04-21,Alpine,003,1148,124,124,1,125,0
2022-04-21,Amador,005,37829,8554,8509,654,9163,86
2022-04-21,Butte,007,227075,33324,33105,7076,40181,411
2022-04-21,Calaveras,009,45235,7304,7296,353,7649,119
2022-04-21,Colusa,011,21464,3459,3453,1047,4500,21
2022-04-21,Contra Costa,013,1133247,195008,190611,13685,204296,1298
2022-04-21,Del Norte,015,27424,5843,5827,186,6013,50
2022-04-21,El Dorado,017,186661,26905,26837,3213,30050,209
2022-04-21,Fresno,019,978130,234586,231751,24335,256086,2744
2022-04-21,Glenn,021,27897,5006,4989,1611,6600,48
2022-04-21,Humboldt,023,135768,17124,17033,2993,20026,145
2022-04-21,Imperial,025,180216,55473,55434,10550,65984,910
2022-04-21,Inyo,027,18085,4085,4079,492,4571,56
2022-04-21,Kern,029,883053,192273,192012,45893,237905,2267
2022-04-21,Kings,031,150075,51584,51588,3526,55114,444
2022-04-21,Lake,033,64148,10752,10720,889,11609,134
2022-04-21,Lassen,035,31185,8960,8966,876,9842,65
2022-04-21,Los Angeles,037,10098052,2735262,2725630,124500,2850130,31667
2022-04-21,Madera,039,155013,37321,37333,6031,43364,354
2022-04-21,Marin,041,260295,34363,34150,2645,36795,288
2022-04-21,Mariposa,043,17540,2431,2422,204,2626,30
2022-04-21,Mendocino,045,87422,13196,13158,3063,16221,122
2022-04-21,Merced,047,269075,62750,62286,8804,71090,815
2022-04-21,Modoc,049,8938,740,745,251,996,8
2022-04-21,Mono,051,14174,2988,2986,127,3113,6
2022-04-21,Monterey,053,433212,79849,79560,13843,93403,729
2022-04-21,Napa,055,140530,26189,26093,1005,27098,143
2022-04-21,Nevada,057,99092,16079,16052,1218,17270,127
2022-04-21,Orange,059,3164182,550868,549765,42013,591778,6989
2022-04-21,Placer,061,380077,63226,63037,7384,70421,622
2022-04-21,Plumas,063,18699,2985,2934,365,3299,13
2022-04-21,Riverside,065,2383286,593864,592683,27967,620650,6450
2022-04-21,Sacramento,067,1510023,282759,280551,26676,307227,2993
2022-04-21,San Benito,069,59416,13036,12966,523,13489,98
2022-04-21,San Bernardino,071,2135413,577034,566806,25073,591879,7047
2022-04-21,San Diego,073,3302833,757181,758311,53491,811802,5233
2022-04-21,San Francisco,075,870044,129313,128323,8484,136807,857
2022-04-21,San Joaquin,077,732212,167478,166626,9989,176615,2224
2022-04-21,San Luis Obispo,079,281455,52918,52826,3795,56621,476
2022-04-21,San Mateo,081,765935,125105,124106,7164,131270,703
2022-04-21,Santa Barbara,083,443738,86634,86376,4759,91135,685
2022-04-21,Santa Clara,085,1922200,321561,317487,12646,330133,2277
2022-04-21,Santa Cruz,087,273765,48947,48255,2131,50386,261
2022-04-21,Shasta,089,179085,30636,30607,6103,36710,557
2022-04-21,Sierra,091,2930,274,276,48,324,4
2022-04-21,Siskiyou,093,43540,4443,4453,2733,7186,81
2022-04-21,Solano,095,438530,82362,81982,5628,87610,448
2022-04-21,Sonoma,097,501317,84960,84581,2812,87393,486
2022-04-21,Stanislaus,099,539301,117998,117737,17920,135657,1632
2022-04-21,Sutter,101,95872,20537,20605,2090,22695,224
2022-04-21,Tehama,103,63373,12068,12064,2573,14637,201
2022-04-21,Trinity,105,12862,1186,1177,287,1464,20
2022-04-21,Tulare,107,460477,106454,106354,27631,133985,1446
2022-04-21,Tuolumne,109,53932,12741,12664,569,13233,181
2022-04-21,Ventura,111,848112,174313,174091,9507,183598,1479
2022-04-21,Yolo,113,214977,37636,36990,2949,39939,314
2022-04-21,Yuba,115,75493,15897,15888,1203,17091,121
2022-04-20,Alameda,001,1643700,261363,258734,14078,272812,1832
2022-04-20,Alpine,003,1148,124,124,1,125,0
2022-04-20,Amador,005,37829,8552,8494,654,9148,86
2022-04-20,Butte,007,227075,33308,33083,7069,40152,408
2022-04-20,Calaveras,009,45235,7298,7288,352,7640,119
2022-04-20,Colusa,011,21464,3459,3453,1047,4500,21
2022-04-20,Contra Costa,013,1133247,194774,190042,13660,203702,1299
2022-04-20,Del Norte,015,27424,5837,5814,186,6000,50
2022-04-20,El Dorado,017,186661,26890,26821,3209,30030,209
2022-04-20,Fresno,019,978130,234536,231568,24334,255902,2740
2022-04-20,Glenn,021,27897,5005,4988,1608,6596,48
2022-04-20,Humboldt,023,135768,17102,16976,2989,19965,145
2022-04-20,Imperial,025,180216,55465,55405,10547,65952,910
2022-04-20,Inyo,027,18085,4085,4075,491,4566,56
2022-04-20,Kern,029,883053,192238,191915,45877,237792,2262
2022-04-20,Kings,031,150075,51575,51571,3524,55095,445
2022-04-20,Lake,033,64148,10752,10711,889,11600,134
2022-04-20,Lassen,035,31185,8960,8951,876,9827,65
2022-04-20,Los Angeles,037,10098052,2733526,2721699,124379,2846078,31630
2022-04-20,Madera,039,155013,37318,37333,6028,43361,354
2022-04-20,Marin,041,260295,34322,33985,2622,36607,288
2022-04-20,Mariposa,043,17540,2429,2412,204,2616,30
2022-04-20,Mendocino,045,87422,13190,13128,3055,16183,122
2022-04-20,Merced,047,269075,62740,62322,8791,71113,813
2022-04-20,Modoc,049,8938,740,744,251,995,8
2022-04-20,Mono,051,14174,2988,2984,127,3111,6
2022-04-20,Monterey,053,433212,79804,79419,13824,93243,727
2022-04-20,Napa,055,140530,26155,26016,1001,27017,143
2022-04-20,Nevada,057,99092,16069,16034,1215,17249,127
2022-04-20,Orange,059,3164182,550540,549136,41966,591102,6963
2022-04-20,Placer,061,380077,63199,62928,7379,70307,619
2022-04-20,Plumas,063,18699,2985,2932,365,3297,13
2022-04-20,Riverside,065,2383286,593672,592224,27945,620169,6447
2022-04-20,Sacramento,067,1510023,282612,279326,26662,305988,2987
2022-04-20,San Benito,069,59416,13030,12971,520,13491,98
2022-04-20,San Bernardino,071,2135413,576827,565405,25056,590461,6977
2022-04-20,San Diego,073,3302833,756739,757138,53430,810568,5231
2022-04-20,San Francisco,075,870044,129005,127594,8466,136060,854
2022-04-20,San Joaquin,077,732212,167409,166531,9982,176513,2222
2022-04-20,San Luis Obispo,079,281455,52891,52740,3788,56528,476
2022-04-20,San Mateo,081,765935,124886,123279,7133,130412,701
2022-04-20,Santa Barbara,083,443738,86598,86214,4753,90967,685
2022-04-20,Santa Clara,085,1922200,321150,316355,12608,328963,2274
2022-04-20,Santa Cruz,087,273765,48883,47997,2127,50124,261
2022-04-20,Shasta,089,179085,30633,30590,6102,36692,554
2022-04-20,Sierra,091,2930,274,276,48,324,4
2022-04-20,Siskiyou,093,43540,4442,4446,2732,7178,80
2022-04-20,Solano,095,438530,82291,81841,5625,87466,447
2022-04-20,Sonoma,097,501317,84873,84429,2788,87217,485
2022-04-20,Stanislaus,099,539301,117962,117540,17909,135449,1630
2022-04-20,Sutter,101,95872,20530,20632,2090,22722,224
2022-04-20,Tehama,103,63373,12066,12061,2573,14634,199
2022-04-20,Trinity,105,12862,1186,1178,287,1465,20
2022-04-20,Tulare,107,460477,106446,105974,27620,133594,1439
2022-04-20,Tuolumne,109,53932,12736,12648,568,13216,180
2022-04-20,Ventura,111,848112,174225,173904,9498,183402,1475
2022-04-20,Yolo,113,214977,37586,36785,2946,39731,311
2022-04-20,Yuba,115,75493,15893,15868,1201,17069,121
2022-04-19,Alameda,001,1643700,261000,258734,14049,272783,1832
2022-04-19,Alpine,003,1148,124,124,1,125,0
2022-04-19,Amador,005,37829,8548,8494,651,9145,86
2022-04-19,Butte,007,227075,33301,33083,7065,40148,408
2022-04-19,Calaveras,009,45235,7295,7288,352,7640,119
2022-04-19,Colusa,011,21464,3459,3453,1047,4500,21
2022-04-19,Contra Costa,013,1133247,194527,190042,13642,203684,1299
2022-04-19,Del Norte,015,27424,5835,5814,184,5998,50
2022-04-19,El Dorado,017,186661,26875,26821,3206,30027,209
2022-04-19,Fresno,019,978130,234481,231568,24324,255892,2740
2022-04-19,Glenn,021,27897,5004,4988,1608,6596,48
2022-04-19,Humboldt,023,135768,17065,16976,2978,19954,145
2022-04-19,Imperial,025,180216,55458,55405,10544,65949,910
2022-04-19,Inyo,027,18085,4082,4075,491,4566,56
2022-04-19,Kern,029,883053,192202,191915,45867,237782,2262
2022-04-19,Kings,031,150075,51561,51571,3523,55094,445
2022-04-19,Lake,033,64148,10748,10711,888,11599,134
2022-04-19,Lassen,035,31185,8960,8951,876,9827,65
2022-04-19,Los Angeles,037,10098052,2731734,2721699,124251,2845950,31630
2022-04-19,Madera,039,155013,37315,37333,6027,43360,354
2022-04-19,Marin,041,260295,34272,33985,2606,36591,288
2022-04-19,Mariposa,043,17540,2429,2412,203,2615,30
2022-04-19,Mendocino,045,87422,13182,13128,3044,16172,122
2022-04-19,Merced,047,269075,62721,62322,8788,71110,813
2022-04-19,Modoc,049,8938,740,744,251,995,8
2022-04-19,Mono,051,14174,2988,2984,127,3111,6
2022-04-19,Monterey,053,433212,79785,79419,13811,93230,727
2022-04-19,Napa,055,140530,26132,26016,992,27008,143
2022-04-19,Nevada,057,99092,16063,16034,1213,17247,127
2022-04-19,Orange,059,3164182,550261,549136,41922,591058,6963
2022-04-19,Placer,061,380077,63168,62928,7374,70302,619
2022-04-19,Plumas,063,18699,2985,2932,365,3297,13
2022-04-19,Riverside,065,2383286,593489,592224,27933,620157,6447
2022-04-19,Sacramento,067,1510023,282437,279326,26640,305966,2987
2022-04-19,San Benito,069,59416,13024,12971,519,13490,98
2022-04-19,San Bernardino,071,2135413,576613,565405,25034,590439,6977
2022-04-19,San Diego,073,3302833,756274,757138,53365,810503,5231
2022-04-19,San Francisco,075,870044,128672,127594,8449,136043,854
2022-04-19,San Joaquin,077,732212,167359,166531,9978,176509,2222
2022-04-19,San Luis Obispo,079,281455,52855,52740,3782,56522,476
2022-04-19,San Mateo,081,765935,124653,123279,7113,130392,701
2022-04-19,Santa Barbara,083,443738,86544,86214,4745,90959,685
2022-04-19,Santa Clara,085,1922200,320730,316355,12580,328935,2274
2022-04-19,Santa Cruz,087,273765,48828,47997,2125,50122,261
2022-04-19,Shasta,089,179085,30621,30590,6101,36691,554
2022-04-19,Sierra,091,2930,274,276,48,324,4
2022-04-19,Siskiyou,093,43540,4441,4446,2730,7176,80
2022-04-19,Solano,095,438530,82207,81841,5618,87459,447
2022-04-19,Sonoma,097,501317,84771,84429,2759,87188,485
2022-04-19,Stanislaus,099,539301,117936,117540,17904,135444,1630
2022-04-19,Sutter,101,95872,20530,20632,2090,22722,224
2022-04-19,Tehama,103,63373,12065,12061,2573,14634,199
2022-04-19,Trinity,105,12862,1185,1178,287,1465,20
2022-04-19,Tulare,107,460477,106431,105974,27614,133588,1439
2022-04-19,Tuolumne,109,53932,12734,12648,568,13216,180
2022-04-19,Ventura,111,848112,174132,173904,9485,183389,1475
2022-04-19,Yolo,113,214977,37541,36785,2944,39729,311
2022-04-19,Yuba,115,75493,15886,15868,1201,17069,121
2022-04-18,Alameda,001,1643700,260613,258734,14030,272764,1832
2022-04-18,Alpine,003,1148,124,124,1,125,0
2022-04-18,Amador,005,37829,8547,8494,650,9144,86
2022-04-18,Butte,007,227075,33297,33083,7060,40143,408
2022-04-18,Calaveras,009,45235,7291,7288,351,7639,119
2022-04-18,Colusa,011,21464,3458,3453,1047,4500,21
2022-04-18,Contra Costa,013,1133247,194292,190042,13617,203659,1299
2022-04-18,Del Norte,015,27424,5830,5814,184,5998,50
2022-04-18,El Dorado,017,186661,26859,26821,3203,30024,209
2022-04-18,Fresno,019,978130,234438,231568,24313,255881,2740
2022-04-18,Glenn,021,27897,5004,4988,1607,6595,48
2022-04-18,Humboldt,023,135768,17036,16976,2975,19951,145
2022-04-18,Imperial,025,180216,55446,55405,10542,65947,910
2022-04-18,Inyo,027,18085,4082,4075,491,4566,56
2022-04-18,Kern,029,883053,192157,191915,45855,237770,2262
2022-04-18,Kings,031,150075,51556,51571,3523,55094,445
2022-04-18,Lake,033,64148,10744,10711,887,11598,134
2022-04-18,Lassen,035,31185,8960,8951,876,9827,65
2022-04-18,Los Angeles,037,10098052,2729908,2721699,124138,2845837,31630
2022-04-18,Madera,039,155013,37307,37333,6026,43359,354
2022-04-18,Marin,041,260295,34209,33985,2583,36568,288
2022-04-18,Mariposa,043,17540,2427,2412,203,2615,30
2022-04-18,Mendocino,045,87422,13165,13128,3039,16167,122
2022-04-18,Merced,047,269075,62709,62322,8782,71104,813
2022-04-18,Modoc,049,8938,739,744,251,995,8
2022-04-18,Mono,051,14174,2987,2984,127,3111,6
2022-04-18,Monterey,053,433212,79712,79419,13795,93214,727
2022-04-18,Napa,055,140530,26096,26016,991,27007,143
2022-04-18,Nevada,057,99092,16053,16034,1211,17245,127
2022-04-18,Orange,059,3164182,549973,549136,41886,591022,6963
2022-04-18,Placer,061,380077,63135,62928,7372,70300,619
2022-04-18,Plumas,063,18699,2985,2932,365,3297,13
2022-04-18,Riverside,065,2383286,593280,592224,27913,620137,6447
2022-04-18,Sacramento,067,1510023,282281,279326,26628,305954,2987
2022-04-18,San Benito,069,59416,13018,12971,519,13490,98
2022-04-18,San Bernardino,071,2135413,576403,565405,25016,590421,6977
2022-04-18,San Diego,073,3302833,755805,757138,53306,810444,5231
2022-04-18,San Francisco,075,870044,128355,127594,8437,136031,854
2022-04-18,San Joaquin,077,732212,167299,166531,9971,176502,2222
2022-04-18,San Luis Obispo,079,281455,52826,52740,3777,56517,476
2022-04-18,San Mateo,081,765935,124420,123279,7094,130373,701
2022-04-18,Santa Barbara,083,443738,86473,86214,4740,90954,685
2022-04-18,Santa Clara,085,1922200,320284,316355,12556,328911,2274
2022-04-18,Santa Cruz,087,273765,48723,47997,2123,50120,261
2022-04-18,Shasta,089,179085,30615,30590,6098,36688,554
2022-04-18,Sierra,091,2930,274,276,48,324,4
2022-04-18,Siskiyou,093,43540,4440,4446,2729,7175,80
2022-04-18,Solano,095,438530,82142,81841,5612,87453,447
2022-04-18,Sonoma,097,501317,84671,84429,2744,87173,485
2022-04-18,Stanislaus,099,539301,117906,117540,17901,135441,1630
2022-04-18,Sutter,101,95872,20528,20632,2088,22720,224
2022-04-18,Tehama,103,63373,12061,12061,2573,14634,199
2022-04-18,Trinity,105,12862,1185,1178,287,1465,20
2022-04-18,Tulare,107,460477,106416,105974,27606,133580,1439
2022-04-18,Tuolumne,109,53932,12727,12648,567,13215,180
2022-04-18,Ventura,111,848112,174041,173904,9475,183379,1475
2022-04-18,Yolo,113,214977,37483,36785,2944,39729,311
2022-04-18,Yuba,115,75493,15877,15868,1200,17068,121
2022-04-17,Alameda,001,1643700,260216,257897,14006,271903,1829
2022-04-17,Alpine,003,1148,124,124,1,125,0
2022-04-17,Amador,005,37829,8542,8491,648,9139,86
2022-04-17,Butte,007,227075,33294,33053,7057,40110,405
2022-04-17,Calaveras,009,45235,7288,7275,350,7625,119
2022-04-17,Colusa,011,21464,3457,3450,1047,4497,21
2022-04-17,Contra Costa,013,1133247,194064,189742,13581,203323,1298
2022-04-17,Del Norte,015,27424,5826,5809,184,5993,50
2022-04-17,El Dorado,017,186661,26848,26796,3201,29997,209
2022-04-17,Fresno,019,978130,234361,231455,24308,255763,2739
2022-04-17,Glenn,021,27897,5004,4991,1607,6598,48
2022-04-17,Humboldt,023,135768,17001,16929,2969,19898,143
2022-04-17,Imperial,025,180216,55437,55371,10541,65912,910
2022-04-17,Inyo,027,18085,4080,4075,491,4566,56
2022-04-17,Kern,029,883053,192122,191866,45840,237706,2258
2022-04-17,Kings,031,150075,51545,51544,3521,55065,445
2022-04-17,Lake,033,64148,10743,10702,887,11589,134
2022-04-17,Lassen,035,31185,8960,8950,876,9826,65
2022-04-17,Los Angeles,037,10098052,2727924,2717479,124019,2841498,31598
2022-04-17,Madera,039,155013,37301,37362,6026,43388,354
2022-04-17,Marin,041,260295,34142,33829,2553,36382,288
2022-04-17,Mariposa,043,17540,2419,2406,203,2609,30
2022-04-17,Mendocino,045,87422,13150,13107,3035,16142,122
2022-04-17,Merced,047,269075,62689,62295,8776,71071,813
2022-04-17,Modoc,049,8938,739,743,251,994,8
2022-04-17,Mono,051,14174,2986,2977,127,3104,6
2022-04-17,Monterey,053,433212,79679,79311,13775,93086,727
2022-04-17,Napa,055,140530,26051,25929,985,26914,143
2022-04-17,Nevada,057,99092,16037,16014,1206,17220,123
2022-04-17,Orange,059,3164182,549610,548311,41835,590146,6945
2022-04-17,Placer,061,380077,63095,62882,7365,70247,618
2022-04-17,Plumas,063,18699,2985,2929,365,3294,13
2022-04-17,Riverside,065,2383286,593059,591772,27893,619665,6443
2022-04-17,Sacramento,067,1510023,282118,278523,26604,305127,2978
2022-04-17,San Benito,069,59416,13015,12926,518,13444,98
2022-04-17,San Bernardino,071,2135413,576165,564397,25002,589399,6948
2022-04-17,San Diego,073,3302833,755318,756165,53238,809403,5229
2022-04-17,San Francisco,075,870044,128036,126976,8421,135397,854
2022-04-17,San Joaquin,077,732212,167249,166645,9965,176610,2220
2022-04-17,San Luis Obispo,079,281455,52757,52698,3772,56470,476
2022-04-17,San Mateo,081,765935,124181,122652,7080,129732,699
2022-04-17,Santa Barbara,083,443738,86415,86030,4733,90763,684
2022-04-17,Santa Clara,085,1922200,319792,315296,12530,327826,2268
2022-04-17,Santa Cruz,087,273765,48601,47895,2121,50016,261
2022-04-17,Shasta,089,179085,30604,30578,6094,36672,554
2022-04-17,Sierra,091,2930,274,276,48,324,4
2022-04-17,Siskiyou,093,43540,4435,4444,2728,7172,80
2022-04-17,Solano,095,438530,82075,81781,5606,87387,447
2022-04-17,Sonoma,097,501317,84559,84172,2737,86909,485
2022-04-17,Stanislaus,099,539301,117876,117567,17894,135461,1619
2022-04-17,Sutter,101,95872,20523,20621,2087,22708,224
2022-04-17,Tehama,103,63373,12060,12061,2573,14634,199
2022-04-17,Trinity,105,12862,1184,1178,287,1465,20
2022-04-17,Tulare,107,460477,106402,105757,27597,133354,1428
2022-04-17,Tuolumne,109,53932,12721,12640,567,13207,180
2022-04-17,Ventura,111,848112,173944,173665,9456,183121,1474
2022-04-17,Yolo,113,214977,37434,36752,2942,39694,311
2022-04-17,Yuba,115,75493,15871,15857,1200,17057,121
2022-04-16,Alameda,001,1643700,260063,257897,13996,271893,1829
2022-04-16,Alpine,003,1148,124,124,1,125,0
2022-04-16,Amador,005,37829,8540,8491,648,9139,86
2022-04-16,Butte,007,227075,33290,33053,7055,40108,405
2022-04-16,Calaveras,009,45235,7286,7275,350,7625,119
2022-04-16,Colusa,011,21464,3457,3450,1047,4497,21
2022-04-16,Contra Costa,013,1133247,193973,189742,13575,203317,1298
2022-04-16,Del Norte,015,27424,5826,5809,184,5993,50
2022-04-16,El Dorado,017,186661,26837,26796,3201,29997,209
2022-04-16,Fresno,019,978130,234333,231455,24307,255762,2739
2022-04-16,Glenn,021,27897,5004,4991,1607,6598,48
2022-04-16,Humboldt,023,135768,16993,16929,2964,19893,143
2022-04-16,Imperial,025,180216,55431,55371,10540,65911,910
2022-04-16,Inyo,027,18085,4080,4075,491,4566,56
2022-04-16,Kern,029,883053,192111,191866,45828,237694,2258
2022-04-16,Kings,031,150075,51542,51544,3521,55065,445
2022-04-16,Lake,033,64148,10741,10702,887,11589,134
2022-04-16,Lassen,035,31185,8960,8950,876,9826,65
2022-04-16,Los Angeles,037,10098052,2727208,2717479,123968,2841447,31598
2022-04-16,Madera,039,155013,37299,37362,6026,43388,354
2022-04-16,Marin,041,260295,34104,33829,2527,36356,288
2022-04-16,Mariposa,043,17540,2418,2406,203,2609,30
2022-04-16,Mendocino,045,87422,13144,13107,3035,16142,122
2022-04-16,Merced,047,269075,62686,62295,8775,71070,813
2022-04-16,Modoc,049,8938,739,743,251,994,8
2022-04-16,Mono,051,14174,2986,2977,127,3104,6
2022-04-16,Monterey,053,433212,79664,79311,13766,93077,727
2022-04-16,Napa,055,140530,26028,25929,983,26912,143
2022-04-16,Nevada,057,99092,16034,16014,1203,17217,123
2022-04-16,Orange,059,3164182,549494,548311,41804,590115,6945
2022-04-16,Placer,061,380077,63078,62882,7363,70245,618
2022-04-16,Plumas,063,18699,2983,2929,365,3294,13
2022-04-16,Riverside,065,2383286,592979,591772,27887,619659,6443
2022-04-16,Sacramento,067,1510023,282066,278523,26601,305124,2978
2022-04-16,San Benito,069,59416,13014,12926,518,13444,98
2022-04-16,San Bernardino,071,2135413,576065,564397,24998,589395,6948
2022-04-16,San Diego,073,3302833,755171,756165,53224,809389,5229
2022-04-16,San Francisco,075,870044,127880,126976,8412,135388,854
2022-04-16,San Joaquin,077,732212,167208,166645,9961,176606,2220
2022-04-16,San Luis Obispo,079,281455,52751,52698,3771,56469,476
2022-04-16,San Mateo,081,765935,124077,122652,7077,129729,699
2022-04-16,Santa Barbara,083,443738,86385,86030,4733,90763,684
2022-04-16,Santa Clara,085,1922200,319551,315296,12522,327818,2268
2022-04-16,Santa Cruz,087,273765,48573,47895,2121,50016,261
2022-04-16,Shasta,089,179085,30600,30578,6094,36672,554
2022-04-16,Sierra,091,2930,274,276,48,324,4
2022-04-16,Siskiyou,093,43540,4435,4444,2728,7172,80
2022-04-16,Solano,095,438530,82060,81781,5604,87385,447
2022-04-16,Sonoma,097,501317,84510,84172,2728,86900,485
2022-04-16,Stanislaus,099,539301,117856,117567,17889,135456,1619
2022-04-16,Sutter,101,95872,20519,20621,2087,22708,224
2022-04-16,Tehama,103,63373,12059,12061,2573,14634,199
2022-04-16,Trinity,105,12862,1184,1178,287,1465,20
2022-04-16,Tulare,107,460477,106392,105757,27595,133352,1428
2022-04-16,Tuolumne,109,53932,12720,12640,567,13207,180
2022-04-16,Ventura,111,848112,173916,173665,9452,183117,1474
2022-04-16,Yolo,113,214977,37426,36752,2941,39693,311
2022-04-16,Yuba,115,75493,15867,15857,1200,17057,121
2022-04-15,Alameda,001,1643700,259881,257897,13988,271885,1829
2022-04-15,Alpine,003,1148,124,124,1,125,0
2022-04-15,Amador,005,37829,8539,8491,646,9137,86
2022-04-15,Butte,007,227075,33288,33053,7053,40106,405
2022-04-15,Calaveras,009,45235,7284,7275,350,7625,119
2022-04-15,Colusa,011,21464,3457,3450,1047,4497,21
2022-04-15,Contra Costa,013,1133247,193856,189742,13568,203310,1298
2022-04-15,Del Norte,015,27424,5825,5809,184,5993,50
2022-04-15,El Dorado,017,186661,26822,26796,3200,29996,209
2022-04-15,Fresno,019,978130,234304,231455,24306,255761,2739
2022-04-15,Glenn,021,27897,5003,4991,1607,6598,48
2022-04-15,Humboldt,023,135768,16981,16929,2963,19892,143
2022-04-15,Imperial,025,180216,55429,55371,10540,65911,910
2022-04-15,Inyo,027,18085,4080,4075,490,4565,56
2022-04-15,Kern,029,883053,192096,191866,45818,237684,2258
2022-04-15,Kings,031,150075,51538,51544,3521,55065,445
2022-04-15,Lake,033,64148,10736,10702,887,11589,134
2022-04-15,Lassen,035,31185,8960,8950,876,9826,65
2022-04-15,Los Angeles,037,10098052,2726431,2717479,123902,2841381,31598
2022-04-15,Madera,039,155013,37297,37362,6026,43388,354
2022-04-15,Marin,041,260295,34070,33829,2506,36335,288
2022-04-15,Mariposa,043,17540,2417,2406,203,2609,30
2022-04-15,Mendocino,045,87422,13138,13107,3033,16140,122
2022-04-15,Merced,047,269075,62682,62295,8775,71070,813
2022-04-15,Modoc,049,8938,739,743,251,994,8
2022-04-15,Mono,051,14174,2981,2977,126,3103,6
2022-04-15,Monterey,053,433212,79637,79311,13760,93071,727
2022-04-15,Napa,055,140530,26011,25929,982,26911,143
2022-04-15,Nevada,057,99092,16032,16014,1202,17216,123
2022-04-15,Orange,059,3164182,549373,548311,41772,590083,6945
2022-04-15,Placer,061,380077,63063,62882,7362,70244,618
2022-04-15,Plumas,063,18699,2983,2929,365,3294,13
2022-04-15,Riverside,065,2383286,592878,591772,27881,619653,6443
2022-04-15,Sacramento,067,1510023,281987,278523,26597,305120,2978
2022-04-15,San Benito,069,59416,13012,12926,517,13443,98
2022-04-15,San Bernardino,071,2135413,575984,564397,24995,589392,6948
2022-04-15,San Diego,073,3302833,754978,756165,53205,809370,5229
2022-04-15,San Francisco,075,870044,127731,126976,8396,135372,854
2022-04-15,San Joaquin,077,732212,167185,166645,9959,176604,2220
2022-04-15,San Luis Obispo,079,281455,52743,52698,3771,56469,476
2022-04-15,San Mateo,081,765935,123941,122652,7070,129722,699
2022-04-15,Santa Barbara,083,443738,86352,86030,4732,90762,684
2022-04-15,Santa Clara,085,1922200,319259,315296,12513,327809,2268
2022-04-15,Santa Cruz,087,273765,48545,47895,2120,50015,261
2022-04-15,Shasta,089,179085,30591,30578,6094,36672,554
2022-04-15,Sierra,091,2930,274,276,48,324,4
2022-04-15,Siskiyou,093,43540,4433,4444,2728,7172,80
2022-04-15,Solano,095,438530,82035,81781,5604,87385,447
2022-04-15,Sonoma,097,501317,84457,84172,2712,86884,485
2022-04-15,Stanislaus,099,539301,117836,117567,17887,135454,1619
2022-04-15,Sutter,101,95872,20516,20621,2087,22708,224
2022-04-15,Tehama,103,63373,12059,12061,2573,14634,199
2022-04-15,Trinity,105,12862,1184,1178,287,1465,20
2022-04-15,Tulare,107,460477,106386,105757,27588,133345,1428
2022-04-15,Tuolumne,109,53932,12717,12640,564,13204,180
2022-04-15,Ventura,111,848112,173887,173665,9446,183111,1474
2022-04-15,Yolo,113,214977,37409,36752,2941,39693,311
2022-04-15,Yuba,115,75493,15864,15857,1200,17057,121
2022-04-14,Alameda,001,1643700,259617,257897,13977,271874,1829
2022-04-14,Alpine,003,1148,124,124,1,125,0
2022-04-14,Amador,005,37829,8539,8491,646,9137,86
2022-04-14,Butte,007,227075,33283,33053,7050,40103,405
2022-04-14,Calaveras,009,45235,7283,7275,350,7625,119
2022-04-14,Colusa,011,21464,3457,3450,1047,4497,21
2022-04-14,Contra Costa,013,1133247,193700,189742,13556,203298,1298
2022-04-14,Del Norte,015,27424,5824,5809,184,5993,50
2022-04-14,El Dorado,017,186661,26819,26796,3198,29994,209
2022-04-14,Fresno,019,978130,234277,231455,24305,255760,2739
2022-04-14,Glenn,021,27897,5003,4991,1605,6596,48
2022-04-14,Humboldt,023,135768,16967,16929,2962,19891,143
2022-04-14,Imperial,025,180216,55419,55371,10540,65911,910
2022-04-14,Inyo,027,18085,4080,4075,489,4564,56
2022-04-14,Kern,029,883053,192077,191866,45810,237676,2258
2022-04-14,Kings,031,150075,51530,51544,3521,55065,445
2022-04-14,Lake,033,64148,10735,10702,887,11589,134
2022-04-14,Lassen,035,31185,8960,8950,875,9825,65
2022-04-14,Los Angeles,037,10098052,2725347,2717479,123813,2841292,31598
2022-04-14,Madera,039,155013,37295,37362,6026,43388,354
2022-04-14,Marin,041,260295,34030,33829,2485,36314,288
2022-04-14,Mariposa,043,17540,2416,2406,203,2609,30
2022-04-14,Mendocino,045,87422,13133,13107,3033,16140,122
2022-04-14,Merced,047,269075,62678,62295,8774,71069,813
2022-04-14,Modoc,049,8938,738,743,251,994,8
2022-04-14,Mono,051,14174,2981,2977,125,3102,6
2022-04-14,Monterey,053,433212,79612,79311,13755,93066,727
2022-04-14,Napa,055,140530,25989,25929,981,26910,143
2022-04-14,Nevada,057,99092,16025,16014,1201,17215,123
2022-04-14,Orange,059,3164182,549182,548311,41743,590054,6945
2022-04-14,Placer,061,380077,63045,62882,7357,70239,618
2022-04-14,Plumas,063,18699,2983,2929,365,3294,13
2022-04-14,Riverside,065,2383286,592757,591772,27871,619643,6443
2022-04-14,Sacramento,067,1510023,281868,278523,26583,305106,2978
2022-04-14,San Benito,069,59416,13006,12926,517,13443,98
2022-04-14,San Bernardino,071,2135413,575812,564397,24990,589387,6948
2022-04-14,San Diego,073,3302833,754700,756165,53167,809332,5229
2022-04-14,San Francisco,075,870044,127528,126976,8383,135359,854
2022-04-14,San Joaquin,077,732212,167154,166645,9958,176603,2220
2022-04-14,San Luis Obispo,079,281455,52727,52698,3767,56465,476
2022-04-14,San Mateo,081,765935,123779,122652,7058,129710,699
2022-04-14,Santa Barbara,083,443738,86307,86030,4730,90760,684
2022-04-14,Santa Clara,085,1922200,318957,315296,12504,327800,2268
2022-04-14,Santa Cruz,087,273765,48515,47895,2119,50014,261
2022-04-14,Shasta,089,179085,30589,30578,6093,36671,554
2022-04-14,Sierra,091,2930,274,276,48,324,4
2022-04-14,Siskiyou,093,43540,4433,4444,2727,7171,80
2022-04-14,Solano,095,438530,81995,81781,5598,87379,447
2022-04-14,Sonoma,097,501317,84366,84172,2707,86879,485
2022-04-14,Stanislaus,099,539301,117817,117567,17884,135451,1619
2022-04-14,Sutter,101,95872,20514,20621,2078,22699,224
2022-04-14,Tehama,103,63373,12058,12061,2572,14633,199
2022-04-14,Trinity,105,12862,1184,1178,287,1465,20
2022-04-14,Tulare,107,460477,106372,105757,27584,133341,1428
2022-04-14,Tuolumne,109,53932,12712,12640,563,13203,180
2022-04-14,Ventura,111,848112,173838,173665,9440,183105,1474
2022-04-14,Yolo,113,214977,37382,36752,2938,39690,311
2022-04-14,Yuba,115,75493,15861,15857,1200,17057,121
2022-04-13,Alameda,001,1643700,259366,257440,13956,271396,1833
2022-04-13,Alpine,003,1148,124,124,1,125,0
2022-04-13,Amador,005,37829,8537,8490,646,9136,86
2022-04-13,Butte,007,227075,33275,33044,7050,40094,402
2022-04-13,Calaveras,009,45235,7282,7270,350,7620,119
2022-04-13,Colusa,011,21464,3457,3451,1047,4498,21
2022-04-13,Contra Costa,013,1133247,193567,189471,13542,203013,1298
2022-04-13,Del Norte,015,27424,5822,5812,184,5996,50
2022-04-13,El Dorado,017,186661,26815,26794,3198,29992,208
2022-04-13,Fresno,019,978130,234244,231325,24293,255618,2738
2022-04-13,Glenn,021,27897,5001,4989,1605,6594,48
2022-04-13,Humboldt,023,135768,16953,16922,2961,19883,143
2022-04-13,Imperial,025,180216,55406,55353,10538,65891,910
2022-04-13,Inyo,027,18085,4080,4074,486,4560,56
2022-04-13,Kern,029,883053,192051,191859,45804,237663,2249
2022-04-13,Kings,031,150075,51524,51535,3521,55056,443
2022-04-13,Lake,033,64148,10733,10695,887,11582,134
2022-04-13,Lassen,035,31185,8959,8949,875,9824,65
2022-04-13,Los Angeles,037,10098052,2724090,2715722,123738,2839460,31578
2022-04-13,Madera,039,155013,37292,37361,6026,43387,354
2022-04-13,Marin,041,260295,33991,33747,2456,36203,288
2022-04-13,Mariposa,043,17540,2410,2402,203,2605,29
2022-04-13,Mendocino,045,87422,13124,13101,3031,16132,120
2022-04-13,Merced,047,269075,62668,62276,8773,71049,811
2022-04-13,Modoc,049,8938,738,743,251,994,8
2022-04-13,Mono,051,14174,2979,2971,125,3096,6
2022-04-13,Monterey,053,433212,79599,79179,13748,92927,727
2022-04-13,Napa,055,140530,25972,25892,978,26870,143
2022-04-13,Nevada,057,99092,16019,16002,1201,17203,123
2022-04-13,Orange,059,3164182,548987,547783,41719,589502,6935
2022-04-13,Placer,061,380077,63018,62851,7354,70205,615
2022-04-13,Plumas,063,18699,2982,2923,365,3288,13
2022-04-13,Riverside,065,2383286,592617,591659,27864,619523,6437
2022-04-13,Sacramento,067,1510023,281782,277866,26580,304446,2974
2022-04-13,San Benito,069,59416,13000,12927,517,13444,98
2022-04-13,San Bernardino,071,2135413,575667,563709,24985,588694,6905
2022-04-13,San Diego,073,3302833,754416,755584,53135,808719,5223
2022-04-13,San Francisco,075,870044,127360,126608,8363,134971,850
2022-04-13,San Joaquin,077,732212,167119,166654,9956,176610,2219
2022-04-13,San Luis Obispo,079,281455,52703,52660,3767,56427,476
2022-04-13,San Mateo,081,765935,123624,122167,7037,129204,699
2022-04-13,Santa Barbara,083,443738,86269,85938,4725,90663,684
2022-04-13,Santa Clara,085,1922200,318685,314863,12487,327350,2267
2022-04-13,Santa Cruz,087,273765,48461,47765,2118,49883,260
2022-04-13,Shasta,089,179085,30587,30569,6093,36662,551
2022-04-13,Sierra,091,2930,274,276,48,324,4
2022-04-13,Siskiyou,093,43540,4432,4444,2726,7170,80
2022-04-13,Solano,095,438530,81957,81843,5595,87438,448
2022-04-13,Sonoma,097,501317,84296,84033,2693,86726,485
2022-04-13,Stanislaus,099,539301,117799,117573,17879,135452,1577
2022-04-13,Sutter,101,95872,20510,20610,2078,22688,223
2022-04-13,Tehama,103,63373,12057,12062,2571,14633,200
2022-04-13,Trinity,105,12862,1184,1177,287,1464,20
2022-04-13,Tulare,107,460477,106365,105519,27579,133098,1426
2022-04-13,Tuolumne,109,53932,12706,12639,563,13202,180
2022-04-13,Ventura,111,848112,173781,173558,9434,182992,1474
2022-04-13,Yolo,113,214977,37343,36684,2936,39620,311
2022-04-13,Yuba,115,75493,15857,15851,1200,17051,121
2022-04-12,Alameda,001,1643700,259121,257440,13947,271387,1833
2022-04-12,Alpine,003,1148,124,124,1,125,0
2022-04-12,Amador,005,37829,8536,8490,646,9136,86
2022-04-12,Butte,007,227075,33263,33044,7044,40088,402
2022-04-12,Calaveras,009,45235,7278,7270,349,7619,119
2022-04-12,Colusa,011,21464,3457,3451,1047,4498,21
2022-04-12,Contra Costa,013,1133247,193412,189471,13529,203000,1298
2022-04-12,Del Norte,015,27424,5819,5812,184,5996,50
2022-04-12,El Dorado,017,186661,26803,26794,3198,29992,208
2022-04-12,Fresno,019,978130,234214,231325,24286,255611,2738
2022-04-12,Glenn,021,27897,5001,4989,1605,6594,48
2022-04-12,Humboldt,023,135768,16945,16922,2959,19881,143
2022-04-12,Imperial,025,180216,55402,55353,10529,65882,910
2022-04-12,Inyo,027,18085,4080,4074,486,4560,56
2022-04-12,Kern,029,883053,192031,191859,45795,237654,2249
2022-04-12,Kings,031,150075,51516,51535,3519,55054,443
2022-04-12,Lake,033,64148,10729,10695,886,11581,134
2022-04-12,Lassen,035,31185,8959,8949,875,9824,65
2022-04-12,Los Angeles,037,10098052,2722850,2715722,123636,2839358,31578
2022-04-12,Madera,039,155013,37291,37361,6026,43387,354
2022-04-12,Marin,041,260295,33945,33747,2430,36177,288
2022-04-12,Mariposa,043,17540,2410,2402,203,2605,29
2022-04-12,Mendocino,045,87422,13116,13101,3025,16126,120
2022-04-12,Merced,047,269075,62654,62276,8771,71047,811
2022-04-12,Modoc,049,8938,738,743,250,993,8
2022-04-12,Mono,051,14174,2979,2971,125,3096,6
2022-04-12,Monterey,053,433212,79575,79179,13741,92920,727
2022-04-12,Napa,055,140530,25949,25892,968,26860,143
2022-04-12,Nevada,057,99092,16016,16002,1200,17202,123
2022-04-12,Orange,059,3164182,548736,547783,41685,589468,6935
2022-04-12,Placer,061,380077,62995,62851,7348,70199,615
2022-04-12,Plumas,063,18699,2981,2923,365,3288,13
2022-04-12,Riverside,065,2383286,592472,591659,27844,619503,6437
2022-04-12,Sacramento,067,1510023,281667,277866,26577,304443,2974
2022-04-12,San Benito,069,59416,12995,12927,516,13443,98
2022-04-12,San Bernardino,071,2135413,575494,563709,24982,588691,6905
2022-04-12,San Diego,073,3302833,754084,755584,53093,808677,5223
2022-04-12,San Francisco,075,870044,127148,126608,8349,134957,850
2022-04-12,San Joaquin,077,732212,167089,166654,9954,176608,2219
2022-04-12,San Luis Obispo,079,281455,52669,52660,3761,56421,476
2022-04-12,San Mateo,081,765935,123459,122167,7023,129190,699
2022-04-12,Santa Barbara,083,443738,86223,85938,4721,90659,684
2022-04-12,Santa Clara,085,1922200,318392,314863,12477,327340,2267
2022-04-12,Santa Cruz,087,273765,48381,47765,2115,49880,260
2022-04-12,Shasta,089,179085,30587,30569,6092,36661,551
2022-04-12,Sierra,091,2930,274,276,48,324,4
2022-04-12,Siskiyou,093,43540,4432,4444,2724,7168,80
2022-04-12,Solano,095,438530,81917,81843,5593,87436,448
2022-04-12,Sonoma,097,501317,84237,84033,2687,86720,485
2022-04-12,Stanislaus,099,539301,117779,117573,17875,135448,1577
2022-04-12,Sutter,101,95872,20507,20610,2078,22688,223
2022-04-12,Tehama,103,63373,12055,12062,2571,14633,200
2022-04-12,Trinity,105,12862,1184,1177,287,1464,20
2022-04-12,Tulare,107,460477,106350,105519,27574,133093,1426
2022-04-12,Tuolumne,109,53932,12704,12639,561,13200,180
2022-04-12,Ventura,111,848112,173733,173558,9428,182986,1474
2022-04-12,Yolo,113,214977,37303,36684,2930,39614,311
2022-04-12,Yuba,115,75493,15852,15851,1200,17051,121
2022-04-11,Alameda,001,1643700,258829,256649,13932,270581,1826
2022-04-11,Alpine,003,1148,124,124,1,125,0
2022-04-11,Amador,005,37829,8535,8489,646,9135,86
2022-04-11,Butte,007,227075,33250,33031,7040,40071,399
2022-04-11,Calaveras,009,45235,7275,7260,349,7609,119
2022-04-11,Colusa,011,21464,3455,3449,1047,4496,21
2022-04-11,Contra Costa,013,1133247,193245,189154,13512,202666,1296
2022-04-11,Del Norte,015,27424,5818,5811,184,5995,50
2022-04-11,El Dorado,017,186661,26790,26757,3197,29954,207
2022-04-11,Fresno,019,978130,234192,231090,24285,255375,2731
2022-04-11,Glenn,021,27897,5000,4988,1604,6592,47
2022-04-11,Humboldt,023,135768,16930,16913,2957,19870,141
2022-04-11,Imperial,025,180216,55397,55267,10527,65794,910
2022-04-11,Inyo,027,18085,4080,4071,486,4557,56
2022-04-11,Kern,029,883053,192006,191542,45793,237335,2244
2022-04-11,Kings,031,150075,51512,51519,3519,55038,443
2022-04-11,Lake,033,64148,10728,10690,885,11575,134
2022-04-11,Lassen,035,31185,8959,8948,875,9823,65
2022-04-11,Los Angeles,037,10098052,2721596,2709735,123564,2833299,31509
2022-04-11,Madera,039,155013,37284,37356,6026,43382,354
2022-04-11,Marin,041,260295,33887,33648,2413,36061,288
2022-04-11,Mariposa,043,17540,2409,2394,203,2597,29
2022-04-11,Mendocino,045,87422,13112,13087,3023,16110,120
2022-04-11,Merced,047,269075,62644,62231,8769,71000,811
2022-04-11,Modoc,049,8938,738,743,250,993,8
2022-04-11,Mono,051,14174,2978,2967,124,3091,6
2022-04-11,Monterey,053,433212,79555,79103,13732,92835,727
2022-04-11,Napa,055,140530,25932,25824,966,26790,144
2022-04-11,Nevada,057,99092,16012,15976,1200,17176,123
2022-04-11,Orange,059,3164182,548530,546983,41651,588634,6912
2022-04-11,Placer,061,380077,62973,62831,7347,70178,616
2022-04-11,Plumas,063,18699,2979,2887,365,3252,13
2022-04-11,Riverside,065,2383286,592345,591268,27827,619095,6429
2022-04-11,Sacramento,067,1510023,281567,277125,26573,303698,2972
2022-04-11,San Benito,069,59416,12994,12917,516,13433,98
2022-04-11,San Bernardino,071,2135413,575344,562571,24973,587544,6892
2022-04-11,San Diego,073,3302833,753758,754281,53053,807334,5210
2022-04-11,San Francisco,075,870044,126918,125963,8337,134300,844
2022-04-11,San Joaquin,077,732212,167051,166547,9948,176495,2212
2022-04-11,San Luis Obispo,079,281455,52646,52609,3760,56369,476
2022-04-11,San Mateo,081,765935,123269,121514,7013,128527,698
2022-04-11,Santa Barbara,083,443738,86174,85754,4716,90470,680
2022-04-11,Santa Clara,085,1922200,318047,313965,12462,326427,2266
2022-04-11,Santa Cruz,087,273765,48286,47624,2112,49736,259
2022-04-11,Shasta,089,179085,30582,30586,6091,36677,549
2022-04-11,Sierra,091,2930,274,272,48,320,4
2022-04-11,Siskiyou,093,43540,4432,4444,2722,7166,80
2022-04-11,Solano,095,438530,81889,81886,5592,87478,448
2022-04-11,Sonoma,097,501317,84169,83600,2675,86275,485
2022-04-11,Stanislaus,099,539301,117745,117528,17867,135395,1578
2022-04-11,Sutter,101,95872,20504,20591,2078,22669,223
2022-04-11,Tehama,103,63373,12054,12059,2570,14629,201
2022-04-11,Trinity,105,12862,1184,1177,287,1464,20
2022-04-11,Tulare,107,460477,106339,105278,27566,132844,1415
2022-04-11,Tuolumne,109,53932,12701,12632,561,13193,180
2022-04-11,Ventura,111,848112,173674,173343,9427,182770,1467
2022-04-11,Yolo,113,214977,37266,36587,2928,39515,312
2022-04-11,Yuba,115,75493,15849,15848,1199,17047,121
2022-04-10,Alameda,001,1643700,258495,256649,13921,270570,1826
2022-04-10,Alpine,003,1148,124,124,1,125,0
2022-04-10,Amador,005,37829,8533,8489,646,9135,86
2022-04-10,Butte,007,227075,33246,33031,7036,40067,399
2022-04-10,Calaveras,009,45235,7272,7260,349,7609,119
2022-04-10,Colusa,011,21464,3454,3449,1047,4496,21
2022-04-10,Contra Costa,013,1133247,193085,189154,13492,202646,1296
2022-04-10,Del Norte,015,27424,5815,5811,184,5995,50
2022-04-10,El Dorado,017,186661,26783,26757,3195,29952,207
2022-04-10,Fresno,019,978130,234154,231090,24283,255373,2731
2022-04-10,Glenn,021,27897,5000,4988,1604,6592,47
2022-04-10,Humboldt,023,135768,16920,16913,2955,19868,141
2022-04-10,Imperial,025,180216,55393,55267,10525,65792,910
2022-04-10,Inyo,027,18085,4080,4071,484,4555,56
2022-04-10,Kern,029,883053,191988,191542,45788,237330,2244
2022-04-10,Kings,031,150075,51510,51519,3519,55038,443
2022-04-10,Lake,033,64148,10724,10690,883,11573,134
2022-04-10,Lassen,035,31185,8958,8948,875,9823,65
2022-04-10,Los Angeles,037,10098052,2720274,2709735,123476,2833211,31509
2022-04-10,Madera,039,155013,37279,37356,6025,43381,354
2022-04-10,Marin,041,260295,33847,33648,2384,36032,288
2022-04-10,Mariposa,043,17540,2407,2394,203,2597,29
2022-04-10,Mendocino,045,87422,13104,13087,3022,16109,120
2022-04-10,Merced,047,269075,62633,62231,8767,70998,811
2022-04-10,Modoc,049,8938,738,743,250,993,8
2022-04-10,Mono,051,14174,2975,2967,124,3091,6
2022-04-10,Monterey,053,433212,79539,79103,13722,92825,727
2022-04-10,Napa,055,140530,25910,25824,964,26788,144
2022-04-10,Nevada,057,99092,15995,15976,1200,17176,123
2022-04-10,Orange,059,3164182,548280,546983,41612,588595,6912
2022-04-10,Placer,061,380077,62939,62831,7346,70177,616
2022-04-10,Plumas,063,18699,2977,2887,365,3252,13
2022-04-10,Riverside,065,2383286,592195,591268,27814,619082,6429
2022-04-10,Sacramento,067,1510023,281469,277125,26563,303688,2972
2022-04-10,San Benito,069,59416,12990,12917,516,13433,98
2022-04-10,San Bernardino,071,2135413,575112,562571,24964,587535,6892
2022-04-10,San Diego,073,3302833,753430,754281,53005,807286,5210
2022-04-10,San Francisco,075,870044,126677,125963,8322,134285,844
2022-04-10,San Joaquin,077,732212,167004,166547,9941,176488,2212
2022-04-10,San Luis Obispo,079,281455,52611,52609,3758,56367,476
2022-04-10,San Mateo,081,765935,123100,121514,7000,128514,698
2022-04-10,Santa Barbara,083,443738,86090,85754,4706,90460,680
2022-04-10,Santa Clara,085,1922200,317717,313965,12448,326413,2266
2022-04-10,Santa Cruz,087,273765,48197,47624,2111,49735,259
2022-04-10,Shasta,089,179085,30575,30586,6091,36677,549
2022-04-10,Sierra,091,2930,274,272,48,320,4
2022-04-10,Siskiyou,093,43540,4432,4444,2721,7165,80
2022-04-10,Solano,095,438530,81842,81886,5587,87473,448
2022-04-10,Sonoma,097,501317,84068,83600,2668,86268,485
2022-04-10,Stanislaus,099,539301,117722,117528,17860,135388,1578
2022-04-10,Sutter,101,95872,20500,20591,2074,22665,223
2022-04-10,Tehama,103,63373,12052,12059,2570,14629,201
2022-04-10,Trinity,105,12862,1184,1177,287,1464,20
2022-04-10,Tulare,107,460477,106325,105278,27559,132837,1415
2022-04-10,Tuolumne,109,53932,12694,12632,561,13193,180
2022-04-10,Ventura,111,848112,173595,173343,9422,182765,1467
2022-04-10,Yolo,113,214977,37236,36587,2923,39510,312
2022-04-10,Yuba,115,75493,15848,15848,1199,17047,121
2022-04-09,Alameda,001,1643700,258321,256649,13916,270565,1826
2022-04-09,Alpine,003,1148,124,124,1,125,0
2022-04-09,Amador,005,37829,8533,8489,645,9134,86
2022-04-09,Butte,007,227075,33243,33031,7036,40067,399
2022-04-09,Calaveras,009,45235,7271,7260,349,7609,119
2022-04-09,Colusa,011,21464,3453,3449,1047,4496,21
2022-04-09,Contra Costa,013,1133247,192989,189154,13485,202639,1296
2022-04-09,Del Norte,015,27424,5814,5811,184,5995,50
2022-04-09,El Dorado,017,186661,26776,26757,3195,29952,207
2022-04-09,Fresno,019,978130,234133,231090,24283,255373,2731
2022-04-09,Glenn,021,27897,5000,4988,1604,6592,47
2022-04-09,Humboldt,023,135768,16913,16913,2955,19868,141
2022-04-09,Imperial,025,180216,55388,55267,10525,65792,910
2022-04-09,Inyo,027,18085,4080,4071,484,4555,56
2022-04-09,Kern,029,883053,191979,191542,45783,237325,2244
2022-04-09,Kings,031,150075,51504,51519,3519,55038,443
2022-04-09,Lake,033,64148,10722,10690,883,11573,134
2022-04-09,Lassen,035,31185,8958,8948,875,9823,65
2022-04-09,Los Angeles,037,10098052,2719590,2709735,123403,2833138,31509
2022-04-09,Madera,039,155013,37276,37356,6025,43381,354
2022-04-09,Marin,041,260295,33808,33648,2347,35995,288
2022-04-09,Mariposa,043,17540,2407,2394,203,2597,29
2022-04-09,Mendocino,045,87422,13102,13087,3022,16109,120
2022-04-09,Merced,047,269075,62621,62231,8765,70996,811
2022-04-09,Modoc,049,8938,738,743,250,993,8
2022-04-09,Mono,051,14174,2974,2967,123,3090,6
2022-04-09,Monterey,053,433212,79530,79103,13718,92821,727
2022-04-09,Napa,055,140530,25885,25824,964,26788,144
2022-04-09,Nevada,057,99092,15992,15976,1200,17176,123
2022-04-09,Orange,059,3164182,548159,546983,41590,588573,6912
2022-04-09,Placer,061,380077,62924,62831,7344,70175,616
2022-04-09,Plumas,063,18699,2977,2887,365,3252,13
2022-04-09,Riverside,065,2383286,592105,591268,27804,619072,6429
2022-04-09,Sacramento,067,1510023,281422,277125,26561,303686,2972
2022-04-09,San Benito,069,59416,12989,12917,515,13432,98
2022-04-09,San Bernardino,071,2135413,575045,562571,24961,587532,6892
2022-04-09,San Diego,073,3302833,753282,754281,52991,807272,5210
2022-04-09,San Francisco,075,870044,126552,125963,8314,134277,844
2022-04-09,San Joaquin,077,732212,166988,166547,9938,176485,2212
2022-04-09,San Luis Obispo,079,281455,52611,52609,3755,56364,476
2022-04-09,San Mateo,081,765935,123006,121514,6997,128511,698
2022-04-09,Santa Barbara,083,443738,86057,85754,4706,90460,680
2022-04-09,Santa Clara,085,1922200,317521,313965,12445,326410,2266
2022-04-09,Santa Cruz,087,273765,48164,47624,2109,49733,259
2022-04-09,Shasta,089,179085,30573,30586,6091,36677,549
2022-04-09,Sierra,091,2930,274,272,48,320,4
2022-04-09,Siskiyou,093,43540,4431,4444,2720,7164,80
2022-04-09,Solano,095,438530,81824,81886,5585,87471,448
2022-04-09,Sonoma,097,501317,84029,83600,2664,86264,485
2022-04-09,Stanislaus,099,539301,117709,117528,17858,135386,1578
2022-04-09,Sutter,101,95872,20500,20591,2074,22665,223
2022-04-09,Tehama,103,63373,12052,12059,2570,14629,201
2022-04-09,Trinity,105,12862,1184,1177,287,1464,20
2022-04-09,Tulare,107,460477,106322,105278,27557,132835,1415
2022-04-09,Tuolumne,109,53932,12692,12632,561,13193,180
2022-04-09,Ventura,111,848112,173558,173343,9419,182762,1467
2022-04-09,Yolo,113,214977,37217,36587,2923,39510,312
2022-04-09,Yuba,115,75493,15847,15848,1199,17047,121
2022-04-08,Alameda,001,1643700,258161,256649,13910,270559,1826
2022-04-08,Alpine,003,1148,124,124,1,125,0
2022-04-08,Amador,005,37829,8531,8489,644,9133,86
2022-04-08,Butte,007,227075,33237,33031,7033,40064,399
2022-04-08,Calaveras,009,45235,7269,7260,349,7609,119
2022-04-08,Colusa,011,21464,3453,3449,1047,4496,21
2022-04-08,Contra Costa,013,1133247,192911,189154,13472,202626,1296
2022-04-08,Del Norte,015,27424,5812,5811,184,5995,50
2022-04-08,El Dorado,017,186661,26774,26757,3195,29952,207
2022-04-08,Fresno,019,978130,234113,231090,24281,255371,2731
2022-04-08,Glenn,021,27897,5000,4988,1604,6592,47
2022-04-08,Humboldt,023,135768,16909,16913,2953,19866,141
2022-04-08,Imperial,025,180216,55384,55267,10525,65792,910
2022-04-08,Inyo,027,18085,4078,4071,483,4554,56
2022-04-08,Kern,029,883053,191960,191542,45782,237324,2244
2022-04-08,Kings,031,150075,51499,51519,3519,55038,443
2022-04-08,Lake,033,64148,10722,10690,883,11573,134
2022-04-08,Lassen,035,31185,8958,8948,875,9823,65
2022-04-08,Los Angeles,037,10098052,2718964,2709735,123345,2833080,31509
2022-04-08,Madera,039,155013,37274,37356,6024,43380,354
2022-04-08,Marin,041,260295,33786,33648,2333,35981,288
2022-04-08,Mariposa,043,17540,2407,2394,202,2596,29
2022-04-08,Mendocino,045,87422,13100,13087,3022,16109,120
2022-04-08,Merced,047,269075,62616,62231,8762,70993,811
2022-04-08,Modoc,049,8938,738,743,250,993,8
2022-04-08,Mono,051,14174,2972,2967,123,3090,6
2022-04-08,Monterey,053,433212,79520,79103,13717,92820,727
2022-04-08,Napa,055,140530,25873,25824,956,26780,144
2022-04-08,Nevada,057,99092,15989,15976,1200,17176,123
2022-04-08,Orange,059,3164182,548038,546983,41576,588559,6912
2022-04-08,Placer,061,380077,62906,62831,7342,70173,616
2022-04-08,Plumas,063,18699,2974,2887,365,3252,13
2022-04-08,Riverside,065,2383286,592029,591268,27801,619069,6429
2022-04-08,Sacramento,067,1510023,281375,277125,26560,303685,2972
2022-04-08,San Benito,069,59416,12989,12917,515,13432,98
2022-04-08,San Bernardino,071,2135413,574992,562571,24958,587529,6892
2022-04-08,San Diego,073,3302833,753114,754281,52980,807261,5210
2022-04-08,San Francisco,075,870044,126456,125963,8309,134272,844
2022-04-08,San Joaquin,077,732212,166970,166547,9936,176483,2212
2022-04-08,San Luis Obispo,079,281455,52606,52609,3755,56364,476
2022-04-08,San Mateo,081,765935,122899,121514,6993,128507,698
2022-04-08,Santa Barbara,083,443738,86036,85754,4706,90460,680
2022-04-08,Santa Clara,085,1922200,317335,313965,12438,326403,2266
2022-04-08,Santa Cruz,087,273765,48147,47624,2106,49730,259
2022-04-08,Shasta,089,179085,30570,30586,6091,36677,549
2022-04-08,Sierra,091,2930,274,272,48,320,4
2022-04-08,Siskiyou,093,43540,4431,4444,2720,7164,80
2022-04-08,Solano,095,438530,81804,81886,5584,87470,448
2022-04-08,Sonoma,097,501317,83978,83600,2660,86260,485
2022-04-08,Stanislaus,099,539301,117694,117528,17856,135384,1578
2022-04-08,Sutter,101,95872,20500,20591,2074,22665,223
2022-04-08,Tehama,103,63373,12052,12059,2570,14629,201
2022-04-08,Trinity,105,12862,1184,1177,287,1464,20
2022-04-08,Tulare,107,460477,106317,105278,27553,132831,1415
2022-04-08,Tuolumne,109,53932,12691,12632,560,13192,180
2022-04-08,Ventura,111,848112,173529,173343,9417,182760,1467
2022-04-08,Yolo,113,214977,37208,36587,2922,39509,312
2022-04-08,Yuba,115,75493,15846,15848,1199,17047,121
2022-04-07,Alameda,001,1643700,257965,256649,13902,270551,1826
2022-04-07,Alpine,003,1148,124,124,1,125,0
2022-04-07,Amador,005,37829,8530,8489,641,9130,86
2022-04-07,Butte,007,227075,33233,33031,7031,40062,399
2022-04-07,Calaveras,009,45235,7267,7260,349,7609,119
2022-04-07,Colusa,011,21464,3452,3449,1047,4496,21
2022-04-07,Contra Costa,013,1133247,192792,189154,13460,202614,1296
2022-04-07,Del Norte,015,27424,5811,5811,184,5995,50
2022-04-07,El Dorado,017,186661,26762,26757,3193,29950,207
2022-04-07,Fresno,019,978130,234087,231090,24280,255370,2731
2022-04-07,Glenn,021,27897,4999,4988,1603,6591,47
2022-04-07,Humboldt,023,135768,16902,16913,2951,19864,141
2022-04-07,Imperial,025,180216,55382,55267,10523,65790,910
2022-04-07,Inyo,027,18085,4078,4071,483,4554,56
2022-04-07,Kern,029,883053,191936,191542,45779,237321,2244
2022-04-07,Kings,031,150075,51491,51519,3519,55038,443
2022-04-07,Lake,033,64148,10718,10690,883,11573,134
2022-04-07,Lassen,035,31185,8958,8948,875,9823,65
2022-04-07,Los Angeles,037,10098052,2718056,2709735,123270,2833005,31509
2022-04-07,Madera,039,155013,37270,37356,6024,43380,354
2022-04-07,Marin,041,260295,33766,33648,2315,35963,288
2022-04-07,Mariposa,043,17540,2404,2394,201,2595,29
2022-04-07,Mendocino,045,87422,13096,13087,3021,16108,120
2022-04-07,Merced,047,269075,62606,62231,8757,70988,811
2022-04-07,Modoc,049,8938,738,743,250,993,8
2022-04-07,Mono,051,14174,2971,2967,123,3090,6
2022-04-07,Monterey,053,433212,79498,79103,13713,92816,727
2022-04-07,Napa,055,140530,25857,25824,952,26776,144
2022-04-07,Nevada,057,99092,15981,15976,1199,17175,123
2022-04-07,Orange,059,3164182,547882,546983,41546,588529,6912
2022-04-07,Placer,061,380077,62889,62831,7339,70170,616
2022-04-07,Plumas,063,18699,2974,2887,365,3252,13
2022-04-07,Riverside,065,2383286,591927,591268,27787,619055,6429
2022-04-07,Sacramento,067,1510023,281310,277125,26553,303678,2972
2022-04-07,San Benito,069,59416,12988,12917,515,13432,98
2022-04-07,San Bernardino,071,2135413,574832,562571,24945,587516,6892
2022-04-07,San Diego,073,3302833,752846,754281,52948,807229,5210
2022-04-07,San Francisco,075,870044,126299,125963,8294,134257,844
2022-04-07,San Joaquin,077,732212,166929,166547,9933,176480,2212
2022-04-07,San Luis Obispo,079,281455,52588,52609,3753,56362,476
2022-04-07,San Mateo,081,765935,122776,121514,6977,128491,698
2022-04-07,Santa Barbara,083,443738,85992,85754,4704,90458,680
2022-04-07,Santa Clara,085,1922200,317112,313965,12426,326391,2266
2022-04-07,Santa Cruz,087,273765,48128,47624,2102,49726,259
2022-04-07,Shasta,089,179085,30568,30586,6091,36677,549
2022-04-07,Sierra,091,2930,274,272,48,320,4
2022-04-07,Siskiyou,093,43540,4431,4444,2719,7163,80
2022-04-07,Solano,095,438530,81774,81886,5584,87470,448
2022-04-07,Sonoma,097,501317,83935,83600,2654,86254,485
2022-04-07,Stanislaus,099,539301,117672,117528,17853,135381,1578
2022-04-07,Sutter,101,95872,20496,20591,2073,22664,223
2022-04-07,Tehama,103,63373,12051,12059,2570,14629,201
2022-04-07,Trinity,105,12862,1184,1177,287,1464,20
2022-04-07,Tulare,107,460477,106311,105278,27552,132830,1415
2022-04-07,Tuolumne,109,53932,12689,12632,559,13191,180
2022-04-07,Ventura,111,848112,173500,173343,9415,182758,1467
2022-04-07,Yolo,113,214977,37190,36587,2922,39509,312
2022-04-07,Yuba,115,75493,15844,15848,1199,17047,121
2022-04-06,Alameda,001,1643700,257779,256143,13894,270037,1814
2022-04-06,Alpine,003,1148,124,124,1,125,0
2022-04-06,Amador,005,37829,8529,8488,641,9129,86
2022-04-06,Butte,007,227075,33228,32997,7029,40026,396
2022-04-06,Calaveras,009,45235,7265,7258,349,7607,120
2022-04-06,Colusa,011,21464,3452,3447,1047,4494,21
2022-04-06,Contra Costa,013,1133247,192726,188850,13444,202294,1296
2022-04-06,Del Norte,015,27424,5811,5809,184,5993,50
2022-04-06,El Dorado,017,186661,26759,26744,3193,29937,205
2022-04-06,Fresno,019,978130,234052,230942,24276,255218,2725
2022-04-06,Glenn,021,27897,4999,4986,1602,6588,47
2022-04-06,Humboldt,023,135768,16898,16904,2950,19854,140
2022-04-06,Imperial,025,180216,55376,55294,10523,65817,908
2022-04-06,Inyo,027,18085,4077,4068,481,4549,56
2022-04-06,Kern,029,883053,191914,191449,45777,237226,2234
2022-04-06,Kings,031,150075,51490,51491,3518,55009,443
2022-04-06,Lake,033,64148,10714,10679,883,11562,136
2022-04-06,Lassen,035,31185,8958,8945,875,9820,65
2022-04-06,Los Angeles,037,10098052,2717012,2707306,123200,2830506,31465
2022-04-06,Madera,039,155013,37266,37349,6024,43373,354
2022-04-06,Marin,041,260295,33745,33566,2308,35874,288
2022-04-06,Mariposa,043,17540,2403,2392,201,2593,29
2022-04-06,Mendocino,045,87422,13092,13074,3020,16094,119
2022-04-06,Merced,047,269075,62598,62195,8753,70948,810
2022-04-06,Modoc,049,8938,738,741,250,991,8
2022-04-06,Mono,051,14174,2970,2967,123,3090,6
2022-04-06,Monterey,053,433212,79485,79019,13705,92724,727
2022-04-06,Napa,055,140530,25838,25790,948,26738,143
2022-04-06,Nevada,057,99092,15979,15974,1199,17173,123
2022-04-06,Orange,059,3164182,547714,546491,41523,588014,6887
2022-04-06,Placer,061,380077,62883,62787,7338,70125,615
2022-04-06,Plumas,063,18699,2974,2850,365,3215,13
2022-04-06,Riverside,065,2383286,591830,590826,27782,618608,6424
2022-04-06,Sacramento,067,1510023,281232,276567,26549,303116,2953
2022-04-06,San Benito,069,59416,12987,12908,515,13423,98
2022-04-06,San Bernardino,071,2135413,574701,561648,24943,586591,6883
2022-04-06,San Diego,073,3302833,752552,753402,52909,806311,5192
2022-04-06,San Francisco,075,870044,126140,125536,8288,133824,843
2022-04-06,San Joaquin,077,732212,166896,166415,9930,176345,2207
2022-04-06,San Luis Obispo,079,281455,52566,52557,3751,56308,475
2022-04-06,San Mateo,081,765935,122667,121041,6966,128007,693
2022-04-06,Santa Barbara,083,443738,85952,85630,4700,90330,679
2022-04-06,Santa Clara,085,1922200,316914,313278,12406,325684,2265
2022-04-06,Santa Cruz,087,273765,48074,47446,2097,49543,259
2022-04-06,Shasta,089,179085,30567,30565,6091,36656,529
2022-04-06,Sierra,091,2930,274,272,48,320,4
2022-04-06,Siskiyou,093,43540,4431,4442,2719,7161,80
2022-04-06,Solano,095,438530,81739,81789,5579,87368,447
2022-04-06,Sonoma,097,501317,83871,83361,2649,86010,485
2022-04-06,Stanislaus,099,539301,117656,117534,17847,135381,1578
2022-04-06,Sutter,101,95872,20491,20581,2073,22654,222
2022-04-06,Tehama,103,63373,12049,12049,2570,14619,198
2022-04-06,Trinity,105,12862,1184,1173,287,1460,20
2022-04-06,Tulare,107,460477,106304,104826,27547,132373,1414
2022-04-06,Tuolumne,109,53932,12687,12621,559,13180,180
2022-04-06,Ventura,111,848112,173447,173179,9409,182588,1460
2022-04-06,Yolo,113,214977,37165,36393,2921,39314,314
2022-04-06,Yuba,115,75493,15839,15839,1199,17038,121
2022-04-05,Alameda,001,1643700,257567,256143,13884,270027,1814
2022-04-05,Alpine,003,1148,124,124,1,125,0
2022-04-05,Amador,005,37829,8527,8488,641,9129,86
2022-04-05,Butte,007,227075,33223,32997,7026,40023,396
2022-04-05,Calaveras,009,45235,7261,7258,349,7607,120
2022-04-05,Colusa,011,21464,3450,3447,1046,4493,21
2022-04-05,Contra Costa,013,1133247,192633,188850,13437,202287,1296
2022-04-05,Del Norte,015,27424,5809,5809,184,5993,50
2022-04-05,El Dorado,017,186661,26747,26744,3193,29937,205
2022-04-05,Fresno,019,978130,234016,230942,24268,255210,2725
2022-04-05,Glenn,021,27897,4999,4986,1601,6587,47
2022-04-05,Humboldt,023,135768,16892,16904,2950,19854,140
2022-04-05,Imperial,025,180216,55374,55294,10523,65817,908
2022-04-05,Inyo,027,18085,4076,4068,480,4548,56
2022-04-05,Kern,029,883053,191894,191449,45774,237223,2234
2022-04-05,Kings,031,150075,51487,51491,3518,55009,443
2022-04-05,Lake,033,64148,10711,10679,883,11562,136
2022-04-05,Lassen,035,31185,8958,8945,874,9819,65
2022-04-05,Los Angeles,037,10098052,2715959,2707306,123126,2830432,31465
2022-04-05,Madera,039,155013,37259,37349,6022,43371,354
2022-04-05,Marin,041,260295,33690,33566,2293,35859,288
2022-04-05,Mariposa,043,17540,2403,2392,201,2593,29
2022-04-05,Mendocino,045,87422,13086,13074,3019,16093,119
2022-04-05,Merced,047,269075,62586,62195,8748,70943,810
2022-04-05,Modoc,049,8938,738,741,250,991,8
2022-04-05,Mono,051,14174,2969,2967,123,3090,6
2022-04-05,Monterey,053,433212,79462,79019,13694,92713,727
2022-04-05,Napa,055,140530,25829,25790,943,26733,143
2022-04-05,Nevada,057,99092,15971,15974,1199,17173,123
2022-04-05,Orange,059,3164182,547533,546491,41494,587985,6887
2022-04-05,Placer,061,380077,62857,62787,7338,70125,615
2022-04-05,Plumas,063,18699,2974,2850,365,3215,13
2022-04-05,Riverside,065,2383286,591709,590826,27770,618596,6424
2022-04-05,Sacramento,067,1510023,281152,276567,26544,303111,2953
2022-04-05,San Benito,069,59416,12980,12908,515,13423,98
2022-04-05,San Bernardino,071,2135413,574570,561648,24933,586581,6883
2022-04-05,San Diego,073,3302833,752244,753402,52865,806267,5192
2022-04-05,San Francisco,075,870044,125938,125536,8280,133816,843
2022-04-05,San Joaquin,077,732212,166854,166415,9928,176343,2207
2022-04-05,San Luis Obispo,079,281455,52549,52557,3746,56303,475
2022-04-05,San Mateo,081,765935,122549,121041,6956,127997,693
2022-04-05,Santa Barbara,083,443738,85916,85630,4699,90329,679
2022-04-05,Santa Clara,085,1922200,316654,313278,12393,325671,2265
2022-04-05,Santa Cruz,087,273765,48007,47446,2094,49540,259
2022-04-05,Shasta,089,179085,30567,30565,6089,36654,529
2022-04-05,Sierra,091,2930,274,272,48,320,4
2022-04-05,Siskiyou,093,43540,4431,4442,2719,7161,80
2022-04-05,Solano,095,438530,81686,81789,5576,87365,447
2022-04-05,Sonoma,097,501317,83807,83361,2640,86001,485
2022-04-05,Stanislaus,099,539301,117642,117534,17838,135372,1578
2022-04-05,Sutter,101,95872,20487,20581,2072,22653,222
2022-04-05,Tehama,103,63373,12047,12049,2569,14618,198
2022-04-05,Trinity,105,12862,1184,1173,287,1460,20
2022-04-05,Tulare,107,460477,106294,104826,27544,132370,1414
2022-04-05,Tuolumne,109,53932,12686,12621,559,13180,180
2022-04-05,Ventura,111,848112,173391,173179,9402,182581,1460
2022-04-05,Yolo,113,214977,37150,36393,2918,39311,314
2022-04-05,Yuba,115,75493,15837,15839,1199,17038,121
2022-04-04,Alameda,001,1643700,257336,256143,13869,270012,1814
2022-04-04,Alpine,003,1148,124,124,1,125,0
2022-04-04,Amador,005,37829,8526,8488,640,9128,86
2022-04-04,Butte,007,227075,33217,32997,7023,40020,396
2022-04-04,Calaveras,009,45235,7261,7258,349,7607,120
2022-04-04,Colusa,011,21464,3449,3447,1046,4493,21
2022-04-04,Contra Costa,013,1133247,192533,188850,13429,202279,1296
2022-04-04,Del Norte,015,27424,5809,5809,184,5993,50
2022-04-04,El Dorado,017,186661,26742,26744,3193,29937,205
2022-04-04,Fresno,019,978130,233998,230942,24263,255205,2725
2022-04-04,Glenn,021,27897,4998,4986,1601,6587,47
2022-04-04,Humboldt,023,135768,16884,16904,2945,19849,140
2022-04-04,Imperial,025,180216,55369,55294,10523,65817,908
2022-04-04,Inyo,027,18085,4076,4068,478,4546,56
2022-04-04,Kern,029,883053,191871,191449,45769,237218,2234
2022-04-04,Kings,031,150075,51481,51491,3518,55009,443
2022-04-04,Lake,033,64148,10706,10679,883,11562,136
2022-04-04,Lassen,035,31185,8958,8945,874,9819,65
2022-04-04,Los Angeles,037,10098052,2714864,2707306,123082,2830388,31465
2022-04-04,Madera,039,155013,37255,37349,6022,43371,354
2022-04-04,Marin,041,260295,33673,33566,2284,35850,288
2022-04-04,Mariposa,043,17540,2402,2392,201,2593,29
2022-04-04,Mendocino,045,87422,13080,13074,3017,16091,119
2022-04-04,Merced,047,269075,62575,62195,8743,70938,810
2022-04-04,Modoc,049,8938,738,741,250,991,8
2022-04-04,Mono,051,14174,2969,2967,123,3090,6
2022-04-04,Monterey,053,433212,79446,79019,13688,92707,727
2022-04-04,Napa,055,140530,25812,25790,942,26732,143
2022-04-04,Nevada,057,99092,15967,15974,1198,17172,123
2022-04-04,Orange,059,3164182,547368,546491,41468,587959,6887
2022-04-04,Placer,061,380077,62847,62787,7337,70124,615
2022-04-04,Plumas,063,18699,2973,2850,365,3215,13
2022-04-04,Riverside,065,2383286,591618,590826,27758,618584,6424
2022-04-04,Sacramento,067,1510023,281060,276567,26536,303103,2953
2022-04-04,San Benito,069,59416,12977,12908,515,13423,98
2022-04-04,San Bernardino,071,2135413,574433,561648,24926,586574,6883
2022-04-04,San Diego,073,3302833,751925,753402,52828,806230,5192
2022-04-04,San Francisco,075,870044,125739,125536,8271,133807,843
2022-04-04,San Joaquin,077,732212,166828,166415,9925,176340,2207
2022-04-04,San Luis Obispo,079,281455,52526,52557,3744,56301,475
2022-04-04,San Mateo,081,765935,122411,121041,6944,127985,693
2022-04-04,Santa Barbara,083,443738,85871,85630,4698,90328,679
2022-04-04,Santa Clara,085,1922200,316385,313278,12381,325659,2265
2022-04-04,Santa Cruz,087,273765,47960,47446,2094,49540,259
2022-04-04,Shasta,089,179085,30564,30565,6088,36653,529
2022-04-04,Sierra,091,2930,274,272,48,320,4
2022-04-04,Siskiyou,093,43540,4431,4442,2719,7161,80
2022-04-04,Solano,095,438530,81640,81789,5573,87362,447
2022-04-04,Sonoma,097,501317,83753,83361,2633,85994,485
2022-04-04,Stanislaus,099,539301,117621,117534,17831,135365,1578
2022-04-04,Sutter,101,95872,20484,20581,2072,22653,222
2022-04-04,Tehama,103,63373,12045,12049,2569,14618,198
2022-04-04,Trinity,105,12862,1184,1173,287,1460,20
2022-04-04,Tulare,107,460477,106285,104826,27541,132367,1414
2022-04-04,Tuolumne,109,53932,12679,12621,559,13180,180
2022-04-04,Ventura,111,848112,173351,173179,9399,182578,1460
2022-04-04,Yolo,113,214977,37136,36393,2916,39309,314
2022-04-04,Yuba,115,75493,15834,15839,1199,17038,121
2022-04-03,Alameda,001,1643700,257080,255650,13867,269517,1813
2022-04-03,Alpine,003,1148,124,124,1,125,0
2022-04-03,Amador,005,37829,8525,8485,640,9125,86
2022-04-03,Butte,007,227075,33210,32981,7021,40002,396
2022-04-03,Calaveras,009,45235,7261,7254,349,7603,119
2022-04-03,Colusa,011,21464,3449,3445,1046,4491,21
2022-04-03,Contra Costa,013,1133247,192427,188658,13419,202077,1291
2022-04-03,Del Norte,015,27424,5809,5812,184,5996,50
2022-04-03,El Dorado,017,186661,26728,26732,3191,29923,200
2022-04-03,Fresno,019,978130,233966,230559,24260,254819,2722
2022-04-03,Glenn,021,27897,4998,4982,1601,6583,47
2022-04-03,Humboldt,023,135768,16879,16898,2945,19843,140
2022-04-03,Imperial,025,180216,55367,55266,10520,65786,908
2022-04-03,Inyo,027,18085,4074,4063,478,4541,56
2022-04-03,Kern,029,883053,191846,191384,45764,237148,2224
2022-04-03,Kings,031,150075,51475,51470,3516,54986,443
2022-04-03,Lake,033,64148,10704,10674,883,11557,136
2022-04-03,Lassen,035,31185,8957,8943,874,9817,65
2022-04-03,Los Angeles,037,10098052,2713674,2703576,122997,2826573,31410
2022-04-03,Madera,039,155013,37253,37333,6021,43354,354
2022-04-03,Marin,041,260295,33638,33493,2276,35769,287
2022-04-03,Mariposa,043,17540,2401,2391,201,2592,29
2022-04-03,Mendocino,045,87422,13074,13058,3016,16074,119
2022-04-03,Merced,047,269075,62560,62149,8737,70886,808
2022-04-03,Modoc,049,8938,737,741,250,991,8
2022-04-03,Mono,051,14174,2969,2967,123,3090,6
2022-04-03,Monterey,053,433212,79429,78964,13663,92627,726
2022-04-03,Napa,055,140530,25793,25757,941,26698,143
2022-04-03,Nevada,057,99092,15961,15962,1197,17159,123
2022-04-03,Orange,059,3164182,547170,546047,41443,587490,6880
2022-04-03,Placer,061,380077,62821,62740,7332,70072,614
2022-04-03,Plumas,063,18699,2972,2803,365,3168,14
2022-04-03,Riverside,065,2383286,591460,590563,27743,618306,6418
2022-04-03,Sacramento,067,1510023,280985,276218,26523,302741,2950
2022-04-03,San Benito,069,59416,12973,12901,515,13416,98
2022-04-03,San Bernardino,071,2135413,574288,561362,24923,586285,6865
2022-04-03,San Diego,073,3302833,751596,752281,52791,805072,5178
2022-04-03,San Francisco,075,870044,125508,125075,8265,133340,843
2022-04-03,San Joaquin,077,732212,166771,166336,9920,176256,2202
2022-04-03,San Luis Obispo,079,281455,52507,52512,3744,56256,475
2022-04-03,San Mateo,081,765935,122271,120717,6937,127654,693
2022-04-03,Santa Barbara,083,443738,85826,85611,4696,90307,678
2022-04-03,Santa Clara,085,1922200,316085,312517,12372,324889,2258
2022-04-03,Santa Cruz,087,273765,47905,47371,2092,49463,259
2022-04-03,Shasta,089,179085,30554,30556,6087,36643,530
2022-04-03,Sierra,091,2930,274,273,48,321,4
2022-04-03,Siskiyou,093,43540,4431,4439,2719,7158,80
2022-04-03,Solano,095,438530,81598,81848,5567,87415,446
2022-04-03,Sonoma,097,501317,83675,83235,2625,85860,485
2022-04-03,Stanislaus,099,539301,117590,117536,17825,135361,1581
2022-04-03,Sutter,101,95872,20481,20570,2072,22642,222
2022-04-03,Tehama,103,63373,12043,12046,2569,14615,198
2022-04-03,Trinity,105,12862,1184,1173,287,1460,20
2022-04-03,Tulare,107,460477,106278,104736,27533,132269,1410
2022-04-03,Tuolumne,109,53932,12678,12618,559,13177,180
2022-04-03,Ventura,111,848112,173298,173044,9395,182439,1460
2022-04-03,Yolo,113,214977,37115,36347,2914,39261,313
2022-04-03,Yuba,115,75493,15832,15835,1199,17034,120
2022-04-02,Alameda,001,1643700,256978,255650,13867,269517,1813
2022-04-02,Alpine,003,1148,124,124,1,125,0
2022-04-02,Amador,005,37829,8525,8485,640,9125,86
2022-04-02,Butte,007,227075,33206,32981,7020,40001,396
2022-04-02,Calaveras,009,45235,7261,7254,349,7603,119
2022-04-02,Colusa,011,21464,3449,3445,1046,4491,21
2022-04-02,Contra Costa,013,1133247,192368,188658,13416,202074,1291
2022-04-02,Del Norte,015,27424,5808,5812,184,5996,50
2022-04-02,El Dorado,017,186661,26725,26732,3191,29923,200
2022-04-02,Fresno,019,978130,233937,230559,24260,254819,2722
2022-04-02,Glenn,021,27897,4998,4982,1601,6583,47
2022-04-02,Humboldt,023,135768,16875,16898,2945,19843,140
2022-04-02,Imperial,025,180216,55364,55266,10520,65786,908
2022-04-02,Inyo,027,18085,4074,4063,478,4541,56
2022-04-02,Kern,029,883053,191831,191384,45760,237144,2224
2022-04-02,Kings,031,150075,51472,51470,3516,54986,443
2022-04-02,Lake,033,64148,10703,10674,883,11557,136
2022-04-02,Lassen,035,31185,8957,8943,874,9817,65
2022-04-02,Los Angeles,037,10098052,2713154,2703576,122957,2826533,31410
2022-04-02,Madera,039,155013,37250,37333,6021,43354,354
2022-04-02,Marin,041,260295,33615,33493,2268,35761,287
2022-04-02,Mariposa,043,17540,2400,2391,201,2592,29
2022-04-02,Mendocino,045,87422,13072,13058,3016,16074,119
2022-04-02,Merced,047,269075,62557,62149,8737,70886,808
2022-04-02,Modoc,049,8938,737,741,250,991,8
2022-04-02,Mono,051,14174,2969,2967,122,3089,6
2022-04-02,Monterey,053,433212,79416,78964,13657,92621,726
2022-04-02,Napa,055,140530,25779,25757,940,26697,143
2022-04-02,Nevada,057,99092,15957,15962,1196,17158,123
2022-04-02,Orange,059,3164182,547064,546047,41431,587478,6880
2022-04-02,Placer,061,380077,62810,62740,7330,70070,614
2022-04-02,Plumas,063,18699,2972,2803,365,3168,14
2022-04-02,Riverside,065,2383286,591386,590563,27738,618301,6418
2022-04-02,Sacramento,067,1510023,280945,276218,26522,302740,2950
2022-04-02,San Benito,069,59416,12972,12901,515,13416,98
2022-04-02,San Bernardino,071,2135413,574236,561362,24920,586282,6865
2022-04-02,San Diego,073,3302833,751472,752281,52781,805062,5178
2022-04-02,San Francisco,075,870044,125403,125075,8257,133332,843
2022-04-02,San Joaquin,077,732212,166750,166336,9918,176254,2202
2022-04-02,San Luis Obispo,079,281455,52502,52512,3744,56256,475
2022-04-02,San Mateo,081,765935,122174,120717,6930,127647,693
2022-04-02,Santa Barbara,083,443738,85807,85611,4695,90306,678
2022-04-02,Santa Clara,085,1922200,315921,312517,12368,324885,2258
2022-04-02,Santa Cruz,087,273765,47893,47371,2091,49462,259
2022-04-02,Shasta,089,179085,30553,30556,6087,36643,530
2022-04-02,Sierra,091,2930,274,273,48,321,4
2022-04-02,Siskiyou,093,43540,4431,4439,2718,7157,80
2022-04-02,Solano,095,438530,81583,81848,5566,87414,446
2022-04-02,Sonoma,097,501317,83627,83235,2619,85854,485
2022-04-02,Stanislaus,099,539301,117581,117536,17823,135359,1581
2022-04-02,Sutter,101,95872,20476,20570,2072,22642,222
2022-04-02,Tehama,103,63373,12043,12046,2569,14615,198
2022-04-02,Trinity,105,12862,1184,1173,287,1460,20
2022-04-02,Tulare,107,460477,106274,104736,27533,132269,1410
2022-04-02,Tuolumne,109,53932,12676,12618,559,13177,180
2022-04-02,Ventura,111,848112,173257,173044,9395,182439,1460
2022-04-02,Yolo,113,214977,37103,36347,2911,39258,313
2022-04-02,Yuba,115,75493,15831,15835,1199,17034,120
2022-04-01,Alameda,001,1643700,256862,255650,13862,269512,1813
2022-04-01,Alpine,003,1148,124,124,1,125,0
2022-04-01,Amador,005,37829,8525,8485,640,9125,86
2022-04-01,Butte,007,227075,33202,32981,7017,39998,396
2022-04-01,Calaveras,009,45235,7259,7254,349,7603,119
2022-04-01,Colusa,011,21464,3448,3445,1046,4491,21
2022-04-01,Contra Costa,013,1133247,192316,188658,13415,202073,1291
2022-04-01,Del Norte,015,27424,5806,5812,184,5996,50
2022-04-01,El Dorado,017,186661,26722,26732,3190,29922,200
2022-04-01,Fresno,019,978130,233912,230559,24258,254817,2722
2022-04-01,Glenn,021,27897,4998,4982,1601,6583,47
2022-04-01,Humboldt,023,135768,16873,16898,2945,19843,140
2022-04-01,Imperial,025,180216,55362,55266,10520,65786,908
2022-04-01,Inyo,027,18085,4072,4063,477,4540,56
2022-04-01,Kern,029,883053,191820,191384,45757,237141,2224
2022-04-01,Kings,031,150075,51469,51470,3516,54986,443
2022-04-01,Lake,033,64148,10700,10674,883,11557,136
2022-04-01,Lassen,035,31185,8956,8943,874,9817,65
2022-04-01,Los Angeles,037,10098052,2712660,2703576,122914,2826490,31410
2022-04-01,Madera,039,155013,37249,37333,6021,43354,354
2022-04-01,Marin,041,260295,33597,33493,2261,35754,287
2022-04-01,Mariposa,043,17540,2397,2391,201,2592,29
2022-04-01,Mendocino,045,87422,13069,13058,3015,16073,119
2022-04-01,Merced,047,269075,62550,62149,8736,70885,808
2022-04-01,Modoc,049,8938,737,741,250,991,8
2022-04-01,Mono,051,14174,2969,2967,122,3089,6
2022-04-01,Monterey,053,433212,79398,78964,13654,92618,726
2022-04-01,Napa,055,140530,25769,25757,940,26697,143
2022-04-01,Nevada,057,99092,15957,15962,1195,17157,123
2022-04-01,Orange,059,3164182,546956,546047,41423,587470,6880
2022-04-01,Placer,061,380077,62796,62740,7330,70070,614
2022-04-01,Plumas,063,18699,2972,2803,364,3167,14
2022-04-01,Riverside,065,2383286,591320,590563,27725,618288,6418
2022-04-01,Sacramento,067,1510023,280907,276218,26515,302733,2950
2022-04-01,San Benito,069,59416,12971,12901,515,13416,98
2022-04-01,San Bernardino,071,2135413,574180,561362,24916,586278,6865
2022-04-01,San Diego,073,3302833,751326,752281,52765,805046,5178
2022-04-01,San Francisco,075,870044,125293,125075,8251,133326,843
2022-04-01,San Joaquin,077,732212,166730,166336,9915,176251,2202
2022-04-01,San Luis Obispo,079,281455,52496,52512,3743,56255,475
2022-04-01,San Mateo,081,765935,122110,120717,6926,127643,693
2022-04-01,Santa Barbara,083,443738,85787,85611,4695,90306,678
2022-04-01,Santa Clara,085,1922200,315771,312517,12367,324884,2258
2022-04-01,Santa Cruz,087,273765,47878,47371,2089,49460,259
2022-04-01,Shasta,089,179085,30552,30556,6087,36643,530
2022-04-01,Sierra,091,2930,274,273,48,321,4
2022-04-01,Siskiyou,093,43540,4431,4439,2717,7156,80
2022-04-01,Solano,095,438530,81568,81848,5566,87414,446
2022-04-01,Sonoma,097,501317,83583,83235,2618,85853,485
2022-04-01,Stanislaus,099,539301,117569,117536,17820,135356,1581
2022-04-01,Sutter,101,95872,20476,20570,2072,22642,222
2022-04-01,Tehama,103,63373,12043,12046,2569,14615,198
2022-04-01,Trinity,105,12862,1184,1173,287,1460,20
2022-04-01,Tulare,107,460477,106269,104736,27529,132265,1410
2022-04-01,Tuolumne,109,53932,12675,12618,559,13177,180
2022-04-01,Ventura,111,848112,173226,173044,9391,182435,1460
2022-04-01,Yolo,113,214977,37089,36347,2910,39257,313
2022-04-01,Yuba,115,75493,15830,15835,1199,17034,120
2022-03-31,Alameda,001,1643700,256687,255650,13849,269499,1813
2022-03-31,Alpine,003,1148,124,124,1,125,0
2022-03-31,Amador,005,37829,8525,8485,640,9125,86
2022-03-31,Butte,007,227075,33198,32981,7014,39995,396
2022-03-31,Calaveras,009,45235,7256,7254,349,7603,119
2022-03-31,Colusa,011,21464,3447,3445,1046,4491,21
2022-03-31,Contra Costa,013,1133247,192220,188658,13409,202067,1291
2022-03-31,Del Norte,015,27424,5805,5812,184,5996,50
2022-03-31,El Dorado,017,186661,26714,26732,3190,29922,200
2022-03-31,Fresno,019,978130,233877,230559,24237,254796,2722
2022-03-31,Glenn,021,27897,4997,4982,1601,6583,47
2022-03-31,Humboldt,023,135768,16869,16898,2945,19843,140
2022-03-31,Imperial,025,180216,55359,55266,10519,65785,908
2022-03-31,Inyo,027,18085,4071,4063,474,4537,56
2022-03-31,Kern,029,883053,191805,191384,45748,237132,2224
2022-03-31,Kings,031,150075,51460,51470,3516,54986,443
2022-03-31,Lake,033,64148,10699,10674,882,11556,136
2022-03-31,Lassen,035,31185,8954,8943,874,9817,65
2022-03-31,Los Angeles,037,10098052,2711918,2703576,122857,2826433,31410
2022-03-31,Madera,039,155013,37246,37333,6021,43354,354
2022-03-31,Marin,041,260295,33571,33493,2249,35742,287
2022-03-31,Mariposa,043,17540,2396,2391,200,2591,29
2022-03-31,Mendocino,045,87422,13065,13058,3015,16073,119
2022-03-31,Merced,047,269075,62545,62149,8733,70882,808
2022-03-31,Modoc,049,8938,737,741,250,991,8
2022-03-31,Mono,051,14174,2969,2967,122,3089,6
2022-03-31,Monterey,053,433212,79381,78964,13643,92607,726
2022-03-31,Napa,055,140530,25762,25757,938,26695,143
2022-03-31,Nevada,057,99092,15950,15962,1194,17156,123
2022-03-31,Orange,059,3164182,546808,546047,41409,587456,6880
2022-03-31,Placer,061,380077,62771,62740,7327,70067,614
2022-03-31,Plumas,063,18699,2972,2803,363,3166,14
2022-03-31,Riverside,065,2383286,591210,590563,27722,618285,6418
2022-03-31,Sacramento,067,1510023,280833,276218,26507,302725,2950
2022-03-31,San Benito,069,59416,12970,12901,515,13416,98
2022-03-31,San Bernardino,071,2135413,574083,561362,24905,586267,6865
2022-03-31,San Diego,073,3302833,751090,752281,52737,805018,5178
2022-03-31,San Francisco,075,870044,125136,125075,8239,133314,843
2022-03-31,San Joaquin,077,732212,166696,166336,9900,176236,2202
2022-03-31,San Luis Obispo,079,281455,52482,52512,3742,56254,475
2022-03-31,San Mateo,081,765935,121999,120717,6925,127642,693
2022-03-31,Santa Barbara,083,443738,85757,85611,4695,90306,678
2022-03-31,Santa Clara,085,1922200,315543,312517,12356,324873,2258
2022-03-31,Santa Cruz,087,273765,47859,47371,2087,49458,259
2022-03-31,Shasta,089,179085,30546,30556,6087,36643,530
2022-03-31,Sierra,091,2930,271,273,48,321,4
2022-03-31,Siskiyou,093,43540,4430,4439,2717,7156,80
2022-03-31,Solano,095,438530,81539,81848,5563,87411,446
2022-03-31,Sonoma,097,501317,83540,83235,2612,85847,485
2022-03-31,Stanislaus,099,539301,117552,117536,17815,135351,1581
2022-03-31,Sutter,101,95872,20473,20570,2071,22641,222
2022-03-31,Tehama,103,63373,12042,12046,2568,14614,198
2022-03-31,Trinity,105,12862,1184,1173,287,1460,20
2022-03-31,Tulare,107,460477,106259,104736,27521,132257,1410
2022-03-31,Tuolumne,109,53932,12674,12618,559,13177,180
2022-03-31,Ventura,111,848112,173186,173044,9388,182432,1460
2022-03-31,Yolo,113,214977,37073,36347,2910,39257,313
2022-03-31,Yuba,115,75493,15830,15835,1196,17031,120
2022-03-30,Alameda,001,1643700,256556,255467,13841,269308,1812
2022-03-30,Alpine,003,1148,124,124,1,125,0
2022-03-30,Amador,005,37829,8525,8485,640,9125,86
2022-03-30,Butte,007,227075,33193,32968,7008,39976,396
2022-03-30,Calaveras,009,45235,7254,7253,348,7601,119
2022-03-30,Colusa,011,21464,3447,3445,1046,4491,21
2022-03-30,Contra Costa,013,1133247,192159,188496,13398,201894,1291
2022-03-30,Del Norte,015,27424,5803,5808,184,5992,50
2022-03-30,El Dorado,017,186661,26705,26722,3190,29912,200
2022-03-30,Fresno,019,978130,233866,230448,24231,254679,2720
2022-03-30,Glenn,021,27897,4996,4982,1601,6583,47
2022-03-30,Humboldt,023,135768,16866,16894,2945,19839,140
2022-03-30,Imperial,025,180216,55355,55252,10516,65768,908
2022-03-30,Inyo,027,18085,4070,4062,472,4534,56
2022-03-30,Kern,029,883053,191777,191363,45743,237106,2219
2022-03-30,Kings,031,150075,51454,51446,3515,54961,443
2022-03-30,Lake,033,64148,10698,10674,882,11556,136
2022-03-30,Lassen,035,31185,8954,8943,874,9817,65
2022-03-30,Los Angeles,037,10098052,2711103,2702536,122802,2825338,31384
2022-03-30,Madera,039,155013,37240,37330,6020,43350,354
2022-03-30,Marin,041,260295,33551,33453,2230,35683,287
2022-03-30,Mariposa,043,17540,2396,2390,200,2590,27
2022-03-30,Mendocino,045,87422,13061,13055,3012,16067,118
2022-03-30,Merced,047,269075,62540,62136,8728,70864,808
2022-03-30,Modoc,049,8938,737,739,250,989,8
2022-03-30,Mono,051,14174,2968,2967,122,3089,6
2022-03-30,Monterey,053,433212,79364,78911,13636,92547,726
2022-03-30,Napa,055,140530,25750,25745,937,26682,141
2022-03-30,Nevada,057,99092,15947,15960,1192,17152,123
2022-03-30,Orange,059,3164182,546658,545895,41387,587282,6876
2022-03-30,Placer,061,380077,62756,62705,7323,70028,614
2022-03-30,Plumas,063,18699,2972,2762,361,3123,13
2022-03-30,Riverside,065,2383286,591127,590437,27709,618146,6411
2022-03-30,Sacramento,067,1510023,280765,276081,26500,302581,2949
2022-03-30,San Benito,069,59416,12966,12898,515,13413,98
2022-03-30,San Bernardino,071,2135413,574000,561153,24901,586054,6863
2022-03-30,San Diego,073,3302833,750859,751684,52710,804394,5169
2022-03-30,San Francisco,075,870044,125030,124930,8230,133160,841
2022-03-30,San Joaquin,077,732212,166667,166299,9894,176193,2201
2022-03-30,San Luis Obispo,079,281455,52468,52484,3738,56222,475
2022-03-30,San Mateo,081,765935,121899,120548,6925,127473,693
2022-03-30,Santa Barbara,083,443738,85735,85488,4692,90180,677
2022-03-30,Santa Clara,085,1922200,315361,312253,12336,324589,2258
2022-03-30,Santa Cruz,087,273765,47803,47340,2086,49426,259
2022-03-30,Shasta,089,179085,30543,30555,6087,36642,530
2022-03-30,Sierra,091,2930,271,273,48,321,4
2022-03-30,Siskiyou,093,43540,4430,4439,2717,7156,80
2022-03-30,Solano,095,438530,81520,81816,5559,87375,443
2022-03-30,Sonoma,097,501317,83503,83163,2611,85774,485
2022-03-30,Stanislaus,099,539301,117539,117593,17812,135405,1559
2022-03-30,Sutter,101,95872,20468,20565,2071,22636,222
2022-03-30,Tehama,103,63373,12041,12045,2567,14612,198
2022-03-30,Trinity,105,12862,1183,1173,287,1460,20
2022-03-30,Tulare,107,460477,106253,104667,27514,132181,1410
2022-03-30,Tuolumne,109,53932,12672,12616,559,13175,180
2022-03-30,Ventura,111,848112,173145,172984,9380,182364,1460
2022-03-30,Yolo,113,214977,37063,36325,2907,39232,313
2022-03-30,Yuba,115,75493,15828,15830,1196,17026,120
2022-03-29,Alameda,001,1643700,256431,255261,13831,269092,1810
2022-03-29,Alpine,003,1148,124,124,1,125,0
2022-03-29,Amador,005,37829,8525,8483,640,9123,86
2022-03-29,Butte,007,227075,33190,32954,7008,39962,396
2022-03-29,Calaveras,009,45235,7253,7250,347,7597,119
2022-03-29,Colusa,011,21464,3447,3445,1046,4491,21
2022-03-29,Contra Costa,013,1133247,192071,188359,13390,201749,1290
2022-03-29,Del Norte,015,27424,5803,5806,183,5989,50
2022-03-29,El Dorado,017,186661,26700,26706,3190,29896,200
2022-03-29,Fresno,019,978130,233838,230256,24227,254483,2718
2022-03-29,Glenn,021,27897,4996,4983,1601,6584,47
2022-03-29,Humboldt,023,135768,16863,16892,2942,19834,140
2022-03-29,Imperial,025,180216,55341,55233,10515,65748,908
2022-03-29,Inyo,027,18085,4068,4062,471,4533,56
2022-03-29,Kern,029,883053,191745,191338,45736,237074,2220
2022-03-29,Kings,031,150075,51447,51416,3514,54930,443
2022-03-29,Lake,033,64148,10694,10674,882,11556,136
2022-03-29,Lassen,035,31185,8953,8943,874,9817,65
2022-03-29,Los Angeles,037,10098052,2710274,2702005,122756,2824761,31378
2022-03-29,Madera,039,155013,37232,37325,6017,43342,354
2022-03-29,Marin,041,260295,33531,33431,2225,35656,287
2022-03-29,Mariposa,043,17540,2396,2388,200,2588,23
2022-03-29,Mendocino,045,87422,13057,13053,3011,16064,119
2022-03-29,Merced,047,269075,62527,62123,8727,70850,806
2022-03-29,Modoc,049,8938,735,737,250,987,8
2022-03-29,Mono,051,14174,2968,2966,122,3088,5
2022-03-29,Monterey,053,433212,79351,78774,13628,92402,725
2022-03-29,Napa,055,140530,25743,25732,937,26669,141
2022-03-29,Nevada,057,99092,15939,15956,1192,17148,123
2022-03-29,Orange,059,3164182,546510,545832,41371,587203,6871
2022-03-29,Placer,061,380077,62738,62687,7318,70005,614
2022-03-29,Plumas,063,18699,2970,2761,361,3122,13
2022-03-29,Riverside,065,2383286,591025,590359,27701,618060,6403
2022-03-29,Sacramento,067,1510023,280699,276040,26488,302528,2946
2022-03-29,San Benito,069,59416,12964,12892,515,13407,97
2022-03-29,San Bernardino,071,2135413,573904,561026,24893,585919,6860
2022-03-29,San Diego,073,3302833,750617,751240,52687,803927,5159
2022-03-29,San Francisco,075,870044,124879,124789,8224,133013,840
2022-03-29,San Joaquin,077,732212,166631,166241,9886,176127,2198
2022-03-29,San Luis Obispo,079,281455,52452,52455,3734,56189,472
2022-03-29,San Mateo,081,765935,121804,120435,6923,127358,686
2022-03-29,Santa Barbara,083,443738,85712,85464,4692,90156,676
2022-03-29,Santa Clara,085,1922200,315122,312067,12319,324386,2259
2022-03-29,Santa Cruz,087,273765,47783,47323,2085,49408,259
2022-03-29,Shasta,089,179085,30536,30552,6085,36637,529
2022-03-29,Sierra,091,2930,271,273,48,321,4
2022-03-29,Siskiyou,093,43540,4430,4439,2716,7155,80
2022-03-29,Solano,095,438530,81496,81713,5556,87269,441
2022-03-29,Sonoma,097,501317,83470,83130,2605,85735,485
2022-03-29,Stanislaus,099,539301,117520,117683,17806,135489,1559
2022-03-29,Sutter,101,95872,20466,20556,2070,22626,221
2022-03-29,Tehama,103,63373,12039,12045,2567,14612,198
2022-03-29,Trinity,105,12862,1183,1173,287,1460,20
2022-03-29,Tulare,107,460477,106249,104622,27509,132131,1406
2022-03-29,Tuolumne,109,53932,12670,12615,559,13174,180
2022-03-29,Ventura,111,848112,173090,172946,9379,182325,1460
2022-03-29,Yolo,113,214977,37050,36296,2906,39202,313
2022-03-29,Yuba,115,75493,15824,15824,1195,17019,117
2022-03-28,Alameda,001,1643700,256278,255192,13821,269013,1808
2022-03-28,Alpine,003,1148,124,124,1,125,0
2022-03-28,Amador,005,37829,8524,8480,640,9120,86
2022-03-28,Butte,007,227075,33173,32947,7008,39955,392
2022-03-28,Calaveras,009,45235,7253,7247,347,7594,119
2022-03-28,Colusa,011,21464,3447,3445,1046,4491,21
2022-03-28,Contra Costa,013,1133247,191991,188305,13385,201690,1290
2022-03-28,Del Norte,015,27424,5801,5834,183,6017,50
2022-03-28,El Dorado,017,186661,26693,26703,3188,29891,200
2022-03-28,Fresno,019,978130,233810,230144,24210,254354,2717
2022-03-28,Glenn,021,27897,4995,4983,1601,6584,47
2022-03-28,Humboldt,023,135768,16862,16916,2942,19858,140
2022-03-28,Imperial,025,180216,55331,55245,10515,65760,909
2022-03-28,Inyo,027,18085,4067,4062,471,4533,56
2022-03-28,Kern,029,883053,191719,191333,45727,237060,2212
2022-03-28,Kings,031,150075,51434,51405,3514,54919,443
2022-03-28,Lake,033,64148,10692,10673,882,11555,136
2022-03-28,Lassen,035,31185,8953,8946,874,9820,63
2022-03-28,Los Angeles,037,10098052,2709405,2700997,122717,2823714,31349
2022-03-28,Madera,039,155013,37228,37324,6017,43341,354
2022-03-28,Marin,041,260295,33506,33391,2220,35611,287
2022-03-28,Mariposa,043,17540,2395,2388,200,2588,23
2022-03-28,Mendocino,045,87422,13055,13046,3010,16056,118
2022-03-28,Merced,047,269075,62517,62116,8722,70838,805
2022-03-28,Modoc,049,8938,734,736,250,986,7
2022-03-28,Mono,051,14174,2968,2966,122,3088,5
2022-03-28,Monterey,053,433212,79318,78784,13624,92408,724
2022-03-28,Napa,055,140530,25737,25723,936,26659,140
2022-03-28,Nevada,057,99092,15937,15969,1192,17161,123
2022-03-28,Orange,059,3164182,546381,545700,41345,587045,6860
2022-03-28,Placer,061,380077,62718,62687,7317,70004,613
2022-03-28,Plumas,063,18699,2969,2760,361,3121,13
2022-03-28,Riverside,065,2383286,590925,590298,27693,617991,6397
2022-03-28,Sacramento,067,1510023,280630,275889,26476,302365,2946
2022-03-28,San Benito,069,59416,12964,12889,515,13404,97
2022-03-28,San Bernardino,071,2135413,573822,560836,24882,585718,6858
2022-03-28,San Diego,073,3302833,750378,750659,52653,803312,5155
2022-03-28,San Francisco,075,870044,124739,124678,8214,132892,839
2022-03-28,San Joaquin,077,732212,166599,166247,9884,176131,2196
2022-03-28,San Luis Obispo,079,281455,52427,52434,3731,56165,470
2022-03-28,San Mateo,081,765935,121688,120337,6918,127255,686
2022-03-28,Santa Barbara,083,443738,85684,85442,4690,90132,675
2022-03-28,Santa Clara,085,1922200,314893,311953,12310,324263,2257
2022-03-28,Santa Cruz,087,273765,47750,47324,2085,49409,259
2022-03-28,Shasta,089,179085,30535,30550,6084,36634,527
2022-03-28,Sierra,091,2930,271,273,48,321,4
2022-03-28,Siskiyou,093,43540,4429,4438,2716,7154,80
2022-03-28,Solano,095,438530,81468,81704,5551,87255,441
2022-03-28,Sonoma,097,501317,83424,83105,2600,85705,485
2022-03-28,Stanislaus,099,539301,117508,117783,17801,135584,1562
2022-03-28,Sutter,101,95872,20460,20549,2070,22619,221
2022-03-28,Tehama,103,63373,12039,12041,2567,14608,200
2022-03-28,Trinity,105,12862,1183,1173,287,1460,20
2022-03-28,Tulare,107,460477,106237,104576,27503,132079,1404
2022-03-28,Tuolumne,109,53932,12670,12627,559,13186,180
2022-03-28,Ventura,111,848112,173051,172867,9378,182245,1455
2022-03-28,Yolo,113,214977,37032,36282,2904,39186,312
2022-03-28,Yuba,115,75493,15823,15821,1193,17014,117
2022-03-27,Alameda,001,1643700,256090,255132,13812,268944,1809
2022-03-27,Alpine,003,1148,124,124,1,125,0
2022-03-27,Amador,005,37829,8521,8480,640,9120,86
2022-03-27,Butte,007,227075,33160,32943,7002,39945,392
2022-03-27,Calaveras,009,45235,7251,7245,347,7592,119
2022-03-27,Colusa,011,21464,3447,3445,1046,4491,21
2022-03-27,Contra Costa,013,1133247,191877,188251,13368,201619,1290
2022-03-27,Del Norte,015,27424,5800,5836,183,6019,50
2022-03-27,El Dorado,017,186661,26679,26699,3185,29884,200
2022-03-27,Fresno,019,978130,233763,230049,24192,254241,2717
2022-03-27,Glenn,021,27897,4993,4983,1601,6584,47
2022-03-27,Humboldt,023,135768,16858,16920,2942,19862,140
2022-03-27,Imperial,025,180216,55318,55240,10514,65754,909
2022-03-27,Inyo,027,18085,4066,4062,469,4531,56
2022-03-27,Kern,029,883053,191681,191332,45721,237053,2213
2022-03-27,Kings,031,150075,51425,51400,3514,54914,443
2022-03-27,Lake,033,64148,10691,10672,881,11553,136
2022-03-27,Lassen,035,31185,8953,8946,874,9820,63
2022-03-27,Los Angeles,037,10098052,2708589,2700983,122670,2823653,31348
2022-03-27,Madera,039,155013,37224,37323,6015,43338,354
2022-03-27,Marin,041,260295,33469,33391,2210,35601,287
2022-03-27,Mariposa,043,17540,2395,2390,200,2590,23
2022-03-27,Mendocino,045,87422,13051,13046,3008,16054,118
2022-03-27,Merced,047,269075,62507,62110,8721,70831,805
2022-03-27,Modoc,049,8938,733,736,248,984,7
2022-03-27,Mono,051,14174,2968,2966,122,3088,5
2022-03-27,Monterey,053,433212,79297,78778,13612,92390,724
2022-03-27,Napa,055,140530,25721,25723,936,26659,140
2022-03-27,Nevada,057,99092,15933,15967,1190,17157,123
2022-03-27,Orange,059,3164182,546247,545644,41311,586955,6860
2022-03-27,Placer,061,380077,62700,62680,7316,69996,613
2022-03-27,Plumas,063,18699,2968,2760,359,3119,13
2022-03-27,Riverside,065,2383286,590839,590251,27682,617933,6395
2022-03-27,Sacramento,067,1510023,280549,275854,26469,302323,2941
2022-03-27,San Benito,069,59416,12959,12889,514,13403,97
2022-03-27,San Bernardino,071,2135413,573705,560853,24880,585733,6862
2022-03-27,San Diego,073,3302833,750122,750659,52629,803288,5155
2022-03-27,San Francisco,075,870044,124554,124619,8203,132822,839
2022-03-27,San Joaquin,077,732212,166563,166238,9880,176118,2196
2022-03-27,San Luis Obispo,079,281455,52406,52430,3729,56159,470
2022-03-27,San Mateo,081,765935,121583,120324,6913,127237,686
2022-03-27,Santa Barbara,083,443738,85648,85434,4688,90122,675
2022-03-27,Santa Clara,085,1922200,314682,311822,12303,324125,2257
2022-03-27,Santa Cruz,087,273765,47717,47321,2083,49404,259
2022-03-27,Shasta,089,179085,30530,30550,6082,36632,527
2022-03-27,Sierra,091,2930,271,273,48,321,4
2022-03-27,Siskiyou,093,43540,4429,4436,2715,7151,80
2022-03-27,Solano,095,438530,81426,81691,5548,87239,441
2022-03-27,Sonoma,097,501317,83371,83088,2596,85684,485
2022-03-27,Stanislaus,099,539301,117488,117778,17798,135576,1562
2022-03-27,Sutter,101,95872,20454,20545,2070,22615,221
2022-03-27,Tehama,103,63373,12039,12040,2567,14607,200
2022-03-27,Trinity,105,12862,1183,1173,287,1460,20
2022-03-27,Tulare,107,460477,106228,104582,27494,132076,1404
2022-03-27,Tuolumne,109,53932,12669,12628,559,13187,180
2022-03-27,Ventura,111,848112,173006,172831,9376,182207,1455
2022-03-27,Yolo,113,214977,37011,36232,2901,39133,312
2022-03-27,Yuba,115,75493,15820,15821,1186,17007,117
2022-03-26,Alameda,001,1643700,256010,254691,13811,268502,1803
2022-03-26,Alpine,003,1148,124,124,1,125,0
2022-03-26,Amador,005,37829,8521,8476,640,9116,86
2022-03-26,Butte,007,227075,33156,32929,7000,39929,391
2022-03-26,Calaveras,009,45235,7249,7240,347,7587,120
2022-03-26,Colusa,011,21464,3445,3445,1046,4491,21
2022-03-26,Contra Costa,013,1133247,191824,187990,13365,201355,1285
2022-03-26,Del Norte,015,27424,5798,5831,183,6014,50
2022-03-26,El Dorado,017,186661,26671,26674,3183,29857,200
2022-03-26,Fresno,019,978130,233740,229799,24191,253990,2710
2022-03-26,Glenn,021,27897,4992,4978,1601,6579,47
2022-03-26,Humboldt,023,135768,16854,16911,2942,19853,139
2022-03-26,Imperial,025,180216,55312,55230,10513,65743,913
2022-03-26,Inyo,027,18085,4066,4060,468,4528,56
2022-03-26,Kern,029,883053,191668,191288,45717,237005,2201
2022-03-26,Kings,031,150075,51424,51397,3514,54911,444
2022-03-26,Lake,033,64148,10691,10659,881,11540,136
2022-03-26,Lassen,035,31185,8953,8944,874,9818,63
2022-03-26,Los Angeles,037,10098052,2708133,2698028,122629,2820657,31291
2022-03-26,Madera,039,155013,37221,37321,6013,43334,354
2022-03-26,Marin,041,260295,33458,33317,2206,35523,287
2022-03-26,Mariposa,043,17540,2395,2386,200,2586,23
2022-03-26,Mendocino,045,87422,13047,13038,3008,16046,118
2022-03-26,Merced,047,269075,62500,62083,8719,70802,805
2022-03-26,Modoc,049,8938,733,736,248,984,7
2022-03-26,Mono,051,14174,2968,2966,122,3088,5
2022-03-26,Monterey,053,433212,79290,78688,13610,92298,724
2022-03-26,Napa,055,140530,25717,25701,936,26637,139
2022-03-26,Nevada,057,99092,15929,15960,1190,17150,123
2022-03-26,Orange,059,3164182,546171,545294,41300,586594,6853
2022-03-26,Placer,061,380077,62688,62634,7312,69946,613
2022-03-26,Plumas,063,18699,2968,2758,358,3116,13
2022-03-26,Riverside,065,2383286,590770,590060,27681,617741,6397
2022-03-26,Sacramento,067,1510023,280515,275529,26467,301996,2935
2022-03-26,San Benito,069,59416,12959,12885,514,13399,97
2022-03-26,San Bernardino,071,2135413,573645,560742,24876,585618,6840
2022-03-26,San Diego,073,3302833,749998,750170,52622,802792,5146
2022-03-26,San Francisco,075,870044,124447,124265,8197,132462,839
2022-03-26,San Joaquin,077,732212,166542,166079,9879,175958,2195
2022-03-26,San Luis Obispo,079,281455,52400,52369,3729,56098,469
2022-03-26,San Mateo,081,765935,121524,120165,6905,127070,684
2022-03-26,Santa Barbara,083,443738,85628,85477,4686,90163,674
2022-03-26,Santa Clara,085,1922200,314524,311189,12296,323485,2250
2022-03-26,Santa Cruz,087,273765,47706,47329,2083,49412,259
2022-03-26,Shasta,089,179085,30529,30542,6081,36623,527
2022-03-26,Sierra,091,2930,271,273,48,321,4
2022-03-26,Siskiyou,093,43540,4428,4433,2715,7148,80
2022-03-26,Solano,095,438530,81417,81659,5548,87207,441
2022-03-26,Sonoma,097,501317,83341,83113,2591,85704,485
2022-03-26,Stanislaus,099,539301,117481,117962,17797,135759,1565
2022-03-26,Sutter,101,95872,20452,20536,2070,22606,221
2022-03-26,Tehama,103,63373,12039,12036,2566,14602,195
2022-03-26,Trinity,105,12862,1183,1174,287,1461,20
2022-03-26,Tulare,107,460477,106220,104538,27493,132031,1400
2022-03-26,Tuolumne,109,53932,12667,12628,559,13187,180
2022-03-26,Ventura,111,848112,172965,172690,9372,182062,1455
2022-03-26,Yolo,113,214977,37002,36234,2901,39135,311
2022-03-26,Yuba,115,75493,15819,15807,1186,16993,117
2022-03-25,Alameda,001,1643700,255947,254691,13808,268499,1803
2022-03-25,Alpine,003,1148,124,124,1,125,0
2022-03-25,Amador,005,37829,8520,8476,640,9116,86
2022-03-25,Butte,007,227075,33151,32929,7000,39929,391
2022-03-25,Calaveras,009,45235,7248,7240,347,7587,120
2022-03-25,Colusa,011,21464,3445,3445,1046,4491,21
2022-03-25,Contra Costa,013,1133247,191776,187990,13362,201352,1285
2022-03-25,Del Norte,015,27424,5798,5831,183,6014,50
2022-03-25,El Dorado,017,186661,26667,26674,3183,29857,200
2022-03-25,Fresno,019,978130,233711,229799,24183,253982,2710
2022-03-25,Glenn,021,27897,4992,4978,1601,6579,47
2022-03-25,Humboldt,023,135768,16854,16911,2942,19853,139
2022-03-25,Imperial,025,180216,55307,55230,10512,65742,913
2022-03-25,Inyo,027,18085,4065,4060,468,4528,56
2022-03-25,Kern,029,883053,191658,191288,45716,237004,2201
2022-03-25,Kings,031,150075,51423,51397,3514,54911,444
2022-03-25,Lake,033,64148,10691,10659,881,11540,136
2022-03-25,Lassen,035,31185,8952,8944,874,9818,63
2022-03-25,Los Angeles,037,10098052,2707709,2698028,122597,2820625,31291
2022-03-25,Madera,039,155013,37220,37321,6012,43333,354
2022-03-25,Marin,041,260295,33443,33317,2197,35514,287
2022-03-25,Mariposa,043,17540,2395,2386,200,2586,23
2022-03-25,Mendocino,045,87422,13047,13038,3008,16046,118
2022-03-25,Merced,047,269075,62494,62083,8718,70801,805
2022-03-25,Modoc,049,8938,733,736,248,984,7
2022-03-25,Mono,051,14174,2967,2966,122,3088,5
2022-03-25,Monterey,053,433212,79279,78688,13607,92295,724
2022-03-25,Napa,055,140530,25710,25701,936,26637,139
2022-03-25,Nevada,057,99092,15928,15960,1190,17150,123
2022-03-25,Orange,059,3164182,546097,545294,41284,586578,6853
2022-03-25,Placer,061,380077,62682,62634,7309,69943,613
2022-03-25,Plumas,063,18699,2967,2758,358,3116,13
2022-03-25,Riverside,065,2383286,590710,590060,27670,617730,6397
2022-03-25,Sacramento,067,1510023,280472,275529,26466,301995,2935
2022-03-25,San Benito,069,59416,12959,12885,514,13399,97
2022-03-25,San Bernardino,071,2135413,573605,560742,24873,585615,6840
2022-03-25,San Diego,073,3302833,749875,750170,52611,802781,5146
2022-03-25,San Francisco,075,870044,124366,124265,8184,132449,839
2022-03-25,San Joaquin,077,732212,166528,166079,9876,175955,2195
2022-03-25,San Luis Obispo,079,281455,52397,52369,3728,56097,469
2022-03-25,San Mateo,081,765935,121472,120165,6905,127070,684
2022-03-25,Santa Barbara,083,443738,85613,85477,4684,90161,674
2022-03-25,Santa Clara,085,1922200,314373,311189,12291,323480,2250
2022-03-25,Santa Cruz,087,273765,47698,47329,2083,49412,259
2022-03-25,Shasta,089,179085,30525,30542,6080,36622,527
2022-03-25,Sierra,091,2930,271,273,48,321,4
2022-03-25,Siskiyou,093,43540,4426,4433,2713,7146,80
2022-03-25,Solano,095,438530,81403,81659,5546,87205,441
2022-03-25,Sonoma,097,501317,83304,83113,2591,85704,485
2022-03-25,Stanislaus,099,539301,117467,117962,17796,135758,1565
2022-03-25,Sutter,101,95872,20447,20536,2070,22606,221
2022-03-25,Tehama,103,63373,12037,12036,2566,14602,195
2022-03-25,Trinity,105,12862,1183,1174,287,1461,20
2022-03-25,Tulare,107,460477,106216,104538,27493,132031,1400
2022-03-25,Tuolumne,109,53932,12666,12628,559,13187,180
2022-03-25,Ventura,111,848112,172927,172690,9372,182062,1455
2022-03-25,Yolo,113,214977,36990,36234,2900,39134,311
2022-03-25,Yuba,115,75493,15814,15807,1185,16992,117
2022-03-24,Alameda,001,1643700,255833,254691,13792,268483,1803
2022-03-24,Alpine,003,1148,124,124,1,125,0
2022-03-24,Amador,005,37829,8520,8476,640,9116,86
2022-03-24,Butte,007,227075,33145,32929,7000,39929,391
2022-03-24,Calaveras,009,45235,7246,7240,347,7587,120
2022-03-24,Colusa,011,21464,3445,3445,1046,4491,21
2022-03-24,Contra Costa,013,1133247,191697,187990,13359,201349,1285
2022-03-24,Del Norte,015,27424,5794,5831,183,6014,50
2022-03-24,El Dorado,017,186661,26657,26674,3183,29857,200
2022-03-24,Fresno,019,978130,233669,229799,24173,253972,2710
2022-03-24,Glenn,021,27897,4991,4978,1601,6579,47
2022-03-24,Humboldt,023,135768,16849,16911,2940,19851,139
2022-03-24,Imperial,025,180216,55300,55230,10512,65742,913
2022-03-24,Inyo,027,18085,4064,4060,468,4528,56
2022-03-24,Kern,029,883053,191648,191288,45714,237002,2201
2022-03-24,Kings,031,150075,51414,51397,3512,54909,444
2022-03-24,Lake,033,64148,10690,10659,881,11540,136
2022-03-24,Lassen,035,31185,8951,8944,874,9818,63
2022-03-24,Los Angeles,037,10098052,2707136,2698028,122553,2820581,31291
2022-03-24,Madera,039,155013,37218,37321,6010,43331,354
2022-03-24,Marin,041,260295,33422,33317,2188,35505,287
2022-03-24,Mariposa,043,17540,2395,2386,200,2586,23
2022-03-24,Mendocino,045,87422,13041,13038,3005,16043,118
2022-03-24,Merced,047,269075,62487,62083,8717,70800,805
2022-03-24,Modoc,049,8938,733,736,248,984,7
2022-03-24,Mono,051,14174,2967,2966,122,3088,5
2022-03-24,Monterey,053,433212,79253,78688,13593,92281,724
2022-03-24,Napa,055,140530,25701,25701,936,26637,139
2022-03-24,Nevada,057,99092,15924,15960,1189,17149,123
2022-03-24,Orange,059,3164182,545995,545294,41269,586563,6853
2022-03-24,Placer,061,380077,62662,62634,7308,69942,613
2022-03-24,Plumas,063,18699,2967,2758,358,3116,13
2022-03-24,Riverside,065,2383286,590633,590060,27662,617722,6397
2022-03-24,Sacramento,067,1510023,280402,275529,26462,301991,2935
2022-03-24,San Benito,069,59416,12958,12885,513,13398,97
2022-03-24,San Bernardino,071,2135413,573522,560742,24869,585611,6840
2022-03-24,San Diego,073,3302833,749668,750170,52598,802768,5146
2022-03-24,San Francisco,075,870044,124284,124265,8178,132443,839
2022-03-24,San Joaquin,077,732212,166501,166079,9876,175955,2195
2022-03-24,San Luis Obispo,079,281455,52381,52369,3727,56096,469
2022-03-24,San Mateo,081,765935,121423,120165,6902,127067,684
2022-03-24,Santa Barbara,083,443738,85598,85477,4681,90158,674
2022-03-24,Santa Clara,085,1922200,314225,311189,12275,323464,2250
2022-03-24,Santa Cruz,087,273765,47680,47329,2082,49411,259
2022-03-24,Shasta,089,179085,30517,30542,6080,36622,527
2022-03-24,Sierra,091,2930,271,273,48,321,4
2022-03-24,Siskiyou,093,43540,4424,4433,2713,7146,80
2022-03-24,Solano,095,438530,81384,81659,5545,87204,441
2022-03-24,Sonoma,097,501317,83269,83113,2589,85702,485
2022-03-24,Stanislaus,099,539301,117459,117962,17793,135755,1565
2022-03-24,Sutter,101,95872,20442,20536,2070,22606,221
2022-03-24,Tehama,103,63373,12035,12036,2565,14601,195
2022-03-24,Trinity,105,12862,1183,1174,287,1461,20
2022-03-24,Tulare,107,460477,106205,104538,27488,132026,1400
2022-03-24,Tuolumne,109,53932,12664,12628,559,13187,180
2022-03-24,Ventura,111,848112,172884,172690,9369,182059,1455
2022-03-24,Yolo,113,214977,36984,36234,2896,39130,311
2022-03-24,Yuba,115,75493,15810,15807,1183,16990,117
2022-03-23,Alameda,001,1643700,255700,254559,13781,268340,1802
2022-03-23,Alpine,003,1148,124,124,1,125,0
2022-03-23,Amador,005,37829,8520,8475,640,9115,86
2022-03-23,Butte,007,227075,33130,32920,6999,39919,387
2022-03-23,Calaveras,009,45235,7241,7237,347,7584,120
2022-03-23,Colusa,011,21464,3444,3444,1046,4490,21
2022-03-23,Contra Costa,013,1133247,191599,187898,13348,201246,1279
2022-03-23,Del Norte,015,27424,5792,5830,183,6013,50
2022-03-23,El Dorado,017,186661,26651,26670,3183,29853,200
2022-03-23,Fresno,019,978130,233633,229656,24160,253816,2710
2022-03-23,Glenn,021,27897,4991,4975,1601,6576,47
2022-03-23,Humboldt,023,135768,16848,16908,2939,19847,139
2022-03-23,Imperial,025,180216,55294,55211,10511,65722,909
2022-03-23,Inyo,027,18085,4064,4060,468,4528,56
2022-03-23,Kern,029,883053,191631,191241,45709,236950,2196
2022-03-23,Kings,031,150075,51403,51384,3512,54896,442
2022-03-23,Lake,033,64148,10686,10658,880,11538,135
2022-03-23,Lassen,035,31185,8950,8944,873,9817,63
2022-03-23,Los Angeles,037,10098052,2706457,2697227,122524,2819751,31267
2022-03-23,Madera,039,155013,37213,37317,6008,43325,354
2022-03-23,Marin,041,260295,33396,33274,2183,35457,287
2022-03-23,Mariposa,043,17540,2393,2382,199,2581,11
2022-03-23,Mendocino,045,87422,13037,13033,3004,16037,118
2022-03-23,Merced,047,269075,62476,62056,8714,70770,805
2022-03-23,Modoc,049,8938,733,736,248,984,7
2022-03-23,Mono,051,14174,2967,2966,122,3088,5
2022-03-23,Monterey,053,433212,79236,78655,13569,92224,724
2022-03-23,Napa,055,140530,25688,25691,934,26625,139
2022-03-23,Nevada,057,99092,15922,15958,1189,17147,123
2022-03-23,Orange,059,3164182,545863,545158,41256,586414,6852
2022-03-23,Placer,061,380077,62643,62622,7306,69928,613
2022-03-23,Plumas,063,18699,2967,2747,358,3105,13
2022-03-23,Riverside,065,2383286,590560,589947,27657,617604,6388
2022-03-23,Sacramento,067,1510023,280339,275398,26454,301852,2934
2022-03-23,San Benito,069,59416,12957,12884,513,13397,97
2022-03-23,San Bernardino,071,2135413,573449,560550,24865,585415,6828
2022-03-23,San Diego,073,3302833,749475,749871,52575,802446,5143
2022-03-23,San Francisco,075,870044,124171,124110,8171,132281,838
2022-03-23,San Joaquin,077,732212,166464,166041,9869,175910,2187
2022-03-23,San Luis Obispo,079,281455,52364,52344,3722,56066,469
2022-03-23,San Mateo,081,765935,121338,120080,6892,126972,685
2022-03-23,Santa Barbara,083,443738,85581,85464,4680,90144,673
2022-03-23,Santa Clara,085,1922200,314059,310956,12263,323219,2250
2022-03-23,Santa Cruz,087,273765,47661,47314,2078,49392,259
2022-03-23,Shasta,089,179085,30513,30524,6079,36603,526
2022-03-23,Sierra,091,2930,271,273,48,321,4
2022-03-23,Siskiyou,093,43540,4424,4433,2713,7146,80
2022-03-23,Solano,095,438530,81350,81615,5544,87159,441
2022-03-23,Sonoma,097,501317,83236,83074,2586,85660,482
2022-03-23,Stanislaus,099,539301,117442,118041,17790,135831,1568
2022-03-23,Sutter,101,95872,20439,20532,2070,22602,218
2022-03-23,Tehama,103,63373,12032,12035,2565,14600,195
2022-03-23,Trinity,105,12862,1183,1174,287,1461,20
2022-03-23,Tulare,107,460477,106188,104489,27483,131972,1394
2022-03-23,Tuolumne,109,53932,12663,12629,559,13188,180
2022-03-23,Ventura,111,848112,172836,172647,9367,182014,1455
2022-03-23,Yolo,113,214977,36965,36197,2894,39091,308
2022-03-23,Yuba,115,75493,15803,15801,1182,16983,117
2022-03-22,Alameda,001,1643700,255576,254467,13487,267954,1802
2022-03-22,Alpine,003,1148,124,122,1,123,0
2022-03-22,Amador,005,37829,8519,8462,639,9101,86
2022-03-22,Butte,007,227075,33120,32907,6995,39902,387
2022-03-22,Calaveras,009,45235,7239,7237,347,7584,120
2022-03-22,Colusa,011,21464,3443,3445,1046,4491,21
2022-03-22,Contra Costa,013,1133247,191522,187813,13327,201140,1279
2022-03-22,Del Norte,015,27424,5786,5824,183,6007,50
2022-03-22,El Dorado,017,186661,26644,26661,3183,29844,200
2022-03-22,Fresno,019,978130,233584,229551,24151,253702,2708
2022-03-22,Glenn,021,27897,4989,4971,1601,6572,47
2022-03-22,Humboldt,023,135768,16845,16911,2939,19850,139
2022-03-22,Imperial,025,180216,55282,55170,10508,65678,908
2022-03-22,Inyo,027,18085,4064,4060,468,4528,56
2022-03-22,Kern,029,883053,191608,191213,45701,236914,2195
2022-03-22,Kings,031,150075,51392,51369,3511,54880,442
2022-03-22,Lake,033,64148,10684,10657,879,11536,135
2022-03-22,Lassen,035,31185,8950,8940,873,9813,63
2022-03-22,Los Angeles,037,10098052,2705791,2696746,122477,2819223,31250
2022-03-22,Madera,039,155013,37210,37304,6005,43309,354
2022-03-22,Marin,041,260295,33371,33253,2179,35432,287
2022-03-22,Mariposa,043,17540,2391,2382,199,2581,6
2022-03-22,Mendocino,045,87422,13032,13030,3002,16032,118
2022-03-22,Merced,047,269075,62465,62056,8710,70766,805
2022-03-22,Modoc,049,8938,733,735,248,983,7
2022-03-22,Mono,051,14174,2967,2963,122,3085,5
2022-03-22,Monterey,053,433212,79219,78614,13559,92173,724
2022-03-22,Napa,055,140530,25678,25688,933,26621,139
2022-03-22,Nevada,057,99092,15914,15950,1189,17139,123
2022-03-22,Orange,059,3164182,545721,545075,41239,586314,6843
2022-03-22,Placer,061,380077,62630,62604,7304,69908,610
2022-03-22,Plumas,063,18699,2966,2744,358,3102,13
2022-03-22,Riverside,065,2383286,590485,589816,27654,617470,6383
2022-03-22,Sacramento,067,1510023,280263,275374,26443,301817,2927
2022-03-22,San Benito,069,59416,12956,12884,512,13396,97
2022-03-22,San Bernardino,071,2135413,573367,560371,24845,585216,6811
2022-03-22,San Diego,073,3302833,749277,749647,52555,802202,5141
2022-03-22,San Francisco,075,870044,124064,123998,8165,132163,838
2022-03-22,San Joaquin,077,732212,166436,165992,9866,175858,2187
2022-03-22,San Luis Obispo,079,281455,52356,52257,3722,55979,465
2022-03-22,San Mateo,081,765935,121265,119975,6889,126864,686
2022-03-22,Santa Barbara,083,443738,85564,85457,4679,90136,672
2022-03-22,Santa Clara,085,1922200,313881,310787,12252,323039,2249
2022-03-22,Santa Cruz,087,273765,47641,47287,2077,49364,259
2022-03-22,Shasta,089,179085,30507,30528,6079,36607,525
2022-03-22,Sierra,091,2930,271,273,48,321,4
2022-03-22,Siskiyou,093,43540,4424,4429,2712,7141,80
2022-03-22,Solano,095,438530,81327,81587,5541,87128,440
2022-03-22,Sonoma,097,501317,83207,83042,2583,85625,482
2022-03-22,Stanislaus,099,539301,117425,118025,17786,135811,1568
2022-03-22,Sutter,101,95872,20438,20525,2067,22592,218
2022-03-22,Tehama,103,63373,12030,12034,2565,14599,162
2022-03-22,Trinity,105,12862,1183,1174,287,1461,20
2022-03-22,Tulare,107,460477,106177,104431,27475,131906,1391
2022-03-22,Tuolumne,109,53932,12663,12628,559,13187,180
2022-03-22,Ventura,111,848112,172787,172590,9365,181955,1455
2022-03-22,Yolo,113,214977,36945,36184,2893,39077,308
2022-03-22,Yuba,115,75493,15800,15795,1181,16976,117
2022-03-21,Alameda,001,1643700,255351,254354,13479,267833,1799
2022-03-21,Alpine,003,1148,124,122,1,123,0
2022-03-21,Amador,005,37829,8516,8461,638,9099,85
2022-03-21,Butte,007,227075,33108,32895,6992,39887,385
2022-03-21,Calaveras,009,45235,7238,7237,347,7584,119
2022-03-21,Colusa,011,21464,3443,3445,1046,4491,21
2022-03-21,Contra Costa,013,1133247,191458,187509,13311,200820,1276
2022-03-21,Del Norte,015,27424,5785,5824,183,6007,50
2022-03-21,El Dorado,017,186661,26633,26610,3183,29793,199
2022-03-21,Fresno,019,978130,233536,229374,24142,253516,2707
2022-03-21,Glenn,021,27897,4987,4972,1596,6568,46
2022-03-21,Humboldt,023,135768,16835,16912,2926,19838,139
2022-03-21,Imperial,025,180216,55269,55133,10507,65640,908
2022-03-21,Inyo,027,18085,4063,4060,468,4528,56
2022-03-21,Kern,029,883053,191575,191184,45695,236879,2187
2022-03-21,Kings,031,150075,51378,51366,3509,54875,441
2022-03-21,Lake,033,64148,10682,10655,879,11534,135
2022-03-21,Lassen,035,31185,8949,8939,873,9812,63
2022-03-21,Los Angeles,037,10098052,2704933,2694711,122429,2817140,31218
2022-03-21,Madera,039,155013,37204,37288,6002,43290,354
2022-03-21,Marin,041,260295,33327,33242,2174,35416,287
2022-03-21,Mariposa,043,17540,2390,2383,198,2581,6
2022-03-21,Mendocino,045,87422,13024,13028,3000,16028,118
2022-03-21,Merced,047,269075,62452,62048,8705,70753,803
2022-03-21,Modoc,049,8938,731,734,248,982,7
2022-03-21,Mono,051,14174,2967,2962,122,3084,5
2022-03-21,Monterey,053,433212,79170,78572,13546,92118,724
2022-03-21,Napa,055,140530,25670,25684,931,26615,138
2022-03-21,Nevada,057,99092,15910,15963,1188,17151,123
2022-03-21,Orange,059,3164182,545568,544943,41222,586165,6841
2022-03-21,Placer,061,380077,62611,62550,7303,69853,610
2022-03-21,Plumas,063,18699,2966,2744,358,3102,13
2022-03-21,Riverside,065,2383286,590404,589707,27650,617357,6376
2022-03-21,Sacramento,067,1510023,280173,275334,26428,301762,2925
2022-03-21,San Benito,069,59416,12950,12872,512,13384,97
2022-03-21,San Bernardino,071,2135413,573279,560210,24832,585042,6807
2022-03-21,San Diego,073,3302833,749053,748833,52535,801368,5138
2022-03-21,San Francisco,075,870044,123897,123912,8156,132068,835
2022-03-21,San Joaquin,077,732212,166409,165939,9863,175802,2185
2022-03-21,San Luis Obispo,079,281455,52331,52219,3717,55936,463
2022-03-21,San Mateo,081,765935,121106,119899,6887,126786,684
2022-03-21,Santa Barbara,083,443738,85549,85416,4677,90093,672
2022-03-21,Santa Clara,085,1922200,313620,310509,12249,322758,2245
2022-03-21,Santa Cruz,087,273765,47605,47267,2076,49343,259
2022-03-21,Shasta,089,179085,30501,30523,6077,36600,525
2022-03-21,Sierra,091,2930,271,273,48,321,4
2022-03-21,Siskiyou,093,43540,4424,4426,2712,7138,80
2022-03-21,Solano,095,438530,81299,81399,5540,86939,441
2022-03-21,Sonoma,097,501317,83165,82979,2581,85560,482
2022-03-21,Stanislaus,099,539301,117392,118144,17784,135928,1571
2022-03-21,Sutter,101,95872,20435,20523,2055,22578,218
2022-03-21,Tehama,103,63373,12026,12030,2565,14595,160
2022-03-21,Trinity,105,12862,1183,1174,287,1461,20
2022-03-21,Tulare,107,460477,106157,104350,27470,131820,1389
2022-03-21,Tuolumne,109,53932,12663,12620,559,13179,180
2022-03-21,Ventura,111,848112,172717,172537,9361,181898,1452
2022-03-21,Yolo,113,214977,36929,36141,2891,39032,307
2022-03-21,Yuba,115,75493,15797,15790,1180,16970,117
2022-03-20,Alameda,001,1643700,255214,254293,13469,267762,1801
2022-03-20,Alpine,003,1148,122,122,1,123,0
2022-03-20,Amador,005,37829,8513,8460,638,9098,85
2022-03-20,Butte,007,227075,33093,32892,6988,39880,385
2022-03-20,Calaveras,009,45235,7238,7233,344,7577,119
2022-03-20,Colusa,011,21464,3443,3446,1046,4492,21
2022-03-20,Contra Costa,013,1133247,191355,187467,13301,200768,1276
2022-03-20,Del Norte,015,27424,5783,5821,183,6004,50
2022-03-20,El Dorado,017,186661,26624,26608,3183,29791,199
2022-03-20,Fresno,019,978130,233458,229297,24131,253428,2707
2022-03-20,Glenn,021,27897,4986,4972,1596,6568,46
2022-03-20,Humboldt,023,135768,16833,16913,2924,19837,139
2022-03-20,Imperial,025,180216,55258,55133,10506,65639,908
2022-03-20,Inyo,027,18085,4063,4060,468,4528,56
2022-03-20,Kern,029,883053,191533,191170,45690,236860,2187
2022-03-20,Kings,031,150075,51367,51360,3509,54869,441
2022-03-20,Lake,033,64148,10678,10652,879,11531,135
2022-03-20,Lassen,035,31185,8947,8938,873,9811,63
2022-03-20,Los Angeles,037,10098052,2704141,2694698,122386,2817084,31219
2022-03-20,Madera,039,155013,37199,37284,5999,43283,354
2022-03-20,Marin,041,260295,33311,33232,2173,35405,275
2022-03-20,Mariposa,043,17540,2390,2383,198,2581,6
2022-03-20,Mendocino,045,87422,13017,13027,2995,16022,118
2022-03-20,Merced,047,269075,62440,62041,8701,70742,803
2022-03-20,Modoc,049,8938,731,734,248,982,7
2022-03-20,Mono,051,14174,2965,2962,122,3084,5
2022-03-20,Monterey,053,433212,79137,78566,13535,92101,723
2022-03-20,Napa,055,140530,25658,25682,930,26612,138
2022-03-20,Nevada,057,99092,15906,15964,1188,17152,123
2022-03-20,Orange,059,3164182,545447,544862,41204,586066,6841
2022-03-20,Placer,061,380077,62590,62525,7303,69828,610
2022-03-20,Plumas,063,18699,2966,2744,358,3102,13
2022-03-20,Riverside,065,2383286,590307,589657,27646,617303,6376
2022-03-20,Sacramento,067,1510023,280090,275317,26416,301733,2927
2022-03-20,San Benito,069,59416,12950,12869,511,13380,97
2022-03-20,San Bernardino,071,2135413,573198,560220,24823,585043,6805
2022-03-20,San Diego,073,3302833,748817,748833,52501,801334,5138
2022-03-20,San Francisco,075,870044,123748,123858,8144,132002,835
2022-03-20,San Joaquin,077,732212,166376,165927,9858,175785,2185
2022-03-20,San Luis Obispo,079,281455,52307,52217,3714,55931,463
2022-03-20,San Mateo,081,765935,121046,119901,6881,126782,684
2022-03-20,Santa Barbara,083,443738,85524,85412,4676,90088,672
2022-03-20,Santa Clara,085,1922200,313412,310412,12241,322653,2243
2022-03-20,Santa Cruz,087,273765,47578,47265,2075,49340,259
2022-03-20,Shasta,089,179085,30491,30522,6076,36598,525
2022-03-20,Sierra,091,2930,271,273,48,321,4
2022-03-20,Siskiyou,093,43540,4423,4426,2712,7138,80
2022-03-20,Solano,095,438530,81269,81393,5538,86931,441
2022-03-20,Sonoma,097,501317,83122,82965,2580,85545,481
2022-03-20,Stanislaus,099,539301,117367,118146,17781,135927,1572
2022-03-20,Sutter,101,95872,20428,20519,2047,22566,218
2022-03-20,Tehama,103,63373,12024,12030,2565,14595,160
2022-03-20,Trinity,105,12862,1183,1174,287,1461,20
2022-03-20,Tulare,107,460477,106136,104353,27458,131811,1389
2022-03-20,Tuolumne,109,53932,12658,12617,559,13176,180
2022-03-20,Ventura,111,848112,172667,172514,9356,181870,1451
2022-03-20,Yolo,113,214977,36910,36135,2890,39025,307
2022-03-20,Yuba,115,75493,15788,15787,1178,16965,117
2022-03-19,Alameda,001,1643700,255138,253936,13467,267403,1797
2022-03-19,Alpine,003,1148,122,122,1,123,0
2022-03-19,Amador,005,37829,8510,8456,638,9094,85
2022-03-19,Butte,007,227075,33085,32856,6988,39844,385
2022-03-19,Calaveras,009,45235,7238,7229,344,7573,119
2022-03-19,Colusa,011,21464,3441,3445,1046,4491,21
2022-03-19,Contra Costa,013,1133247,191319,187225,13300,200525,1276
2022-03-19,Del Norte,015,27424,5780,5815,183,5998,48
2022-03-19,El Dorado,017,186661,26620,26618,3183,29801,199
2022-03-19,Fresno,019,978130,233435,228965,24130,253095,2694
2022-03-19,Glenn,021,27897,4986,4971,1596,6567,44
2022-03-19,Humboldt,023,135768,16827,16901,2924,19825,138
2022-03-19,Imperial,025,180216,55257,55038,10505,65543,898
2022-03-19,Inyo,027,18085,4063,4061,468,4529,56
2022-03-19,Kern,029,883053,191518,190943,45682,236625,2184
2022-03-19,Kings,031,150075,51362,51334,3509,54843,441
2022-03-19,Lake,033,64148,10678,10641,879,11520,135
2022-03-19,Lassen,035,31185,8947,8925,873,9798,63
2022-03-19,Los Angeles,037,10098052,2703764,2686759,122352,2809111,31133
2022-03-19,Madera,039,155013,37199,37273,5999,43272,354
2022-03-19,Marin,041,260295,33292,33163,2169,35332,272
2022-03-19,Mariposa,043,17540,2389,2378,198,2576,6
2022-03-19,Mendocino,045,87422,13017,13012,2995,16007,117
2022-03-19,Merced,047,269075,62435,61985,8699,70684,800
2022-03-19,Modoc,049,8938,731,734,248,982,7
2022-03-19,Mono,051,14174,2965,2961,122,3083,5
2022-03-19,Monterey,053,433212,79126,78483,13528,92011,720
2022-03-19,Napa,055,140530,25655,25654,930,26584,138
2022-03-19,Nevada,057,99092,15904,15960,1188,17148,123
2022-03-19,Orange,059,3164182,545376,543907,41188,585095,6817
2022-03-19,Placer,061,380077,62576,62483,7303,69786,605
2022-03-19,Plumas,063,18699,2966,2724,358,3082,13
2022-03-19,Riverside,065,2383286,590257,589017,27639,616656,6359
2022-03-19,Sacramento,067,1510023,280048,274855,26412,301267,2913
2022-03-19,San Benito,069,59416,12949,12859,511,13370,97
2022-03-19,San Bernardino,071,2135413,573152,559935,24821,584756,6778
2022-03-19,San Diego,073,3302833,748717,747344,52487,799831,5133
2022-03-19,San Francisco,075,870044,123678,123587,8142,131729,833
2022-03-19,San Joaquin,077,732212,166351,165765,9855,175620,2181
2022-03-19,San Luis Obispo,079,281455,52301,52174,3714,55888,463
2022-03-19,San Mateo,081,765935,121009,119782,6880,126662,667
2022-03-19,Santa Barbara,083,443738,85509,85336,4675,90011,671
2022-03-19,Santa Clara,085,1922200,313290,309918,12232,322150,2225
2022-03-19,Santa Cruz,087,273765,47570,47203,2071,49274,256
2022-03-19,Shasta,089,179085,30487,30495,6076,36571,525
2022-03-19,Sierra,091,2930,271,273,48,321,4
2022-03-19,Siskiyou,093,43540,4422,4422,2712,7134,76
2022-03-19,Solano,095,438530,81260,81340,5535,86875,441
2022-03-19,Sonoma,097,501317,83105,82838,2577,85415,472
2022-03-19,Stanislaus,099,539301,117357,118138,17779,135917,1568
2022-03-19,Sutter,101,95872,20425,20503,2047,22550,218
2022-03-19,Tehama,103,63373,12024,12007,2565,14572,160
2022-03-19,Trinity,105,12862,1183,1173,287,1460,20
2022-03-19,Tulare,107,460477,106127,104290,27453,131743,1384
2022-03-19,Tuolumne,109,53932,12657,12617,559,13176,180
2022-03-19,Ventura,111,848112,172636,172380,9355,181735,1451
2022-03-19,Yolo,113,214977,36901,36086,2890,38976,306
2022-03-19,Yuba,115,75493,15784,15768,1177,16945,117
2022-03-18,Alameda,001,1643700,255077,253936,13464,267400,1797
2022-03-18,Alpine,003,1148,122,122,1,123,0
2022-03-18,Amador,005,37829,8510,8456,638,9094,85
2022-03-18,Butte,007,227075,33080,32856,6985,39841,385
2022-03-18,Calaveras,009,45235,7238,7229,344,7573,119
2022-03-18,Colusa,011,21464,3441,3445,1046,4491,21
2022-03-18,Contra Costa,013,1133247,191287,187225,13298,200523,1276
2022-03-18,Del Norte,015,27424,5778,5815,183,5998,48
2022-03-18,El Dorado,017,186661,26615,26618,3181,29799,199
2022-03-18,Fresno,019,978130,233402,228965,24130,253095,2694
2022-03-18,Glenn,021,27897,4985,4971,1596,6567,44
2022-03-18,Humboldt,023,135768,16824,16901,2923,19824,138
2022-03-18,Imperial,025,180216,55255,55038,10505,65543,898
2022-03-18,Inyo,027,18085,4063,4061,468,4529,56
2022-03-18,Kern,029,883053,191507,190943,45679,236622,2184
2022-03-18,Kings,031,150075,51354,51334,3509,54843,441
2022-03-18,Lake,033,64148,10676,10641,878,11519,135
2022-03-18,Lassen,035,31185,8946,8925,873,9798,63
2022-03-18,Los Angeles,037,10098052,2703410,2686759,122326,2809085,31133
2022-03-18,Madera,039,155013,37194,37273,5999,43272,354
2022-03-18,Marin,041,260295,33278,33163,2169,35332,272
2022-03-18,Mariposa,043,17540,2388,2378,198,2576,6
2022-03-18,Mendocino,045,87422,13013,13012,2995,16007,117
2022-03-18,Merced,047,269075,62423,61985,8699,70684,800
2022-03-18,Modoc,049,8938,731,734,248,982,7
2022-03-18,Mono,051,14174,2964,2961,122,3083,5
2022-03-18,Monterey,053,433212,79108,78483,13526,92009,720
2022-03-18,Napa,055,140530,25652,25654,930,26584,138
2022-03-18,Nevada,057,99092,15901,15960,1187,17147,123
2022-03-18,Orange,059,3164182,545309,543907,41179,585086,6817
2022-03-18,Placer,061,380077,62567,62483,7303,69786,605
2022-03-18,Plumas,063,18699,2966,2724,358,3082,13
2022-03-18,Riverside,065,2383286,590197,589017,27635,616652,6359
2022-03-18,Sacramento,067,1510023,280012,274855,26408,301263,2913
2022-03-18,San Benito,069,59416,12947,12859,511,13370,97
2022-03-18,San Bernardino,071,2135413,573114,559935,24819,584754,6778
2022-03-18,San Diego,073,3302833,748609,747344,52472,799816,5133
2022-03-18,San Francisco,075,870044,123598,123587,8137,131724,833
2022-03-18,San Joaquin,077,732212,166336,165765,9850,175615,2181
2022-03-18,San Luis Obispo,079,281455,52294,52174,3714,55888,463
2022-03-18,San Mateo,081,765935,120974,119782,6877,126659,667
2022-03-18,Santa Barbara,083,443738,85499,85336,4674,90010,671
2022-03-18,Santa Clara,085,1922200,313184,309918,12229,322147,2225
2022-03-18,Santa Cruz,087,273765,47558,47203,2070,49273,256
2022-03-18,Shasta,089,179085,30486,30495,6076,36571,525
2022-03-18,Sierra,091,2930,271,273,48,321,4
2022-03-18,Siskiyou,093,43540,4422,4422,2712,7134,76
2022-03-18,Solano,095,438530,81249,81340,5529,86869,441
2022-03-18,Sonoma,097,501317,83084,82838,2576,85414,472
2022-03-18,Stanislaus,099,539301,117344,118138,17779,135917,1568
2022-03-18,Sutter,101,95872,20422,20503,2047,22550,218
2022-03-18,Tehama,103,63373,12023,12007,2565,14572,160
2022-03-18,Trinity,105,12862,1183,1173,287,1460,20
2022-03-18,Tulare,107,460477,106121,104290,27448,131738,1384
2022-03-18,Tuolumne,109,53932,12656,12617,559,13176,180
2022-03-18,Ventura,111,848112,172616,172380,9350,181730,1451
2022-03-18,Yolo,113,214977,36890,36086,2890,38976,306
2022-03-18,Yuba,115,75493,15782,15768,1177,16945,117
2022-03-17,Alameda,001,1643700,254978,253936,13458,267394,1797
2022-03-17,Alpine,003,1148,122,122,1,123,0
2022-03-17,Amador,005,37829,8503,8456,638,9094,85
2022-03-17,Butte,007,227075,33067,32856,6983,39839,385
2022-03-17,Calaveras,009,45235,7235,7229,344,7573,119
2022-03-17,Colusa,011,21464,3441,3445,1046,4491,21
2022-03-17,Contra Costa,013,1133247,191223,187225,13287,200512,1276
2022-03-17,Del Norte,015,27424,5776,5815,183,5998,48
2022-03-17,El Dorado,017,186661,26609,26618,3181,29799,199
2022-03-17,Fresno,019,978130,233353,228965,24127,253092,2694
2022-03-17,Glenn,021,27897,4985,4971,1596,6567,44
2022-03-17,Humboldt,023,135768,16820,16901,2921,19822,138
2022-03-17,Imperial,025,180216,55244,55038,10505,65543,898
2022-03-17,Inyo,027,18085,4063,4061,468,4529,56
2022-03-17,Kern,029,883053,191476,190943,45676,236619,2184
2022-03-17,Kings,031,150075,51351,51334,3508,54842,441
2022-03-17,Lake,033,64148,10673,10641,878,11519,135
2022-03-17,Lassen,035,31185,8944,8925,873,9798,63
2022-03-17,Los Angeles,037,10098052,2702752,2686759,122291,2809050,31133
2022-03-17,Madera,039,155013,37190,37273,5999,43272,354
2022-03-17,Marin,041,260295,33266,33163,2168,35331,272
2022-03-17,Mariposa,043,17540,2388,2378,198,2576,6
2022-03-17,Mendocino,045,87422,13009,13012,2992,16004,117
2022-03-17,Merced,047,269075,62417,61985,8696,70681,800
2022-03-17,Modoc,049,8938,731,734,248,982,7
2022-03-17,Mono,051,14174,2964,2961,121,3082,5
2022-03-17,Monterey,053,433212,79085,78483,13520,92003,720
2022-03-17,Napa,055,140530,25647,25654,930,26584,138
2022-03-17,Nevada,057,99092,15898,15960,1187,17147,123
2022-03-17,Orange,059,3164182,545215,543907,41169,585076,6817
2022-03-17,Placer,061,380077,62551,62483,7301,69784,605
2022-03-17,Plumas,063,18699,2965,2724,358,3082,13
2022-03-17,Riverside,065,2383286,590117,589017,27628,616645,6359
2022-03-17,Sacramento,067,1510023,279946,274855,26402,301257,2913
2022-03-17,San Benito,069,59416,12946,12859,511,13370,97
2022-03-17,San Bernardino,071,2135413,573050,559935,24816,584751,6778
2022-03-17,San Diego,073,3302833,748434,747344,52456,799800,5133
2022-03-17,San Francisco,075,870044,123518,123587,8132,131719,833
2022-03-17,San Joaquin,077,732212,166316,165765,9848,175613,2181
2022-03-17,San Luis Obispo,079,281455,52280,52174,3712,55886,463
2022-03-17,San Mateo,081,765935,120926,119782,6873,126655,667
2022-03-17,Santa Barbara,083,443738,85483,85336,4674,90010,671
2022-03-17,Santa Clara,085,1922200,313063,309918,12225,322143,2225
2022-03-17,Santa Cruz,087,273765,47542,47203,2068,49271,256
2022-03-17,Shasta,089,179085,30482,30495,6074,36569,525
2022-03-17,Sierra,091,2930,271,273,48,321,4
2022-03-17,Siskiyou,093,43540,4422,4422,2712,7134,76
2022-03-17,Solano,095,438530,81220,81340,5525,86865,441
2022-03-17,Sonoma,097,501317,83056,82838,2574,85412,472
2022-03-17,Stanislaus,099,539301,117330,118138,17774,135912,1568
2022-03-17,Sutter,101,95872,20412,20503,2036,22539,218
2022-03-17,Tehama,103,63373,12023,12007,2565,14572,160
2022-03-17,Trinity,105,12862,1183,1173,287,1460,20
2022-03-17,Tulare,107,460477,106105,104290,27438,131728,1384
2022-03-17,Tuolumne,109,53932,12654,12617,558,13175,180
2022-03-17,Ventura,111,848112,172567,172380,9348,181728,1451
2022-03-17,Yolo,113,214977,36876,36086,2890,38976,306
2022-03-17,Yuba,115,75493,15780,15768,1176,16944,117
2022-03-16,Alameda,001,1643700,254878,253792,13455,267247,1794
2022-03-16,Alpine,003,1148,122,122,1,123,0
2022-03-16,Amador,005,37829,8495,8449,638,9087,85
2022-03-16,Butte,007,227075,33056,32837,6978,39815,385
2022-03-16,Calaveras,009,45235,7233,7229,344,7573,120
2022-03-16,Colusa,011,21464,3441,3445,1046,4491,22
2022-03-16,Contra Costa,013,1133247,191165,187100,13276,200376,1266
2022-03-16,Del Norte,015,27424,5775,5811,181,5992,48
2022-03-16,El Dorado,017,186661,26596,26602,3180,29782,199
2022-03-16,Fresno,019,978130,233306,228786,24116,252902,2689
2022-03-16,Glenn,021,27897,4984,4969,1596,6565,44
2022-03-16,Humboldt,023,135768,16817,16893,2921,19814,138
2022-03-16,Imperial,025,180216,55232,55002,10504,65506,897
2022-03-16,Inyo,027,18085,4062,4061,468,4529,56
2022-03-16,Kern,029,883053,191433,190835,45669,236504,2170
2022-03-16,Kings,031,150075,51336,51321,3508,54829,437
2022-03-16,Lake,033,64148,10671,10633,877,11510,133
2022-03-16,Lassen,035,31185,8941,8924,873,9797,62
2022-03-16,Los Angeles,037,10098052,2702121,2685789,122251,2808040,31102
2022-03-16,Madera,039,155013,37180,37262,5998,43260,354
2022-03-16,Marin,041,260295,33245,33136,2166,35302,272
2022-03-16,Mariposa,043,17540,2386,2376,198,2574,6
2022-03-16,Mendocino,045,87422,13006,13011,2991,16002,117
2022-03-16,Merced,047,269075,62401,61959,8692,70651,798
2022-03-16,Modoc,049,8938,730,734,248,982,7
2022-03-16,Mono,051,14174,2964,2960,121,3081,5
2022-03-16,Monterey,053,433212,79063,78416,13515,91931,720
2022-03-16,Napa,055,140530,25638,25638,930,26568,138
2022-03-16,Nevada,057,99092,15896,15960,1187,17147,123
2022-03-16,Orange,059,3164182,545092,543326,41146,584472,6791
2022-03-16,Placer,061,380077,62535,62435,7299,69734,605
2022-03-16,Plumas,063,18699,2965,2723,358,3081,13
2022-03-16,Riverside,065,2383286,590021,588761,27625,616386,6351
2022-03-16,Sacramento,067,1510023,279879,274709,26395,301104,2910
2022-03-16,San Benito,069,59416,12941,12854,511,13365,97
2022-03-16,San Bernardino,071,2135413,572969,559746,24809,584555,6775
2022-03-16,San Diego,073,3302833,748227,746970,52432,799402,5126
2022-03-16,San Francisco,075,870044,123418,123446,8125,131571,831
2022-03-16,San Joaquin,077,732212,166269,165703,9845,175548,2169
2022-03-16,San Luis Obispo,079,281455,52262,52132,3708,55840,462
2022-03-16,San Mateo,081,765935,120863,119680,6865,126545,660
2022-03-16,Santa Barbara,083,443738,85450,85322,4670,89992,670
2022-03-16,Santa Clara,085,1922200,312877,309689,12210,321899,2224
2022-03-16,Santa Cruz,087,273765,47512,47161,2068,49229,255
2022-03-16,Shasta,089,179085,30473,30489,6070,36559,527
2022-03-16,Sierra,091,2930,271,273,48,321,4
2022-03-16,Siskiyou,093,43540,4420,4419,2710,7129,76
2022-03-16,Solano,095,438530,81197,81277,5523,86800,440
2022-03-16,Sonoma,097,501317,83012,82791,2565,85356,472
2022-03-16,Stanislaus,099,539301,117304,118072,17772,135844,1567
2022-03-16,Sutter,101,95872,20410,20494,2035,22529,218
2022-03-16,Tehama,103,63373,12021,11999,2565,14564,160
2022-03-16,Trinity,105,12862,1183,1173,287,1460,20
2022-03-16,Tulare,107,460477,106092,104217,27432,131649,1377
2022-03-16,Tuolumne,109,53932,12649,12610,558,13168,180
2022-03-16,Ventura,111,848112,172526,172212,9344,181556,1451
2022-03-16,Yolo,113,214977,36853,36079,2889,38968,307
2022-03-16,Yuba,115,75493,15775,15758,1176,16934,117
2022-03-15,Alameda,001,1643700,254744,253694,13446,267140,1793
2022-03-15,Alpine,003,1148,122,122,1,123,0
2022-03-15,Amador,005,37829,8492,8448,638,9086,85
2022-03-15,Butte,007,227075,33043,32822,6977,39799,385
2022-03-15,Calaveras,009,45235,7231,7236,344,7580,118
2022-03-15,Colusa,011,21464,3441,3445,1046,4491,21
2022-03-15,Contra Costa,013,1133247,191084,187021,13269,200290,1265
2022-03-15,Del Norte,015,27424,5772,5806,178,5984,48
2022-03-15,El Dorado,017,186661,26593,26596,3180,29776,199
2022-03-15,Fresno,019,978130,233263,228631,24107,252738,2689
2022-03-15,Glenn,021,27897,4982,4966,1596,6562,44
2022-03-15,Humboldt,023,135768,16811,16889,2920,19809,138
2022-03-15,Imperial,025,180216,55221,54981,10500,65481,896
2022-03-15,Inyo,027,18085,4062,4062,467,4529,56
2022-03-15,Kern,029,883053,191404,190645,45659,236304,2168
2022-03-15,Kings,031,150075,51317,51317,3504,54821,437
2022-03-15,Lake,033,64148,10667,10631,877,11508,131
2022-03-15,Lassen,035,31185,8939,8926,873,9799,62
2022-03-15,Los Angeles,037,10098052,2701434,2685071,122194,2807265,31077
2022-03-15,Madera,039,155013,37171,37258,5997,43255,354
2022-03-15,Marin,041,260295,33222,33111,2165,35276,272
2022-03-15,Mariposa,043,17540,2384,2377,198,2575,6
2022-03-15,Mendocino,045,87422,13001,13005,2990,15995,117
2022-03-15,Merced,047,269075,62384,61916,8683,70599,798
2022-03-15,Modoc,049,8938,730,733,248,981,7
2022-03-15,Mono,051,14174,2964,2961,121,3082,5
2022-03-15,Monterey,053,433212,79033,78400,13507,91907,718
2022-03-15,Napa,055,140530,25630,25657,928,26585,138
2022-03-15,Nevada,057,99092,15894,15960,1185,17145,123
2022-03-15,Orange,059,3164182,544952,543197,41139,584336,6780
2022-03-15,Placer,061,380077,62518,62398,7295,69693,604
2022-03-15,Plumas,063,18699,2964,2722,358,3080,13
2022-03-15,Riverside,065,2383286,589922,588622,27617,616239,6333
2022-03-15,Sacramento,067,1510023,279794,274633,26389,301022,2907
2022-03-15,San Benito,069,59416,12936,12849,511,13360,95
2022-03-15,San Bernardino,071,2135413,572893,559605,24806,584411,6770
2022-03-15,San Diego,073,3302833,747984,746474,52410,798884,5116
2022-03-15,San Francisco,075,870044,123302,123526,8116,131642,831
2022-03-15,San Joaquin,077,732212,166226,165664,9839,175503,2161
2022-03-15,San Luis Obispo,079,281455,52252,52060,3704,55764,458
2022-03-15,San Mateo,081,765935,120812,119586,6859,126445,649
2022-03-15,Santa Barbara,083,443738,85425,85353,4666,90019,668
2022-03-15,Santa Clara,085,1922200,312713,309535,12199,321734,2224
2022-03-15,Santa Cruz,087,273765,47459,47117,2068,49185,255
2022-03-15,Shasta,089,179085,30464,30476,6067,36543,524
2022-03-15,Sierra,091,2930,271,273,48,321,4
2022-03-15,Siskiyou,093,43540,4420,4420,2710,7130,76
2022-03-15,Solano,095,438530,81161,81260,5522,86782,440
2022-03-15,Sonoma,097,501317,82972,82737,2565,85302,472
2022-03-15,Stanislaus,099,539301,117286,118085,17769,135854,1567
2022-03-15,Sutter,101,95872,20407,20480,2026,22506,217
2022-03-15,Tehama,103,63373,12018,11997,2565,14562,160
2022-03-15,Trinity,105,12862,1183,1173,287,1460,20
2022-03-15,Tulare,107,460477,106073,104153,27420,131573,1375
2022-03-15,Tuolumne,109,53932,12645,12602,558,13160,180
2022-03-15,Ventura,111,848112,172481,172150,9341,181491,1451
2022-03-15,Yolo,113,214977,36838,36079,2885,38964,308
2022-03-15,Yuba,115,75493,15767,15756,1176,16932,116
2022-03-14,Alameda,001,1643700,254633,253629,13442,267071,1791
2022-03-14,Alpine,003,1148,122,122,1,123,0
2022-03-14,Amador,005,37829,8487,8448,638,9086,85
2022-03-14,Butte,007,227075,33027,32812,6977,39789,385
2022-03-14,Calaveras,009,45235,7230,7245,344,7589,118
2022-03-14,Colusa,011,21464,3440,3445,1046,4491,21
2022-03-14,Contra Costa,013,1133247,190992,186969,13261,200230,1265
2022-03-14,Del Norte,015,27424,5766,5807,178,5985,48
2022-03-14,El Dorado,017,186661,26588,26570,3180,29750,199
2022-03-14,Fresno,019,978130,233188,228470,24097,252567,2682
2022-03-14,Glenn,021,27897,4980,4966,1596,6562,44
2022-03-14,Humboldt,023,135768,16804,16890,2918,19808,137
2022-03-14,Imperial,025,180216,55210,54933,10499,65432,897
2022-03-14,Inyo,027,18085,4062,4062,467,4529,56
2022-03-14,Kern,029,883053,191369,190526,45648,236174,2166
2022-03-14,Kings,031,150075,51299,51293,3503,54796,437
2022-03-14,Lake,033,64148,10664,10631,877,11508,131
2022-03-14,Lassen,035,31185,8939,8927,872,9799,62
2022-03-14,Los Angeles,037,10098052,2700803,2683369,122129,2805498,31034
2022-03-14,Madera,039,155013,37164,37255,5996,43251,354
2022-03-14,Marin,041,260295,33194,33099,2165,35264,272
2022-03-14,Mariposa,043,17540,2383,2376,198,2574,6
2022-03-14,Mendocino,045,87422,12996,12992,2983,15975,117
2022-03-14,Merced,047,269075,62365,61905,8681,70586,795
2022-03-14,Modoc,049,8938,729,731,248,979,7
2022-03-14,Mono,051,14174,2963,2961,121,3082,5
2022-03-14,Monterey,053,433212,79018,78376,13471,91847,718
2022-03-14,Napa,055,140530,25616,25649,928,26577,138
2022-03-14,Nevada,057,99092,15892,15954,1185,17139,123
2022-03-14,Orange,059,3164182,544815,543099,41125,584224,6775
2022-03-14,Placer,061,380077,62500,62389,7293,69682,601
2022-03-14,Plumas,063,18699,2964,2711,358,3069,13
2022-03-14,Riverside,065,2383286,589787,588531,27607,616138,6332
2022-03-14,Sacramento,067,1510023,279712,274682,26384,301066,2899
2022-03-14,San Benito,069,59416,12931,12846,511,13357,95
2022-03-14,San Bernardino,071,2135413,572806,559505,24801,584306,6767
2022-03-14,San Diego,073,3302833,747681,745515,52381,797896,5108
2022-03-14,San Francisco,075,870044,123212,123575,8109,131684,824
2022-03-14,San Joaquin,077,732212,166187,165662,9838,175500,2142
2022-03-14,San Luis Obispo,079,281455,52224,52046,3701,55747,458
2022-03-14,San Mateo,081,765935,120739,119564,6857,126421,649
2022-03-14,Santa Barbara,083,443738,85388,85396,4665,90061,667
2022-03-14,Santa Clara,085,1922200,312521,309600,12196,321796,2223
2022-03-14,Santa Cruz,087,273765,47421,47107,2066,49173,255
2022-03-14,Shasta,089,179085,30459,30462,6064,36526,520
2022-03-14,Sierra,091,2930,271,273,48,321,4
2022-03-14,Siskiyou,093,43540,4415,4419,2709,7128,76
2022-03-14,Solano,095,438530,81112,81233,5517,86750,440
2022-03-14,Sonoma,097,501317,82937,82731,2561,85292,473
2022-03-14,Stanislaus,099,539301,117250,118088,17765,135853,1567
2022-03-14,Sutter,101,95872,20400,20478,2026,22504,217
2022-03-14,Tehama,103,63373,12016,11996,2565,14561,160
2022-03-14,Trinity,105,12862,1183,1172,287,1459,20
2022-03-14,Tulare,107,460477,106046,104121,27413,131534,1365
2022-03-14,Tuolumne,109,53932,12644,12567,557,13124,180
2022-03-14,Ventura,111,848112,172428,172107,9339,181446,1442
2022-03-14,Yolo,113,214977,36822,36059,2883,38942,308
2022-03-14,Yuba,115,75493,15755,15748,1176,16924,116
2022-03-13,Alameda,001,1643700,254508,253547,13434,266981,1792
2022-03-13,Alpine,003,1148,122,122,1,123,0
2022-03-13,Amador,005,37829,8485,8444,638,9082,85
2022-03-13,Butte,007,227075,33008,32806,6974,39780,384
2022-03-13,Calaveras,009,45235,7225,7253,344,7597,118
2022-03-13,Colusa,011,21464,3440,3444,1044,4488,21
2022-03-13,Contra Costa,013,1133247,190894,186911,13248,200159,1265
2022-03-13,Del Norte,015,27424,5762,5808,178,5986,48
2022-03-13,El Dorado,017,186661,26583,26563,3179,29742,199
2022-03-13,Fresno,019,978130,233106,228421,24083,252504,2683
2022-03-13,Glenn,021,27897,4977,4966,1595,6561,44
2022-03-13,Humboldt,023,135768,16796,16883,2918,19801,137
2022-03-13,Imperial,025,180216,55199,54934,10497,65431,897
2022-03-13,Inyo,027,18085,4062,4062,466,4528,56
2022-03-13,Kern,029,883053,191315,190495,45636,236131,2166
2022-03-13,Kings,031,150075,51291,51273,3503,54776,437
2022-03-13,Lake,033,64148,10661,10626,877,11503,131
2022-03-13,Lassen,035,31185,8938,8929,871,9800,62
2022-03-13,Los Angeles,037,10098052,2700080,2683351,122087,2805438,31034
2022-03-13,Madera,039,155013,37156,37248,5996,43244,354
2022-03-13,Marin,041,260295,33170,33083,2163,35246,272
2022-03-13,Mariposa,043,17540,2381,2376,198,2574,6
2022-03-13,Mendocino,045,87422,12990,12987,2978,15965,117
2022-03-13,Merced,047,269075,62343,61895,8671,70566,795
2022-03-13,Modoc,049,8938,729,731,248,979,7
2022-03-13,Mono,051,14174,2963,2961,121,3082,5
2022-03-13,Monterey,053,433212,78982,78366,13423,91789,718
2022-03-13,Napa,055,140530,25602,25639,927,26566,138
2022-03-13,Nevada,057,99092,15885,15959,1185,17144,123
2022-03-13,Orange,059,3164182,544695,543036,41101,584137,6774
2022-03-13,Placer,061,380077,62472,62372,7290,69662,601
2022-03-13,Plumas,063,18699,2964,2711,358,3069,13
2022-03-13,Riverside,065,2383286,589654,588487,27601,616088,6332
2022-03-13,Sacramento,067,1510023,279603,274715,26371,301086,2899
2022-03-13,San Benito,069,59416,12925,12844,509,13353,95
2022-03-13,San Bernardino,071,2135413,572716,559450,24791,584241,6767
2022-03-13,San Diego,073,3302833,747340,745515,52347,797862,5108
2022-03-13,San Francisco,075,870044,123092,123622,8103,131725,824
2022-03-13,San Joaquin,077,732212,166137,165641,9836,175477,2142
2022-03-13,San Luis Obispo,079,281455,52194,52040,3699,55739,458
2022-03-13,San Mateo,081,765935,120661,119521,6848,126369,649
2022-03-13,Santa Barbara,083,443738,85348,85453,4663,90116,667
2022-03-13,Santa Clara,085,1922200,312335,309493,12188,321681,2225
2022-03-13,Santa Cruz,087,273765,47369,47087,2066,49153,255
2022-03-13,Shasta,089,179085,30442,30457,6062,36519,520
2022-03-13,Sierra,091,2930,271,273,48,321,4
2022-03-13,Siskiyou,093,43540,4415,4418,2709,7127,76
2022-03-13,Solano,095,438530,81076,81217,5512,86729,440
2022-03-13,Sonoma,097,501317,82903,82711,2557,85268,473
2022-03-13,Stanislaus,099,539301,117217,118075,17760,135835,1567
2022-03-13,Sutter,101,95872,20396,20474,2026,22500,217
2022-03-13,Tehama,103,63373,12015,11997,2564,14561,160
2022-03-13,Trinity,105,12862,1183,1172,287,1459,20
2022-03-13,Tulare,107,460477,106013,104119,27405,131524,1365
2022-03-13,Tuolumne,109,53932,12641,12565,557,13122,180
2022-03-13,Ventura,111,848112,172370,172080,9332,181412,1442
2022-03-13,Yolo,113,214977,36803,36019,2881,38900,308
2022-03-13,Yuba,115,75493,15750,15741,1176,16917,116
2022-03-12,Alameda,001,1643700,254440,253079,13429,266508,1783
2022-03-12,Alpine,003,1148,122,122,1,123,0
2022-03-12,Amador,005,37829,8481,8427,638,9065,84
2022-03-12,Butte,007,227075,33003,32774,6972,39746,380
2022-03-12,Calaveras,009,45235,7224,7253,344,7597,118
2022-03-12,Colusa,011,21464,3440,3440,1044,4484,21
2022-03-12,Contra Costa,013,1133247,190852,186618,13247,199865,1256
2022-03-12,Del Norte,015,27424,5761,5791,178,5969,48
2022-03-12,El Dorado,017,186661,26579,26538,3179,29717,199
2022-03-12,Fresno,019,978130,233084,228041,24083,252124,2653
2022-03-12,Glenn,021,27897,4977,4955,1595,6550,44
2022-03-12,Humboldt,023,135768,16792,16862,2917,19779,137
2022-03-12,Imperial,025,180216,55194,54837,10494,65331,896
2022-03-12,Inyo,027,18085,4062,4056,466,4522,56
2022-03-12,Kern,029,883053,191298,190330,45631,235961,2162
2022-03-12,Kings,031,150075,51285,51145,3503,54648,436
2022-03-12,Lake,033,64148,10659,10594,876,11470,131
2022-03-12,Lassen,035,31185,8937,8915,871,9786,62
2022-03-12,Los Angeles,037,10098052,2699754,2678858,122065,2800923,30901
2022-03-12,Madera,039,155013,37151,37223,5996,43219,354
2022-03-12,Marin,041,260295,33145,33015,2162,35177,272
2022-03-12,Mariposa,043,17540,2381,2372,198,2570,6
2022-03-12,Mendocino,045,87422,12986,12965,2978,15943,117
2022-03-12,Merced,047,269075,62336,61840,8669,70509,795
2022-03-12,Modoc,049,8938,729,730,248,978,7
2022-03-12,Mono,051,14174,2963,2960,120,3080,5
2022-03-12,Monterey,053,433212,78975,78285,13421,91706,716
2022-03-12,Napa,055,140530,25592,25584,926,26510,138
2022-03-12,Nevada,057,99092,15879,15947,1185,17132,123
2022-03-12,Orange,059,3164182,544631,542354,41092,583446,6718
2022-03-12,Placer,061,380077,62463,62282,7290,69572,598
2022-03-12,Plumas,063,18699,2964,2707,358,3065,13
2022-03-12,Riverside,065,2383286,589589,588022,27596,615618,6317
2022-03-12,Sacramento,067,1510023,279563,274519,26367,300886,2886
2022-03-12,San Benito,069,59416,12922,12868,509,13377,95
2022-03-12,San Bernardino,071,2135413,572668,559013,24790,583803,6734
2022-03-12,San Diego,073,3302833,747218,744386,52325,796711,5090
2022-03-12,San Francisco,075,870044,123027,123610,8097,131707,823
2022-03-12,San Joaquin,077,732212,166116,165516,9833,175349,2117
2022-03-12,San Luis Obispo,079,281455,52185,51947,3696,55643,457
2022-03-12,San Mateo,081,765935,120625,119288,6847,126135,641
2022-03-12,Santa Barbara,083,443738,85329,85421,4663,90084,664
2022-03-12,Santa Clara,085,1922200,312230,308989,12183,321172,2208
2022-03-12,Santa Cruz,087,273765,47356,46982,2065,49047,254
2022-03-12,Shasta,089,179085,30430,30419,6060,36479,517
2022-03-12,Sierra,091,2930,271,273,48,321,4
2022-03-12,Siskiyou,093,43540,4415,4405,2709,7114,75
2022-03-12,Solano,095,438530,81062,81058,5512,86570,436
2022-03-12,Sonoma,097,501317,82886,82622,2555,85177,473
2022-03-12,Stanislaus,099,539301,117203,117884,17759,135643,1564
2022-03-12,Sutter,101,95872,20395,20429,2026,22455,217
2022-03-12,Tehama,103,63373,12015,11983,2564,14547,159
2022-03-12,Trinity,105,12862,1182,1172,287,1459,20
2022-03-12,Tulare,107,460477,106008,103994,27401,131395,1358
2022-03-12,Tuolumne,109,53932,12640,12476,557,13033,180
2022-03-12,Ventura,111,848112,172345,171932,9331,181263,1442
2022-03-12,Yolo,113,214977,36796,35982,2879,38861,308
2022-03-12,Yuba,115,75493,15750,15722,1176,16898,116
2022-03-11,Alameda,001,1643700,254377,253079,13429,266508,1783
2022-03-11,Alpine,003,1148,122,122,1,123,0
2022-03-11,Amador,005,37829,8479,8427,638,9065,84
2022-03-11,Butte,007,227075,32999,32774,6971,39745,380
2022-03-11,Calaveras,009,45235,7224,7253,344,7597,118
2022-03-11,Colusa,011,21464,3440,3440,1044,4484,21
2022-03-11,Contra Costa,013,1133247,190804,186618,13245,199863,1256
2022-03-11,Del Norte,015,27424,5757,5791,178,5969,48
2022-03-11,El Dorado,017,186661,26575,26538,3179,29717,199
2022-03-11,Fresno,019,978130,233029,228041,24079,252120,2653
2022-03-11,Glenn,021,27897,4977,4955,1595,6550,44
2022-03-11,Humboldt,023,135768,16787,16862,2916,19778,137
2022-03-11,Imperial,025,180216,55188,54837,10493,65330,896
2022-03-11,Inyo,027,18085,4062,4056,466,4522,56
2022-03-11,Kern,029,883053,191276,190330,45626,235956,2162
2022-03-11,Kings,031,150075,51266,51145,3503,54648,436
2022-03-11,Lake,033,64148,10655,10594,876,11470,131
2022-03-11,Lassen,035,31185,8936,8915,871,9786,62
2022-03-11,Los Angeles,037,10098052,2699433,2678858,122037,2800895,30901
2022-03-11,Madera,039,155013,37146,37223,5996,43219,354
2022-03-11,Marin,041,260295,33129,33015,2161,35176,272
2022-03-11,Mariposa,043,17540,2380,2372,198,2570,6
2022-03-11,Mendocino,045,87422,12980,12965,2978,15943,117
2022-03-11,Merced,047,269075,62329,61840,8667,70507,795
2022-03-11,Modoc,049,8938,729,730,248,978,7
2022-03-11,Mono,051,14174,2962,2960,120,3080,5
2022-03-11,Monterey,053,433212,78962,78285,13414,91699,716
2022-03-11,Napa,055,140530,25581,25584,926,26510,138
2022-03-11,Nevada,057,99092,15876,15947,1185,17132,123
2022-03-11,Orange,059,3164182,544562,542354,41078,583432,6718
2022-03-11,Placer,061,380077,62452,62282,7289,69571,598
2022-03-11,Plumas,063,18699,2962,2707,358,3065,13
2022-03-11,Riverside,065,2383286,589512,588022,27592,615614,6317
2022-03-11,Sacramento,067,1510023,279493,274519,26365,300884,2886
2022-03-11,San Benito,069,59416,12921,12868,509,13377,95
2022-03-11,San Bernardino,071,2135413,572611,559013,24785,583798,6734
2022-03-11,San Diego,073,3302833,747052,744386,52311,796697,5090
2022-03-11,San Francisco,075,870044,122970,123610,8093,131703,823
2022-03-11,San Joaquin,077,732212,166078,165516,9830,175346,2117
2022-03-11,San Luis Obispo,079,281455,52177,51947,3695,55642,457
2022-03-11,San Mateo,081,765935,120576,119288,6844,126132,641
2022-03-11,Santa Barbara,083,443738,85309,85421,4662,90083,664
2022-03-11,Santa Clara,085,1922200,312093,308989,12180,321169,2208
2022-03-11,Santa Cruz,087,273765,47341,46982,2065,49047,254
2022-03-11,Shasta,089,179085,30425,30419,6057,36476,517
2022-03-11,Sierra,091,2930,271,273,48,321,4
2022-03-11,Siskiyou,093,43540,4415,4405,2707,7112,75
2022-03-11,Solano,095,438530,81048,81058,5511,86569,436
2022-03-11,Sonoma,097,501317,82860,82622,2553,85175,473
2022-03-11,Stanislaus,099,539301,117189,117884,17757,135641,1564
2022-03-11,Sutter,101,95872,20393,20429,2026,22455,217
2022-03-11,Tehama,103,63373,12013,11983,2564,14547,159
2022-03-11,Trinity,105,12862,1182,1172,287,1459,20
2022-03-11,Tulare,107,460477,105994,103994,27395,131389,1358
2022-03-11,Tuolumne,109,53932,12638,12476,557,13033,180
2022-03-11,Ventura,111,848112,172309,171932,9326,181258,1442
2022-03-11,Yolo,113,214977,36785,35982,2879,38861,308
2022-03-11,Yuba,115,75493,15747,15722,1176,16898,116
2022-03-10,Alameda,001,1643700,254252,253079,13425,266504,1783
2022-03-10,Alpine,003,1148,122,122,1,123,0
2022-03-10,Amador,005,37829,8478,8427,638,9065,84
2022-03-10,Butte,007,227075,32983,32774,6969,39743,380
2022-03-10,Calaveras,009,45235,7223,7253,343,7596,118
2022-03-10,Colusa,011,21464,3440,3440,1044,4484,21
2022-03-10,Contra Costa,013,1133247,190720,186618,13235,199853,1256
2022-03-10,Del Norte,015,27424,5748,5791,178,5969,48
2022-03-10,El Dorado,017,186661,26564,26538,3178,29716,199
2022-03-10,Fresno,019,978130,232953,228041,24069,252110,2653
2022-03-10,Glenn,021,27897,4974,4955,1595,6550,44
2022-03-10,Humboldt,023,135768,16778,16862,2915,19777,137
2022-03-10,Imperial,025,180216,55178,54837,10492,65329,896
2022-03-10,Inyo,027,18085,4061,4056,466,4522,56
2022-03-10,Kern,029,883053,191243,190330,45612,235942,2162
2022-03-10,Kings,031,150075,51237,51145,3502,54647,436
2022-03-10,Lake,033,64148,10645,10594,875,11469,131
2022-03-10,Lassen,035,31185,8936,8915,871,9786,62
2022-03-10,Los Angeles,037,10098052,2698881,2678858,121996,2800854,30901
2022-03-10,Madera,039,155013,37140,37223,5989,43212,354
2022-03-10,Marin,041,260295,33116,33015,2157,35172,272
2022-03-10,Mariposa,043,17540,2380,2372,198,2570,6
2022-03-10,Mendocino,045,87422,12977,12965,2978,15943,117
2022-03-10,Merced,047,269075,62309,61840,8662,70502,795
2022-03-10,Modoc,049,8938,728,730,248,978,7
2022-03-10,Mono,051,14174,2962,2960,120,3080,5
2022-03-10,Monterey,053,433212,78939,78285,13389,91674,716
2022-03-10,Napa,055,140530,25572,25584,925,26509,138
2022-03-10,Nevada,057,99092,15869,15947,1185,17132,123
2022-03-10,Orange,059,3164182,544441,542354,41060,583414,6718
2022-03-10,Placer,061,380077,62430,62282,7284,69566,598
2022-03-10,Plumas,063,18699,2961,2707,358,3065,13
2022-03-10,Riverside,065,2383286,589397,588022,27587,615609,6317
2022-03-10,Sacramento,067,1510023,279416,274519,26359,300878,2886
2022-03-10,San Benito,069,59416,12920,12868,508,13376,95
2022-03-10,San Bernardino,071,2135413,572538,559013,24781,583794,6734
2022-03-10,San Diego,073,3302833,746794,744386,52280,796666,5090
2022-03-10,San Francisco,075,870044,122903,123610,8087,131697,823
2022-03-10,San Joaquin,077,732212,166045,165516,9828,175344,2117
2022-03-10,San Luis Obispo,079,281455,52154,51947,3692,55639,457
2022-03-10,San Mateo,081,765935,120513,119288,6842,126130,641
2022-03-10,Santa Barbara,083,443738,85277,85421,4661,90082,664
2022-03-10,Santa Clara,085,1922200,311921,308989,12173,321162,2208
2022-03-10,Santa Cruz,087,273765,47309,46982,2065,49047,254
2022-03-10,Shasta,089,179085,30416,30419,6055,36474,517
2022-03-10,Sierra,091,2930,271,273,48,321,4
2022-03-10,Siskiyou,093,43540,4415,4405,2707,7112,75
2022-03-10,Solano,095,438530,81012,81058,5506,86564,436
2022-03-10,Sonoma,097,501317,82833,82622,2553,85175,473
2022-03-10,Stanislaus,099,539301,117154,117884,17755,135639,1564
2022-03-10,Sutter,101,95872,20389,20429,2026,22455,217
2022-03-10,Tehama,103,63373,12012,11983,2564,14547,159
2022-03-10,Trinity,105,12862,1182,1172,287,1459,20
2022-03-10,Tulare,107,460477,105976,103994,27389,131383,1358
2022-03-10,Tuolumne,109,53932,12635,12476,557,13033,180
2022-03-10,Ventura,111,848112,172268,171932,9323,181255,1442
2022-03-10,Yolo,113,214977,36772,35982,2878,38860,308
2022-03-10,Yuba,115,75493,15737,15722,1175,16897,116
2022-03-09,Alameda,001,1643700,254120,252893,13421,266314,1781
2022-03-09,Alpine,003,1148,122,125,1,126,0
2022-03-09,Amador,005,37829,8472,8409,638,9047,84
2022-03-09,Butte,007,227075,32974,32767,6965,39732,380
2022-03-09,Calaveras,009,45235,7221,7249,343,7592,117
2022-03-09,Colusa,011,21464,3439,3439,1044,4483,21
2022-03-09,Contra Costa,013,1133247,190614,186483,13220,199703,1256
2022-03-09,Del Norte,015,27424,5744,5765,178,5943,48
2022-03-09,El Dorado,017,186661,26560,26515,3178,29693,198
2022-03-09,Fresno,019,978130,232856,227885,24062,251947,2653
2022-03-09,Glenn,021,27897,4974,4953,1594,6547,44
2022-03-09,Humboldt,023,135768,16773,16854,2912,19766,137
2022-03-09,Imperial,025,180216,55172,54764,10490,65254,894
2022-03-09,Inyo,027,18085,4061,4056,466,4522,56
2022-03-09,Kern,029,883053,191195,190254,45599,235853,2159
2022-03-09,Kings,031,150075,51216,51122,3502,54624,435
2022-03-09,Lake,033,64148,10638,10586,875,11461,130
2022-03-09,Lassen,035,31185,8936,8901,871,9772,62
2022-03-09,Los Angeles,037,10098052,2698235,2677901,121956,2799857,30842
2022-03-09,Madera,039,155013,37132,37207,5988,43195,354
2022-03-09,Marin,041,260295,33098,32967,2157,35124,272
2022-03-09,Mariposa,043,17540,2377,2372,198,2570,6
2022-03-09,Mendocino,045,87422,12973,12957,2973,15930,117
2022-03-09,Merced,047,269075,62292,61792,8656,70448,792
2022-03-09,Modoc,049,8938,727,730,247,977,7
2022-03-09,Mono,051,14174,2962,2962,120,3082,5
2022-03-09,Monterey,053,433212,78917,78258,13346,91604,716
2022-03-09,Napa,055,140530,25551,25561,924,26485,138
2022-03-09,Nevada,057,99092,15860,15938,1184,17122,123
2022-03-09,Orange,059,3164182,544311,542278,41048,583326,6700
2022-03-09,Placer,061,380077,62408,62242,7280,69522,598
2022-03-09,Plumas,063,18699,2960,2708,358,3066,13
2022-03-09,Riverside,065,2383286,589285,587833,27577,615410,6305
2022-03-09,Sacramento,067,1510023,279328,274373,26343,300716,2877
2022-03-09,San Benito,069,59416,12903,12864,508,13372,95
2022-03-09,San Bernardino,071,2135413,572438,558795,24770,583565,6723
2022-03-09,San Diego,073,3302833,746523,743956,52253,796209,5083
2022-03-09,San Francisco,075,870044,122812,123676,8083,131759,812
2022-03-09,San Joaquin,077,732212,166005,165444,9822,175266,2113
2022-03-09,San Luis Obispo,079,281455,52135,51923,3690,55613,457
2022-03-09,San Mateo,081,765935,120455,119194,6830,126024,639
2022-03-09,Santa Barbara,083,443738,85263,85382,4659,90041,661
2022-03-09,Santa Clara,085,1922200,311767,308765,12163,320928,2206
2022-03-09,Santa Cruz,087,273765,47269,46917,2064,48981,254
2022-03-09,Shasta,089,179085,30394,30407,6054,36461,493
2022-03-09,Sierra,091,2930,271,273,48,321,4
2022-03-09,Siskiyou,093,43540,4414,4403,2706,7109,75
2022-03-09,Solano,095,438530,80976,80984,5505,86489,436
2022-03-09,Sonoma,097,501317,82800,82574,2551,85125,473
2022-03-09,Stanislaus,099,539301,117117,117827,17750,135577,1541
2022-03-09,Sutter,101,95872,20378,20409,2022,22431,217
2022-03-09,Tehama,103,63373,12008,11980,2564,14544,159
2022-03-09,Trinity,105,12862,1182,1174,287,1461,20
2022-03-09,Tulare,107,460477,105948,103932,27376,131308,1350
2022-03-09,Tuolumne,109,53932,12633,12444,557,13001,180
2022-03-09,Ventura,111,848112,172217,171852,9320,181172,1448
2022-03-09,Yolo,113,214977,36753,35973,2866,38839,308
2022-03-09,Yuba,115,75493,15732,15714,1174,16888,115
2022-03-08,Alameda,001,1643700,253962,252744,13408,266152,1769
2022-03-08,Alpine,003,1148,122,125,1,126,0
2022-03-08,Amador,005,37829,8458,8407,638,9045,84
2022-03-08,Butte,007,227075,32960,32759,6961,39720,380
2022-03-08,Calaveras,009,45235,7217,7245,343,7588,117
2022-03-08,Colusa,011,21464,3436,3439,1043,4482,21
2022-03-08,Contra Costa,013,1133247,190527,186396,13207,199603,1256
2022-03-08,Del Norte,015,27424,5739,5763,178,5941,48
2022-03-08,El Dorado,017,186661,26550,26503,3172,29675,197
2022-03-08,Fresno,019,978130,232758,227808,24053,251861,2653
2022-03-08,Glenn,021,27897,4972,4944,1593,6537,43
2022-03-08,Humboldt,023,135768,16761,16837,2899,19736,137
2022-03-08,Imperial,025,180216,55157,54721,10488,65209,890
2022-03-08,Inyo,027,18085,4058,4056,466,4522,56
2022-03-08,Kern,029,883053,191132,190208,45585,235793,2154
2022-03-08,Kings,031,150075,51174,51089,3500,54589,434
2022-03-08,Lake,033,64148,10628,10571,875,11446,130
2022-03-08,Lassen,035,31185,8935,8897,871,9768,62
2022-03-08,Los Angeles,037,10098052,2697544,2677166,121919,2799085,30803
2022-03-08,Madera,039,155013,37122,37185,5987,43172,354
2022-03-08,Marin,041,260295,33061,32943,2156,35099,272
2022-03-08,Mariposa,043,17540,2375,2371,198,2569,6
2022-03-08,Mendocino,045,87422,12969,12950,2972,15922,117
2022-03-08,Merced,047,269075,62271,61767,8645,70412,791
2022-03-08,Modoc,049,8938,726,729,247,976,7
2022-03-08,Mono,051,14174,2961,2961,120,3081,5
2022-03-08,Monterey,053,433212,78897,78247,13309,91556,711
2022-03-08,Napa,055,140530,25525,25528,923,26451,137
2022-03-08,Nevada,057,99092,15849,15939,1183,17122,122
2022-03-08,Orange,059,3164182,544165,542164,41028,583192,6692
2022-03-08,Placer,061,380077,62379,62221,7279,69500,594
2022-03-08,Plumas,063,18699,2960,2703,358,3061,13
2022-03-08,Riverside,065,2383286,589177,587686,27570,615256,6294
2022-03-08,Sacramento,067,1510023,279226,274276,26324,300600,2872
2022-03-08,San Benito,069,59416,12901,12855,508,13363,94
2022-03-08,San Bernardino,071,2135413,572345,558512,24760,583272,6715
2022-03-08,San Diego,073,3302833,746180,743604,52236,795840,5077
2022-03-08,San Francisco,075,870044,122716,123675,8078,131753,807
2022-03-08,San Joaquin,077,732212,165969,165381,9818,175199,2104
2022-03-08,San Luis Obispo,079,281455,52107,51900,3687,55587,451
2022-03-08,San Mateo,081,765935,120374,119103,6820,125923,638
2022-03-08,Santa Barbara,083,443738,85231,85363,4659,90022,659
2022-03-08,Santa Clara,085,1922200,311540,308528,12156,320684,2206
2022-03-08,Santa Cruz,087,273765,47232,46875,2063,48938,254
2022-03-08,Shasta,089,179085,30375,30372,6051,36423,493
2022-03-08,Sierra,091,2930,271,273,48,321,4
2022-03-08,Siskiyou,093,43540,4410,4404,2706,7110,74
2022-03-08,Solano,095,438530,80948,80924,5502,86426,434
2022-03-08,Sonoma,097,501317,82752,82571,2550,85121,473
2022-03-08,Stanislaus,099,539301,117073,117782,17741,135523,1541
2022-03-08,Sutter,101,95872,20370,20403,2022,22425,217
2022-03-08,Tehama,103,63373,12004,11972,2563,14535,158
2022-03-08,Trinity,105,12862,1182,1174,287,1461,20
2022-03-08,Tulare,107,460477,105910,103893,27365,131258,1334
2022-03-08,Tuolumne,109,53932,12628,12427,555,12982,180
2022-03-08,Ventura,111,848112,172153,171806,9313,181119,1447
2022-03-08,Yolo,113,214977,36727,35946,2865,38811,306
2022-03-08,Yuba,115,75493,15727,15705,1173,16878,115
2022-03-07,Alameda,001,1643700,253753,252578,13397,265975,1766
2022-03-07,Alpine,003,1148,122,125,1,126,0
2022-03-07,Amador,005,37829,8455,8368,638,9006,84
2022-03-07,Butte,007,227075,32945,32734,6957,39691,378
2022-03-07,Calaveras,009,45235,7213,7242,343,7585,116
2022-03-07,Colusa,011,21464,3436,3437,1043,4480,21
2022-03-07,Contra Costa,013,1133247,190427,186087,13186,199273,1256
2022-03-07,Del Norte,015,27424,5735,5758,178,5936,48
2022-03-07,El Dorado,017,186661,26544,26487,3171,29658,196
2022-03-07,Fresno,019,978130,232667,227670,24030,251700,2653
2022-03-07,Glenn,021,27897,4969,4939,1593,6532,43
2022-03-07,Humboldt,023,135768,16748,16829,2894,19723,137
2022-03-07,Imperial,025,180216,55135,54712,10483,65195,890
2022-03-07,Inyo,027,18085,4056,4054,466,4520,56
2022-03-07,Kern,029,883053,191068,190163,45562,235725,2152
2022-03-07,Kings,031,150075,51144,51065,3495,54560,433
2022-03-07,Lake,033,64148,10616,10562,874,11436,130
2022-03-07,Lassen,035,31185,8934,8896,871,9767,62
2022-03-07,Los Angeles,037,10098052,2696748,2675497,121878,2797375,30759
2022-03-07,Madera,039,155013,37112,37164,5985,43149,354
2022-03-07,Marin,041,260295,33024,32919,2153,35072,272
2022-03-07,Mariposa,043,17540,2374,2369,198,2567,6
2022-03-07,Mendocino,045,87422,12962,12940,2971,15911,117
2022-03-07,Merced,047,269075,62231,61751,8638,70389,791
2022-03-07,Modoc,049,8938,726,729,247,976,7
2022-03-07,Mono,051,14174,2961,2960,120,3080,5
2022-03-07,Monterey,053,433212,78863,78161,13261,91422,706
2022-03-07,Napa,055,140530,25496,25500,923,26423,136
2022-03-07,Nevada,057,99092,15842,15935,1177,17112,122
2022-03-07,Orange,059,3164182,543994,542028,41001,583029,6687
2022-03-07,Placer,061,380077,62350,62215,7278,69493,591
2022-03-07,Plumas,063,18699,2960,2702,358,3060,13
2022-03-07,Riverside,065,2383286,589050,587537,27562,615099,6279
2022-03-07,Sacramento,067,1510023,279124,274079,26311,300390,2866
2022-03-07,San Benito,069,59416,12895,12843,508,13351,94
2022-03-07,San Bernardino,071,2135413,572240,558265,24750,583015,6703
2022-03-07,San Diego,073,3302833,745839,742287,52193,794480,5068
2022-03-07,San Francisco,075,870044,122604,123655,8072,131727,807
2022-03-07,San Joaquin,077,732212,165918,165343,9811,175154,2091
2022-03-07,San Luis Obispo,079,281455,52062,51874,3685,55559,448
2022-03-07,San Mateo,081,765935,120298,119035,6813,125848,630
2022-03-07,Santa Barbara,083,443738,85193,85345,4658,90003,659
2022-03-07,Santa Clara,085,1922200,311345,308517,12148,320665,2202
2022-03-07,Santa Cruz,087,273765,47182,46823,2062,48885,254
2022-03-07,Shasta,089,179085,30362,30352,6048,36400,493
2022-03-07,Sierra,091,2930,271,273,48,321,4
2022-03-07,Siskiyou,093,43540,4406,4398,2705,7103,74
2022-03-07,Solano,095,438530,80891,80886,5500,86386,435
2022-03-07,Sonoma,097,501317,82708,82530,2549,85079,473
2022-03-07,Stanislaus,099,539301,117034,117713,17734,135447,1537
2022-03-07,Sutter,101,95872,20359,20400,2021,22421,217
2022-03-07,Tehama,103,63373,11999,11966,2562,14528,158
2022-03-07,Trinity,105,12862,1180,1173,287,1460,20
2022-03-07,Tulare,107,460477,105874,103834,27355,131189,1316
2022-03-07,Tuolumne,109,53932,12622,12408,554,12962,179
2022-03-07,Ventura,111,848112,172102,171886,9311,181197,1436
2022-03-07,Yolo,113,214977,36704,35934,2859,38793,306
2022-03-07,Yuba,115,75493,15720,15701,1172,16873,115
2022-03-06,Alameda,001,1643700,253560,252460,13388,265848,1766
2022-03-06,Alpine,003,1148,122,125,1,126,0
2022-03-06,Amador,005,37829,8452,8367,636,9003,84
2022-03-06,Butte,007,227075,32933,32714,6952,39666,376
2022-03-06,Calaveras,009,45235,7211,7236,342,7578,116
2022-03-06,Colusa,011,21464,3434,3435,1042,4477,21
2022-03-06,Contra Costa,013,1133247,190313,185974,13161,199135,1256
2022-03-06,Del Norte,015,27424,5720,5744,177,5921,48
2022-03-06,El Dorado,017,186661,26536,26478,3169,29647,196
2022-03-06,Fresno,019,978130,232526,227514,24020,251534,2653
2022-03-06,Glenn,021,27897,4965,4939,1593,6532,43
2022-03-06,Humboldt,023,135768,16738,16813,2891,19704,137
2022-03-06,Imperial,025,180216,55117,54719,10473,65192,890
2022-03-06,Inyo,027,18085,4054,4053,466,4519,56
2022-03-06,Kern,029,883053,191012,190088,45542,235630,2152
2022-03-06,Kings,031,150075,51074,51050,3493,54543,432
2022-03-06,Lake,033,64148,10602,10539,873,11412,130
2022-03-06,Lassen,035,31185,8921,8887,870,9757,62
2022-03-06,Los Angeles,037,10098052,2695824,2675456,121824,2797280,30759
2022-03-06,Madera,039,155013,37082,37135,5978,43113,354
2022-03-06,Marin,041,260295,32998,32879,2152,35031,272
2022-03-06,Mariposa,043,17540,2373,2365,197,2562,6
2022-03-06,Mendocino,045,87422,12950,12923,2967,15890,116
2022-03-06,Merced,047,269075,62199,61722,8620,70342,791
2022-03-06,Modoc,049,8938,726,729,247,976,7
2022-03-06,Mono,051,14174,2961,2959,120,3079,5
2022-03-06,Monterey,053,433212,78817,78154,13230,91384,706
2022-03-06,Napa,055,140530,25461,25457,921,26378,136
2022-03-06,Nevada,057,99092,15831,15924,1176,17100,122
2022-03-06,Orange,059,3164182,543836,541903,40955,582858,6688
2022-03-06,Placer,061,380077,62317,62185,7274,69459,591
2022-03-06,Plumas,063,18699,2955,2704,358,3062,13
2022-03-06,Riverside,065,2383286,588887,587388,27542,614930,6279
2022-03-06,Sacramento,067,1510023,278988,273935,26287,300222,2869
2022-03-06,San Benito,069,59416,12884,12835,507,13342,94
2022-03-06,San Bernardino,071,2135413,572118,558139,24738,582877,6701
2022-03-06,San Diego,073,3302833,745444,742287,52144,794431,5068
2022-03-06,San Francisco,075,870044,122472,123742,8069,131811,806
2022-03-06,San Joaquin,077,732212,165836,165252,9805,175057,2091
2022-03-06,San Luis Obispo,079,281455,52024,51828,3683,55511,448
2022-03-06,San Mateo,081,765935,120215,118916,6804,125720,630
2022-03-06,Santa Barbara,083,443738,85152,85317,4653,89970,659
2022-03-06,Santa Clara,085,1922200,311077,308250,12146,320396,2201
2022-03-06,Santa Cruz,087,273765,47131,46755,2061,48816,254
2022-03-06,Shasta,089,179085,30339,30332,6032,36364,493
2022-03-06,Sierra,091,2930,271,273,48,321,4
2022-03-06,Siskiyou,093,43540,4404,4398,2703,7101,74
2022-03-06,Solano,095,438530,80834,80833,5494,86327,435
2022-03-06,Sonoma,097,501317,82673,82458,2545,85003,473
2022-03-06,Stanislaus,099,539301,116988,117680,17722,135402,1536
2022-03-06,Sutter,101,95872,20349,20390,2017,22407,217
2022-03-06,Tehama,103,63373,11991,11963,2562,14525,158
2022-03-06,Trinity,105,12862,1180,1172,286,1458,20
2022-03-06,Tulare,107,460477,105818,103794,27343,131137,1316
2022-03-06,Tuolumne,109,53932,12616,12379,552,12931,179
2022-03-06,Ventura,111,848112,172033,171819,9309,181128,1436
2022-03-06,Yolo,113,214977,36678,35882,2856,38738,306
2022-03-06,Yuba,115,75493,15716,15694,1171,16865,115
2022-03-05,Alameda,001,1643700,253444,251988,13383,265371,1760
2022-03-05,Alpine,003,1148,122,125,1,126,0
2022-03-05,Amador,005,37829,8449,8344,636,8980,83
2022-03-05,Butte,007,227075,32925,32663,6948,39611,372
2022-03-05,Calaveras,009,45235,7208,7236,342,7578,116
2022-03-05,Colusa,011,21464,3434,3433,1042,4475,21
2022-03-05,Contra Costa,013,1133247,190250,185734,13156,198890,1235
2022-03-05,Del Norte,015,27424,5717,5725,177,5902,48
2022-03-05,El Dorado,017,186661,26530,26446,3166,29612,193
2022-03-05,Fresno,019,978130,232474,227154,24019,251173,2640
2022-03-05,Glenn,021,27897,4961,4927,1593,6520,43
2022-03-05,Humboldt,023,135768,16732,16781,2889,19670,136
2022-03-05,Imperial,025,180216,55107,54650,10471,65121,880
2022-03-05,Inyo,027,18085,4053,4043,465,4508,56
2022-03-05,Kern,029,883053,190979,189817,45524,235341,2141
2022-03-05,Kings,031,150075,51067,50926,3492,54418,431
2022-03-05,Lake,033,64148,10594,10512,872,11384,130
2022-03-05,Lassen,035,31185,8913,8818,870,9688,62
2022-03-05,Los Angeles,037,10098052,2695460,2671564,121788,2793352,30608
2022-03-05,Madera,039,155013,37067,37100,5978,43078,354
2022-03-05,Marin,041,260295,32986,32829,2152,34981,272
2022-03-05,Mariposa,043,17540,2373,2363,197,2560,6
2022-03-05,Mendocino,045,87422,12947,12845,2967,15812,113
2022-03-05,Merced,047,269075,62188,61653,8620,70273,789
2022-03-05,Modoc,049,8938,726,729,247,976,7
2022-03-05,Mono,051,14174,2961,2961,120,3081,5
2022-03-05,Monterey,053,433212,78798,78028,13223,91251,704
2022-03-05,Napa,055,140530,25443,25405,921,26326,134
2022-03-05,Nevada,057,99092,15827,15907,1176,17083,122
2022-03-05,Orange,059,3164182,543711,541463,40943,582406,6638
2022-03-05,Placer,061,380077,62303,62117,7267,69384,591
2022-03-05,Plumas,063,18699,2954,2701,358,3059,13
2022-03-05,Riverside,065,2383286,588796,586785,27538,614323,6239
2022-03-05,Sacramento,067,1510023,278924,273487,26281,299768,2847
2022-03-05,San Benito,069,59416,12882,12820,507,13327,94
2022-03-05,San Bernardino,071,2135413,572060,557421,24732,582153,6641
2022-03-05,San Diego,073,3302833,745257,740747,52132,792879,5045
2022-03-05,San Francisco,075,870044,122402,123537,8066,131603,798
2022-03-05,San Joaquin,077,732212,165796,165085,9797,174882,2069
2022-03-05,San Luis Obispo,079,281455,52016,51739,3682,55421,446
2022-03-05,San Mateo,081,765935,120160,118646,6800,125446,621
2022-03-05,Santa Barbara,083,443738,85137,85249,4653,89902,655
2022-03-05,Santa Clara,085,1922200,310960,307689,12143,319832,2195
2022-03-05,Santa Cruz,087,273765,47111,46622,2061,48683,253
2022-03-05,Shasta,089,179085,30327,30282,6032,36314,492
2022-03-05,Sierra,091,2930,271,273,47,320,4
2022-03-05,Siskiyou,093,43540,4403,4389,2702,7091,74
2022-03-05,Solano,095,438530,80817,80690,5494,86184,435
2022-03-05,Sonoma,097,501317,82651,82313,2545,84858,473
2022-03-05,Stanislaus,099,539301,116962,117501,17720,135221,1531
2022-03-05,Sutter,101,95872,20341,20346,2017,22363,217
2022-03-05,Tehama,103,63373,11988,11939,2562,14501,158
2022-03-05,Trinity,105,12862,1180,1170,284,1454,20
2022-03-05,Tulare,107,460477,105804,103534,27334,130868,1305
2022-03-05,Tuolumne,109,53932,12612,12325,551,12876,178
2022-03-05,Ventura,111,848112,171992,171666,9307,180973,1436
2022-03-05,Yolo,113,214977,36664,35856,2856,38712,306
2022-03-05,Yuba,115,75493,15708,15666,1171,16837,115
2022-03-04,Alameda,001,1643700,253348,251988,13375,265363,1760
2022-03-04,Alpine,003,1148,122,125,1,126,0
2022-03-04,Amador,005,37829,8448,8344,636,8980,83
2022-03-04,Butte,007,227075,32919,32663,6943,39606,372
2022-03-04,Calaveras,009,45235,7207,7236,342,7578,116
2022-03-04,Colusa,011,21464,3432,3433,1042,4475,21
2022-03-04,Contra Costa,013,1133247,190182,185734,13153,198887,1235
2022-03-04,Del Norte,015,27424,5707,5725,177,5902,48
2022-03-04,El Dorado,017,186661,26526,26446,3166,29612,193
2022-03-04,Fresno,019,978130,232411,227154,24012,251166,2640
2022-03-04,Glenn,021,27897,4960,4927,1593,6520,43
2022-03-04,Humboldt,023,135768,16728,16781,2889,19670,136
2022-03-04,Imperial,025,180216,55100,54650,10467,65117,880
2022-03-04,Inyo,027,18085,4053,4043,465,4508,56
2022-03-04,Kern,029,883053,190937,189817,45514,235331,2141
2022-03-04,Kings,031,150075,51054,50926,3492,54418,431
2022-03-04,Lake,033,64148,10593,10512,872,11384,130
2022-03-04,Lassen,035,31185,8911,8818,870,9688,62
2022-03-04,Los Angeles,037,10098052,2694930,2671564,121758,2793322,30608
2022-03-04,Madera,039,155013,37058,37100,5978,43078,354
2022-03-04,Marin,041,260295,32964,32829,2150,34979,272
2022-03-04,Mariposa,043,17540,2368,2363,197,2560,6
2022-03-04,Mendocino,045,87422,12941,12845,2967,15812,113
2022-03-04,Merced,047,269075,62178,61653,8618,70271,789
2022-03-04,Modoc,049,8938,726,729,247,976,7
2022-03-04,Mono,051,14174,2961,2961,120,3081,5
2022-03-04,Monterey,053,433212,78778,78028,13217,91245,704
2022-03-04,Napa,055,140530,25428,25405,920,26325,134
2022-03-04,Nevada,057,99092,15822,15907,1176,17083,122
2022-03-04,Orange,059,3164182,543592,541463,40925,582388,6638
2022-03-04,Placer,061,380077,62291,62117,7264,69381,591
2022-03-04,Plumas,063,18699,2954,2701,357,3058,13
2022-03-04,Riverside,065,2383286,588709,586785,27537,614322,6239
2022-03-04,Sacramento,067,1510023,278850,273487,26278,299765,2847
2022-03-04,San Benito,069,59416,12878,12820,507,13327,94
2022-03-04,San Bernardino,071,2135413,571978,557421,24731,582152,6641
2022-03-04,San Diego,073,3302833,745019,740747,52115,792862,5045
2022-03-04,San Francisco,075,870044,122337,123537,8059,131596,798
2022-03-04,San Joaquin,077,732212,165764,165085,9796,174881,2069
2022-03-04,San Luis Obispo,079,281455,52007,51739,3681,55420,446
2022-03-04,San Mateo,081,765935,120102,118646,6798,125444,621
2022-03-04,Santa Barbara,083,443738,85114,85249,4653,89902,655
2022-03-04,Santa Clara,085,1922200,310809,307689,12141,319830,2195
2022-03-04,Santa Cruz,087,273765,47089,46622,2061,48683,253
2022-03-04,Shasta,089,179085,30319,30282,6029,36311,492
2022-03-04,Sierra,091,2930,271,273,47,320,4
2022-03-04,Siskiyou,093,43540,4402,4389,2698,7087,74
2022-03-04,Solano,095,438530,80784,80690,5491,86181,435
2022-03-04,Sonoma,097,501317,82620,82313,2544,84857,473
2022-03-04,Stanislaus,099,539301,116943,117501,17718,135219,1531
2022-03-04,Sutter,101,95872,20337,20346,2017,22363,217
2022-03-04,Tehama,103,63373,11985,11939,2562,14501,158
2022-03-04,Trinity,105,12862,1180,1170,284,1454,20
2022-03-04,Tulare,107,460477,105785,103534,27329,130863,1305
2022-03-04,Tuolumne,109,53932,12607,12325,551,12876,178
2022-03-04,Ventura,111,848112,171944,171666,9304,180970,1436
2022-03-04,Yolo,113,214977,36647,35856,2856,38712,306
2022-03-04,Yuba,115,75493,15703,15666,1170,16836,115
2022-03-03,Alameda,001,1643700,253230,251988,13363,265351,1760
2022-03-03,Alpine,003,1148,122,125,1,126,0
2022-03-03,Amador,005,37829,8447,8344,636,8980,83
2022-03-03,Butte,007,227075,32902,32663,6936,39599,372
2022-03-03,Calaveras,009,45235,7195,7236,342,7578,116
2022-03-03,Colusa,011,21464,3432,3433,1042,4475,21
2022-03-03,Contra Costa,013,1133247,190107,185734,13138,198872,1235
2022-03-03,Del Norte,015,27424,5700,5725,177,5902,48
2022-03-03,El Dorado,017,186661,26508,26446,3165,29611,193
2022-03-03,Fresno,019,978130,232283,227154,24005,251159,2640
2022-03-03,Glenn,021,27897,4957,4927,1592,6519,43
2022-03-03,Humboldt,023,135768,16713,16781,2888,19669,136
2022-03-03,Imperial,025,180216,55083,54650,10465,65115,880
2022-03-03,Inyo,027,18085,4052,4043,465,4508,56
2022-03-03,Kern,029,883053,190869,189817,45496,235313,2141
2022-03-03,Kings,031,150075,51031,50926,3490,54416,431
2022-03-03,Lake,033,64148,10588,10512,870,11382,130
2022-03-03,Lassen,035,31185,8903,8818,870,9688,62
2022-03-03,Los Angeles,037,10098052,2694206,2671564,121716,2793280,30608
2022-03-03,Madera,039,155013,37042,37100,5973,43073,354
2022-03-03,Marin,041,260295,32938,32829,2149,34978,272
2022-03-03,Mariposa,043,17540,2367,2363,197,2560,6
2022-03-03,Mendocino,045,87422,12930,12845,2965,15810,113
2022-03-03,Merced,047,269075,62159,61653,8612,70265,789
2022-03-03,Modoc,049,8938,726,729,247,976,7
2022-03-03,Mono,051,14174,2960,2961,120,3081,5
2022-03-03,Monterey,053,433212,78748,78028,13200,91228,704
2022-03-03,Napa,055,140530,25404,25405,919,26324,134
2022-03-03,Nevada,057,99092,15817,15907,1171,17078,122
2022-03-03,Orange,059,3164182,543415,541463,40899,582362,6638
2022-03-03,Placer,061,380077,62269,62117,7261,69378,591
2022-03-03,Plumas,063,18699,2953,2701,357,3058,13
2022-03-03,Riverside,065,2383286,588576,586785,27532,614317,6239
2022-03-03,Sacramento,067,1510023,278737,273487,26261,299748,2847
2022-03-03,San Benito,069,59416,12874,12820,507,13327,94
2022-03-03,San Bernardino,071,2135413,571876,557421,24725,582146,6641
2022-03-03,San Diego,073,3302833,744675,740747,52097,792844,5045
2022-03-03,San Francisco,075,870044,122263,123537,8048,131585,798
2022-03-03,San Joaquin,077,732212,165690,165085,9793,174878,2069
2022-03-03,San Luis Obispo,079,281455,51952,51739,3673,55412,446
2022-03-03,San Mateo,081,765935,120026,118646,6789,125435,621
2022-03-03,Santa Barbara,083,443738,85095,85249,4644,89893,655
2022-03-03,Santa Clara,085,1922200,310627,307689,12127,319816,2195
2022-03-03,Santa Cruz,087,273765,47039,46622,2059,48681,253
2022-03-03,Shasta,089,179085,30301,30282,6027,36309,492
2022-03-03,Sierra,091,2930,271,273,47,320,4
2022-03-03,Siskiyou,093,43540,4400,4389,2698,7087,74
2022-03-03,Solano,095,438530,80736,80690,5489,86179,435
2022-03-03,Sonoma,097,501317,82571,82313,2540,84853,473
2022-03-03,Stanislaus,099,539301,116910,117501,17710,135211,1531
2022-03-03,Sutter,101,95872,20329,20346,2017,22363,217
2022-03-03,Tehama,103,63373,11982,11939,2562,14501,158
2022-03-03,Trinity,105,12862,1179,1170,284,1454,20
2022-03-03,Tulare,107,460477,105742,103534,27321,130855,1305
2022-03-03,Tuolumne,109,53932,12596,12325,551,12876,178
2022-03-03,Ventura,111,848112,171892,171666,9302,180968,1436
2022-03-03,Yolo,113,214977,36623,35856,2851,38707,306
2022-03-03,Yuba,115,75493,15697,15666,1165,16831,115
2022-03-02,Alameda,001,1643700,253052,251886,13346,265232,1759
2022-03-02,Alpine,003,1148,122,125,1,126,0
2022-03-02,Amador,005,37829,8434,8341,636,8977,83
2022-03-02,Butte,007,227075,32890,32636,6932,39568,372
2022-03-02,Calaveras,009,45235,7194,7225,342,7567,116
2022-03-02,Colusa,011,21464,3429,3428,1042,4470,21
2022-03-02,Contra Costa,013,1133247,190014,185589,13120,198709,1236
2022-03-02,Del Norte,015,27424,5693,5708,175,5883,47
2022-03-02,El Dorado,017,186661,26496,26433,3162,29595,192
2022-03-02,Fresno,019,978130,232150,226932,23995,250927,2629
2022-03-02,Glenn,021,27897,4956,4922,1591,6513,43
2022-03-02,Humboldt,023,135768,16703,16747,2881,19628,135
2022-03-02,Imperial,025,180216,55057,54629,10460,65089,878
2022-03-02,Inyo,027,18085,4050,4041,464,4505,56
2022-03-02,Kern,029,883053,190801,189656,45477,235133,2136
2022-03-02,Kings,031,150075,51005,50819,3487,54306,431
2022-03-02,Lake,033,64148,10575,10495,868,11363,130
2022-03-02,Lassen,035,31185,8900,8811,869,9680,62
2022-03-02,Los Angeles,037,10098052,2693328,2670287,121669,2791956,30535
2022-03-02,Madera,039,155013,37025,37077,5971,43048,354
2022-03-02,Marin,041,260295,32921,32794,2148,34942,272
2022-03-02,Mariposa,043,17540,2367,2359,197,2556,6
2022-03-02,Mendocino,045,87422,12917,12832,2960,15792,112
2022-03-02,Merced,047,269075,62134,61606,8603,70209,785
2022-03-02,Modoc,049,8938,726,729,247,976,7
2022-03-02,Mono,051,14174,2960,2961,120,3081,5
2022-03-02,Monterey,053,433212,78711,77963,13177,91140,703
2022-03-02,Napa,055,140530,25355,25382,918,26300,134
2022-03-02,Nevada,057,99092,15806,15920,1170,17090,122
2022-03-02,Orange,059,3164182,543211,541230,40872,582102,6623
2022-03-02,Placer,061,380077,62247,62066,7258,69324,589
2022-03-02,Plumas,063,18699,2953,2700,357,3057,13
2022-03-02,Riverside,065,2383286,588426,586513,27522,614035,6229
2022-03-02,Sacramento,067,1510023,278620,273291,26250,299541,2837
2022-03-02,San Benito,069,59416,12863,12814,507,13321,94
2022-03-02,San Bernardino,071,2135413,571766,557082,24719,581801,6619
2022-03-02,San Diego,073,3302833,744315,739803,52049,791852,5034
2022-03-02,San Francisco,075,870044,122168,123442,8046,131488,792
2022-03-02,San Joaquin,077,732212,165631,164968,9788,174756,2063
2022-03-02,San Luis Obispo,079,281455,51914,51686,3668,55354,446
2022-03-02,San Mateo,081,765935,119939,118518,6773,125291,617
2022-03-02,Santa Barbara,083,443738,85070,85183,4643,89826,655
2022-03-02,Santa Clara,085,1922200,310413,307354,12114,319468,2184
2022-03-02,Santa Cruz,087,273765,46968,46534,2058,48592,253
2022-03-02,Shasta,089,179085,30276,30253,6017,36270,490
2022-03-02,Sierra,091,2930,271,273,47,320,4
2022-03-02,Siskiyou,093,43540,4399,4384,2695,7079,74
2022-03-02,Solano,095,438530,80670,80626,5486,86112,433
2022-03-02,Sonoma,097,501317,82525,82208,2536,84744,473
2022-03-02,Stanislaus,099,539301,116874,117411,17685,135096,1519
2022-03-02,Sutter,101,95872,20307,20317,2000,22317,216
2022-03-02,Tehama,103,63373,11978,11930,2561,14491,158
2022-03-02,Trinity,105,12862,1177,1160,284,1444,20
2022-03-02,Tulare,107,460477,105702,103451,27306,130757,1302
2022-03-02,Tuolumne,109,53932,12591,12297,551,12848,179
2022-03-02,Ventura,111,848112,171839,171770,9298,181068,1427
2022-03-02,Yolo,113,214977,36605,35799,2846,38645,305
2022-03-02,Yuba,115,75493,15684,15653,1160,16813,115
2022-03-01,Alameda,001,1643700,252882,251830,13334,265164,1749
2022-03-01,Alpine,003,1148,122,125,1,126,0
2022-03-01,Amador,005,37829,8386,8334,634,8968,83
2022-03-01,Butte,007,227075,32866,32575,6927,39502,372
2022-03-01,Calaveras,009,45235,7191,7223,341,7564,116
2022-03-01,Colusa,011,21464,3428,3423,1042,4465,21
2022-03-01,Contra Costa,013,1133247,189904,185378,13105,198483,1231
2022-03-01,Del Norte,015,27424,5690,5701,174,5875,45
2022-03-01,El Dorado,017,186661,26477,26413,3160,29573,192
2022-03-01,Fresno,019,978130,232010,226594,23981,250575,2628
2022-03-01,Glenn,021,27897,4954,4919,1589,6508,40
2022-03-01,Humboldt,023,135768,16682,16727,2874,19601,135
2022-03-01,Imperial,025,180216,55040,54570,10454,65024,875
2022-03-01,Inyo,027,18085,4046,4041,463,4504,56
2022-03-01,Kern,029,883053,190727,189365,45453,234818,2120
2022-03-01,Kings,031,150075,50983,50763,3483,54246,427
2022-03-01,Lake,033,64148,10564,10471,866,11337,128
2022-03-01,Lassen,035,31185,8896,8801,869,9670,61
2022-03-01,Los Angeles,037,10098052,2692378,2669489,121612,2791101,30486
2022-03-01,Madera,039,155013,37005,37046,5965,43011,354
2022-03-01,Marin,041,260295,32895,32764,2147,34911,272
2022-03-01,Mariposa,043,17540,2366,2357,196,2553,6
2022-03-01,Mendocino,045,87422,12906,12818,2958,15776,112
2022-03-01,Merced,047,269075,62103,61549,8589,70138,781
2022-03-01,Modoc,049,8938,726,729,247,976,7
2022-03-01,Mono,051,14174,2959,2960,120,3080,6
2022-03-01,Monterey,053,433212,78685,77911,13167,91078,696
2022-03-01,Napa,055,140530,25324,25344,918,26262,134
2022-03-01,Nevada,057,99092,15798,15916,1167,17083,121
2022-03-01,Orange,059,3164182,542995,541054,40837,581891,6612
2022-03-01,Placer,061,380077,62219,62021,7253,69274,583
2022-03-01,Plumas,063,18699,2953,2694,357,3051,13
2022-03-01,Riverside,065,2383286,588262,586184,27521,613705,6198
2022-03-01,Sacramento,067,1510023,278490,273089,26237,299326,2831
2022-03-01,San Benito,069,59416,12859,12806,507,13313,94
2022-03-01,San Bernardino,071,2135413,571632,556743,24717,581460,6588
2022-03-01,San Diego,073,3302833,743890,739136,52007,791143,5029
2022-03-01,San Francisco,075,870044,122065,123481,8040,131521,792
2022-03-01,San Joaquin,077,732212,165564,164894,9784,174678,2062
2022-03-01,San Luis Obispo,079,281455,51878,51592,3664,55256,445
2022-03-01,San Mateo,081,765935,119867,118358,6766,125124,613
2022-03-01,Santa Barbara,083,443738,85034,85134,4639,89773,654
2022-03-01,Santa Clara,085,1922200,310158,306978,12102,319080,2190
2022-03-01,Santa Cruz,087,273765,46918,46471,2055,48526,253
2022-03-01,Shasta,089,179085,30247,30227,6014,36241,489
2022-03-01,Sierra,091,2930,271,274,47,321,5
2022-03-01,Siskiyou,093,43540,4397,4384,2692,7076,74
2022-03-01,Solano,095,438530,80607,80556,5483,86039,434
2022-03-01,Sonoma,097,501317,82456,82103,2530,84633,477
2022-03-01,Stanislaus,099,539301,116822,117308,17660,134968,1521
2022-03-01,Sutter,101,95872,20293,20288,1996,22284,217
2022-03-01,Tehama,103,63373,11972,11923,2558,14481,158
2022-03-01,Trinity,105,12862,1176,1159,284,1443,20
2022-03-01,Tulare,107,460477,105620,103371,27286,130657,1302
2022-03-01,Tuolumne,109,53932,12584,12276,549,12825,175
2022-03-01,Ventura,111,848112,171769,171672,9291,180963,1427
2022-03-01,Yolo,113,214977,36580,35801,2840,38641,299
2022-03-01,Yuba,115,75493,15676,15637,1160,16797,116
2022-02-28,Alameda,001,1643700,252659,251714,13320,265034,1742
2022-02-28,Alpine,003,1148,122,125,1,126,0
2022-02-28,Amador,005,37829,8380,8308,633,8941,83
2022-02-28,Butte,007,227075,32847,32550,6921,39471,368
2022-02-28,Calaveras,009,45235,7188,7220,340,7560,110
2022-02-28,Colusa,011,21464,3427,3422,1040,4462,21
2022-02-28,Contra Costa,013,1133247,189799,185272,13086,198358,1231
2022-02-28,Del Norte,015,27424,5685,5699,173,5872,45
2022-02-28,El Dorado,017,186661,26467,26409,3155,29564,191
2022-02-28,Fresno,019,978130,231809,226519,23960,250479,2622
2022-02-28,Glenn,021,27897,4950,4918,1589,6507,40
2022-02-28,Humboldt,023,135768,16667,16717,2870,19587,135
2022-02-28,Imperial,025,180216,55013,54517,10450,64967,875
2022-02-28,Inyo,027,18085,4046,4041,462,4503,56
2022-02-28,Kern,029,883053,190635,189245,45424,234669,2115
2022-02-28,Kings,031,150075,50943,50741,3482,54223,427
2022-02-28,Lake,033,64148,10552,10468,862,11330,128
2022-02-28,Lassen,035,31185,8839,8794,869,9663,55
2022-02-28,Los Angeles,037,10098052,2691214,2666804,121516,2788320,30410
2022-02-28,Madera,039,155013,36979,37023,5949,42972,354
2022-02-28,Marin,041,260295,32870,32775,2147,34922,272
2022-02-28,Mariposa,043,17540,2363,2354,194,2548,6
2022-02-28,Mendocino,045,87422,12897,12800,2950,15750,112
2022-02-28,Merced,047,269075,62058,61519,8572,70091,781
2022-02-28,Modoc,049,8938,726,727,247,974,7
2022-02-28,Mono,051,14174,2959,2961,120,3081,5
2022-02-28,Monterey,053,433212,78618,77865,13146,91011,693
2022-02-28,Napa,055,140530,25297,25317,918,26235,129
2022-02-28,Nevada,057,99092,15792,15908,1161,17069,121
2022-02-28,Orange,059,3164182,542742,540839,40823,581662,6605
2022-02-28,Placer,061,380077,62188,61976,7248,69224,577
2022-02-28,Plumas,063,18699,2953,2691,356,3047,13
2022-02-28,Riverside,065,2383286,588068,585891,27489,613380,6179
2022-02-28,Sacramento,067,1510023,278350,273038,26213,299251,2825
2022-02-28,San Benito,069,59416,12854,12798,507,13305,94
2022-02-28,San Bernardino,071,2135413,571448,556540,24703,581243,6576
2022-02-28,San Diego,073,3302833,743502,737760,51977,789737,5018
2022-02-28,San Francisco,075,870044,121905,123402,8034,131436,792
2022-02-28,San Joaquin,077,732212,165480,164833,9774,174607,2060
2022-02-28,San Luis Obispo,079,281455,51817,51565,3657,55222,440
2022-02-28,San Mateo,081,765935,119769,118301,6760,125061,611
2022-02-28,Santa Barbara,083,443738,84990,85076,4634,89710,653
2022-02-28,Santa Clara,085,1922200,309879,306930,12081,319011,2180
2022-02-28,Santa Cruz,087,273765,46848,46447,2055,48502,253
2022-02-28,Shasta,089,179085,30222,30213,6010,36223,488
2022-02-28,Sierra,091,2930,271,273,47,320,4
2022-02-28,Siskiyou,093,43540,4394,4382,2687,7069,74
2022-02-28,Solano,095,438530,80539,80544,5471,86015,430
2022-02-28,Sonoma,097,501317,82388,82058,2527,84585,477
2022-02-28,Stanislaus,099,539301,116758,117231,17643,134874,1521
2022-02-28,Sutter,101,95872,20280,20285,1993,22278,214
2022-02-28,Tehama,103,63373,11959,11917,2558,14475,158
2022-02-28,Trinity,105,12862,1176,1160,284,1444,20
2022-02-28,Tulare,107,460477,105571,103304,27270,130574,1300
2022-02-28,Tuolumne,109,53932,12574,12247,549,12796,175
2022-02-28,Ventura,111,848112,171685,171614,9290,180904,1423
2022-02-28,Yolo,113,214977,36544,35754,2833,38587,299
2022-02-28,Yuba,115,75493,15661,15625,1159,16784,115
2022-02-27,Alameda,001,1643700,252385,251624,13311,264935,1744
2022-02-27,Alpine,003,1148,122,125,1,126,0
2022-02-27,Amador,005,37829,8376,8305,630,8935,83
2022-02-27,Butte,007,227075,32811,32551,6908,39459,368
2022-02-27,Calaveras,009,45235,7180,7214,340,7554,110
2022-02-27,Colusa,011,21464,3425,3422,1040,4462,21
2022-02-27,Contra Costa,013,1133247,189670,185185,13066,198251,1230
2022-02-27,Del Norte,015,27424,5668,5691,171,5862,45
2022-02-27,El Dorado,017,186661,26449,26410,3153,29563,191
2022-02-27,Fresno,019,978130,231609,226397,23933,250330,2621
2022-02-27,Glenn,021,27897,4948,4915,1589,6504,40
2022-02-27,Humboldt,023,135768,16645,16713,2863,19576,135
2022-02-27,Imperial,025,180216,54965,54509,10433,64942,875
2022-02-27,Inyo,027,18085,4045,4041,458,4499,56
2022-02-27,Kern,029,883053,190518,189219,45385,234604,2115
2022-02-27,Kings,031,150075,50915,50733,3481,54214,428
2022-02-27,Lake,033,64148,10533,10463,862,11325,128
2022-02-27,Lassen,035,31185,8831,8786,869,9655,55
2022-02-27,Los Angeles,037,10098052,2689905,2666789,121435,2788224,30410
2022-02-27,Madera,039,155013,36953,37009,5941,42950,354
2022-02-27,Marin,041,260295,32832,32756,2145,34901,272
2022-02-27,Mariposa,043,17540,2360,2352,194,2546,6
2022-02-27,Mendocino,045,87422,12880,12798,2937,15735,112
2022-02-27,Merced,047,269075,62005,61491,8554,70045,779
2022-02-27,Modoc,049,8938,725,727,247,974,7
2022-02-27,Mono,051,14174,2958,2960,120,3080,5
2022-02-27,Monterey,053,433212,78561,77851,13122,90973,693
2022-02-27,Napa,055,140530,25260,25316,918,26234,129
2022-02-27,Nevada,057,99092,15784,15900,1157,17057,121
2022-02-27,Orange,059,3164182,542496,540659,40794,581453,6605
2022-02-27,Placer,061,380077,62148,61965,7244,69209,577
2022-02-27,Plumas,063,18699,2950,2691,356,3047,13
2022-02-27,Riverside,065,2383286,587827,585833,27465,613298,6179
2022-02-27,Sacramento,067,1510023,278161,272927,26184,299111,2822
2022-02-27,San Benito,069,59416,12847,12798,507,13305,94
2022-02-27,San Bernardino,071,2135413,571263,556457,24693,581150,6572
2022-02-27,San Diego,073,3302833,743031,737760,51931,789691,5018
2022-02-27,San Francisco,075,870044,121781,123327,8023,131350,791
2022-02-27,San Joaquin,077,732212,165376,164814,9767,174581,2060
2022-02-27,San Luis Obispo,079,281455,51725,51564,3650,55214,439
2022-02-27,San Mateo,081,765935,119659,118244,6755,124999,611
2022-02-27,Santa Barbara,083,443738,84952,85050,4630,89680,653
2022-02-27,Santa Clara,085,1922200,309590,306756,12054,318810,2180
2022-02-27,Santa Cruz,087,273765,46787,46411,2055,48466,253
2022-02-27,Shasta,089,179085,30190,30206,6005,36211,488
2022-02-27,Sierra,091,2930,271,273,47,320,4
2022-02-27,Siskiyou,093,43540,4389,4378,2675,7053,74
2022-02-27,Solano,095,438530,80465,80515,5458,85973,430
2022-02-27,Sonoma,097,501317,82306,82041,2520,84561,476
2022-02-27,Stanislaus,099,539301,116692,117200,17623,134823,1522
2022-02-27,Sutter,101,95872,20263,20280,1987,22267,214
2022-02-27,Tehama,103,63373,11946,11915,2557,14472,158
2022-02-27,Trinity,105,12862,1175,1158,284,1442,20
2022-02-27,Tulare,107,460477,105502,103270,27221,130491,1300
2022-02-27,Tuolumne,109,53932,12561,12243,548,12791,175
2022-02-27,Ventura,111,848112,171610,171660,9286,180946,1423
2022-02-27,Yolo,113,214977,36517,35744,2828,38572,299
2022-02-27,Yuba,115,75493,15651,15619,1157,16776,113
2022-02-26,Alameda,001,1643700,252271,250867,13307,264174,1716
2022-02-26,Alpine,003,1148,122,125,1,126,0
2022-02-26,Amador,005,37829,8374,8282,629,8911,83
2022-02-26,Butte,007,227075,32797,32466,6905,39371,368
2022-02-26,Calaveras,009,45235,7179,7192,340,7532,110
2022-02-26,Colusa,011,21464,3425,3414,1040,4454,21
2022-02-26,Contra Costa,013,1133247,189602,184686,13048,197734,1209
2022-02-26,Del Norte,015,27424,5663,5639,171,5810,45
2022-02-26,El Dorado,017,186661,26437,26355,3150,29505,191
2022-02-26,Fresno,019,978130,231519,225679,23933,249612,2597
2022-02-26,Glenn,021,27897,4946,4909,1588,6497,40
2022-02-26,Humboldt,023,135768,16620,16619,2862,19481,133
2022-02-26,Imperial,025,180216,54938,54367,10431,64798,871
2022-02-26,Inyo,027,18085,4044,4034,453,4487,56
2022-02-26,Kern,029,883053,190465,188584,45366,233950,2106
2022-02-26,Kings,031,150075,50902,50579,3481,54060,423
2022-02-26,Lake,033,64148,10528,10383,862,11245,128
2022-02-26,Lassen,035,31185,8830,8761,869,9630,55
2022-02-26,Los Angeles,037,10098052,2689335,2660973,121395,2782368,30202
2022-02-26,Madera,039,155013,36938,36933,5939,42872,330
2022-02-26,Marin,041,260295,32816,32651,2143,34794,267
2022-02-26,Mariposa,043,17540,2359,2332,194,2526,6
2022-02-26,Mendocino,045,87422,12873,12762,2937,15699,111
2022-02-26,Merced,047,269075,61984,61348,8553,69901,775
2022-02-26,Modoc,049,8938,725,726,247,973,7
2022-02-26,Mono,051,14174,2958,2959,119,3078,5
2022-02-26,Monterey,053,433212,78529,77610,13116,90726,692
2022-02-26,Napa,055,140530,25245,25221,917,26138,130
2022-02-26,Nevada,057,99092,15780,15850,1155,17005,121
2022-02-26,Orange,059,3164182,542385,539992,40777,580769,6540
2022-02-26,Placer,061,380077,62129,61803,7241,69044,573
2022-02-26,Plumas,063,18699,2950,2673,356,3029,13
2022-02-26,Riverside,065,2383286,587706,584835,27456,612291,6143
2022-02-26,Sacramento,067,1510023,278065,272339,26174,298513,2793
2022-02-26,San Benito,069,59416,12843,12770,507,13277,92
2022-02-26,San Bernardino,071,2135413,571174,555668,24686,580354,6505
2022-02-26,San Diego,073,3302833,742808,736049,51907,787956,5002
2022-02-26,San Francisco,075,870044,121711,123079,8015,131094,769
2022-02-26,San Joaquin,077,732212,165343,164418,9766,174184,2048
2022-02-26,San Luis Obispo,079,281455,51713,51358,3648,55006,438
2022-02-26,San Mateo,081,765935,119605,117860,6754,124614,603
2022-02-26,Santa Barbara,083,443738,84921,84830,4630,89460,652
2022-02-26,Santa Clara,085,1922200,309441,305895,12050,317945,2166
2022-02-26,Santa Cruz,087,273765,46764,46186,2055,48241,251
2022-02-26,Shasta,089,179085,30181,30108,5999,36107,485
2022-02-26,Sierra,091,2930,271,270,47,317,1
2022-02-26,Siskiyou,093,43540,4389,4359,2673,7032,72
2022-02-26,Solano,095,438530,80430,80225,5454,85679,428
2022-02-26,Sonoma,097,501317,82272,81702,2518,84220,432
2022-02-26,Stanislaus,099,539301,116654,116896,17618,134514,1503
2022-02-26,Sutter,101,95872,20254,20230,1987,22217,214
2022-02-26,Tehama,103,63373,11940,11878,2555,14433,158
2022-02-26,Trinity,105,12862,1174,1156,284,1440,20
2022-02-26,Tulare,107,460477,105466,102983,27206,130189,1295
2022-02-26,Tuolumne,109,53932,12558,12169,548,12717,175
2022-02-26,Ventura,111,848112,171578,171292,9283,180575,1411
2022-02-26,Yolo,113,214977,36496,35615,2825,38440,296
2022-02-26,Yuba,115,75493,15639,15587,1157,16744,113
2022-02-25,Alameda,001,1643700,252148,250867,13298,264165,1716
2022-02-25,Alpine,003,1148,122,125,1,126,0
2022-02-25,Amador,005,37829,8363,8282,629,8911,83
2022-02-25,Butte,007,227075,32784,32466,6902,39368,368
2022-02-25,Calaveras,009,45235,7177,7192,340,7532,110
2022-02-25,Colusa,011,21464,3425,3414,1040,4454,21
2022-02-25,Contra Costa,013,1133247,189518,184686,13027,197713,1209
2022-02-25,Del Norte,015,27424,5654,5639,171,5810,45
2022-02-25,El Dorado,017,186661,26429,26355,3150,29505,191
2022-02-25,Fresno,019,978130,231422,225679,23926,249605,2597
2022-02-25,Glenn,021,27897,4944,4909,1588,6497,40
2022-02-25,Humboldt,023,135768,16609,16619,2862,19481,133
2022-02-25,Imperial,025,180216,54920,54367,10430,64797,871
2022-02-25,Inyo,027,18085,4043,4034,453,4487,56
2022-02-25,Kern,029,883053,190400,188584,45353,233937,2106
2022-02-25,Kings,031,150075,50888,50579,3479,54058,423
2022-02-25,Lake,033,64148,10510,10383,862,11245,128
2022-02-25,Lassen,035,31185,8827,8761,869,9630,55
2022-02-25,Los Angeles,037,10098052,2688749,2660973,121364,2782337,30202
2022-02-25,Madera,039,155013,36918,36933,5938,42871,330
2022-02-25,Marin,041,260295,32802,32651,2143,34794,267
2022-02-25,Mariposa,043,17540,2356,2332,194,2526,6
2022-02-25,Mendocino,045,87422,12871,12762,2937,15699,111
2022-02-25,Merced,047,269075,61953,61348,8548,69896,775
2022-02-25,Modoc,049,8938,725,726,247,973,7
2022-02-25,Mono,051,14174,2957,2959,119,3078,5
2022-02-25,Monterey,053,433212,78501,77610,13110,90720,692
2022-02-25,Napa,055,140530,25236,25221,917,26138,130
2022-02-25,Nevada,057,99092,15769,15850,1152,17002,121
2022-02-25,Orange,059,3164182,542250,539992,40754,580746,6540
2022-02-25,Placer,061,380077,62114,61803,7235,69038,573
2022-02-25,Plumas,063,18699,2948,2673,356,3029,13
2022-02-25,Riverside,065,2383286,587552,584835,27444,612279,6143
2022-02-25,Sacramento,067,1510023,277963,272339,26169,298508,2793
2022-02-25,San Benito,069,59416,12841,12770,507,13277,92
2022-02-25,San Bernardino,071,2135413,571067,555668,24679,580347,6505
2022-02-25,San Diego,073,3302833,742525,736049,51888,787937,5002
2022-02-25,San Francisco,075,870044,121630,123079,8012,131091,769
2022-02-25,San Joaquin,077,732212,165303,164418,9761,174179,2048
2022-02-25,San Luis Obispo,079,281455,51709,51358,3639,54997,438
2022-02-25,San Mateo,081,765935,119543,117860,6750,124610,603
2022-02-25,Santa Barbara,083,443738,84884,84830,4630,89460,652
2022-02-25,Santa Clara,085,1922200,309255,305895,12047,317942,2166
2022-02-25,Santa Cruz,087,273765,46730,46186,2053,48239,251
2022-02-25,Shasta,089,179085,30172,30108,5997,36105,485
2022-02-25,Sierra,091,2930,271,270,47,317,1
2022-02-25,Siskiyou,093,43540,4389,4359,2672,7031,72
2022-02-25,Solano,095,438530,80401,80225,5453,85678,428
2022-02-25,Sonoma,097,501317,82221,81702,2516,84218,432
2022-02-25,Stanislaus,099,539301,116626,116896,17614,134510,1503
2022-02-25,Sutter,101,95872,20245,20230,1987,22217,214
2022-02-25,Tehama,103,63373,11938,11878,2555,14433,158
2022-02-25,Trinity,105,12862,1174,1156,284,1440,20
2022-02-25,Tulare,107,460477,105432,102983,27184,130167,1295
2022-02-25,Tuolumne,109,53932,12555,12169,548,12717,175
2022-02-25,Ventura,111,848112,171527,171292,9282,180574,1411
2022-02-25,Yolo,113,214977,36481,35615,2825,38440,296
2022-02-25,Yuba,115,75493,15632,15587,1157,16744,113
2022-02-24,Alameda,001,1643700,251940,250867,13289,264156,1716
2022-02-24,Alpine,003,1148,122,125,1,126,0
2022-02-24,Amador,005,37829,8358,8282,628,8910,83
2022-02-24,Butte,007,227075,32763,32466,6898,39364,368
2022-02-24,Calaveras,009,45235,7175,7192,338,7530,110
2022-02-24,Colusa,011,21464,3424,3414,1039,4453,21
2022-02-24,Contra Costa,013,1133247,189389,184686,13018,197704,1209
2022-02-24,Del Norte,015,27424,5639,5639,170,5809,45
2022-02-24,El Dorado,017,186661,26414,26355,3150,29505,191
2022-02-24,Fresno,019,978130,231227,225679,23911,249590,2597
2022-02-24,Glenn,021,27897,4942,4909,1587,6496,40
2022-02-24,Humboldt,023,135768,16593,16619,2861,19480,133
2022-02-24,Imperial,025,180216,54880,54367,10421,64788,871
2022-02-24,Inyo,027,18085,4042,4034,452,4486,56
2022-02-24,Kern,029,883053,190260,188584,45320,233904,2106
2022-02-24,Kings,031,150075,50858,50579,3474,54053,423
2022-02-24,Lake,033,64148,10493,10383,862,11245,128
2022-02-24,Lassen,035,31185,8823,8761,868,9629,55
2022-02-24,Los Angeles,037,10098052,2687592,2660973,121309,2782282,30202
2022-02-24,Madera,039,155013,36892,36933,5936,42869,330
2022-02-24,Marin,041,260295,32782,32651,2142,34793,267
2022-02-24,Mariposa,043,17540,2350,2332,193,2525,6
2022-02-24,Mendocino,045,87422,12864,12762,2933,15695,111
2022-02-24,Merced,047,269075,61923,61348,8539,69887,775
2022-02-24,Modoc,049,8938,724,726,247,973,7
2022-02-24,Mono,051,14174,2956,2959,119,3078,5
2022-02-24,Monterey,053,433212,78449,77610,13102,90712,692
2022-02-24,Napa,055,140530,25196,25221,913,26134,130
2022-02-24,Nevada,057,99092,15755,15850,1152,17002,121
2022-02-24,Orange,059,3164182,542001,539992,40719,580711,6540
2022-02-24,Placer,061,380077,62077,61803,7233,69036,573
2022-02-24,Plumas,063,18699,2943,2673,355,3028,13
2022-02-24,Riverside,065,2383286,587299,584835,27418,612253,6143
2022-02-24,Sacramento,067,1510023,277790,272339,26153,298492,2793
2022-02-24,San Benito,069,59416,12830,12770,507,13277,92
2022-02-24,San Bernardino,071,2135413,570874,555668,24667,580335,6505
2022-02-24,San Diego,073,3302833,742111,736049,51841,787890,5002
2022-02-24,San Francisco,075,870044,121507,123079,8005,131084,769
2022-02-24,San Joaquin,077,732212,165175,164418,9757,174175,2048
2022-02-24,San Luis Obispo,079,281455,51663,51358,3637,54995,438
2022-02-24,San Mateo,081,765935,119450,117860,6744,124604,603
2022-02-24,Santa Barbara,083,443738,84819,84830,4629,89459,652
2022-02-24,Santa Clara,085,1922200,309020,305895,12034,317929,2166
2022-02-24,Santa Cruz,087,273765,46650,46186,2051,48237,251
2022-02-24,Shasta,089,179085,30153,30108,5991,36099,485
2022-02-24,Sierra,091,2930,271,270,47,317,1
2022-02-24,Siskiyou,093,43540,4386,4359,2669,7028,72
2022-02-24,Solano,095,438530,80322,80225,5449,85674,428
2022-02-24,Sonoma,097,501317,82167,81702,2511,84213,432
2022-02-24,Stanislaus,099,539301,116551,116896,17601,134497,1503
2022-02-24,Sutter,101,95872,20231,20230,1971,22201,214
2022-02-24,Tehama,103,63373,11932,11878,2554,14432,158
2022-02-24,Trinity,105,12862,1172,1156,284,1440,20
2022-02-24,Tulare,107,460477,105376,102983,27155,130138,1295
2022-02-24,Tuolumne,109,53932,12545,12169,546,12715,175
2022-02-24,Ventura,111,848112,171449,171292,9279,180571,1411
2022-02-24,Yolo,113,214977,36455,35615,2823,38438,296
2022-02-24,Yuba,115,75493,15618,15587,1157,16744,113
2022-02-23,Alameda,001,1643700,251714,247686,13275,260961,1713
2022-02-23,Alpine,003,1148,122,125,1,126,0
2022-02-23,Amador,005,37829,8340,8274,628,8902,79
2022-02-23,Butte,007,227075,32736,32417,6895,39312,367
2022-02-23,Calaveras,009,45235,7165,7182,337,7519,107
2022-02-23,Colusa,011,21464,3420,3411,1039,4450,21
2022-02-23,Contra Costa,013,1133247,189246,184013,13005,197018,1209
2022-02-23,Del Norte,015,27424,5628,5625,169,5794,45
2022-02-23,El Dorado,017,186661,26398,26317,3146,29463,189
2022-02-23,Fresno,019,978130,231040,225308,23888,249196,2596
2022-02-23,Glenn,021,27897,4938,4909,1585,6494,40
2022-02-23,Humboldt,023,135768,16577,16601,2858,19459,132
2022-02-23,Imperial,025,180216,54841,54292,10408,64700,871
2022-02-23,Inyo,027,18085,4041,4031,449,4480,54
2022-02-23,Kern,029,883053,190157,188432,45273,233705,2106
2022-02-23,Kings,031,150075,50825,50416,3473,53889,423
2022-02-23,Lake,033,64148,10475,10368,861,11229,126
2022-02-23,Lassen,035,31185,8807,8749,868,9617,55
2022-02-23,Los Angeles,037,10098052,2686230,2659569,121267,2780836,30167
2022-02-23,Madera,039,155013,36861,36876,5926,42802,330
2022-02-23,Marin,041,260295,32759,32625,2141,34766,267
2022-02-23,Mariposa,043,17540,2345,2325,192,2517,6
2022-02-23,Mendocino,045,87422,12854,12747,2929,15676,111
2022-02-23,Merced,047,269075,61891,61295,8533,69828,772
2022-02-23,Modoc,049,8938,724,723,246,969,7
2022-02-23,Mono,051,14174,2955,2960,119,3079,5
2022-02-23,Monterey,053,433212,78411,77472,13079,90551,691
2022-02-23,Napa,055,140530,25171,25185,908,26093,128
2022-02-23,Nevada,057,99092,15749,15825,1149,16974,121
2022-02-23,Orange,059,3164182,541696,539631,40697,580328,6520
2022-02-23,Placer,061,380077,62030,61758,7226,68984,573
2022-02-23,Plumas,063,18699,2939,2663,355,3018,13
2022-02-23,Riverside,065,2383286,587008,584381,27382,611763,6119
2022-02-23,Sacramento,067,1510023,277631,272057,26132,298189,2796
2022-02-23,San Benito,069,59416,12823,12756,506,13262,92
2022-02-23,San Bernardino,071,2135413,570714,555238,24651,579889,6479
2022-02-23,San Diego,073,3302833,741607,735406,51791,787197,4988
2022-02-23,San Francisco,075,870044,121380,122127,8003,130130,769
2022-02-23,San Joaquin,077,732212,165083,164257,9751,174008,2042
2022-02-23,San Luis Obispo,079,281455,51615,51264,3635,54899,434
2022-02-23,San Mateo,081,765935,119359,117585,6735,124320,603
2022-02-23,Santa Barbara,083,443738,84758,84760,4625,89385,651
2022-02-23,Santa Clara,085,1922200,308763,305484,12025,317509,2157
2022-02-23,Santa Cruz,087,273765,46580,46059,2050,48109,251
2022-02-23,Shasta,089,179085,30125,30066,5988,36054,481
2022-02-23,Sierra,091,2930,271,270,47,317,1
2022-02-23,Siskiyou,093,43540,4383,4356,2667,7023,71
2022-02-23,Solano,095,438530,80232,80103,5447,85550,427
2022-02-23,Sonoma,097,501317,82113,81594,2509,84103,432
2022-02-23,Stanislaus,099,539301,116474,116789,17592,134381,1482
2022-02-23,Sutter,101,95872,20214,20194,1967,22161,213
2022-02-23,Tehama,103,63373,11922,11863,2554,14417,154
2022-02-23,Trinity,105,12862,1172,1156,284,1440,20
2022-02-23,Tulare,107,460477,105309,102812,27132,129944,1290
2022-02-23,Tuolumne,109,53932,12536,12158,545,12703,175
2022-02-23,Ventura,111,848112,171361,171163,9272,180435,1401
2022-02-23,Yolo,113,214977,36417,35590,2816,38406,296
2022-02-23,Yuba,115,75493,15615,15571,1155,16726,113
2022-02-22,Alameda,001,1643700,251466,247434,13264,260698,1706
2022-02-22,Alpine,003,1148,122,124,1,125,0
2022-02-22,Amador,005,37829,8330,8243,628,8871,79
2022-02-22,Butte,007,227075,32701,32359,6888,39247,366
2022-02-22,Calaveras,009,45235,7156,7178,337,7515,107
2022-02-22,Colusa,011,21464,3419,3402,1037,4439,21
2022-02-22,Contra Costa,013,1133247,189093,183812,12986,196798,1201
2022-02-22,Del Norte,015,27424,5619,5611,168,5779,45
2022-02-22,El Dorado,017,186661,26389,26289,3146,29435,189
2022-02-22,Fresno,019,978130,230814,225104,23862,248966,2592
2022-02-22,Glenn,021,27897,4937,4900,1584,6484,40
2022-02-22,Humboldt,023,135768,16553,16559,2854,19413,132
2022-02-22,Imperial,025,180216,54809,54227,10404,64631,864
2022-02-22,Inyo,027,18085,4039,4026,447,4473,54
2022-02-22,Kern,029,883053,190037,188237,45237,233474,2102
2022-02-22,Kings,031,150075,50763,50359,3471,53830,423
2022-02-22,Lake,033,64148,10464,10353,859,11212,126
2022-02-22,Lassen,035,31185,8803,8730,868,9598,55
2022-02-22,Los Angeles,037,10098052,2684772,2658230,121178,2779408,30129
2022-02-22,Madera,039,155013,36827,36833,5917,42750,330
2022-02-22,Marin,041,260295,32734,32591,2140,34731,267
2022-02-22,Mariposa,043,17540,2337,2322,192,2514,6
2022-02-22,Mendocino,045,87422,12840,12714,2919,15633,110
2022-02-22,Merced,047,269075,61830,61241,8526,69767,770
2022-02-22,Modoc,049,8938,721,720,246,966,6
2022-02-22,Mono,051,14174,2955,2961,119,3080,5
2022-02-22,Monterey,053,433212,78357,77359,13060,90419,690
2022-02-22,Napa,055,140530,25142,25151,907,26058,128
2022-02-22,Nevada,057,99092,15733,15815,1148,16963,121
2022-02-22,Orange,059,3164182,541409,539390,40664,580054,6502
2022-02-22,Placer,061,380077,61992,61709,7221,68930,572
2022-02-22,Plumas,063,18699,2933,2659,354,3013,13
2022-02-22,Riverside,065,2383286,586751,583969,27362,611331,6097
2022-02-22,Sacramento,067,1510023,277441,271789,26108,297897,2775
2022-02-22,San Benito,069,59416,12812,12742,505,13247,92
2022-02-22,San Bernardino,071,2135413,570512,554903,24632,579535,6451
2022-02-22,San Diego,073,3302833,741082,734536,51736,786272,4974
2022-02-22,San Francisco,075,870044,121251,121954,7999,129953,769
2022-02-22,San Joaquin,077,732212,164962,164111,9741,173852,2040
2022-02-22,San Luis Obispo,079,281455,51530,51193,3629,54822,431
2022-02-22,San Mateo,081,765935,119265,117418,6730,124148,603
2022-02-22,Santa Barbara,083,443738,84697,84701,4621,89322,650
2022-02-22,Santa Clara,085,1922200,308480,305045,12019,317064,2155
2022-02-22,Santa Cruz,087,273765,46515,45958,2050,48008,251
2022-02-22,Shasta,089,179085,30100,30024,5983,36007,479
2022-02-22,Sierra,091,2930,271,269,46,315,0
2022-02-22,Siskiyou,093,43540,4380,4350,2662,7012,70
2022-02-22,Solano,095,438530,80156,79968,5445,85413,425
2022-02-22,Sonoma,097,501317,82047,81412,2505,83917,431
2022-02-22,Stanislaus,099,539301,116393,116676,17572,134248,1475
2022-02-22,Sutter,101,95872,20198,20164,1965,22129,210
2022-02-22,Tehama,103,63373,11913,11852,2553,14405,152
2022-02-22,Trinity,105,12862,1172,1147,283,1430,20
2022-02-22,Tulare,107,460477,105203,102717,27102,129819,1287
2022-02-22,Tuolumne,109,53932,12518,12136,544,12680,175
2022-02-22,Ventura,111,848112,171276,171064,9266,180330,1401
2022-02-22,Yolo,113,214977,36380,35527,2811,38338,292
2022-02-22,Yuba,115,75493,15605,15550,1154,16704,110
2022-02-21,Alameda,001,1643700,251184,247434,13248,260682,1704
2022-02-21,Alpine,003,1148,122,124,1,125,0
2022-02-21,Amador,005,37829,8324,8246,628,8874,79
2022-02-21,Butte,007,227075,32659,32356,6864,39220,366
2022-02-21,Calaveras,009,45235,7148,7175,337,7512,107
2022-02-21,Colusa,011,21464,3417,3401,1035,4436,21
2022-02-21,Contra Costa,013,1133247,188865,183701,12972,196673,1201
2022-02-21,Del Norte,015,27424,5601,5601,167,5768,45
2022-02-21,El Dorado,017,186661,26361,26273,3141,29414,189
2022-02-21,Fresno,019,978130,230497,224923,23806,248729,2592
2022-02-21,Glenn,021,27897,4932,4897,1584,6481,40
2022-02-21,Humboldt,023,135768,16510,16548,2846,19394,132
2022-02-21,Imperial,025,180216,54749,54208,10391,64599,864
2022-02-21,Inyo,027,18085,4036,4023,447,4470,54
2022-02-21,Kern,029,883053,189844,188188,45185,233373,2102
2022-02-21,Kings,031,150075,50697,50188,3468,53656,422
2022-02-21,Lake,033,64148,10442,10334,857,11191,126
2022-02-21,Lassen,035,31185,8795,8705,863,9568,55
2022-02-21,Los Angeles,037,10098052,2683000,2656873,121083,2777956,30108
2022-02-21,Madera,039,155013,36790,36796,5896,42692,330
2022-02-21,Marin,041,260295,32710,32570,2140,34710,258
2022-02-21,Mariposa,043,17540,2334,2321,192,2513,6
2022-02-21,Mendocino,045,87422,12813,12706,2908,15614,110
2022-02-21,Merced,047,269075,61773,61209,8509,69718,770
2022-02-21,Modoc,049,8938,720,718,246,964,6
2022-02-21,Mono,051,14174,2954,2960,119,3079,5
2022-02-21,Monterey,053,433212,78263,77354,13019,90373,690
2022-02-21,Napa,055,140530,25103,25126,907,26033,128
2022-02-21,Nevada,057,99092,15722,15810,1145,16955,121
2022-02-21,Orange,059,3164182,541057,539068,40639,579707,6502
2022-02-21,Placer,061,380077,61938,61727,7217,68944,572
2022-02-21,Plumas,063,18699,2930,2657,349,3006,13
2022-02-21,Riverside,065,2383286,586382,583712,27315,611027,6097
2022-02-21,Sacramento,067,1510023,277188,271588,26075,297663,2769
2022-02-21,San Benito,069,59416,12799,12731,505,13236,92
2022-02-21,San Bernardino,071,2135413,570274,554662,24611,579273,6441
2022-02-21,San Diego,073,3302833,740467,732298,51658,783956,4974
2022-02-21,San Francisco,075,870044,121070,121865,7995,129860,769
2022-02-21,San Joaquin,077,732212,164822,164036,9729,173765,2040
2022-02-21,San Luis Obispo,079,281455,51439,51184,3622,54806,429
2022-02-21,San Mateo,081,765935,119172,117259,6722,123981,605
2022-02-21,Santa Barbara,083,443738,84621,84626,4613,89239,650
2022-02-21,Santa Clara,085,1922200,308149,304858,12013,316871,2158
2022-02-21,Santa Cruz,087,273765,46389,45941,2049,47990,251
2022-02-21,Shasta,089,179085,30055,30004,5975,35979,479
2022-02-21,Sierra,091,2930,271,269,46,315,0
2022-02-21,Siskiyou,093,43540,4369,4337,2657,6994,70
2022-02-21,Solano,095,438530,80063,79906,5440,85346,425
2022-02-21,Sonoma,097,501317,81934,81361,2498,83859,431
2022-02-21,Stanislaus,099,539301,116282,116597,17548,134145,1475
2022-02-21,Sutter,101,95872,20173,20152,1963,22115,210
2022-02-21,Tehama,103,63373,11899,11842,2552,14394,152
2022-02-21,Trinity,105,12862,1171,1147,283,1430,20
2022-02-21,Tulare,107,460477,105109,102614,27059,129673,1287
2022-02-21,Tuolumne,109,53932,12507,12126,541,12667,175
2022-02-21,Ventura,111,848112,171137,170939,9257,180196,1401
2022-02-21,Yolo,113,214977,36337,35518,2802,38320,292
2022-02-21,Yuba,115,75493,15586,15546,1145,16691,110
2022-02-20,Alameda,001,1643700,250955,246028,13240,259268,1700
2022-02-20,Alpine,003,1148,122,124,1,125,0
2022-02-20,Amador,005,37829,8312,8203,628,8831,79
2022-02-20,Butte,007,227075,32631,32173,6860,39033,364
2022-02-20,Calaveras,009,45235,7145,7136,336,7472,107
2022-02-20,Colusa,011,21464,3414,3389,1034,4423,21
2022-02-20,Contra Costa,013,1133247,188735,182797,12967,195764,1190
2022-02-20,Del Norte,015,27424,5586,5511,167,5678,45
2022-02-20,El Dorado,017,186661,26340,26101,3140,29241,189
2022-02-20,Fresno,019,978130,230300,223594,23790,247384,2544
2022-02-20,Glenn,021,27897,4929,4881,1584,6465,39
2022-02-20,Humboldt,023,135768,16498,16393,2842,19235,132
2022-02-20,Imperial,025,180216,54683,53967,10381,64348,862
2022-02-20,Inyo,027,18085,4036,4018,446,4464,52
2022-02-20,Kern,029,883053,189709,187158,45141,232299,2095
2022-02-20,Kings,031,150075,50669,49724,3465,53189,421
2022-02-20,Lake,033,64148,10409,10184,856,11040,126
2022-02-20,Lassen,035,31185,8783,8640,863,9503,55
2022-02-20,Los Angeles,037,10098052,2681679,2642878,121002,2763880,29842
2022-02-20,Madera,039,155013,36759,36526,5892,42418,330
2022-02-20,Marin,041,260295,32693,32441,2140,34581,258
2022-02-20,Mariposa,043,17540,2328,2310,190,2500,6
2022-02-20,Mendocino,045,87422,12803,12625,2905,15530,110
2022-02-20,Merced,047,269075,61745,60886,8504,69390,769
2022-02-20,Modoc,049,8938,719,714,246,960,6
2022-02-20,Mono,051,14174,2954,2956,119,3075,5
2022-02-20,Monterey,053,433212,78203,76765,13006,89771,682
2022-02-20,Napa,055,140530,25081,24970,905,25875,127
2022-02-20,Nevada,057,99092,15711,15715,1144,16859,121
2022-02-20,Orange,059,3164182,540738,538019,40602,578621,6416
2022-02-20,Placer,061,380077,61905,61417,7209,68626,560
2022-02-20,Plumas,063,18699,2926,2646,347,2993,13
2022-02-20,Riverside,065,2383286,586113,581788,27289,609077,6087
2022-02-20,Sacramento,067,1510023,277008,270080,26051,296131,2747
2022-02-20,San Benito,069,59416,12796,12665,505,13170,92
2022-02-20,San Bernardino,071,2135413,570066,553151,24594,577745,6400
2022-02-20,San Diego,073,3302833,739895,729549,51593,781142,4947
2022-02-20,San Francisco,075,870044,120933,121197,7985,129182,756
2022-02-20,San Joaquin,077,732212,164703,163083,9718,172801,2033
2022-02-20,San Luis Obispo,079,281455,51410,50823,3618,54441,424
2022-02-20,San Mateo,081,765935,119098,116648,6715,123363,598
2022-02-20,Santa Barbara,083,443738,84577,83988,4611,88599,642
2022-02-20,Santa Clara,085,1922200,307866,303077,12005,315082,2138
2022-02-20,Santa Cruz,087,273765,46323,45532,2046,47578,250
2022-02-20,Shasta,089,179085,30026,29847,5968,35815,479
2022-02-20,Sierra,091,2930,271,269,46,315,0
2022-02-20,Siskiyou,093,43540,4364,4307,2656,6963,70
2022-02-20,Solano,095,438530,79988,78914,5436,84350,424
2022-02-20,Sonoma,097,501317,81859,80843,2495,83338,431
2022-02-20,Stanislaus,099,539301,116216,115976,17531,133507,1454
2022-02-20,Sutter,101,95872,20161,20060,1960,22020,210
2022-02-20,Tehama,103,63373,11887,11760,2549,14309,152
2022-02-20,Trinity,105,12862,1170,1130,283,1413,20
2022-02-20,Tulare,107,460477,105021,101996,27033,129029,1286
2022-02-20,Tuolumne,109,53932,12486,12036,541,12577,175
2022-02-20,Ventura,111,848112,171041,170331,9250,179581,1384
2022-02-20,Yolo,113,214977,36311,35363,2799,38162,293
2022-02-20,Yuba,115,75493,15571,15449,1144,16593,112
2022-02-19,Alameda,001,1643700,250783,246028,13236,259264,1700
2022-02-19,Alpine,003,1148,122,124,1,125,0
2022-02-19,Amador,005,37829,8308,8203,628,8831,79
2022-02-19,Butte,007,227075,32607,32173,6857,39030,364
2022-02-19,Calaveras,009,45235,7145,7136,336,7472,107
2022-02-19,Colusa,011,21464,3413,3389,1032,4421,21
2022-02-19,Contra Costa,013,1133247,188638,182797,12966,195763,1190
2022-02-19,Del Norte,015,27424,5576,5511,167,5678,45
2022-02-19,El Dorado,017,186661,26322,26101,3138,29239,189
2022-02-19,Fresno,019,978130,230182,223594,23783,247377,2544
2022-02-19,Glenn,021,27897,4924,4881,1584,6465,39
2022-02-19,Humboldt,023,135768,16483,16393,2842,19235,132
2022-02-19,Imperial,025,180216,54667,53967,10376,64343,862
2022-02-19,Inyo,027,18085,4035,4018,445,4463,52
2022-02-19,Kern,029,883053,189606,187158,45117,232275,2095
2022-02-19,Kings,031,150075,50646,49724,3464,53188,421
2022-02-19,Lake,033,64148,10400,10184,856,11040,126
2022-02-19,Lassen,035,31185,8771,8640,862,9502,55
2022-02-19,Los Angeles,037,10098052,2680891,2642878,120960,2763838,29842
2022-02-19,Madera,039,155013,36737,36526,5890,42416,330
2022-02-19,Marin,041,260295,32670,32441,2139,34580,258
2022-02-19,Mariposa,043,17540,2325,2310,190,2500,6
2022-02-19,Mendocino,045,87422,12793,12625,2905,15530,110
2022-02-19,Merced,047,269075,61701,60886,8500,69386,769
2022-02-19,Modoc,049,8938,719,714,245,959,6
2022-02-19,Mono,051,14174,2953,2956,119,3075,5
2022-02-19,Monterey,053,433212,78114,76765,12995,89760,682
2022-02-19,Napa,055,140530,25071,24970,905,25875,127
2022-02-19,Nevada,057,99092,15703,15715,1144,16859,121
2022-02-19,Orange,059,3164182,540536,538019,40576,578595,6416
2022-02-19,Placer,061,380077,61858,61417,7209,68626,560
2022-02-19,Plumas,063,18699,2925,2646,347,2993,13
2022-02-19,Riverside,065,2383286,585931,581788,27277,609065,6087
2022-02-19,Sacramento,067,1510023,276863,270080,26040,296120,2747
2022-02-19,San Benito,069,59416,12783,12665,504,13169,92
2022-02-19,San Bernardino,071,2135413,569904,553151,24587,577738,6400
2022-02-19,San Diego,073,3302833,739550,729549,51546,781095,4947
2022-02-19,San Francisco,075,870044,120847,121197,7981,129178,756
2022-02-19,San Joaquin,077,732212,164630,163083,9707,172790,2033
2022-02-19,San Luis Obispo,079,281455,51397,50823,3614,54437,424
2022-02-19,San Mateo,081,765935,119056,116648,6714,123362,598
2022-02-19,Santa Barbara,083,443738,84510,83988,4610,88598,642
2022-02-19,Santa Clara,085,1922200,307671,303077,12003,315080,2138
2022-02-19,Santa Cruz,087,273765,46285,45532,2044,47576,250
2022-02-19,Shasta,089,179085,30012,29847,5965,35812,479
2022-02-19,Sierra,091,2930,271,269,46,315,0
2022-02-19,Siskiyou,093,43540,4361,4307,2656,6963,70
2022-02-19,Solano,095,438530,79946,78914,5435,84349,424
2022-02-19,Sonoma,097,501317,81817,80843,2495,83338,431
2022-02-19,Stanislaus,099,539301,116144,115976,17525,133501,1454
2022-02-19,Sutter,101,95872,20153,20060,1960,22020,210
2022-02-19,Tehama,103,63373,11880,11760,2549,14309,152
2022-02-19,Trinity,105,12862,1168,1130,283,1413,20
2022-02-19,Tulare,107,460477,104974,101996,27008,129004,1286
2022-02-19,Tuolumne,109,53932,12477,12036,541,12577,175
2022-02-19,Ventura,111,848112,170966,170331,9246,179577,1384
2022-02-19,Yolo,113,214977,36280,35363,2795,38158,293
2022-02-19,Yuba,115,75493,15562,15449,1144,16593,112
2022-02-18,Alameda,001,1643700,250618,246028,13228,259256,1700
2022-02-18,Alpine,003,1148,121,124,1,125,0
2022-02-18,Amador,005,37829,8301,8203,626,8829,79
2022-02-18,Butte,007,227075,32586,32173,6851,39024,364
2022-02-18,Calaveras,009,45235,7140,7136,335,7471,107
2022-02-18,Colusa,011,21464,3411,3389,1032,4421,21
2022-02-18,Contra Costa,013,1133247,188531,182797,12960,195757,1190
2022-02-18,Del Norte,015,27424,5565,5511,167,5678,45
2022-02-18,El Dorado,017,186661,26311,26101,3138,29239,189
2022-02-18,Fresno,019,978130,229994,223594,23770,247364,2544
2022-02-18,Glenn,021,27897,4923,4881,1583,6464,39
2022-02-18,Humboldt,023,135768,16466,16393,2837,19230,132
2022-02-18,Imperial,025,180216,54641,53967,10365,64332,862
2022-02-18,Inyo,027,18085,4033,4018,445,4463,52
2022-02-18,Kern,029,883053,189494,187158,45072,232230,2095
2022-02-18,Kings,031,150075,50559,49724,3464,53188,421
2022-02-18,Lake,033,64148,10382,10184,854,11038,126
2022-02-18,Lassen,035,31185,8751,8640,861,9501,55
2022-02-18,Los Angeles,037,10098052,2679908,2642878,120905,2763783,29842
2022-02-18,Madera,039,155013,36714,36526,5888,42414,330
2022-02-18,Marin,041,260295,32652,32441,2137,34578,258
2022-02-18,Mariposa,043,17540,2323,2310,190,2500,6
2022-02-18,Mendocino,045,87422,12783,12625,2905,15530,110
2022-02-18,Merced,047,269075,61657,60886,8491,69377,769
2022-02-18,Modoc,049,8938,719,714,245,959,6
2022-02-18,Mono,051,14174,2953,2956,119,3075,5
2022-02-18,Monterey,053,433212,78041,76765,12987,89752,682
2022-02-18,Napa,055,140530,25053,24970,905,25875,127
2022-02-18,Nevada,057,99092,15695,15715,1144,16859,121
2022-02-18,Orange,059,3164182,540300,538019,40537,578556,6416
2022-02-18,Placer,061,380077,61829,61417,7202,68619,560
2022-02-18,Plumas,063,18699,2921,2646,347,2993,13
2022-02-18,Riverside,065,2383286,585750,581788,27269,609057,6087
2022-02-18,Sacramento,067,1510023,276671,270080,26031,296111,2747
2022-02-18,San Benito,069,59416,12775,12665,504,13169,92
2022-02-18,San Bernardino,071,2135413,569726,553151,24582,577733,6400
2022-02-18,San Diego,073,3302833,739126,729549,51520,781069,4947
2022-02-18,San Francisco,075,870044,120759,121197,7973,129170,756
2022-02-18,San Joaquin,077,732212,164561,163083,9700,172783,2033
2022-02-18,San Luis Obispo,079,281455,51381,50823,3611,54434,424
2022-02-18,San Mateo,081,765935,118991,116648,6711,123359,598
2022-02-18,Santa Barbara,083,443738,84470,83988,4608,88596,642
2022-02-18,Santa Clara,085,1922200,307435,303077,12002,315079,2138
2022-02-18,Santa Cruz,087,273765,46251,45532,2043,47575,250
2022-02-18,Shasta,089,179085,29998,29847,5964,35811,479
2022-02-18,Sierra,091,2930,271,269,46,315,0
2022-02-18,Siskiyou,093,43540,4358,4307,2654,6961,70
2022-02-18,Solano,095,438530,79876,78914,5434,84348,424
2022-02-18,Sonoma,097,501317,81761,80843,2494,83337,431
2022-02-18,Stanislaus,099,539301,116094,115976,17511,133487,1454
2022-02-18,Sutter,101,95872,20141,20060,1960,22020,210
2022-02-18,Tehama,103,63373,11869,11760,2549,14309,152
2022-02-18,Trinity,105,12862,1167,1130,282,1412,20
2022-02-18,Tulare,107,460477,104923,101996,26967,128963,1286
2022-02-18,Tuolumne,109,53932,12471,12036,540,12576,175
2022-02-18,Ventura,111,848112,170876,170331,9241,179572,1384
2022-02-18,Yolo,113,214977,36252,35363,2793,38156,293
2022-02-18,Yuba,115,75493,15547,15449,1144,16593,112
2022-02-17,Alameda,001,1643700,250352,246028,13213,259241,1700
2022-02-17,Alpine,003,1148,121,124,1,125,0
2022-02-17,Amador,005,37829,8297,8203,624,8827,79
2022-02-17,Butte,007,227075,32553,32173,6847,39020,364
2022-02-17,Calaveras,009,45235,7131,7136,332,7468,107
2022-02-17,Colusa,011,21464,3408,3389,1032,4421,21
2022-02-17,Contra Costa,013,1133247,188335,182797,12928,195725,1190
2022-02-17,Del Norte,015,27424,5544,5511,167,5678,45
2022-02-17,El Dorado,017,186661,26285,26101,3128,29229,189
2022-02-17,Fresno,019,978130,229704,223594,23740,247334,2544
2022-02-17,Glenn,021,27897,4921,4881,1580,6461,39
2022-02-17,Humboldt,023,135768,16426,16393,2836,19229,132
2022-02-17,Imperial,025,180216,54570,53967,10349,64316,862
2022-02-17,Inyo,027,18085,4031,4018,444,4462,52
2022-02-17,Kern,029,883053,189340,187158,45023,232181,2095
2022-02-17,Kings,031,150075,50495,49724,3459,53183,421
2022-02-17,Lake,033,64148,10352,10184,850,11034,126
2022-02-17,Lassen,035,31185,8741,8640,859,9499,55
2022-02-17,Los Angeles,037,10098052,2678086,2642878,120825,2763703,29842
2022-02-17,Madera,039,155013,36671,36526,5881,42407,330
2022-02-17,Marin,041,260295,32626,32441,2136,34577,258
2022-02-17,Mariposa,043,17540,2321,2310,189,2499,6
2022-02-17,Mendocino,045,87422,12766,12625,2902,15527,110
2022-02-17,Merced,047,269075,61583,60886,8473,69359,769
2022-02-17,Modoc,049,8938,718,714,245,959,6
2022-02-17,Mono,051,14174,2951,2956,119,3075,5
2022-02-17,Monterey,053,433212,77929,76765,12945,89710,682
2022-02-17,Napa,055,140530,25021,24970,903,25873,127
2022-02-17,Nevada,057,99092,15683,15715,1143,16858,121
2022-02-17,Orange,059,3164182,539961,538019,40510,578529,6416
2022-02-17,Placer,061,380077,61787,61417,7194,68611,560
2022-02-17,Plumas,063,18699,2918,2646,347,2993,13
2022-02-17,Riverside,065,2383286,585377,581788,27242,609030,6087
2022-02-17,Sacramento,067,1510023,276384,270080,25983,296063,2747
2022-02-17,San Benito,069,59416,12764,12665,504,13169,92
2022-02-17,San Bernardino,071,2135413,569422,553151,24568,577719,6400
2022-02-17,San Diego,073,3302833,738529,729549,51466,781015,4947
2022-02-17,San Francisco,075,870044,120625,121197,7963,129160,756
2022-02-17,San Joaquin,077,732212,164397,163083,9687,172770,2033
2022-02-17,San Luis Obispo,079,281455,51276,50823,3603,54426,424
2022-02-17,San Mateo,081,765935,118896,116648,6702,123350,598
2022-02-17,Santa Barbara,083,443738,84370,83988,4601,88589,642
2022-02-17,Santa Clara,085,1922200,307065,303077,11988,315065,2138
2022-02-17,Santa Cruz,087,273765,46168,45532,2041,47573,250
2022-02-17,Shasta,089,179085,29971,29847,5961,35808,479
2022-02-17,Sierra,091,2930,271,269,46,315,0
2022-02-17,Siskiyou,093,43540,4349,4307,2650,6957,70
2022-02-17,Solano,095,438530,79795,78914,5427,84341,424
2022-02-17,Sonoma,097,501317,81695,80843,2487,83330,431
2022-02-17,Stanislaus,099,539301,115990,115976,17494,133470,1454
2022-02-17,Sutter,101,95872,20126,20060,1952,22012,210
2022-02-17,Tehama,103,63373,11861,11760,2548,14308,152
2022-02-17,Trinity,105,12862,1165,1130,280,1410,20
2022-02-17,Tulare,107,460477,104811,101996,26943,128939,1286
2022-02-17,Tuolumne,109,53932,12460,12036,540,12576,175
2022-02-17,Ventura,111,848112,170736,170331,9240,179571,1384
2022-02-17,Yolo,113,214977,36214,35363,2792,38155,293
2022-02-17,Yuba,115,75493,15532,15449,1144,16593,112
2022-02-16,Alameda,001,1643700,250043,245662,13176,258838,1691
2022-02-16,Alpine,003,1148,121,124,1,125,0
2022-02-16,Amador,005,37829,8279,8197,623,8820,77
2022-02-16,Butte,007,227075,32507,32095,6834,38929,363
2022-02-16,Calaveras,009,45235,7127,7129,329,7458,107
2022-02-16,Colusa,011,21464,3402,3384,1032,4416,21
2022-02-16,Contra Costa,013,1133247,188102,182423,12892,195315,1179
2022-02-16,Del Norte,015,27424,5524,5473,164,5637,45
2022-02-16,El Dorado,017,186661,26260,26061,3124,29185,189
2022-02-16,Fresno,019,978130,229344,223056,23691,246747,2542
2022-02-16,Glenn,021,27897,4918,4873,1575,6448,39
2022-02-16,Humboldt,023,135768,16402,16342,2826,19168,132
2022-02-16,Imperial,025,180216,54492,53901,10321,64222,861
2022-02-16,Inyo,027,18085,4028,4013,443,4456,52
2022-02-16,Kern,029,883053,189123,186740,44938,231678,2084
2022-02-16,Kings,031,150075,50442,49575,3450,53025,420
2022-02-16,Lake,033,64148,10327,10145,850,10995,125
2022-02-16,Lassen,035,31185,8708,8618,859,9477,55
2022-02-16,Los Angeles,037,10098052,2676009,2640005,120717,2760722,29749
2022-02-16,Madera,039,155013,36604,36382,5867,42249,330
2022-02-16,Marin,041,260295,32590,32381,2134,34515,257
2022-02-16,Mariposa,043,17540,2319,2305,189,2494,6
2022-02-16,Mendocino,045,87422,12744,12605,2892,15497,108
2022-02-16,Merced,047,269075,61516,60776,8441,69217,767
2022-02-16,Modoc,049,8938,718,711,241,952,6
2022-02-16,Mono,051,14174,2949,2953,119,3072,5
2022-02-16,Monterey,053,433212,77782,76624,12904,89528,682
2022-02-16,Napa,055,140530,24983,24897,900,25797,128
2022-02-16,Nevada,057,99092,15665,15677,1139,16816,121
2022-02-16,Orange,059,3164182,539556,537934,40465,578399,6392
2022-02-16,Placer,061,380077,61744,61278,7182,68460,556
2022-02-16,Plumas,063,18699,2915,2644,345,2989,13
2022-02-16,Riverside,065,2383286,584980,580828,27196,608024,6064
2022-02-16,Sacramento,067,1510023,276061,269416,25927,295343,2736
2022-02-16,San Benito,069,59416,12737,12644,504,13148,92
2022-02-16,San Bernardino,071,2135413,569148,552353,24546,576899,6379
2022-02-16,San Diego,073,3302833,737769,728610,51389,779999,4931
2022-02-16,San Francisco,075,870044,120452,120987,7960,128947,756
2022-02-16,San Joaquin,077,732212,164230,162752,9677,172429,2032
2022-02-16,San Luis Obispo,079,281455,51204,50704,3591,54295,425
2022-02-16,San Mateo,081,765935,118778,116438,6684,123122,595
2022-02-16,Santa Barbara,083,443738,84294,83968,4589,88557,642
2022-02-16,Santa Clara,085,1922200,306673,302439,11957,314396,2130
2022-02-16,Santa Cruz,087,273765,46078,45274,2039,47313,250
2022-02-16,Shasta,089,179085,29933,29767,5949,35716,477
2022-02-16,Sierra,091,2930,270,269,46,315,0
2022-02-16,Siskiyou,093,43540,4342,4302,2644,6946,71
2022-02-16,Solano,095,438530,79680,78742,5421,84163,422
2022-02-16,Sonoma,097,501317,81567,80642,2477,83119,431
2022-02-16,Stanislaus,099,539301,115871,115751,17461,133212,1443
2022-02-16,Sutter,101,95872,20109,20020,1949,21969,210
2022-02-16,Tehama,103,63373,11844,11738,2546,14284,152
2022-02-16,Trinity,105,12862,1165,1130,279,1409,20
2022-02-16,Tulare,107,460477,104692,101817,26893,128710,1281
2022-02-16,Tuolumne,109,53932,12448,11991,539,12530,171
2022-02-16,Ventura,111,848112,170602,170117,9232,179349,1372
2022-02-16,Yolo,113,214977,36164,35284,2790,38074,292
2022-02-16,Yuba,115,75493,15510,15405,1141,16546,110
2022-02-15,Alameda,001,1643700,249689,245265,13150,258415,1683
2022-02-15,Alpine,003,1148,121,124,1,125,0
2022-02-15,Amador,005,37829,8269,8183,622,8805,77
2022-02-15,Butte,007,227075,32458,32011,6820,38831,361
2022-02-15,Calaveras,009,45235,7117,7115,329,7444,106
2022-02-15,Colusa,011,21464,3394,3374,1031,4405,21
2022-02-15,Contra Costa,013,1133247,187845,182041,12862,194903,1179
2022-02-15,Del Norte,015,27424,5496,5439,163,5602,45
2022-02-15,El Dorado,017,186661,26242,25988,3119,29107,189
2022-02-15,Fresno,019,978130,228970,222673,23634,246307,2543
2022-02-15,Glenn,021,27897,4909,4862,1574,6436,39
2022-02-15,Humboldt,023,135768,16357,16297,2811,19108,132
2022-02-15,Imperial,025,180216,54428,53813,10306,64119,860
2022-02-15,Inyo,027,18085,4027,4009,442,4451,52
2022-02-15,Kern,029,883053,188902,186324,44846,231170,2072
2022-02-15,Kings,031,150075,50349,49473,3441,52914,418
2022-02-15,Lake,033,64148,10295,10112,844,10956,123
2022-02-15,Lassen,035,31185,8694,8587,857,9444,55
2022-02-15,Los Angeles,037,10098052,2673758,2638266,120588,2758854,29691
2022-02-15,Madera,039,155013,36538,36260,5847,42107,330
2022-02-15,Marin,041,260295,32548,32355,2132,34487,255
2022-02-15,Mariposa,043,17540,2318,2302,189,2491,6
2022-02-15,Mendocino,045,87422,12727,12580,2873,15453,108
2022-02-15,Merced,047,269075,61434,60674,8409,69083,763
2022-02-15,Modoc,049,8938,716,710,238,948,6
2022-02-15,Mono,051,14174,2948,2952,119,3071,5
2022-02-15,Monterey,053,433212,77656,75530,12846,88376,682
2022-02-15,Napa,055,140530,24933,24832,893,25725,127
2022-02-15,Nevada,057,99092,15639,15643,1138,16781,121
2022-02-15,Orange,059,3164182,539100,537478,40420,577898,6374
2022-02-15,Placer,061,380077,61683,61170,7171,68341,554
2022-02-15,Plumas,063,18699,2911,2638,345,2983,13
2022-02-15,Riverside,065,2383286,584495,579940,27137,607077,6049
2022-02-15,Sacramento,067,1510023,275673,268950,25848,294798,2721
2022-02-15,San Benito,069,59416,12718,12616,504,13120,91
2022-02-15,San Bernardino,071,2135413,568788,551803,24526,576329,6372
2022-02-15,San Diego,073,3302833,736809,727486,51286,778772,4914
2022-02-15,San Francisco,075,870044,120282,120759,7949,128708,756
2022-02-15,San Joaquin,077,732212,164013,162518,9663,172181,2021
2022-02-15,San Luis Obispo,079,281455,51107,50534,3576,54110,419
2022-02-15,San Mateo,081,765935,118642,116253,6664,122917,595
2022-02-15,Santa Barbara,083,443738,84158,83734,4575,88309,640
2022-02-15,Santa Clara,085,1922200,306175,301831,11922,313753,2130
2022-02-15,Santa Cruz,087,273765,45974,45171,2034,47205,250
2022-02-15,Shasta,089,179085,29882,29684,5935,35619,477
2022-02-15,Sierra,091,2930,270,269,46,315,0
2022-02-15,Siskiyou,093,43540,4335,4288,2637,6925,70
2022-02-15,Solano,095,438530,79546,78626,5416,84042,426
2022-02-15,Sonoma,097,501317,81446,80433,2471,82904,431
2022-02-15,Stanislaus,099,539301,115730,115549,17430,132979,1429
2022-02-15,Sutter,101,95872,20080,19980,1944,21924,208
2022-02-15,Tehama,103,63373,11826,11717,2544,14261,151
2022-02-15,Trinity,105,12862,1159,1125,276,1401,20
2022-02-15,Tulare,107,460477,104540,101645,26838,128483,1278
2022-02-15,Tuolumne,109,53932,12429,11945,537,12482,171
2022-02-15,Ventura,111,848112,170428,169942,9225,179167,1372
2022-02-15,Yolo,113,214977,36114,35241,2782,38023,289
2022-02-15,Yuba,115,75493,15482,15372,1136,16508,109
2022-02-14,Alameda,001,1643700,249255,244315,13117,257432,1677
2022-02-14,Alpine,003,1148,121,125,1,126,0
2022-02-14,Amador,005,37829,8254,8164,619,8783,77
2022-02-14,Butte,007,227075,32404,31946,6805,38751,360
2022-02-14,Calaveras,009,45235,7104,7097,327,7424,106
2022-02-14,Colusa,011,21464,3391,3367,1027,4394,21
2022-02-14,Contra Costa,013,1133247,187561,181753,12824,194577,1167
2022-02-14,Del Norte,015,27424,5473,5426,162,5588,45
2022-02-14,El Dorado,017,186661,26206,25915,3110,29025,188
2022-02-14,Fresno,019,978130,228489,222360,23546,245906,2538
2022-02-14,Glenn,021,27897,4904,4854,1574,6428,39
2022-02-14,Humboldt,023,135768,16317,16264,2786,19050,132
2022-02-14,Imperial,025,180216,54356,53765,10280,64045,860
2022-02-14,Inyo,027,18085,4026,4010,441,4451,52
2022-02-14,Kern,029,883053,188560,186037,44738,230775,2063
2022-02-14,Kings,031,150075,50243,49395,3432,52827,419
2022-02-14,Lake,033,64148,10258,10090,841,10931,123
2022-02-14,Lassen,035,31185,8684,8539,855,9394,55
2022-02-14,Los Angeles,037,10098052,2671196,2636064,120461,2756525,29650
2022-02-14,Madera,039,155013,36474,36194,5824,42018,330
2022-02-14,Marin,041,260295,32512,32304,2129,34433,255
2022-02-14,Mariposa,043,17540,2311,2295,189,2484,6
2022-02-14,Mendocino,045,87422,12700,12541,2841,15382,108
2022-02-14,Merced,047,269075,61344,60591,8366,68957,758
2022-02-14,Modoc,049,8938,711,707,238,945,6
2022-02-14,Mono,051,14174,2947,2954,119,3073,5
2022-02-14,Monterey,053,433212,77485,75407,12767,88174,678
2022-02-14,Napa,055,140530,24874,24776,893,25669,127
2022-02-14,Nevada,057,99092,15620,15629,1137,16766,121
2022-02-14,Orange,059,3164182,538596,536924,40354,577278,6355
2022-02-14,Placer,061,380077,61614,61123,7156,68279,554
2022-02-14,Plumas,063,18699,2909,2631,345,2976,13
2022-02-14,Riverside,065,2383286,583948,579174,27069,606243,5994
2022-02-14,Sacramento,067,1510023,275230,268547,25736,294283,2717
2022-02-14,San Benito,069,59416,12694,12598,503,13101,91
2022-02-14,San Bernardino,071,2135413,568372,551338,24506,575844,6372
2022-02-14,San Diego,073,3302833,735841,723902,51183,775085,4894
2022-02-14,San Francisco,075,870044,120095,120581,7939,128520,756
2022-02-14,San Joaquin,077,732212,163775,162363,9640,172003,2018
2022-02-14,San Luis Obispo,079,281455,50999,50465,3566,54031,416
2022-02-14,San Mateo,081,765935,118478,116129,6656,122785,592
2022-02-14,Santa Barbara,083,443738,84012,83697,4565,88262,636
2022-02-14,Santa Clara,085,1922200,305640,301319,11898,313217,2127
2022-02-14,Santa Cruz,087,273765,45811,45042,2030,47072,250
2022-02-14,Shasta,089,179085,29796,29595,5918,35513,474
2022-02-14,Sierra,091,2930,270,269,46,315,0
2022-02-14,Siskiyou,093,43540,4322,4278,2623,6901,69
2022-02-14,Solano,095,438530,79366,78533,5405,83938,427
2022-02-14,Sonoma,097,501317,81306,80336,2459,82795,431
2022-02-14,Stanislaus,099,539301,115552,115426,17387,132813,1406
2022-02-14,Sutter,101,95872,20052,19957,1938,21895,209
2022-02-14,Tehama,103,63373,11803,11686,2543,14229,151
2022-02-14,Trinity,105,12862,1156,1123,276,1399,20
2022-02-14,Tulare,107,460477,104334,101448,26744,128192,1276
2022-02-14,Tuolumne,109,53932,12400,11920,534,12454,170
2022-02-14,Ventura,111,848112,170251,169725,9213,178938,1361
2022-02-14,Yolo,113,214977,36055,35112,2772,37884,286
2022-02-14,Yuba,115,75493,15452,15375,1132,16507,108
2022-02-13,Alameda,001,1643700,248764,243681,13083,256764,1677
2022-02-13,Alpine,003,1148,121,125,1,126,0
2022-02-13,Amador,005,37829,8225,8146,616,8762,77
2022-02-13,Butte,007,227075,32329,31865,6783,38648,360
2022-02-13,Calaveras,009,45235,7097,7083,324,7407,106
2022-02-13,Colusa,011,21464,3389,3366,1025,4391,21
2022-02-13,Contra Costa,013,1133247,187199,181313,12760,194073,1159
2022-02-13,Del Norte,015,27424,5441,5379,162,5541,45
2022-02-13,El Dorado,017,186661,26170,25871,3102,28973,188
2022-02-13,Fresno,019,978130,227955,221686,23487,245173,2537
2022-02-13,Glenn,021,27897,4897,4847,1571,6418,39
2022-02-13,Humboldt,023,135768,16270,16210,2758,18968,132
2022-02-13,Imperial,025,180216,54258,53658,10245,63903,860
2022-02-13,Inyo,027,18085,4023,4006,439,4445,52
2022-02-13,Kern,029,883053,188308,185640,44653,230293,2063
2022-02-13,Kings,031,150075,50116,49243,3420,52663,416
2022-02-13,Lake,033,64148,10195,10042,834,10876,123
2022-02-13,Lassen,035,31185,8659,8503,853,9356,55
2022-02-13,Los Angeles,037,10098052,2668048,2631267,120321,2751588,29595
2022-02-13,Madera,039,155013,36357,36054,5796,41850,330
2022-02-13,Marin,041,260295,32441,32222,2122,34344,255
2022-02-13,Mariposa,043,17540,2305,2292,187,2479,6
2022-02-13,Mendocino,045,87422,12671,12521,2802,15323,108
2022-02-13,Merced,047,269075,61201,60460,8312,68772,758
2022-02-13,Modoc,049,8938,709,704,231,935,6
2022-02-13,Mono,051,14174,2946,2949,119,3068,5
2022-02-13,Monterey,053,433212,77278,75295,12693,87988,678
2022-02-13,Napa,055,140530,24797,24743,890,25633,127
2022-02-13,Nevada,057,99092,15586,15590,1130,16720,121
2022-02-13,Orange,059,3164182,537970,536134,40292,576426,6355
2022-02-13,Placer,061,380077,61538,61020,7135,68155,554
2022-02-13,Plumas,063,18699,2901,2626,342,2968,13
2022-02-13,Riverside,065,2383286,583354,578363,27028,605391,5995
2022-02-13,Sacramento,067,1510023,274717,267947,25606,293553,2699
2022-02-13,San Benito,069,59416,12661,12578,502,13080,91
2022-02-13,San Bernardino,071,2135413,567885,550632,24472,575104,6367
2022-02-13,San Diego,073,3302833,734704,723902,51063,774965,4894
2022-02-13,San Francisco,075,870044,119843,120295,7927,128222,756
2022-02-13,San Joaquin,077,732212,163475,162028,9612,171640,2018
2022-02-13,San Luis Obispo,079,281455,50854,50384,3558,53942,415
2022-02-13,San Mateo,081,765935,118257,115876,6630,122506,592
2022-02-13,Santa Barbara,083,443738,83848,83547,4558,88105,635
2022-02-13,Santa Clara,085,1922200,304998,300412,11861,312273,2114
2022-02-13,Santa Cruz,087,273765,45656,44887,2028,46915,240
2022-02-13,Shasta,089,179085,29717,29531,5895,35426,474
2022-02-13,Sierra,091,2930,270,269,46,315,0
2022-02-13,Siskiyou,093,43540,4315,4264,2607,6871,69
2022-02-13,Solano,095,438530,79208,78424,5382,83806,426
2022-02-13,Sonoma,097,501317,81142,80172,2447,82619,431
2022-02-13,Stanislaus,099,539301,115359,115156,17347,132503,1406
2022-02-13,Sutter,101,95872,20013,19900,1938,21838,209
2022-02-13,Tehama,103,63373,11778,11644,2540,14184,151
2022-02-13,Trinity,105,12862,1153,1120,273,1393,20
2022-02-13,Tulare,107,460477,104121,101135,26656,127791,1276
2022-02-13,Tuolumne,109,53932,12374,11891,529,12420,170
2022-02-13,Ventura,111,848112,170057,169422,9193,178615,1361
2022-02-13,Yolo,113,214977,35988,35057,2760,37817,286
2022-02-13,Yuba,115,75493,15418,15346,1131,16477,107
2022-02-12,Alameda,001,1643700,248545,242137,13069,255206,1668
2022-02-12,Alpine,003,1148,121,124,1,125,0
2022-02-12,Amador,005,37829,8219,8091,616,8707,76
2022-02-12,Butte,007,227075,32300,31601,6777,38378,360
2022-02-12,Calaveras,009,45235,7094,7022,323,7345,106
2022-02-12,Colusa,011,21464,3386,3345,1025,4370,21
2022-02-12,Contra Costa,013,1133247,187008,180270,12753,193023,1141
2022-02-12,Del Norte,015,27424,5422,5262,162,5424,45
2022-02-12,El Dorado,017,186661,26154,25692,3102,28794,188
2022-02-12,Fresno,019,978130,227743,219909,23472,243381,2509
2022-02-12,Glenn,021,27897,4896,4818,1570,6388,39
2022-02-12,Humboldt,023,135768,16246,16058,2755,18813,132
2022-02-12,Imperial,025,180216,54214,53304,10235,63539,860
2022-02-12,Inyo,027,18085,4021,3991,439,4430,52
2022-02-12,Kern,029,883053,188197,184639,44615,229254,2037
2022-02-12,Kings,031,150075,50076,48893,3413,52306,415
2022-02-12,Lake,033,64148,10174,9926,830,10756,123
2022-02-12,Lassen,035,31185,8636,8477,852,9329,55
2022-02-12,Los Angeles,037,10098052,2666893,2616426,120250,2736676,29364
2022-02-12,Madera,039,155013,36323,35710,5790,41500,330
2022-02-12,Marin,041,260295,32409,32048,2119,34167,255
2022-02-12,Mariposa,043,17540,2305,2286,187,2473,6
2022-02-12,Mendocino,045,87422,12655,12439,2802,15241,107
2022-02-12,Merced,047,269075,61147,60187,8307,68494,758
2022-02-12,Modoc,049,8938,709,697,231,928,6
2022-02-12,Mono,051,14174,2945,2939,119,3058,5
2022-02-12,Monterey,053,433212,77217,74842,12671,87513,672
2022-02-12,Napa,055,140530,24769,24530,890,25420,124
2022-02-12,Nevada,057,99092,15573,15499,1129,16628,119
2022-02-12,Orange,059,3164182,537678,534503,40257,574760,6305
2022-02-12,Placer,061,380077,61482,60636,7132,67768,554
2022-02-12,Plumas,063,18699,2900,2617,341,2958,13
2022-02-12,Riverside,065,2383286,582992,575566,27005,602571,5961
2022-02-12,Sacramento,067,1510023,274481,266347,25596,291943,2686
2022-02-12,San Benito,069,59416,12649,12526,502,13028,91
2022-02-12,San Bernardino,071,2135413,567650,548822,24459,573281,6360
2022-02-12,San Diego,073,3302833,734205,720287,51012,771299,4854
2022-02-12,San Francisco,075,870044,119721,119113,7916,127029,740
2022-02-12,San Joaquin,077,732212,163344,161234,9606,170840,2014
2022-02-12,San Luis Obispo,079,281455,50818,50064,3555,53619,416
2022-02-12,San Mateo,081,765935,118169,115235,6623,121858,589
2022-02-12,Santa Barbara,083,443738,83762,83390,4551,87941,631
2022-02-12,Santa Clara,085,1922200,304661,298176,11854,310030,2093
2022-02-12,Santa Cruz,087,273765,45620,44447,2026,46473,239
2022-02-12,Shasta,089,179085,29688,29370,5891,35261,473
2022-02-12,Sierra,091,2930,270,268,46,314,0
2022-02-12,Siskiyou,093,43540,4307,4231,2604,6835,68
2022-02-12,Solano,095,438530,79166,77865,5377,83242,424
2022-02-12,Sonoma,097,501317,81038,79533,2445,81978,431
2022-02-12,Stanislaus,099,539301,115234,114531,17334,131865,1406
2022-02-12,Sutter,101,95872,19998,19800,1938,21738,211
2022-02-12,Tehama,103,63373,11762,11580,2540,14120,151
2022-02-12,Trinity,105,12862,1152,1115,273,1388,20
2022-02-12,Tulare,107,460477,104026,100434,26619,127053,1273
2022-02-12,Tuolumne,109,53932,12356,11754,529,12283,125
2022-02-12,Ventura,111,848112,169950,168736,9188,177924,1340
2022-02-12,Yolo,113,214977,35947,34773,2757,37530,286
2022-02-12,Yuba,115,75493,15404,15242,1130,16372,107
2022-02-11,Alameda,001,1643700,248261,242137,13056,255193,1668
2022-02-11,Alpine,003,1148,121,124,1,125,0
2022-02-11,Amador,005,37829,8207,8091,616,8707,76
2022-02-11,Butte,007,227075,32256,31601,6766,38367,360
2022-02-11,Calaveras,009,45235,7091,7022,323,7345,106
2022-02-11,Colusa,011,21464,3384,3345,1024,4369,21
2022-02-11,Contra Costa,013,1133247,186806,180270,12734,193004,1141
2022-02-11,Del Norte,015,27424,5406,5262,161,5423,45
2022-02-11,El Dorado,017,186661,26135,25692,3101,28793,188
2022-02-11,Fresno,019,978130,227449,219909,23454,243363,2509
2022-02-11,Glenn,021,27897,4892,4818,1570,6388,39
2022-02-11,Humboldt,023,135768,16218,16058,2750,18808,132
2022-02-11,Imperial,025,180216,54185,53304,10224,63528,860
2022-02-11,Inyo,027,18085,4017,3991,435,4426,52
2022-02-11,Kern,029,883053,188039,184639,44564,229203,2037
2022-02-11,Kings,031,150075,50037,48893,3412,52305,415
2022-02-11,Lake,033,64148,10149,9926,828,10754,123
2022-02-11,Lassen,035,31185,8596,8477,852,9329,55
2022-02-11,Los Angeles,037,10098052,2665263,2616426,120161,2736587,29364
2022-02-11,Madera,039,155013,36281,35710,5784,41494,330
2022-02-11,Marin,041,260295,32377,32048,2116,34164,255
2022-02-11,Mariposa,043,17540,2300,2286,187,2473,6
2022-02-11,Mendocino,045,87422,12639,12439,2802,15241,107
2022-02-11,Merced,047,269075,61097,60187,8295,68482,758
2022-02-11,Modoc,049,8938,707,697,231,928,6
2022-02-11,Mono,051,14174,2944,2939,119,3058,5
2022-02-11,Monterey,053,433212,77101,74842,12658,87500,672
2022-02-11,Napa,055,140530,24743,24530,890,25420,124
2022-02-11,Nevada,057,99092,15559,15499,1126,16625,119
2022-02-11,Orange,059,3164182,537327,534503,40197,574700,6305
2022-02-11,Placer,061,380077,61430,60636,7130,67766,554
2022-02-11,Plumas,063,18699,2896,2617,339,2956,13
2022-02-11,Riverside,065,2383286,582575,575566,26989,602555,5961
2022-02-11,Sacramento,067,1510023,274217,266347,25584,291931,2686
2022-02-11,San Benito,069,59416,12644,12526,502,13028,91
2022-02-11,San Bernardino,071,2135413,567335,548822,24445,573267,6360
2022-02-11,San Diego,073,3302833,733502,720287,50953,771240,4854
2022-02-11,San Francisco,075,870044,119600,119113,7900,127013,740
2022-02-11,San Joaquin,077,732212,163175,161234,9595,170829,2014
2022-02-11,San Luis Obispo,079,281455,50781,50064,3551,53615,416
2022-02-11,San Mateo,081,765935,118051,115235,6614,121849,589
2022-02-11,Santa Barbara,083,443738,83678,83390,4550,87940,631
2022-02-11,Santa Clara,085,1922200,304234,298176,11838,310014,2093
2022-02-11,Santa Cruz,087,273765,45528,44447,2026,46473,239
2022-02-11,Shasta,089,179085,29657,29370,5883,35253,473
2022-02-11,Sierra,091,2930,269,268,45,313,0
2022-02-11,Siskiyou,093,43540,4296,4231,2598,6829,68
2022-02-11,Solano,095,438530,79041,77865,5371,83236,424
2022-02-11,Sonoma,097,501317,80952,79533,2440,81973,431
2022-02-11,Stanislaus,099,539301,115134,114531,17319,131850,1406
2022-02-11,Sutter,101,95872,19975,19800,1936,21736,211
2022-02-11,Tehama,103,63373,11748,11580,2540,14120,151
2022-02-11,Trinity,105,12862,1151,1115,272,1387,20
2022-02-11,Tulare,107,460477,103907,100434,26568,127002,1273
2022-02-11,Tuolumne,109,53932,12340,11754,527,12281,125
2022-02-11,Ventura,111,848112,169811,168736,9183,177919,1340
2022-02-11,Yolo,113,214977,35914,34773,2755,37528,286
2022-02-11,Yuba,115,75493,15387,15242,1129,16371,107
2022-02-10,Alameda,001,1643700,247738,242137,13014,255151,1668
2022-02-10,Alpine,003,1148,121,124,1,125,0
2022-02-10,Amador,005,37829,8195,8091,610,8701,76
2022-02-10,Butte,007,227075,32205,31601,6752,38353,360
2022-02-10,Calaveras,009,45235,7079,7022,321,7343,106
2022-02-10,Colusa,011,21464,3378,3345,1022,4367,21
2022-02-10,Contra Costa,013,1133247,186445,180270,12669,192939,1141
2022-02-10,Del Norte,015,27424,5377,5262,159,5421,45
2022-02-10,El Dorado,017,186661,26091,25692,3095,28787,188
2022-02-10,Fresno,019,978130,226873,219909,23368,243277,2509
2022-02-10,Glenn,021,27897,4886,4818,1568,6386,39
2022-02-10,Humboldt,023,135768,16168,16058,2728,18786,132
2022-02-10,Imperial,025,180216,54116,53304,10181,63485,860
2022-02-10,Inyo,027,18085,4013,3991,435,4426,52
2022-02-10,Kern,029,883053,187731,184639,44455,229094,2037
2022-02-10,Kings,031,150075,49926,48893,3401,52294,415
2022-02-10,Lake,033,64148,10118,9926,826,10752,123
2022-02-10,Lassen,035,31185,8582,8477,850,9327,55
2022-02-10,Los Angeles,037,10098052,2662128,2616426,119978,2736404,29364
2022-02-10,Madera,039,155013,36184,35710,5753,41463,330
2022-02-10,Marin,041,260295,32319,32048,2104,34152,255
2022-02-10,Mariposa,043,17540,2296,2286,186,2472,6
2022-02-10,Mendocino,045,87422,12617,12439,2778,15217,107
2022-02-10,Merced,047,269075,60971,60187,8238,68425,758
2022-02-10,Modoc,049,8938,706,697,230,927,6
2022-02-10,Mono,051,14174,2942,2939,118,3057,5
2022-02-10,Monterey,053,433212,76920,74842,12578,87420,672
2022-02-10,Napa,055,140530,24679,24530,888,25418,124
2022-02-10,Nevada,057,99092,15534,15499,1125,16624,119
2022-02-10,Orange,059,3164182,536677,534503,40126,574629,6305
2022-02-10,Placer,061,380077,61349,60636,7121,67757,554
2022-02-10,Plumas,063,18699,2893,2617,332,2949,13
2022-02-10,Riverside,065,2383286,581855,575566,26934,602500,5961
2022-02-10,Sacramento,067,1510023,273732,266347,25496,291843,2686
2022-02-10,San Benito,069,59416,12623,12526,500,13026,91
2022-02-10,San Bernardino,071,2135413,566790,548822,24415,573237,6360
2022-02-10,San Diego,073,3302833,732399,720287,50827,771114,4854
2022-02-10,San Francisco,075,870044,119386,119113,7883,126996,740
2022-02-10,San Joaquin,077,732212,162863,161234,9587,170821,2014
2022-02-10,San Luis Obispo,079,281455,50682,50064,3540,53604,416
2022-02-10,San Mateo,081,765935,117825,115235,6597,121832,589
2022-02-10,Santa Barbara,083,443738,83494,83390,4544,87934,631
2022-02-10,Santa Clara,085,1922200,303561,298176,11783,309959,2093
2022-02-10,Santa Cruz,087,273765,45384,44447,2024,46471,239
2022-02-10,Shasta,089,179085,29595,29370,5863,35233,473
2022-02-10,Sierra,091,2930,269,268,45,313,0
2022-02-10,Siskiyou,093,43540,4291,4231,2585,6816,68
2022-02-10,Solano,095,438530,78848,77865,5352,83217,424
2022-02-10,Sonoma,097,501317,80816,79533,2423,81956,431
2022-02-10,Stanislaus,099,539301,114954,114531,17280,131811,1406
2022-02-10,Sutter,101,95872,19936,19800,1921,21721,211
2022-02-10,Tehama,103,63373,11718,11580,2537,14117,151
2022-02-10,Trinity,105,12862,1148,1115,271,1386,20
2022-02-10,Tulare,107,460477,103719,100434,26491,126925,1273
2022-02-10,Tuolumne,109,53932,12318,11754,522,12276,125
2022-02-10,Ventura,111,848112,169530,168736,9169,177905,1340
2022-02-10,Yolo,113,214977,35839,34773,2749,37522,286
2022-02-10,Yuba,115,75493,15355,15242,1124,16366,107
2022-02-09,Alameda,001,1643700,247202,241141,12958,254099,1668
2022-02-09,Alpine,003,1148,120,124,1,125,0
2022-02-09,Amador,005,37829,8181,8069,605,8674,76
2022-02-09,Butte,007,227075,32112,31433,6738,38171,359
2022-02-09,Calaveras,009,45235,7065,7005,317,7322,106
2022-02-09,Colusa,011,21464,3375,3331,1021,4352,21
2022-02-09,Contra Costa,013,1133247,186086,179695,12622,192317,1132
2022-02-09,Del Norte,015,27424,5330,5204,158,5362,45
2022-02-09,El Dorado,017,186661,26054,25572,3082,28654,186
2022-02-09,Fresno,019,978130,226252,218989,23279,242268,2502
2022-02-09,Glenn,021,27897,4871,4804,1567,6371,39
2022-02-09,Humboldt,023,135768,16121,15929,2703,18632,131
2022-02-09,Imperial,025,180216,54013,53102,10109,63211,858
2022-02-09,Inyo,027,18085,4007,3989,434,4423,52
2022-02-09,Kern,029,883053,187356,184068,44341,228409,2021
2022-02-09,Kings,031,150075,49815,48718,3395,52113,410
2022-02-09,Lake,033,64148,10078,9880,821,10701,124
2022-02-09,Lassen,035,31185,8557,8459,849,9308,55
2022-02-09,Los Angeles,037,10098052,2658499,2611611,119840,2731451,29263
2022-02-09,Madera,039,155013,36087,35559,5723,41282,330
2022-02-09,Marin,041,260295,32270,31965,2097,34062,255
2022-02-09,Mariposa,043,17540,2293,2279,186,2465,6
2022-02-09,Mendocino,045,87422,12583,12378,2749,15127,107
2022-02-09,Merced,047,269075,60841,59952,8181,68133,755
2022-02-09,Modoc,049,8938,703,691,229,920,6
2022-02-09,Mono,051,14174,2940,2937,118,3055,5
2022-02-09,Monterey,053,433212,76718,74500,12492,86992,670
2022-02-09,Napa,055,140530,24633,24429,883,25312,123
2022-02-09,Nevada,057,99092,15513,15446,1123,16569,119
2022-02-09,Orange,059,3164182,536046,534316,40046,574362,6263
2022-02-09,Placer,061,380077,61254,60490,7101,67591,553
2022-02-09,Plumas,063,18699,2888,2609,328,2937,13
2022-02-09,Riverside,065,2383286,581114,573907,26889,600796,5911
2022-02-09,Sacramento,067,1510023,273168,265624,25380,291004,2673
2022-02-09,San Benito,069,59416,12599,12492,500,12992,91
2022-02-09,San Bernardino,071,2135413,566183,547768,24389,572157,6349
2022-02-09,San Diego,073,3302833,731041,717896,50715,768611,4832
2022-02-09,San Francisco,075,870044,119135,118550,7872,126422,731
2022-02-09,San Joaquin,077,732212,162558,160618,9577,170195,2014
2022-02-09,San Luis Obispo,079,281455,50536,49833,3535,53368,414
2022-02-09,San Mateo,081,765935,117637,114890,6557,121447,589
2022-02-09,Santa Barbara,083,443738,83312,82830,4538,87368,629
2022-02-09,Santa Clara,085,1922200,302838,297157,11725,308882,2090
2022-02-09,Santa Cruz,087,273765,45202,44200,2017,46217,239
2022-02-09,Shasta,089,179085,29526,29215,5842,35057,471
2022-02-09,Sierra,091,2930,268,268,44,312,0
2022-02-09,Siskiyou,093,43540,4277,4217,2579,6796,68
2022-02-09,Solano,095,438530,78655,77299,5343,82642,423
2022-02-09,Sonoma,097,501317,80642,79165,2416,81581,431
2022-02-09,Stanislaus,099,539301,114705,114039,17049,131088,1406
2022-02-09,Sutter,101,95872,19894,19758,1908,21666,207
2022-02-09,Tehama,103,63373,11693,11542,2533,14075,149
2022-02-09,Trinity,105,12862,1144,1110,270,1380,20
2022-02-09,Tulare,107,460477,103506,100049,26405,126454,1271
2022-02-09,Tuolumne,109,53932,12280,11702,519,12221,95
2022-02-09,Ventura,111,848112,169293,168253,9156,177409,1325
2022-02-09,Yolo,113,214977,35769,34588,2733,37321,285
2022-02-09,Yuba,115,75493,15324,15187,1113,16300,105
2022-02-08,Alameda,001,1643700,246566,240587,12886,253473,1651
2022-02-08,Alpine,003,1148,120,124,1,125,0
2022-02-08,Amador,005,37829,8173,8050,598,8648,76
2022-02-08,Butte,007,227075,32028,31353,6716,38069,359
2022-02-08,Calaveras,009,45235,7048,6981,315,7296,101
2022-02-08,Colusa,011,21464,3367,3320,1020,4340,21
2022-02-08,Contra Costa,013,1133247,185641,179078,12541,191619,1132
2022-02-08,Del Norte,015,27424,5305,5156,153,5309,44
2022-02-08,El Dorado,017,186661,26009,25446,3072,28518,186
2022-02-08,Fresno,019,978130,225504,218416,23172,241588,2502
2022-02-08,Glenn,021,27897,4854,4784,1563,6347,39
2022-02-08,Humboldt,023,135768,16061,15865,2671,18536,130
2022-02-08,Imperial,025,180216,53884,52977,10065,63042,855
2022-02-08,Inyo,027,18085,4002,3983,434,4417,52
2022-02-08,Kern,029,883053,187020,183519,44211,227730,2010
2022-02-08,Kings,031,150075,49655,48479,3383,51862,411
2022-02-08,Lake,033,64148,10048,9806,815,10621,125
2022-02-08,Lassen,035,31185,8548,8423,845,9268,55
2022-02-08,Los Angeles,037,10098052,2654194,2611204,119655,2730859,29259
2022-02-08,Madera,039,155013,35979,35381,5667,41048,330
2022-02-08,Marin,041,260295,32196,31878,2092,33970,255
2022-02-08,Mariposa,043,17540,2292,2266,178,2444,6
2022-02-08,Mendocino,045,87422,12551,12336,2718,15054,107
2022-02-08,Merced,047,269075,60727,59789,8121,67910,751
2022-02-08,Modoc,049,8938,699,684,229,913,6
2022-02-08,Mono,051,14174,2939,2932,118,3050,5
2022-02-08,Monterey,053,433212,76513,74316,12407,86723,670
2022-02-08,Napa,055,140530,24560,24346,877,25223,121
2022-02-08,Nevada,057,99092,15487,15383,1120,16503,117
2022-02-08,Orange,059,3164182,535359,533507,39958,573465,6205
2022-02-08,Placer,061,380077,61146,60301,7089,67390,553
2022-02-08,Plumas,063,18699,2877,2596,321,2917,13
2022-02-08,Riverside,065,2383286,580285,571892,26817,598709,5908
2022-02-08,Sacramento,067,1510023,272497,264479,25205,289684,2664
2022-02-08,San Benito,069,59416,12575,12434,498,12932,91
2022-02-08,San Bernardino,071,2135413,565471,544658,24345,569003,6335
2022-02-08,San Diego,073,3302833,729468,717896,50583,768479,4832
2022-02-08,San Francisco,075,870044,118823,117942,7863,125805,731
2022-02-08,San Joaquin,077,732212,162174,160147,9559,169706,2005
2022-02-08,San Luis Obispo,079,281455,50371,49556,3505,53061,410
2022-02-08,San Mateo,081,765935,117419,114541,6527,121068,589
2022-02-08,Santa Barbara,083,443738,83144,82461,4513,86974,627
2022-02-08,Santa Clara,085,1922200,301955,295679,11678,307357,2091
2022-02-08,Santa Cruz,087,273765,45047,43884,2012,45896,239
2022-02-08,Shasta,089,179085,29443,29084,5815,34899,470
2022-02-08,Sierra,091,2930,268,267,44,311,0
2022-02-08,Siskiyou,093,43540,4267,4191,2570,6761,68
2022-02-08,Solano,095,438530,78422,77031,5328,82359,421
2022-02-08,Sonoma,097,501317,80428,78798,2392,81190,431
2022-02-08,Stanislaus,099,539301,114449,113733,16971,130704,1406
2022-02-08,Sutter,101,95872,19856,19717,1896,21613,203
2022-02-08,Tehama,103,63373,11665,11491,2526,14017,149
2022-02-08,Trinity,105,12862,1138,1110,270,1380,20
2022-02-08,Tulare,107,460477,103216,99694,26274,125968,1267
2022-02-08,Tuolumne,109,53932,12255,11665,517,12182,92
2022-02-08,Ventura,111,848112,169056,167830,9141,176971,1325
2022-02-08,Yolo,113,214977,35687,34462,2720,37182,281
2022-02-08,Yuba,115,75493,15279,15126,1091,16217,107
2022-02-07,Alameda,001,1643700,245847,238678,12821,251499,1643
2022-02-07,Alpine,003,1148,120,124,1,125,0
2022-02-07,Amador,005,37829,8145,7980,590,8570,75
2022-02-07,Butte,007,227075,31940,31184,6686,37870,355
2022-02-07,Calaveras,009,45235,7026,6910,314,7224,100
2022-02-07,Colusa,011,21464,3356,3283,1016,4299,21
2022-02-07,Contra Costa,013,1133247,185159,177767,12467,190234,1130
2022-02-07,Del Norte,015,27424,5264,5093,148,5241,44
2022-02-07,El Dorado,017,186661,25947,25257,3062,28319,185
2022-02-07,Fresno,019,978130,224630,216495,23026,239521,2493
2022-02-07,Glenn,021,27897,4846,4762,1559,6321,39
2022-02-07,Humboldt,023,135768,15986,15764,2646,18410,129
2022-02-07,Imperial,025,180216,53769,52689,9996,62685,853
2022-02-07,Inyo,027,18085,3997,3976,428,4404,51
2022-02-07,Kern,029,883053,186547,182047,44047,226094,1998
2022-02-07,Kings,031,150075,49471,48147,3366,51513,403
2022-02-07,Lake,033,64148,10002,9519,807,10326,125
2022-02-07,Lassen,035,31185,8530,8362,839,9201,55
2022-02-07,Los Angeles,037,10098052,2649771,2607438,119437,2726875,29210
2022-02-07,Madera,039,155013,35855,35083,5620,40703,330
2022-02-07,Marin,041,260295,32129,31670,2082,33752,255
2022-02-07,Mariposa,043,17540,2287,2253,174,2427,6
2022-02-07,Mendocino,045,87422,12493,12237,2680,14917,107
2022-02-07,Merced,047,269075,60597,59472,8028,67500,748
2022-02-07,Modoc,049,8938,695,679,229,908,6
2022-02-07,Mono,051,14174,2937,2917,118,3035,5
2022-02-07,Monterey,053,433212,76258,69433,12300,81733,670
2022-02-07,Napa,055,140530,24475,23237,868,24105,120
2022-02-07,Nevada,057,99092,15451,15268,1114,16382,113
2022-02-07,Orange,059,3164182,534596,531442,39877,571319,6179
2022-02-07,Placer,061,380077,61021,59894,7074,66968,546
2022-02-07,Plumas,063,18699,2866,2573,312,2885,13
2022-02-07,Riverside,065,2383286,579343,568874,26733,595607,5868
2022-02-07,Sacramento,067,1510023,271810,262834,25023,287857,2631
2022-02-07,San Benito,069,59416,12536,12285,496,12781,90
2022-02-07,San Bernardino,071,2135413,564674,542846,24305,567151,6335
2022-02-07,San Diego,073,3302833,727750,716244,50394,766638,4811
2022-02-07,San Francisco,075,870044,118483,113945,7838,121783,727
2022-02-07,San Joaquin,077,732212,161792,159358,9540,168898,1998
2022-02-07,San Luis Obispo,079,281455,50201,48994,3486,52480,406
2022-02-07,San Mateo,081,765935,117133,107060,6498,113558,589
2022-02-07,Santa Barbara,083,443738,82956,81608,4498,86106,624
2022-02-07,Santa Clara,085,1922200,301003,293360,11631,304991,2085
2022-02-07,Santa Cruz,087,273765,44831,43244,2008,45252,239
2022-02-07,Shasta,089,179085,29353,28900,5789,34689,468
2022-02-07,Sierra,091,2930,268,265,44,309,0
2022-02-07,Siskiyou,093,43540,4256,4157,2554,6711,68
2022-02-07,Solano,095,438530,78165,73934,5299,79233,420
2022-02-07,Sonoma,097,501317,80171,78296,2376,80672,431
2022-02-07,Stanislaus,099,539301,114190,113029,16827,129856,1406
2022-02-07,Sutter,101,95872,19823,19599,1869,21468,203
2022-02-07,Tehama,103,63373,11623,11418,2518,13936,146
2022-02-07,Trinity,105,12862,1134,1109,267,1376,20
2022-02-07,Tulare,107,460477,102857,98774,26144,124918,1263
2022-02-07,Tuolumne,109,53932,12207,11578,513,12091,92
2022-02-07,Ventura,111,848112,168739,166904,9126,176030,1324
2022-02-07,Yolo,113,214977,35577,34007,2705,36712,281
2022-02-07,Yuba,115,75493,15232,14998,1084,16082,105
2022-02-06,Alameda,001,1643700,244936,237188,12738,249926,1643
2022-02-06,Alpine,003,1148,120,123,1,124,0
2022-02-06,Amador,005,37829,8114,7922,578,8500,73
2022-02-06,Butte,007,227075,31811,31021,6635,37656,355
2022-02-06,Calaveras,009,45235,6999,6870,309,7179,99
2022-02-06,Colusa,011,21464,3346,3282,1015,4297,21
2022-02-06,Contra Costa,013,1133247,184498,176863,12304,189167,1128
2022-02-06,Del Norte,015,27424,5208,5038,146,5184,44
2022-02-06,El Dorado,017,186661,25884,25165,3050,28215,185
2022-02-06,Fresno,019,978130,223772,214726,22772,237498,2489
2022-02-06,Glenn,021,27897,4832,4738,1550,6288,39
2022-02-06,Humboldt,023,135768,15903,15658,2606,18264,128
2022-02-06,Imperial,025,180216,53582,52396,9950,62346,853
2022-02-06,Inyo,027,18085,3995,3970,425,4395,51
2022-02-06,Kern,029,883053,185995,181188,43808,224996,1996
2022-02-06,Kings,031,150075,49247,47669,3341,51010,401
2022-02-06,Lake,033,64148,9933,9468,790,10258,125
2022-02-06,Lassen,035,31185,8510,8326,834,9160,55
2022-02-06,Los Angeles,037,10098052,2644266,2602620,119180,2721800,29180
2022-02-06,Madera,039,155013,35670,34901,5528,40429,330
2022-02-06,Marin,041,260295,32031,31488,2069,33557,255
2022-02-06,Mariposa,043,17540,2279,2244,163,2407,6
2022-02-06,Mendocino,045,87422,12450,12169,2610,14779,107
2022-02-06,Merced,047,269075,60371,59112,7861,66973,748
2022-02-06,Modoc,049,8938,690,675,228,903,6
2022-02-06,Mono,051,14174,2932,2901,116,3017,5
2022-02-06,Monterey,053,433212,75892,67912,12143,80055,670
2022-02-06,Napa,055,140530,24356,23230,861,24091,120
2022-02-06,Nevada,057,99092,15386,15192,1101,16293,113
2022-02-06,Orange,059,3164182,533644,527906,39776,567682,6171
2022-02-06,Placer,061,380077,60844,59507,7048,66555,544
2022-02-06,Plumas,063,18699,2853,2559,303,2862,13
2022-02-06,Riverside,065,2383286,578205,568276,26656,594932,5865
2022-02-06,Sacramento,067,1510023,270944,261353,24762,286115,2631
2022-02-06,San Benito,069,59416,12481,12186,488,12674,90
2022-02-06,San Bernardino,071,2135413,563698,541103,24235,565338,6334
2022-02-06,San Diego,073,3302833,725688,709938,50151,760089,4786
2022-02-06,San Francisco,075,870044,118102,113115,7812,120927,728
2022-02-06,San Joaquin,077,732212,161224,158510,9501,168011,1997
2022-02-06,San Luis Obispo,079,281455,49976,48843,3429,52272,405
2022-02-06,San Mateo,081,765935,116795,105556,6459,112015,587
2022-02-06,Santa Barbara,083,443738,82638,81118,4461,85579,623
2022-02-06,Santa Clara,085,1922200,299882,291732,11515,303247,2075
2022-02-06,Santa Cruz,087,273765,44518,42952,1994,44946,239
2022-02-06,Shasta,089,179085,29230,28762,5740,34502,468
2022-02-06,Sierra,091,2930,268,265,44,309,0
2022-02-06,Siskiyou,093,43540,4235,4118,2528,6646,68
2022-02-06,Solano,095,438530,77868,73475,5256,78731,419
2022-02-06,Sonoma,097,501317,79836,77887,2356,80243,431
2022-02-06,Stanislaus,099,539301,113794,112521,16679,129200,1406
2022-02-06,Sutter,101,95872,19781,19523,1831,21354,203
2022-02-06,Tehama,103,63373,11583,11366,2498,13864,146
2022-02-06,Trinity,105,12862,1133,1102,266,1368,20
2022-02-06,Tulare,107,460477,102425,98260,25963,124223,1262
2022-02-06,Tuolumne,109,53932,12155,11507,495,12002,92
2022-02-06,Ventura,111,848112,168363,166235,9115,175350,1323
2022-02-06,Yolo,113,214977,35438,33784,2688,36472,281
2022-02-06,Yuba,115,75493,15187,14917,1075,15992,104
2022-02-05,Alameda,001,1643700,244520,235698,12728,248426,1638
2022-02-05,Alpine,003,1148,120,124,1,125,0
2022-02-05,Amador,005,37829,8105,7855,576,8431,71
2022-02-05,Butte,007,227075,31756,30733,6621,37354,355
2022-02-05,Calaveras,009,45235,6983,6789,309,7098,99
2022-02-05,Colusa,011,21464,3339,3234,1015,4249,21
2022-02-05,Contra Costa,013,1133247,184221,175871,12288,188159,1115
2022-02-05,Del Norte,015,27424,5166,4978,146,5124,44
2022-02-05,El Dorado,017,186661,25852,24813,3048,27861,185
2022-02-05,Fresno,019,978130,223417,213539,22751,236290,2477
2022-02-05,Glenn,021,27897,4830,4691,1544,6235,39
2022-02-05,Humboldt,023,135768,15854,15514,2603,18117,127
2022-02-05,Imperial,025,180216,53521,52153,9937,62090,853
2022-02-05,Inyo,027,18085,3992,3948,425,4373,51
2022-02-05,Kern,029,883053,185786,180296,43706,224002,1987
2022-02-05,Kings,031,150075,49160,47538,3334,50872,402
2022-02-05,Lake,033,64148,9914,9289,783,10072,124
2022-02-05,Lassen,035,31185,8499,8288,832,9120,55
2022-02-05,Los Angeles,037,10098052,2642092,2572702,119056,2691758,28947
2022-02-05,Madera,039,155013,35617,34471,5515,39986,329
2022-02-05,Marin,041,260295,31985,31299,2065,33364,255
2022-02-05,Mariposa,043,17540,2278,2222,162,2384,6
2022-02-05,Mendocino,045,87422,12422,12066,2608,14674,107
2022-02-05,Merced,047,269075,60277,58908,7854,66762,744
2022-02-05,Modoc,049,8938,689,664,228,892,6
2022-02-05,Mono,051,14174,2931,2904,116,3020,5
2022-02-05,Monterey,053,433212,75776,67342,12099,79441,666
2022-02-05,Napa,055,140530,24300,22973,860,23833,118
2022-02-05,Nevada,057,99092,15364,15002,1096,16098,113
2022-02-05,Orange,059,3164182,533203,527516,39684,567200,6134
2022-02-05,Placer,061,380077,60719,59043,7035,66078,533
2022-02-05,Plumas,063,18699,2852,2550,302,2852,13
2022-02-05,Riverside,065,2383286,577603,563991,26586,590577,5827
2022-02-05,Sacramento,067,1510023,270548,259437,24727,284164,2610
2022-02-05,San Benito,069,59416,12436,12142,488,12630,90
2022-02-05,San Bernardino,071,2135413,563186,539312,24215,563527,6322
2022-02-05,San Diego,073,3302833,724830,703957,50074,754031,4735
2022-02-05,San Francisco,075,870044,117892,112481,7785,120266,720
2022-02-05,San Joaquin,077,732212,161038,157420,9489,166909,1989
2022-02-05,San Luis Obispo,079,281455,49939,48361,3427,51788,404
2022-02-05,San Mateo,081,765935,116607,104810,6451,111261,587
2022-02-05,Santa Barbara,083,443738,82475,80478,4449,84927,617
2022-02-05,Santa Clara,085,1922200,299229,289262,11499,300761,2067
2022-02-05,Santa Cruz,087,273765,44444,42553,1991,44544,239
2022-02-05,Shasta,089,179085,29188,28604,5730,34334,466
2022-02-05,Sierra,091,2930,268,262,44,306,0
2022-02-05,Siskiyou,093,43540,4228,4106,2515,6621,67
2022-02-05,Solano,095,438530,77793,73112,5247,78359,415
2022-02-05,Sonoma,097,501317,79670,77213,2352,79565,431
2022-02-05,Stanislaus,099,539301,113592,111783,16656,128439,1406
2022-02-05,Sutter,101,95872,19751,19406,1825,21231,203
2022-02-05,Tehama,103,63373,11564,11259,2491,13750,146
2022-02-05,Trinity,105,12862,1131,1085,266,1351,20
2022-02-05,Tulare,107,460477,102256,97414,25881,123295,1254
2022-02-05,Tuolumne,109,53932,12129,11409,492,11901,91
2022-02-05,Ventura,111,848112,168137,165532,9099,174631,1308
2022-02-05,Yolo,113,214977,35354,33614,2673,36287,281
2022-02-05,Yuba,115,75493,15156,14801,1067,15868,105
2022-02-04,Alameda,001,1643700,244031,235698,12717,248415,1638
2022-02-04,Alpine,003,1148,120,124,1,125,0
2022-02-04,Amador,005,37829,8089,7855,572,8427,71
2022-02-04,Butte,007,227075,31697,30733,6609,37342,355
2022-02-04,Calaveras,009,45235,6973,6789,307,7096,99
2022-02-04,Colusa,011,21464,3335,3234,1013,4247,21
2022-02-04,Contra Costa,013,1133247,183887,175871,12260,188131,1115
2022-02-04,Del Norte,015,27424,5145,4978,146,5124,44
2022-02-04,El Dorado,017,186661,25818,24813,3045,27858,185
2022-02-04,Fresno,019,978130,222931,213539,22717,236256,2477
2022-02-04,Glenn,021,27897,4821,4691,1541,6232,39
2022-02-04,Humboldt,023,135768,15827,15514,2600,18114,127
2022-02-04,Imperial,025,180216,53444,52153,9920,62073,853
2022-02-04,Inyo,027,18085,3989,3948,425,4373,51
2022-02-04,Kern,029,883053,185561,180296,43582,223878,1987
2022-02-04,Kings,031,150075,49085,47538,3327,50865,402
2022-02-04,Lake,033,64148,9892,9289,780,10069,124
2022-02-04,Lassen,035,31185,8476,8288,832,9120,55
2022-02-04,Los Angeles,037,10098052,2639455,2572702,118925,2691627,28947
2022-02-04,Madera,039,155013,35534,34471,5507,39978,329
2022-02-04,Marin,041,260295,31921,31299,2056,33355,255
2022-02-04,Mariposa,043,17540,2276,2222,160,2382,6
2022-02-04,Mendocino,045,87422,12391,12066,2606,14672,107
2022-02-04,Merced,047,269075,60197,58908,7844,66752,744
2022-02-04,Modoc,049,8938,689,664,228,892,6
2022-02-04,Mono,051,14174,2929,2904,116,3020,5
2022-02-04,Monterey,053,433212,75586,67342,12056,79398,666
2022-02-04,Napa,055,140530,24253,22973,856,23829,118
2022-02-04,Nevada,057,99092,15330,15002,1092,16094,113
2022-02-04,Orange,059,3164182,532654,527516,39626,567142,6134
2022-02-04,Placer,061,380077,60615,59043,7024,66067,533
2022-02-04,Plumas,063,18699,2845,2550,301,2851,13
2022-02-04,Riverside,065,2383286,576891,563991,26574,590565,5827
2022-02-04,Sacramento,067,1510023,270044,259437,24704,284141,2610
2022-02-04,San Benito,069,59416,12417,12142,486,12628,90
2022-02-04,San Bernardino,071,2135413,562604,539312,24194,563506,6322
2022-02-04,San Diego,073,3302833,723699,703957,49987,753944,4735
2022-02-04,San Francisco,075,870044,117650,112481,7760,120241,720
2022-02-04,San Joaquin,077,732212,160808,157420,9477,166897,1989
2022-02-04,San Luis Obispo,079,281455,49878,48361,3420,51781,404
2022-02-04,San Mateo,081,765935,116375,104810,6437,111247,587
2022-02-04,Santa Barbara,083,443738,82326,80478,4448,84926,617
2022-02-04,Santa Clara,085,1922200,298558,289262,11478,300740,2067
2022-02-04,Santa Cruz,087,273765,44239,42553,1987,44540,239
2022-02-04,Shasta,089,179085,29135,28604,5719,34323,466
2022-02-04,Sierra,091,2930,268,262,44,306,0
2022-02-04,Siskiyou,093,43540,4220,4106,2508,6614,67
2022-02-04,Solano,095,438530,77601,73112,5209,78321,415
2022-02-04,Sonoma,097,501317,79511,77213,2271,79484,431
2022-02-04,Stanislaus,099,539301,113411,111783,16630,128413,1406
2022-02-04,Sutter,101,95872,19727,19406,1818,21224,203
2022-02-04,Tehama,103,63373,11549,11259,2490,13749,146
2022-02-04,Trinity,105,12862,1130,1085,265,1350,20
2022-02-04,Tulare,107,460477,102076,97414,25801,123215,1254
2022-02-04,Tuolumne,109,53932,12117,11409,491,11900,91
2022-02-04,Ventura,111,848112,167868,165532,9091,174623,1308
2022-02-04,Yolo,113,214977,35261,33614,2667,36281,281
2022-02-04,Yuba,115,75493,15138,14801,1067,15868,105
2022-02-03,Alameda,001,1643700,243255,235698,12655,248353,1638
2022-02-03,Alpine,003,1148,120,124,1,125,0
2022-02-03,Amador,005,37829,8069,7855,567,8422,71
2022-02-03,Butte,007,227075,31591,30733,6580,37313,355
2022-02-03,Calaveras,009,45235,6943,6789,304,7093,99
2022-02-03,Colusa,011,21464,3322,3234,1011,4245,21
2022-02-03,Contra Costa,013,1133247,183261,175871,12156,188027,1115
2022-02-03,Del Norte,015,27424,5103,4978,143,5121,44
2022-02-03,El Dorado,017,186661,25747,24813,3040,27853,185
2022-02-03,Fresno,019,978130,221990,213539,22556,236095,2477
2022-02-03,Glenn,021,27897,4804,4691,1524,6215,39
2022-02-03,Humboldt,023,135768,15751,15514,2564,18078,127
2022-02-03,Imperial,025,180216,53300,52153,9869,62022,853
2022-02-03,Inyo,027,18085,3986,3948,421,4369,51
2022-02-03,Kern,029,883053,185097,180296,43368,223664,1987
2022-02-03,Kings,031,150075,48927,47538,3320,50858,402
2022-02-03,Lake,033,64148,9838,9289,774,10063,124
2022-02-03,Lassen,035,31185,8452,8288,831,9119,55
2022-02-03,Los Angeles,037,10098052,2634036,2572702,118663,2691365,28947
2022-02-03,Madera,039,155013,35398,34471,5463,39934,329
2022-02-03,Marin,041,260295,31825,31299,2051,33350,255
2022-02-03,Mariposa,043,17540,2264,2222,157,2379,6
2022-02-03,Mendocino,045,87422,12347,12066,2583,14649,107
2022-02-03,Merced,047,269075,60045,58908,7747,66655,744
2022-02-03,Modoc,049,8938,686,664,228,892,6
2022-02-03,Mono,051,14174,2924,2904,115,3019,5
2022-02-03,Monterey,053,433212,75299,67342,11864,79206,666
2022-02-03,Napa,055,140530,24122,22973,856,23829,118
2022-02-03,Nevada,057,99092,15290,15002,1082,16084,113
2022-02-03,Orange,059,3164182,531729,527516,39534,567050,6134
2022-02-03,Placer,061,380077,60417,59043,7001,66044,533
2022-02-03,Plumas,063,18699,2831,2550,297,2847,13
2022-02-03,Riverside,065,2383286,575688,563991,26503,590494,5827
2022-02-03,Sacramento,067,1510023,269086,259437,24514,283951,2610
2022-02-03,San Benito,069,59416,12389,12142,483,12625,90
2022-02-03,San Bernardino,071,2135413,561592,539312,24155,563467,6322
2022-02-03,San Diego,073,3302833,721730,703957,49815,753772,4735
2022-02-03,San Francisco,075,870044,117318,112481,7731,120212,720
2022-02-03,San Joaquin,077,732212,160319,157420,9446,166866,1989
2022-02-03,San Luis Obispo,079,281455,49679,48361,3405,51766,404
2022-02-03,San Mateo,081,765935,116024,104810,6404,111214,587
2022-02-03,Santa Barbara,083,443738,81968,80478,4419,84897,617
2022-02-03,Santa Clara,085,1922200,297362,289262,11371,300633,2067
2022-02-03,Santa Cruz,087,273765,43899,42553,1980,44533,239
2022-02-03,Shasta,089,179085,29031,28604,5692,34296,466
2022-02-03,Sierra,091,2930,268,262,44,306,0
2022-02-03,Siskiyou,093,43540,4205,4106,2492,6598,67
2022-02-03,Solano,095,438530,77270,73112,5190,78302,415
2022-02-03,Sonoma,097,501317,79215,77213,2264,79477,431
2022-02-03,Stanislaus,099,539301,113033,111783,16542,128325,1406
2022-02-03,Sutter,101,95872,19675,19406,1802,21208,203
2022-02-03,Tehama,103,63373,11519,11259,2482,13741,146
2022-02-03,Trinity,105,12862,1128,1085,264,1349,20
2022-02-03,Tulare,107,460477,101673,97414,25663,123077,1254
2022-02-03,Tuolumne,109,53932,12076,11409,479,11888,91
2022-02-03,Ventura,111,848112,167483,165532,9079,174611,1308
2022-02-03,Yolo,113,214977,35152,33614,2653,36267,281
2022-02-03,Yuba,115,75493,15088,14801,1051,15852,105
2022-02-02,Alameda,001,1643700,242306,234300,12555,246855,1632
2022-02-02,Alpine,003,1148,120,123,1,124,0
2022-02-02,Amador,005,37829,8039,7781,558,8339,71
2022-02-02,Butte,007,227075,31479,30550,6543,37093,355
2022-02-02,Calaveras,009,45235,6917,6753,300,7053,99
2022-02-02,Colusa,011,21464,3307,3211,1010,4221,21
2022-02-02,Contra Costa,013,1133247,182633,174876,12059,186935,1113
2022-02-02,Del Norte,015,27424,5061,4924,139,5063,44
2022-02-02,El Dorado,017,186661,25684,24690,3021,27711,185
2022-02-02,Fresno,019,978130,220955,211976,22422,234398,2463
2022-02-02,Glenn,021,27897,4785,4667,1514,6181,39
2022-02-02,Humboldt,023,135768,15691,15392,2525,17917,127
2022-02-02,Imperial,025,180216,53104,51875,9742,61617,853
2022-02-02,Inyo,027,18085,3980,3944,420,4364,51
2022-02-02,Kern,029,883053,184501,179386,43155,222541,1974
2022-02-02,Kings,031,150075,48737,47061,3294,50355,401
2022-02-02,Lake,033,64148,9780,9235,767,10002,120
2022-02-02,Lassen,035,31185,8439,8258,822,9080,55
2022-02-02,Los Angeles,037,10098052,2627818,2561902,118288,2680190,28850
2022-02-02,Madera,039,155013,35230,34265,5391,39656,329
2022-02-02,Marin,041,260295,31722,31149,2041,33190,255
2022-02-02,Mariposa,043,17540,2253,2215,153,2368,6
2022-02-02,Mendocino,045,87422,12294,11996,2544,14540,105
2022-02-02,Merced,047,269075,59861,58532,7661,66193,744
2022-02-02,Modoc,049,8938,680,662,228,890,6
2022-02-02,Mono,051,14174,2913,2887,115,3002,5
2022-02-02,Monterey,053,433212,74908,66852,11684,78536,666
2022-02-02,Napa,055,140530,24002,22859,843,23702,117
2022-02-02,Nevada,057,99092,15232,14895,1060,15955,112
2022-02-02,Orange,059,3164182,530674,524418,39440,563858,6127
2022-02-02,Placer,061,380077,60223,58654,6972,65626,533
2022-02-02,Plumas,063,18699,2815,2540,294,2834,12
2022-02-02,Riverside,065,2383286,574409,561220,26456,587676,5827
2022-02-02,Sacramento,067,1510023,268084,258078,24307,282385,2602
2022-02-02,San Benito,069,59416,12349,12058,479,12537,90
2022-02-02,San Bernardino,071,2135413,560572,537485,24092,561577,6317
2022-02-02,San Diego,073,3302833,719529,703957,49626,753583,4735
2022-02-02,San Francisco,075,870044,116947,112008,7715,119723,714
2022-02-02,San Joaquin,077,732212,159746,156537,9420,165957,1986
2022-02-02,San Luis Obispo,079,281455,49481,48119,3392,51511,403
2022-02-02,San Mateo,081,765935,115649,104201,6340,110541,587
2022-02-02,Santa Barbara,083,443738,81625,79979,4388,84367,612
2022-02-02,Santa Clara,085,1922200,296188,287443,11259,298702,2051
2022-02-02,Santa Cruz,087,273765,43610,42127,1969,44096,239
2022-02-02,Shasta,089,179085,28930,28429,5647,34076,465
2022-02-02,Sierra,091,2930,268,262,44,306,0
2022-02-02,Siskiyou,093,43540,4195,4078,2463,6541,67
2022-02-02,Solano,095,438530,76911,72711,5163,77874,414
2022-02-02,Sonoma,097,501317,78902,76681,2251,78932,431
2022-02-02,Stanislaus,099,539301,112637,111167,16409,127576,1403
2022-02-02,Sutter,101,95872,19611,19290,1773,21063,203
2022-02-02,Tehama,103,63373,11461,11193,2463,13656,146
2022-02-02,Trinity,105,12862,1125,1074,262,1336,20
2022-02-02,Tulare,107,460477,101284,96820,25511,122331,1249
2022-02-02,Tuolumne,109,53932,11999,11342,476,11818,91
2022-02-02,Ventura,111,848112,167085,164905,9060,173965,1292
2022-02-02,Yolo,113,214977,35027,33332,2630,35962,281
2022-02-02,Yuba,115,75493,15023,14720,1043,15763,104
2022-02-01,Alameda,001,1643700,241236,233782,12450,246232,1620
2022-02-01,Alpine,003,1148,120,123,1,124,0
2022-02-01,Amador,005,37829,7993,7783,552,8335,73
2022-02-01,Butte,007,227075,31336,30496,6501,36997,355
2022-02-01,Calaveras,009,45235,6880,6749,296,7045,98
2022-02-01,Colusa,011,21464,3295,3202,997,4199,21
2022-02-01,Contra Costa,013,1133247,181872,174379,11915,186294,1115
2022-02-01,Del Norte,015,27424,5013,4907,136,5043,44
2022-02-01,El Dorado,017,186661,25624,24664,3004,27668,184
2022-02-01,Fresno,019,978130,219767,211352,22259,233611,2464
2022-02-01,Glenn,021,27897,4769,4649,1504,6153,39
2022-02-01,Humboldt,023,135768,15609,15354,2497,17851,127
2022-02-01,Imperial,025,180216,52891,51675,9677,61352,846
2022-02-01,Inyo,027,18085,3970,3928,417,4345,51
2022-02-01,Kern,029,883053,183854,178987,42910,221897,1967
2022-02-01,Kings,031,150075,48477,46959,3271,50230,400
2022-02-01,Lake,033,64148,9724,9211,760,9971,119
2022-02-01,Lassen,035,31185,8421,8231,818,9049,55
2022-02-01,Los Angeles,037,10098052,2620665,2548794,117914,2666708,28752
2022-02-01,Madera,039,155013,35010,34124,5310,39434,329
2022-02-01,Marin,041,260295,31598,31099,2025,33124,255
2022-02-01,Mariposa,043,17540,2246,2210,152,2362,6
2022-02-01,Mendocino,045,87422,12232,11978,2507,14485,105
2022-02-01,Merced,047,269075,59674,58362,7535,65897,743
2022-02-01,Modoc,049,8938,673,664,228,892,6
2022-02-01,Mono,051,14174,2907,2888,115,3003,5
2022-02-01,Monterey,053,433212,74488,66553,11490,78043,665
2022-02-01,Napa,055,140530,23903,22795,827,23622,116
2022-02-01,Nevada,057,99092,15171,14863,1048,15911,112
2022-02-01,Orange,059,3164182,529526,523741,39296,563037,6108
2022-02-01,Placer,061,380077,59975,58486,6934,65420,532
2022-02-01,Plumas,063,18699,2800,2526,291,2817,12
2022-02-01,Riverside,065,2383286,573021,560010,26408,586418,5825
2022-02-01,Sacramento,067,1510023,267031,257504,24041,281545,2593
2022-02-01,San Benito,069,59416,12283,12053,476,12529,90
2022-02-01,San Bernardino,071,2135413,559278,536591,24027,560618,6311
2022-02-01,San Diego,073,3302833,717009,701009,49398,750407,4710
2022-02-01,San Francisco,075,870044,116479,111606,7696,119302,713
2022-02-01,San Joaquin,077,732212,159213,156300,9397,165697,1987
2022-02-01,San Luis Obispo,079,281455,49252,47842,3331,51173,403
2022-02-01,San Mateo,081,765935,115180,103868,6298,110166,589
2022-02-01,Santa Barbara,083,443738,81180,79659,4351,84010,608
2022-02-01,Santa Clara,085,1922200,294657,286109,11154,297263,2070
2022-02-01,Santa Cruz,087,273765,43310,41782,1953,43735,239
2022-02-01,Shasta,089,179085,28810,28382,5594,33976,465
2022-02-01,Sierra,091,2930,266,262,44,306,0
2022-02-01,Siskiyou,093,43540,4181,4072,2436,6508,66
2022-02-01,Solano,095,438530,76634,72494,5141,77635,415
2022-02-01,Sonoma,097,501317,78542,76379,2228,78607,431
2022-02-01,Stanislaus,099,539301,112227,110925,16303,127228,1403
2022-02-01,Sutter,101,95872,19543,19256,1740,20996,202
2022-02-01,Tehama,103,63373,11404,11165,2450,13615,146
2022-02-01,Trinity,105,12862,1121,1073,262,1335,19
2022-02-01,Tulare,107,460477,100793,96467,25314,121781,1247
2022-02-01,Tuolumne,109,53932,11949,11318,467,11785,91
2022-02-01,Ventura,111,848112,166580,164721,9035,173756,1293
2022-02-01,Yolo,113,214977,34875,33257,2604,35861,275
2022-02-01,Yuba,115,75493,14962,14693,1036,15729,103
2022-01-31,Alameda,001,1643700,239882,232743,12341,245084,1607
2022-01-31,Alpine,003,1148,119,123,1,124,0
2022-01-31,Amador,005,37829,7940,7682,535,8217,73
2022-01-31,Butte,007,227075,31160,30371,6453,36824,354
2022-01-31,Calaveras,009,45235,6844,6700,285,6985,96
2022-01-31,Colusa,011,21464,3285,3187,988,4175,21
2022-01-31,Contra Costa,013,1133247,181028,173466,11788,185254,1115
2022-01-31,Del Norte,015,27424,4979,4879,133,5012,43
2022-01-31,El Dorado,017,186661,25519,24545,2974,27519,184
2022-01-31,Fresno,019,978130,218262,210589,22057,232646,2464
2022-01-31,Glenn,021,27897,4733,4641,1492,6133,39
2022-01-31,Humboldt,023,135768,15519,15308,2464,17772,126
2022-01-31,Imperial,025,180216,52675,51472,9568,61040,846
2022-01-31,Inyo,027,18085,3959,3922,411,4333,50
2022-01-31,Kern,029,883053,183072,178375,42594,220969,1967
2022-01-31,Kings,031,150075,48120,46845,3237,50082,398
2022-01-31,Lake,033,64148,9651,9141,748,9889,119
2022-01-31,Lassen,035,31185,8390,8162,812,8974,55
2022-01-31,Los Angeles,037,10098052,2612442,2541189,117506,2658695,28718
2022-01-31,Madera,039,155013,34795,33886,5214,39100,329
2022-01-31,Marin,041,260295,31473,31023,2008,33031,253
2022-01-31,Mariposa,043,17540,2236,2203,143,2346,6
2022-01-31,Mendocino,045,87422,12166,11896,2466,14362,104
2022-01-31,Merced,047,269075,59387,58198,7346,65544,740
2022-01-31,Modoc,049,8938,670,661,228,889,6
2022-01-31,Mono,051,14174,2893,2889,115,3004,5
2022-01-31,Monterey,053,433212,74036,66117,11277,77394,661
2022-01-31,Napa,055,140530,23735,22707,810,23517,113
2022-01-31,Nevada,057,99092,15094,14813,1035,15848,112
2022-01-31,Orange,059,3164182,528199,522358,39159,561517,6098
2022-01-31,Placer,061,380077,59728,58252,6903,65155,523
2022-01-31,Plumas,063,18699,2787,2513,289,2802,12
2022-01-31,Riverside,065,2383286,571203,558166,26344,584510,5785
2022-01-31,Sacramento,067,1510023,265739,256594,23789,280383,2571
2022-01-31,San Benito,069,59416,12224,11976,475,12451,90
2022-01-31,San Bernardino,071,2135413,557629,535276,23945,559221,6302
2022-01-31,San Diego,073,3302833,714103,698571,49126,747697,4686
2022-01-31,San Francisco,075,870044,116074,111119,7662,118781,712
2022-01-31,San Joaquin,077,732212,158453,155736,9366,165102,1985
2022-01-31,San Luis Obispo,079,281455,48998,47656,3274,50930,395
2022-01-31,San Mateo,081,765935,114672,103313,6240,109553,589
2022-01-31,Santa Barbara,083,443738,80674,79267,4309,83576,606
2022-01-31,Santa Clara,085,1922200,292967,284562,11050,295612,2041
2022-01-31,Santa Cruz,087,273765,42931,41630,1946,43576,239
2022-01-31,Shasta,089,179085,28680,28190,5553,33743,462
2022-01-31,Sierra,091,2930,266,261,44,305,0
2022-01-31,Siskiyou,093,43540,4165,4054,2420,6474,66
2022-01-31,Solano,095,438530,75927,72258,5094,77352,414
2022-01-31,Sonoma,097,501317,78088,76199,2198,78397,431
2022-01-31,Stanislaus,099,539301,111699,110493,16122,126615,1403
2022-01-31,Sutter,101,95872,19463,19189,1690,20879,202
2022-01-31,Tehama,103,63373,11341,11112,2422,13534,145
2022-01-31,Trinity,105,12862,1116,1071,259,1330,19
2022-01-31,Tulare,107,460477,100163,96053,25082,121135,1245
2022-01-31,Tuolumne,109,53932,11859,11278,460,11738,91
2022-01-31,Ventura,111,848112,166044,164060,9010,173070,1286
2022-01-31,Yolo,113,214977,34714,33175,2577,35752,274
2022-01-31,Yuba,115,75493,14899,14652,1016,15668,103
2022-01-30,Alameda,001,1643700,238324,231838,12189,244027,1607
2022-01-30,Alpine,003,1148,119,123,1,124,0
2022-01-30,Amador,005,37829,7889,7644,512,8156,73
2022-01-30,Butte,007,227075,30954,30255,6374,36629,354
2022-01-30,Calaveras,009,45235,6788,6676,274,6950,96
2022-01-30,Colusa,011,21464,3265,3168,980,4148,21
2022-01-30,Contra Costa,013,1133247,180034,172902,11585,184487,1102
2022-01-30,Del Norte,015,27424,4938,4833,130,4963,43
2022-01-30,El Dorado,017,186661,25396,24491,2949,27440,184
2022-01-30,Fresno,019,978130,216686,209645,21795,231440,2463
2022-01-30,Glenn,021,27897,4700,4619,1483,6102,39
2022-01-30,Humboldt,023,135768,15407,15247,2409,17656,126
2022-01-30,Imperial,025,180216,52351,51415,9399,60814,846
2022-01-30,Inyo,027,18085,3942,3921,408,4329,50
2022-01-30,Kern,029,883053,182207,177924,42272,220196,1967
2022-01-30,Kings,031,150075,47768,46654,3180,49834,398
2022-01-30,Lake,033,64148,9562,9080,727,9807,119
2022-01-30,Lassen,035,31185,8366,8158,804,8962,55
2022-01-30,Los Angeles,037,10098052,2602365,2530739,117035,2647774,28678
2022-01-30,Madera,039,155013,34496,33752,5030,38782,329
2022-01-30,Marin,041,260295,31325,30875,1994,32869,253
2022-01-30,Mariposa,043,17540,2224,2177,138,2315,6
2022-01-30,Mendocino,045,87422,12093,11860,2360,14220,104
2022-01-30,Merced,047,269075,59015,58006,7052,65058,740
2022-01-30,Modoc,049,8938,667,661,228,889,6
2022-01-30,Mono,051,14174,2887,2888,115,3003,5
2022-01-30,Monterey,053,433212,73447,65996,10998,76994,661
2022-01-30,Napa,055,140530,23567,22588,794,23382,114
2022-01-30,Nevada,057,99092,15005,14741,1019,15760,112
2022-01-30,Orange,059,3164182,526561,521334,39009,560343,6098
2022-01-30,Placer,061,380077,59399,58030,6863,64893,523
2022-01-30,Plumas,063,18699,2762,2510,275,2785,12
2022-01-30,Riverside,065,2383286,569134,557088,26244,583332,5767
2022-01-30,Sacramento,067,1510023,264281,255715,23295,279010,2572
2022-01-30,San Benito,069,59416,12158,11945,470,12415,90
2022-01-30,San Bernardino,071,2135413,555856,534050,23834,557884,6302
2022-01-30,San Diego,073,3302833,710566,687145,48690,735835,4665
2022-01-30,San Francisco,075,870044,115525,110772,7628,118400,712
2022-01-30,San Joaquin,077,732212,157464,155165,9328,164493,1985
2022-01-30,San Luis Obispo,079,281455,48601,47599,3238,50837,394
2022-01-30,San Mateo,081,765935,114099,102979,6195,109174,589
2022-01-30,Santa Barbara,083,443738,79997,79072,4248,83320,606
2022-01-30,Santa Clara,085,1922200,290991,282846,10919,293765,2035
2022-01-30,Santa Cruz,087,273765,42472,41330,1938,43268,239
2022-01-30,Shasta,089,179085,28519,28105,5469,33574,462
2022-01-30,Sierra,091,2930,266,261,44,305,0
2022-01-30,Siskiyou,093,43540,4135,4039,2373,6412,66
2022-01-30,Solano,095,438530,75401,71857,5043,76900,414
2022-01-30,Sonoma,097,501317,77569,75890,2169,78059,431
2022-01-30,Stanislaus,099,539301,111045,110111,15919,126030,1403
2022-01-30,Sutter,101,95872,19371,19108,1593,20701,202
2022-01-30,Tehama,103,63373,11269,11071,2392,13463,145
2022-01-30,Trinity,105,12862,1110,1068,259,1327,19
2022-01-30,Tulare,107,460477,99420,95676,24822,120498,1245
2022-01-30,Tuolumne,109,53932,11750,11242,423,11665,91
2022-01-30,Ventura,111,848112,165466,163521,8980,172501,1286
2022-01-30,Yolo,113,214977,34496,33043,2544,35587,274
2022-01-30,Yuba,115,75493,14809,14584,996,15580,103
2022-01-29,Alameda,001,1643700,237650,225602,12171,237773,1605
2022-01-29,Alpine,003,1148,119,123,1,124,0
2022-01-29,Amador,005,37829,7867,7505,509,8014,73
2022-01-29,Butte,007,227075,30864,29557,6343,35900,353
2022-01-29,Calaveras,009,45235,6769,6484,274,6758,96
2022-01-29,Colusa,011,21464,3260,3107,976,4083,21
2022-01-29,Contra Costa,013,1133247,179487,168003,11552,179555,1101
2022-01-29,Del Norte,015,27424,4920,4589,128,4717,43
2022-01-29,El Dorado,017,186661,25353,24008,2942,26950,184
2022-01-29,Fresno,019,978130,216228,202691,21756,224447,2457
2022-01-29,Glenn,021,27897,4692,4516,1476,5992,39
2022-01-29,Humboldt,023,135768,15360,14812,2402,17214,126
2022-01-29,Imperial,025,180216,52234,50153,9343,59496,845
2022-01-29,Inyo,027,18085,3940,3895,400,4295,50
2022-01-29,Kern,029,883053,181867,174456,42110,216566,1962
2022-01-29,Kings,031,150075,47649,45047,3173,48220,397
2022-01-29,Lake,033,64148,9529,8747,723,9470,119
2022-01-29,Lassen,035,31185,8345,7961,801,8762,55
2022-01-29,Los Angeles,037,10098052,2598458,2473332,116769,2590101,28467
2022-01-29,Madera,039,155013,34387,32753,5002,37755,329
2022-01-29,Marin,041,260295,31260,30137,1992,32129,253
2022-01-29,Mariposa,043,17540,2222,2117,136,2253,6
2022-01-29,Mendocino,045,87422,12069,11591,2344,13935,104
2022-01-29,Merced,047,269075,58907,56472,7047,63519,735
2022-01-29,Modoc,049,8938,667,654,228,882,6
2022-01-29,Mono,051,14174,2885,2860,115,2975,5
2022-01-29,Monterey,053,433212,73292,64090,10936,75026,658
2022-01-29,Napa,055,140530,23511,22121,792,22913,113
2022-01-29,Nevada,057,99092,14971,14337,1016,15353,112
2022-01-29,Orange,059,3164182,525857,511255,38903,550158,6038
2022-01-29,Placer,061,380077,59208,56562,6847,63409,523
2022-01-29,Plumas,063,18699,2752,2463,271,2734,12
2022-01-29,Riverside,065,2383286,568110,548121,26202,574323,5726
2022-01-29,Sacramento,067,1510023,263641,249130,23249,272379,2558
2022-01-29,San Benito,069,59416,12100,11670,469,12139,90
2022-01-29,San Bernardino,071,2135413,555107,525249,23790,549039,6297
2022-01-29,San Diego,073,3302833,709232,683027,48590,731617,4643
2022-01-29,San Francisco,075,870044,115251,108265,7580,115845,712
2022-01-29,San Joaquin,077,732212,157219,150849,9306,160155,1971
2022-01-29,San Luis Obispo,079,281455,48511,46374,3235,49609,391
2022-01-29,San Mateo,081,765935,113758,100306,6176,106482,586
2022-01-29,Santa Barbara,083,443738,79775,76546,4242,80788,604
2022-01-29,Santa Clara,085,1922200,290056,273879,10891,284770,2019
2022-01-29,Santa Cruz,087,273765,42341,39228,1936,41164,240
2022-01-29,Shasta,089,179085,28459,27504,5456,32960,452
2022-01-29,Sierra,091,2930,266,260,43,303,0
2022-01-29,Siskiyou,093,43540,4125,3987,2366,6353,66
2022-01-29,Solano,095,438530,75256,69862,5030,74892,407
2022-01-29,Sonoma,097,501317,77354,73439,2164,75603,427
2022-01-29,Stanislaus,099,539301,110795,107668,15868,123536,1403
2022-01-29,Sutter,101,95872,19323,18797,1577,20374,202
2022-01-29,Tehama,103,63373,11234,10880,2383,13263,145
2022-01-29,Trinity,105,12862,1107,1033,258,1291,19
2022-01-29,Tulare,107,460477,99163,93154,24750,117904,1237
2022-01-29,Tuolumne,109,53932,11724,10806,415,11221,91
2022-01-29,Ventura,111,848112,165136,160466,8961,169427,1271
2022-01-29,Yolo,113,214977,34382,32123,2528,34651,275
2022-01-29,Yuba,115,75493,14769,14295,994,15289,103
2022-01-28,Alameda,001,1643700,236705,225602,12153,237755,1605
2022-01-28,Alpine,003,1148,119,123,1,124,0
2022-01-28,Amador,005,37829,7841,7505,508,8013,73
2022-01-28,Butte,007,227075,30787,29557,6321,35878,353
2022-01-28,Calaveras,009,45235,6751,6484,273,6757,96
2022-01-28,Colusa,011,21464,3255,3107,975,4082,21
2022-01-28,Contra Costa,013,1133247,178937,168003,11515,179518,1101
2022-01-28,Del Norte,015,27424,4896,4589,127,4716,43
2022-01-28,El Dorado,017,186661,25308,24008,2935,26943,184
2022-01-28,Fresno,019,978130,215350,202691,21700,224391,2457
2022-01-28,Glenn,021,27897,4679,4516,1474,5990,39
2022-01-28,Humboldt,023,135768,15324,14812,2392,17204,126
2022-01-28,Imperial,025,180216,52106,50153,9313,59466,845
2022-01-28,Inyo,027,18085,3936,3895,397,4292,50
2022-01-28,Kern,029,883053,181456,174456,41952,216408,1962
2022-01-28,Kings,031,150075,47519,45047,3163,48210,397
2022-01-28,Lake,033,64148,9497,8747,720,9467,119
2022-01-28,Lassen,035,31185,8275,7961,799,8760,55
2022-01-28,Los Angeles,037,10098052,2592735,2473332,116556,2589888,28467
2022-01-28,Madera,039,155013,34259,32753,4986,37739,329
2022-01-28,Marin,041,260295,31167,30137,1972,32109,253
2022-01-28,Mariposa,043,17540,2212,2117,134,2251,6
2022-01-28,Mendocino,045,87422,12026,11591,2342,13933,104
2022-01-28,Merced,047,269075,58806,56472,7032,63504,735
2022-01-28,Modoc,049,8938,666,654,228,882,6
2022-01-28,Mono,051,14174,2880,2860,114,2974,5
2022-01-28,Monterey,053,433212,73089,64090,10887,74977,658
2022-01-28,Napa,055,140530,23432,22121,790,22911,113
2022-01-28,Nevada,057,99092,14934,14337,1014,15351,112
2022-01-28,Orange,059,3164182,524785,511255,38813,550068,6038
2022-01-28,Placer,061,380077,59009,56562,6824,63386,523
2022-01-28,Plumas,063,18699,2744,2463,269,2732,12
2022-01-28,Riverside,065,2383286,566788,548121,26161,574282,5726
2022-01-28,Sacramento,067,1510023,262897,249130,23196,272326,2558
2022-01-28,San Benito,069,59416,12078,11670,464,12134,90
2022-01-28,San Bernardino,071,2135413,554067,525249,23753,549002,6297
2022-01-28,San Diego,073,3302833,707410,683027,48511,731538,4643
2022-01-28,San Francisco,075,870044,114896,108265,7531,115796,712
2022-01-28,San Joaquin,077,732212,156930,150849,9292,160141,1971
2022-01-28,San Luis Obispo,079,281455,48427,46374,3228,49602,391
2022-01-28,San Mateo,081,765935,113405,100306,6156,106462,586
2022-01-28,Santa Barbara,083,443738,79526,76546,4240,80786,604
2022-01-28,Santa Clara,085,1922200,288867,273879,10842,284721,2019
2022-01-28,Santa Cruz,087,273765,42148,39228,1925,41153,240
2022-01-28,Shasta,089,179085,28399,27504,5442,32946,452
2022-01-28,Sierra,091,2930,266,260,43,303,0
2022-01-28,Siskiyou,093,43540,4115,3987,2362,6349,66
2022-01-28,Solano,095,438530,74704,69862,4964,74826,407
2022-01-28,Sonoma,097,501317,77148,73439,2157,75596,427
2022-01-28,Stanislaus,099,539301,110522,107668,15821,123489,1403
2022-01-28,Sutter,101,95872,19278,18797,1575,20372,202
2022-01-28,Tehama,103,63373,11202,10880,2376,13256,145
2022-01-28,Trinity,105,12862,1098,1033,258,1291,19
2022-01-28,Tulare,107,460477,98890,93154,24644,117798,1237
2022-01-28,Tuolumne,109,53932,11691,10806,411,11217,91
2022-01-28,Ventura,111,848112,164682,160466,8942,169408,1271
2022-01-28,Yolo,113,214977,34277,32123,2522,34645,275
2022-01-28,Yuba,115,75493,14730,14295,990,15285,103
2022-01-27,Alameda,001,1643700,235121,225602,12022,237624,1605
2022-01-27,Alpine,003,1148,119,123,1,124,0
2022-01-27,Amador,005,37829,7794,7505,497,8002,73
2022-01-27,Butte,007,227075,30634,29557,6267,35824,353
2022-01-27,Calaveras,009,45235,6725,6484,257,6741,96
2022-01-27,Colusa,011,21464,3239,3107,970,4077,21
2022-01-27,Contra Costa,013,1133247,177873,168003,11341,179344,1101
2022-01-27,Del Norte,015,27424,4852,4589,123,4712,43
2022-01-27,El Dorado,017,186661,25199,24008,2916,26924,184
2022-01-27,Fresno,019,978130,213702,202691,21480,224171,2457
2022-01-27,Glenn,021,27897,4647,4516,1466,5982,39
2022-01-27,Humboldt,023,135768,15236,14812,2355,17167,126
2022-01-27,Imperial,025,180216,51837,50153,9202,59355,845
2022-01-27,Inyo,027,18085,3929,3895,388,4283,50
2022-01-27,Kern,029,883053,180677,174456,41591,216047,1962
2022-01-27,Kings,031,150075,47180,45047,3125,48172,397
2022-01-27,Lake,033,64148,9443,8747,703,9450,119
2022-01-27,Lassen,035,31185,8234,7961,793,8754,55
2022-01-27,Los Angeles,037,10098052,2581581,2473332,116044,2589376,28467
2022-01-27,Madera,039,155013,34050,32753,4884,37637,329
2022-01-27,Marin,041,260295,31003,30137,1957,32094,253
2022-01-27,Mariposa,043,17540,2189,2117,131,2248,6
2022-01-27,Mendocino,045,87422,11975,11591,2293,13884,104
2022-01-27,Merced,047,269075,58535,56472,6869,63341,735
2022-01-27,Modoc,049,8938,664,654,227,881,6
2022-01-27,Mono,051,14174,2875,2860,114,2974,5
2022-01-27,Monterey,053,433212,72467,64090,10642,74732,658
2022-01-27,Napa,055,140530,23277,22121,763,22884,113
2022-01-27,Nevada,057,99092,14862,14337,987,15324,112
2022-01-27,Orange,059,3164182,523058,511255,38675,549930,6038
2022-01-27,Placer,061,380077,58691,56562,6772,63334,523
2022-01-27,Plumas,063,18699,2733,2463,257,2720,12
2022-01-27,Riverside,065,2383286,564613,548121,26093,574214,5726
2022-01-27,Sacramento,067,1510023,261613,249130,22871,272001,2558
2022-01-27,San Benito,069,59416,12023,11670,459,12129,90
2022-01-27,San Bernardino,071,2135413,552171,525249,23652,548901,6297
2022-01-27,San Diego,073,3302833,704068,683027,48152,731179,4643
2022-01-27,San Francisco,075,870044,114389,108265,7473,115738,712
2022-01-27,San Joaquin,077,732212,156070,150849,9227,160076,1971
2022-01-27,San Luis Obispo,079,281455,48156,46374,3193,49567,391
2022-01-27,San Mateo,081,765935,112820,100306,6087,106393,586
2022-01-27,Santa Barbara,083,443738,79047,76546,4185,80731,604
2022-01-27,Santa Clara,085,1922200,286795,273879,10696,284575,2019
2022-01-27,Santa Cruz,087,273765,41483,39228,1907,41135,240
2022-01-27,Shasta,089,179085,28273,27504,5393,32897,452
2022-01-27,Sierra,091,2930,265,260,42,302,0
2022-01-27,Siskiyou,093,43540,4094,3987,2325,6312,66
2022-01-27,Solano,095,438530,74065,69862,4906,74768,407
2022-01-27,Sonoma,097,501317,76682,73439,2143,75582,427
2022-01-27,Stanislaus,099,539301,109996,107668,15664,123332,1403
2022-01-27,Sutter,101,95872,19172,18797,1551,20348,202
2022-01-27,Tehama,103,63373,11150,10880,2360,13240,145
2022-01-27,Trinity,105,12862,1094,1033,257,1290,19
2022-01-27,Tulare,107,460477,98221,93154,24383,117537,1237
2022-01-27,Tuolumne,109,53932,11637,10806,403,11209,91
2022-01-27,Ventura,111,848112,164030,160466,8906,169372,1271
2022-01-27,Yolo,113,214977,34131,32123,2507,34630,275
2022-01-27,Yuba,115,75493,14652,14295,974,15269,103
2022-01-26,Alameda,001,1643700,233232,222680,11858,234538,1596
2022-01-26,Alpine,003,1148,119,123,1,124,0
2022-01-26,Amador,005,37829,7720,7427,482,7909,73
2022-01-26,Butte,007,227075,30439,29229,6203,35432,353
2022-01-26,Calaveras,009,45235,6687,6387,251,6638,96
2022-01-26,Colusa,011,21464,3220,3094,965,4059,21
2022-01-26,Contra Costa,013,1133247,176674,165972,11171,177143,1095
2022-01-26,Del Norte,015,27424,4794,4542,122,4664,43
2022-01-26,El Dorado,017,186661,25077,23819,2893,26712,181
2022-01-26,Fresno,019,978130,211838,199689,21260,220949,2452
2022-01-26,Glenn,021,27897,4614,4472,1461,5933,39
2022-01-26,Humboldt,023,135768,15138,14715,2312,17027,126
2022-01-26,Imperial,025,180216,51480,49477,9062,58539,839
2022-01-26,Inyo,027,18085,3926,3889,358,4247,50
2022-01-26,Kern,029,883053,179737,173052,41251,214303,1953
2022-01-26,Kings,031,150075,46775,44367,3096,47463,396
2022-01-26,Lake,033,64148,9361,8645,693,9338,119
2022-01-26,Lassen,035,31185,8194,7888,793,8681,55
2022-01-26,Los Angeles,037,10098052,2569372,2450620,115599,2566219,28382
2022-01-26,Madera,039,155013,33811,32323,4747,37070,329
2022-01-26,Marin,041,260295,30820,29813,1940,31753,253
2022-01-26,Mariposa,043,17540,2172,2108,124,2232,6
2022-01-26,Mendocino,045,87422,11927,11453,2242,13695,103
2022-01-26,Merced,047,269075,58159,56060,6692,62752,733
2022-01-26,Modoc,049,8938,663,652,226,878,6
2022-01-26,Mono,051,14174,2872,2852,114,2966,4
2022-01-26,Monterey,053,433212,71910,63264,10354,73618,659
2022-01-26,Napa,055,140530,23121,21864,753,22617,112
2022-01-26,Nevada,057,99092,14767,14128,975,15103,112
2022-01-26,Orange,059,3164182,521068,506419,38509,544928,6007
2022-01-26,Placer,061,380077,58352,55892,6711,62603,524
2022-01-26,Plumas,063,18699,2706,2425,255,2680,12
2022-01-26,Riverside,065,2383286,562082,543788,25977,569765,5701
2022-01-26,Sacramento,067,1510023,259919,246416,22544,268960,2559
2022-01-26,San Benito,069,59416,11952,11563,447,12010,90
2022-01-26,San Bernardino,071,2135413,549898,521699,23545,545244,6291
2022-01-26,San Diego,073,3302833,699853,676392,47794,724186,4622
2022-01-26,San Francisco,075,870044,113748,107174,7441,114615,704
2022-01-26,San Joaquin,077,732212,155074,148770,9173,157943,1971
2022-01-26,San Luis Obispo,079,281455,47851,45716,3167,48883,391
2022-01-26,San Mateo,081,765935,112154,99016,5963,104979,586
2022-01-26,Santa Barbara,083,443738,78519,75548,4125,79673,600
2022-01-26,Santa Clara,085,1922200,284679,270470,10525,280995,2015
2022-01-26,Santa Cruz,087,273765,40964,38298,1893,40191,239
2022-01-26,Shasta,089,179085,28126,27255,5348,32603,452
2022-01-26,Sierra,091,2930,264,260,41,301,0
2022-01-26,Siskiyou,093,43540,4078,3971,2300,6271,66
2022-01-26,Solano,095,438530,73369,69150,4839,73989,401
2022-01-26,Sonoma,097,501317,76122,72509,2108,74617,423
2022-01-26,Stanislaus,099,539301,109441,106582,15447,122029,1396
2022-01-26,Sutter,101,95872,19062,18670,1507,20177,202
2022-01-26,Tehama,103,63373,11096,10749,2346,13095,145
2022-01-26,Trinity,105,12862,1089,1008,257,1265,19
2022-01-26,Tulare,107,460477,97415,91904,24144,116048,1234
2022-01-26,Tuolumne,109,53932,11453,10699,392,11091,91
2022-01-26,Ventura,111,848112,163320,159077,8864,167941,1263
2022-01-26,Yolo,113,214977,33913,31913,2469,34382,275
2022-01-26,Yuba,115,75493,14567,14171,952,15123,103
2022-01-25,Alameda,001,1643700,231344,219753,11687,231440,1589
2022-01-25,Alpine,003,1148,119,122,1,123,0
2022-01-25,Amador,005,37829,7643,7352,471,7823,73
2022-01-25,Butte,007,227075,30226,28887,6126,35013,351
2022-01-25,Calaveras,009,45235,6629,6266,238,6504,95
2022-01-25,Colusa,011,21464,3199,3074,963,4037,21
2022-01-25,Contra Costa,013,1133247,175275,163792,10943,174735,1092
2022-01-25,Del Norte,015,27424,4724,4514,117,4631,43
2022-01-25,El Dorado,017,186661,24940,23339,2869,26208,179
2022-01-25,Fresno,019,978130,209661,198262,20966,219228,2434
2022-01-25,Glenn,021,27897,4584,4418,1445,5863,39
2022-01-25,Humboldt,023,135768,15046,14574,2286,16860,126
2022-01-25,Imperial,025,180216,51024,48913,8841,57754,832
2022-01-25,Inyo,027,18085,3910,3857,316,4173,50
2022-01-25,Kern,029,883053,178732,171695,40803,212498,1947
2022-01-25,Kings,031,150075,46307,43853,3051,46904,396
2022-01-25,Lake,033,64148,9282,8543,681,9224,118
2022-01-25,Lassen,035,31185,8163,7834,784,8618,55
2022-01-25,Los Angeles,037,10098052,2554425,2433516,114956,2548472,28293
2022-01-25,Madera,039,155013,33490,31794,4614,36408,329
2022-01-25,Marin,041,260295,30643,29589,1927,31516,253
2022-01-25,Mariposa,043,17540,2160,2069,118,2187,6
2022-01-25,Mendocino,045,87422,11807,11280,2139,13419,103
2022-01-25,Merced,047,269075,57767,55555,6552,62107,733
2022-01-25,Modoc,049,8938,661,652,226,878,6
2022-01-25,Mono,051,14174,2862,2826,113,2939,4
2022-01-25,Monterey,053,433212,71336,62498,9953,72451,654
2022-01-25,Napa,055,140530,22926,21668,719,22387,111
2022-01-25,Nevada,057,99092,14655,13944,953,14897,112
2022-01-25,Orange,059,3164182,518787,504274,38312,542586,5980
2022-01-25,Placer,061,380077,57949,55465,6638,62103,518
2022-01-25,Plumas,063,18699,2682,2397,251,2648,12
2022-01-25,Riverside,065,2383286,558991,540723,25813,566536,5686
2022-01-25,Sacramento,067,1510023,257968,244468,22016,266484,2545
2022-01-25,San Benito,069,59416,11853,11446,443,11889,88
2022-01-25,San Bernardino,071,2135413,547273,519150,23431,542581,6288
2022-01-25,San Diego,073,3302833,694861,670110,47342,717452,4604
2022-01-25,San Francisco,075,870044,112989,106254,7399,113653,703
2022-01-25,San Joaquin,077,732212,154073,147271,9108,156379,1972
2022-01-25,San Luis Obispo,079,281455,47490,45130,3119,48249,391
2022-01-25,San Mateo,081,765935,111320,98010,5852,103862,586
2022-01-25,Santa Barbara,083,443738,77851,74686,4046,78732,594
2022-01-25,Santa Clara,085,1922200,282028,268031,10323,278354,2006
2022-01-25,Santa Cruz,087,273765,40293,37850,1878,39728,237
2022-01-25,Shasta,089,179085,27964,27090,5282,32372,452
2022-01-25,Sierra,091,2930,264,260,37,297,0
2022-01-25,Siskiyou,093,43540,4054,3958,2265,6223,65
2022-01-25,Solano,095,438530,72797,68657,4780,73437,399
2022-01-25,Sonoma,097,501317,75433,71633,2068,73701,423
2022-01-25,Stanislaus,099,539301,108768,105965,15221,121186,1396
2022-01-25,Sutter,101,95872,18959,18508,1467,19975,200
2022-01-25,Tehama,103,63373,11033,10669,2322,12991,145
2022-01-25,Trinity,105,12862,1082,999,255,1254,19
2022-01-25,Tulare,107,460477,96555,91237,23825,115062,1229
2022-01-25,Tuolumne,109,53932,11272,10516,368,10884,91
2022-01-25,Ventura,111,848112,162466,157971,8815,166786,1263
2022-01-25,Yolo,113,214977,33654,31677,2425,34102,274
2022-01-25,Yuba,115,75493,14482,14038,925,14963,103
2022-01-24,Alameda,001,1643700,228877,216252,11420,227672,1581
2022-01-24,Alpine,003,1148,119,120,1,121,0
2022-01-24,Amador,005,37829,7592,7166,434,7600,73
2022-01-24,Butte,007,227075,29992,28607,6061,34668,350
2022-01-24,Calaveras,009,45235,6581,6172,224,6396,95
2022-01-24,Colusa,011,21464,3179,3052,946,3998,21
2022-01-24,Contra Costa,013,1133247,173717,162161,10721,172882,1092
2022-01-24,Del Norte,015,27424,4664,4460,117,4577,43
2022-01-24,El Dorado,017,186661,24776,23128,2842,25970,179
2022-01-24,Fresno,019,978130,207326,196092,20640,216732,2430
2022-01-24,Glenn,021,27897,4544,4367,1436,5803,39
2022-01-24,Humboldt,023,135768,14935,14416,2241,16657,126
2022-01-24,Imperial,025,180216,50483,48228,8561,56789,824
2022-01-24,Inyo,027,18085,3904,3805,292,4097,50
2022-01-24,Kern,029,883053,177425,169892,40332,210224,1946
2022-01-24,Kings,031,150075,45735,43260,2980,46240,396
2022-01-24,Lake,033,64148,9173,8423,666,9089,118
2022-01-24,Lassen,035,31185,8079,7732,765,8497,55
2022-01-24,Los Angeles,037,10098052,2537902,2391045,114179,2505224,28230
2022-01-24,Madera,039,155013,33055,31339,4430,35769,329
2022-01-24,Marin,041,260295,30410,29301,1891,31192,253
2022-01-24,Mariposa,043,17540,2135,2033,114,2147,6
2022-01-24,Mendocino,045,87422,11703,11002,2060,13062,103
2022-01-24,Merced,047,269075,57263,54970,6267,61237,730
2022-01-24,Modoc,049,8938,658,648,225,873,6
2022-01-24,Mono,051,14174,2852,2802,112,2914,4
2022-01-24,Monterey,053,433212,70476,61975,9598,71573,654
2022-01-24,Napa,055,140530,22747,21494,707,22201,111
2022-01-24,Nevada,057,99092,14528,13774,930,14704,112
2022-01-24,Orange,059,3164182,516208,501634,38046,539680,5969
2022-01-24,Placer,061,380077,57467,54933,6589,61522,518
2022-01-24,Plumas,063,18699,2650,2370,237,2607,12
2022-01-24,Riverside,065,2383286,555259,535962,25605,561567,5661
2022-01-24,Sacramento,067,1510023,255604,241522,21460,262982,2526
2022-01-24,San Benito,069,59416,11751,11331,430,11761,88
2022-01-24,San Bernardino,071,2135413,544382,515604,23268,538872,6285
2022-01-24,San Diego,073,3302833,689205,663580,46791,710371,4586
2022-01-24,San Francisco,075,870044,112032,105418,7305,112723,703
2022-01-24,San Joaquin,077,732212,152753,145984,9032,155016,1959
2022-01-24,San Luis Obispo,079,281455,47019,44616,3065,47681,387
2022-01-24,San Mateo,081,765935,110356,96968,5739,102707,586
2022-01-24,Santa Barbara,083,443738,77040,73866,3953,77819,591
2022-01-24,Santa Clara,085,1922200,279130,265341,10112,275453,2006
2022-01-24,Santa Cruz,087,273765,39493,37188,1860,39048,237
2022-01-24,Shasta,089,179085,27780,26871,5194,32065,452
2022-01-24,Sierra,091,2930,264,258,37,295,0
2022-01-24,Siskiyou,093,43540,4046,3934,2226,6160,64
2022-01-24,Solano,095,438530,72115,68094,4703,72797,400
2022-01-24,Sonoma,097,501317,74518,70733,2031,72764,423
2022-01-24,Stanislaus,099,539301,108010,104933,14933,119866,1395
2022-01-24,Sutter,101,95872,18844,18336,1381,19717,200
2022-01-24,Tehama,103,63373,10963,10567,2302,12869,145
2022-01-24,Trinity,105,12862,1073,978,253,1231,19
2022-01-24,Tulare,107,460477,95483,90089,23468,113557,1219
2022-01-24,Tuolumne,109,53932,11151,10374,360,10734,91
2022-01-24,Ventura,111,848112,161444,156551,8770,165321,1261
2022-01-24,Yolo,113,214977,33361,31480,2396,33876,273
2022-01-24,Yuba,115,75493,14376,13862,886,14748,103
2022-01-23,Alameda,001,1643700,226180,214003,11103,225106,1583
2022-01-23,Alpine,003,1148,119,120,1,121,0
2022-01-23,Amador,005,37829,7536,7090,394,7484,73
2022-01-23,Butte,007,227075,29693,28340,5935,34275,350
2022-01-23,Calaveras,009,45235,6516,6095,203,6298,95
2022-01-23,Colusa,011,21464,3154,3040,937,3977,21
2022-01-23,Contra Costa,013,1133247,171778,160798,10348,171146,1092
2022-01-23,Del Norte,015,27424,4596,4419,111,4530,43
2022-01-23,El Dorado,017,186661,24590,22925,2795,25720,179
2022-01-23,Fresno,019,978130,204788,193642,20155,213797,2430
2022-01-23,Glenn,021,27897,4497,4340,1414,5754,39
2022-01-23,Humboldt,023,135768,14813,14296,2159,16455,126
2022-01-23,Imperial,025,180216,49885,47935,8279,56214,824
2022-01-23,Inyo,027,18085,3877,3781,278,4059,50
2022-01-23,Kern,029,883053,176062,168585,39804,208389,1946
2022-01-23,Kings,031,150075,45101,42622,2878,45500,397
2022-01-23,Lake,033,64148,9003,8363,640,9003,118
2022-01-23,Lassen,035,31185,8030,7710,741,8451,55
2022-01-23,Los Angeles,037,10098052,2517580,2390590,113032,2503622,28231
2022-01-23,Madera,039,155013,32697,30962,4194,35156,329
2022-01-23,Marin,041,260295,30157,29025,1853,30878,253
2022-01-23,Mariposa,043,17540,2120,2011,111,2122,6
2022-01-23,Mendocino,045,87422,11578,10889,1932,12821,103
2022-01-23,Merced,047,269075,56691,54644,5810,60454,730
2022-01-23,Modoc,049,8938,656,645,222,867,6
2022-01-23,Mono,051,14174,2844,2788,110,2898,4
2022-01-23,Monterey,053,433212,69638,61522,9165,70687,654
2022-01-23,Napa,055,140530,22485,21281,694,21975,111
2022-01-23,Nevada,057,99092,14366,13629,901,14530,112
2022-01-23,Orange,059,3164182,513103,498968,37754,536722,5970
2022-01-23,Placer,061,380077,56897,54568,6500,61068,518
2022-01-23,Plumas,063,18699,2617,2368,208,2576,12
2022-01-23,Riverside,065,2383286,550812,532273,25303,557576,5661
2022-01-23,Sacramento,067,1510023,252966,239589,20519,260108,2530
2022-01-23,San Benito,069,59416,11629,11225,419,11644,88
2022-01-23,San Bernardino,071,2135413,540821,512657,22990,535647,6281
2022-01-23,San Diego,073,3302833,682600,640215,45982,686197,4566
2022-01-23,San Francisco,075,870044,110965,104485,7197,111682,704
2022-01-23,San Joaquin,077,732212,151123,144621,8950,153571,1959
2022-01-23,San Luis Obispo,079,281455,46322,44183,2991,47174,386
2022-01-23,San Mateo,081,765935,109237,95940,5595,101535,586
2022-01-23,Santa Barbara,083,443738,75916,73041,3830,76871,590
2022-01-23,Santa Clara,085,1922200,275784,261991,9793,271784,2005
2022-01-23,Santa Cruz,087,273765,38961,36547,1829,38376,237
2022-01-23,Shasta,089,179085,27500,26732,5074,31806,452
2022-01-23,Sierra,091,2930,263,252,37,289,0
2022-01-23,Siskiyou,093,43540,4021,3916,2169,6085,64
2022-01-23,Solano,095,438530,71314,67457,4609,72066,400
2022-01-23,Sonoma,097,501317,73564,69791,1975,71766,423
2022-01-23,Stanislaus,099,539301,107149,104067,14641,118708,1395
2022-01-23,Sutter,101,95872,18685,18175,1268,19443,200
2022-01-23,Tehama,103,63373,10865,10481,2271,12752,145
2022-01-23,Trinity,105,12862,1070,961,251,1212,19
2022-01-23,Tulare,107,460477,94228,89120,23059,112179,1219
2022-01-23,Tuolumne,109,53932,10959,10243,343,10586,91
2022-01-23,Ventura,111,848112,160263,155052,8693,163745,1261
2022-01-23,Yolo,113,214977,32985,30908,2356,33264,273
2022-01-23,Yuba,115,75493,14252,13762,833,14595,103
2022-01-22,Alameda,001,1643700,225120,203927,11076,215003,1575
2022-01-22,Alpine,003,1148,118,119,1,120,0
2022-01-22,Amador,005,37829,7502,6845,389,7234,73
2022-01-22,Butte,007,227075,29571,27232,5903,33135,350
2022-01-22,Calaveras,009,45235,6486,5835,202,6037,95
2022-01-22,Colusa,011,21464,3137,2954,934,3888,21
2022-01-22,Contra Costa,013,1133247,170803,154111,10318,164429,1091
2022-01-22,Del Norte,015,27424,4557,4269,107,4376,43
2022-01-22,El Dorado,017,186661,24525,22273,2783,25056,179
2022-01-22,Fresno,019,978130,203953,185292,20085,205377,2429
2022-01-22,Glenn,021,27897,4490,4174,1411,5585,39
2022-01-22,Humboldt,023,135768,14745,13628,2146,15774,125
2022-01-22,Imperial,025,180216,49694,45741,8221,53962,820
2022-01-22,Inyo,027,18085,3873,3706,254,3960,50
2022-01-22,Kern,029,883053,175435,162902,39504,202406,1946
2022-01-22,Kings,031,150075,44893,40580,2865,43445,396
2022-01-22,Lake,033,64148,8969,8056,632,8688,118
2022-01-22,Lassen,035,31185,7996,7545,734,8279,55
2022-01-22,Los Angeles,037,10098052,2510163,2286280,112529,2398809,28038
2022-01-22,Madera,039,155013,32578,29595,4179,33774,329
2022-01-22,Marin,041,260295,30030,27893,1848,29741,253
2022-01-22,Mariposa,043,17540,2116,1920,111,2031,6
2022-01-22,Mendocino,045,87422,11528,10395,1910,12305,103
2022-01-22,Merced,047,269075,56534,53025,5801,58826,727
2022-01-22,Modoc,049,8938,655,639,222,861,6
2022-01-22,Mono,051,14174,2843,2723,106,2829,4
2022-01-22,Monterey,053,433212,69432,59038,9123,68161,651
2022-01-22,Napa,055,140530,22390,20402,684,21086,111
2022-01-22,Nevada,057,99092,14298,12957,893,13850,112
2022-01-22,Orange,059,3164182,511494,480329,37506,517835,5946
2022-01-22,Placer,061,380077,56626,52557,6463,59020,512
2022-01-22,Plumas,063,18699,2600,2289,204,2493,12
2022-01-22,Riverside,065,2383286,548895,513567,25231,538798,5623
2022-01-22,Sacramento,067,1510023,251924,230206,20414,250620,2510
2022-01-22,San Benito,069,59416,11571,10743,414,11157,88
2022-01-22,San Bernardino,071,2135413,539284,495209,22896,518105,6267
2022-01-22,San Diego,073,3302833,680113,628904,45761,674665,4559
2022-01-22,San Francisco,075,870044,110309,100238,7048,107286,702
2022-01-22,San Joaquin,077,732212,150680,138264,8908,147172,1960
2022-01-22,San Luis Obispo,079,281455,46203,42154,2985,45139,385
2022-01-22,San Mateo,081,765935,108651,91440,5533,96973,585
2022-01-22,Santa Barbara,083,443738,75494,69555,3824,73379,589
2022-01-22,Santa Clara,085,1922200,274099,249205,9727,258932,1993
2022-01-22,Santa Cruz,087,273765,38779,33741,1823,35564,237
2022-01-22,Shasta,089,179085,27404,25919,5052,30971,450
2022-01-22,Sierra,091,2930,263,248,36,284,0
2022-01-22,Siskiyou,093,43540,4003,3845,2148,5993,62
2022-01-22,Solano,095,438530,71091,63882,4571,68453,391
2022-01-22,Sonoma,097,501317,73144,66013,1965,67978,422
2022-01-22,Stanislaus,099,539301,106691,100092,14543,114635,1393
2022-01-22,Sutter,101,95872,18617,17616,1255,18871,199
2022-01-22,Tehama,103,63373,10830,10171,2260,12431,142
2022-01-22,Trinity,105,12862,1068,925,251,1176,19
2022-01-22,Tulare,107,460477,93851,85223,22937,108160,1211
2022-01-22,Tuolumne,109,53932,10891,9731,337,10068,91
2022-01-22,Ventura,111,848112,159572,148742,8653,157395,1250
2022-01-22,Yolo,113,214977,32807,30061,2339,32400,273
2022-01-22,Yuba,115,75493,14163,13288,829,14117,103
2022-01-21,Alameda,001,1643700,223547,203927,11044,214971,1575
2022-01-21,Alpine,003,1148,118,119,1,120,0
2022-01-21,Amador,005,37829,7445,6845,386,7231,73
2022-01-21,Butte,007,227075,29445,27232,5860,33092,350
2022-01-21,Calaveras,009,45235,6440,5835,202,6037,95
2022-01-21,Colusa,011,21464,3130,2954,928,3882,21
2022-01-21,Contra Costa,013,1133247,169696,154111,10238,164349,1091
2022-01-21,Del Norte,015,27424,4517,4269,107,4376,43
2022-01-21,El Dorado,017,186661,24440,22273,2767,25040,179
2022-01-21,Fresno,019,978130,202683,185292,19985,205277,2429
2022-01-21,Glenn,021,27897,4468,4174,1407,5581,39
2022-01-21,Humboldt,023,135768,14675,13628,2127,15755,125
2022-01-21,Imperial,025,180216,49505,45741,8145,53886,820
2022-01-21,Inyo,027,18085,3860,3706,249,3955,50
2022-01-21,Kern,029,883053,174720,162902,39134,202036,1946
2022-01-21,Kings,031,150075,44696,40580,2857,43437,396
2022-01-21,Lake,033,64148,8912,8056,620,8676,118
2022-01-21,Lassen,035,31185,7947,7545,730,8275,55
2022-01-21,Los Angeles,037,10098052,2498862,2286280,112072,2398352,28038
2022-01-21,Madera,039,155013,32287,29595,4151,33746,329
2022-01-21,Marin,041,260295,29855,27893,1829,29722,253
2022-01-21,Mariposa,043,17540,2104,1920,110,2030,6
2022-01-21,Mendocino,045,87422,11447,10395,1907,12302,103
2022-01-21,Merced,047,269075,56373,53025,5797,58822,727
2022-01-21,Modoc,049,8938,654,639,222,861,6
2022-01-21,Mono,051,14174,2829,2723,103,2826,4
2022-01-21,Monterey,053,433212,68961,59038,8997,68035,651
2022-01-21,Napa,055,140530,22270,20402,676,21078,111
2022-01-21,Nevada,057,99092,14200,12957,889,13846,112
2022-01-21,Orange,059,3164182,509257,480329,37261,517590,5946
2022-01-21,Placer,061,380077,56234,52557,6401,58958,512
2022-01-21,Plumas,063,18699,2587,2289,199,2488,12
2022-01-21,Riverside,065,2383286,546240,513567,25152,538719,5623
2022-01-21,Sacramento,067,1510023,250487,230206,20315,250521,2510
2022-01-21,San Benito,069,59416,11536,10743,411,11154,88
2022-01-21,San Bernardino,071,2135413,537209,495209,22821,518030,6267
2022-01-21,San Diego,073,3302833,675945,628904,45584,674488,4559
2022-01-21,San Francisco,075,870044,109549,100238,6960,107198,702
2022-01-21,San Joaquin,077,732212,150077,138264,8852,147116,1960
2022-01-21,San Luis Obispo,079,281455,46077,42154,2982,45136,385
2022-01-21,San Mateo,081,765935,107980,91440,5494,96934,585
2022-01-21,Santa Barbara,083,443738,74992,69555,3815,73370,589
2022-01-21,Santa Clara,085,1922200,272267,249205,9619,258824,1993
2022-01-21,Santa Cruz,087,273765,38060,33741,1810,35551,237
2022-01-21,Shasta,089,179085,27315,25919,5005,30924,450
2022-01-21,Sierra,091,2930,261,248,35,283,0
2022-01-21,Siskiyou,093,43540,3994,3845,2130,5975,62
2022-01-21,Solano,095,438530,70678,63882,4488,68370,391
2022-01-21,Sonoma,097,501317,72620,66013,1955,67968,422
2022-01-21,Stanislaus,099,539301,106186,100092,14468,114560,1393
2022-01-21,Sutter,101,95872,18531,17616,1241,18857,199
2022-01-21,Tehama,103,63373,10793,10171,2258,12429,142
2022-01-21,Trinity,105,12862,1062,925,250,1175,19
2022-01-21,Tulare,107,460477,93371,85223,22783,108006,1211
2022-01-21,Tuolumne,109,53932,10808,9731,330,10061,91
2022-01-21,Ventura,111,848112,158763,148742,8622,157364,1250
2022-01-21,Yolo,113,214977,32644,30061,2318,32379,273
2022-01-21,Yuba,115,75493,14091,13288,822,14110,103
2022-01-20,Alameda,001,1643700,220486,203927,10811,214738,1575
2022-01-20,Alpine,003,1148,118,119,1,120,0
2022-01-20,Amador,005,37829,7381,6845,368,7213,73
2022-01-20,Butte,007,227075,29179,27232,5780,33012,350
2022-01-20,Calaveras,009,45235,6335,5835,193,6028,95
2022-01-20,Colusa,011,21464,3104,2954,916,3870,21
2022-01-20,Contra Costa,013,1133247,167646,154111,9965,164076,1091
2022-01-20,Del Norte,015,27424,4477,4269,104,4373,43
2022-01-20,El Dorado,017,186661,24239,22273,2721,24994,179
2022-01-20,Fresno,019,978130,200041,185292,19600,204892,2429
2022-01-20,Glenn,021,27897,4434,4174,1398,5572,39
2022-01-20,Humboldt,023,135768,14548,13628,2077,15705,125
2022-01-20,Imperial,025,180216,48987,45741,7970,53711,820
2022-01-20,Inyo,027,18085,3848,3706,238,3944,50
2022-01-20,Kern,029,883053,173197,162902,38595,201497,1946
2022-01-20,Kings,031,150075,44141,40580,2817,43397,396
2022-01-20,Lake,033,64148,8816,8056,592,8648,118
2022-01-20,Lassen,035,31185,7894,7545,715,8260,55
2022-01-20,Los Angeles,037,10098052,2474132,2286280,111099,2397379,28038
2022-01-20,Madera,039,155013,31899,29595,4026,33621,329
2022-01-20,Marin,041,260295,29563,27893,1792,29685,253
2022-01-20,Mariposa,043,17540,2077,1920,107,2027,6
2022-01-20,Mendocino,045,87422,11349,10395,1829,12224,103
2022-01-20,Merced,047,269075,55929,53025,5568,58593,727
2022-01-20,Modoc,049,8938,652,639,222,861,6
2022-01-20,Mono,051,14174,2821,2723,102,2825,4
2022-01-20,Monterey,053,433212,68198,59038,8581,67619,651
2022-01-20,Napa,055,140530,22005,20402,637,21039,111
2022-01-20,Nevada,057,99092,14056,12957,867,13824,112
2022-01-20,Orange,059,3164182,505322,480329,36888,517217,5946
2022-01-20,Placer,061,380077,55750,52557,6341,58898,512
2022-01-20,Plumas,063,18699,2559,2289,195,2484,12
2022-01-20,Riverside,065,2383286,541671,513567,24921,538488,5623
2022-01-20,Sacramento,067,1510023,248207,230206,19684,249890,2510
2022-01-20,San Benito,069,59416,11425,10743,398,11141,88
2022-01-20,San Bernardino,071,2135413,533000,495209,22542,517751,6267
2022-01-20,San Diego,073,3302833,668854,628904,44880,673784,4559
2022-01-20,San Francisco,075,870044,108402,100238,6821,107059,702
2022-01-20,San Joaquin,077,732212,148425,138264,8724,146988,1960
2022-01-20,San Luis Obispo,079,281455,45566,42154,2948,45102,385
2022-01-20,San Mateo,081,765935,106755,91440,5290,96730,585
2022-01-20,Santa Barbara,083,443738,74094,69555,3703,73258,589
2022-01-20,Santa Clara,085,1922200,268917,249205,9291,258496,1993
2022-01-20,Santa Cruz,087,273765,37175,33741,1787,35528,237
2022-01-20,Shasta,089,179085,27124,25919,4938,30857,450
2022-01-20,Sierra,091,2930,261,248,33,281,0
2022-01-20,Siskiyou,093,43540,3983,3845,2097,5942,62
2022-01-20,Solano,095,438530,69727,63882,4399,68281,391
2022-01-20,Sonoma,097,501317,71593,66013,1904,67917,422
2022-01-20,Stanislaus,099,539301,105226,100092,14262,114354,1393
2022-01-20,Sutter,101,95872,18367,17616,1213,18829,199
2022-01-20,Tehama,103,63373,10720,10171,2240,12411,142
2022-01-20,Trinity,105,12862,1048,925,249,1174,19
2022-01-20,Tulare,107,460477,92321,85223,22500,107723,1211
2022-01-20,Tuolumne,109,53932,10666,9731,320,10051,91
2022-01-20,Ventura,111,848112,157378,148742,8545,157287,1250
2022-01-20,Yolo,113,214977,32357,30061,2284,32345,273
2022-01-20,Yuba,115,75493,13985,13288,789,14077,103
2022-01-19,Alameda,001,1643700,217117,199739,10492,210231,1571
2022-01-19,Alpine,003,1148,117,119,1,120,0
2022-01-19,Amador,005,37829,7300,6789,326,7115,73
2022-01-19,Butte,007,227075,28874,26839,5693,32532,351
2022-01-19,Calaveras,009,45235,6245,5765,184,5949,95
2022-01-19,Colusa,011,21464,3070,2938,908,3846,21
2022-01-19,Contra Costa,013,1133247,165216,151543,9719,161262,1091
2022-01-19,Del Norte,015,27424,4438,4240,103,4343,43
2022-01-19,El Dorado,017,186661,23987,21953,2681,24634,177
2022-01-19,Fresno,019,978130,197079,181526,19270,200796,2430
2022-01-19,Glenn,021,27897,4382,4127,1388,5515,39
2022-01-19,Humboldt,023,135768,14391,13391,2027,15418,125
2022-01-19,Imperial,025,180216,48252,45156,7773,52929,820
2022-01-19,Inyo,027,18085,3825,3680,199,3879,49
2022-01-19,Kern,029,883053,171431,160747,37917,198664,1946
2022-01-19,Kings,031,150075,43443,40027,2749,42776,395
2022-01-19,Lake,033,64148,8689,7972,579,8551,118
2022-01-19,Lassen,035,31185,7837,7507,693,8200,55
2022-01-19,Los Angeles,037,10098052,2445742,2251718,109683,2361401,27934
2022-01-19,Madera,039,155013,31519,29021,3856,32877,329
2022-01-19,Marin,041,260295,29266,27375,1751,29126,251
2022-01-19,Mariposa,043,17540,2052,1896,100,1996,6
2022-01-19,Mendocino,045,87422,11178,10252,1736,11988,103
2022-01-19,Merced,047,269075,55383,52355,5211,57566,724
2022-01-19,Modoc,049,8938,650,635,221,856,6
2022-01-19,Mono,051,14174,2799,2677,100,2777,4
2022-01-19,Monterey,053,433212,67290,58426,8124,66550,651
2022-01-19,Napa,055,140530,21752,20090,610,20700,110
2022-01-19,Nevada,057,99092,13899,12703,840,13543,112
2022-01-19,Orange,059,3164182,500834,468460,36517,504977,5943
2022-01-19,Placer,061,380077,55186,51545,6273,57818,511
2022-01-19,Plumas,063,18699,2519,2239,189,2428,12
2022-01-19,Riverside,065,2383286,536152,503575,24686,528261,5604
2022-01-19,Sacramento,067,1510023,245309,226035,18968,245003,2512
2022-01-19,San Benito,069,59416,11283,10639,386,11025,88
2022-01-19,San Bernardino,071,2135413,528236,487846,22163,510009,6265
2022-01-19,San Diego,073,3302833,660081,614709,44142,658851,4553
2022-01-19,San Francisco,075,870044,107032,98652,6745,105397,694
2022-01-19,San Joaquin,077,732212,146521,135953,8601,144554,1959
2022-01-19,San Luis Obispo,079,281455,44967,41374,2882,44256,382
2022-01-19,San Mateo,081,765935,105341,89715,5026,94741,585
2022-01-19,Santa Barbara,083,443738,73097,68531,3604,72135,586
2022-01-19,Santa Clara,085,1922200,265124,244922,8934,253856,1991
2022-01-19,Santa Cruz,087,273765,35873,33026,1763,34789,237
2022-01-19,Shasta,089,179085,26857,25355,4866,30221,450
2022-01-19,Sierra,091,2930,261,245,32,277,0
2022-01-19,Siskiyou,093,43540,3959,3821,2044,5865,62
2022-01-19,Solano,095,438530,68881,63003,4269,67272,392
2022-01-19,Sonoma,097,501317,70493,64689,1858,66547,420
2022-01-19,Stanislaus,099,539301,104176,98952,13970,112922,1381
2022-01-19,Sutter,101,95872,18198,17436,1125,18561,199
2022-01-19,Tehama,103,63373,10605,10064,2196,12260,142
2022-01-19,Trinity,105,12862,1036,916,248,1164,19
2022-01-19,Tulare,107,460477,91039,83743,22033,105776,1200
2022-01-19,Tuolumne,109,53932,10506,9613,295,9908,91
2022-01-19,Ventura,111,848112,155863,144738,8470,153208,1234
2022-01-19,Yolo,113,214977,31992,29392,2248,31640,273
2022-01-19,Yuba,115,75493,13823,13114,776,13890,104
2022-01-18,Alameda,001,1643700,213769,195728,10175,205903,1566
2022-01-18,Alpine,003,1148,117,118,1,119,0
2022-01-18,Amador,005,37829,7162,6691,290,6981,73
2022-01-18,Butte,007,227075,28482,26514,5611,32125,347
2022-01-18,Calaveras,009,45235,6156,5684,169,5853,94
2022-01-18,Colusa,011,21464,3026,2903,903,3806,21
2022-01-18,Contra Costa,013,1133247,163070,149446,9341,158787,1085
2022-01-18,Del Norte,015,27424,4368,4229,98,4327,43
2022-01-18,El Dorado,017,186661,23619,21707,2637,24344,175
2022-01-18,Fresno,019,978130,193532,178922,18813,197735,2425
2022-01-18,Glenn,021,27897,4348,4070,1376,5446,39
2022-01-18,Humboldt,023,135768,14227,13218,1955,15173,125
2022-01-18,Imperial,025,180216,47556,44742,7592,52334,819
2022-01-18,Inyo,027,18085,3784,3654,189,3843,49
2022-01-18,Kern,029,883053,169409,158864,37164,196028,1943
2022-01-18,Kings,031,150075,42569,39440,2671,42111,392
2022-01-18,Lake,033,64148,8576,7919,560,8479,117
2022-01-18,Lassen,035,31185,7754,7461,654,8115,55
2022-01-18,Los Angeles,037,10098052,2412307,2227360,108207,2335567,27871
2022-01-18,Madera,039,155013,30997,28717,3667,32384,329
2022-01-18,Marin,041,260295,28960,27036,1710,28746,251
2022-01-18,Mariposa,043,17540,2027,1872,96,1968,6
2022-01-18,Mendocino,045,87422,11009,10114,1651,11765,103
2022-01-18,Merced,047,269075,54771,51746,4923,56669,718
2022-01-18,Modoc,049,8938,648,633,216,849,6
2022-01-18,Mono,051,14174,2778,2643,99,2742,4
2022-01-18,Monterey,053,433212,66514,57846,7645,65491,650
2022-01-18,Napa,055,140530,21420,19911,595,20506,109
2022-01-18,Nevada,057,99092,13715,12584,798,13382,111
2022-01-18,Orange,059,3164182,495501,461324,36012,497336,5938
2022-01-18,Placer,061,380077,54541,50983,6200,57183,508
2022-01-18,Plumas,063,18699,2481,2218,183,2401,12
2022-01-18,Riverside,065,2383286,530174,497278,24379,521657,5599
2022-01-18,Sacramento,067,1510023,242222,223745,17986,241731,2496
2022-01-18,San Benito,069,59416,11142,10520,372,10892,88
2022-01-18,San Bernardino,071,2135413,522784,483753,21734,505487,6258
2022-01-18,San Diego,073,3302833,649884,605137,43096,648233,4547
2022-01-18,San Francisco,075,870044,105567,96505,6629,103134,694
2022-01-18,San Joaquin,077,732212,144554,134365,8385,142750,1957
2022-01-18,San Luis Obispo,079,281455,44286,40848,2796,43644,381
2022-01-18,San Mateo,081,765935,103828,88225,4829,93054,585
2022-01-18,Santa Barbara,083,443738,71879,67216,3431,70647,581
2022-01-18,Santa Clara,085,1922200,260939,240281,8539,248820,1986
2022-01-18,Santa Cruz,087,273765,35223,32203,1727,33930,237
2022-01-18,Shasta,089,179085,26575,25162,4772,29934,448
2022-01-18,Sierra,091,2930,257,244,32,276,0
2022-01-18,Siskiyou,093,43540,3926,3799,1991,5790,62
2022-01-18,Solano,095,438530,68030,62204,4158,66362,391
2022-01-18,Sonoma,097,501317,69105,63714,1803,65517,419
2022-01-18,Stanislaus,099,539301,102956,98000,13593,111593,1379
2022-01-18,Sutter,101,95872,18006,17295,1054,18349,198
2022-01-18,Tehama,103,63373,10509,9975,2144,12119,142
2022-01-18,Trinity,105,12862,1023,907,247,1154,19
2022-01-18,Tulare,107,460477,89573,82667,21630,104297,1196
2022-01-18,Tuolumne,109,53932,10337,9528,284,9812,91
2022-01-18,Ventura,111,848112,154152,143384,8384,151768,1233
2022-01-18,Yolo,113,214977,31595,28786,2198,30984,270
2022-01-18,Yuba,115,75493,13663,12971,751,13722,101
2022-01-17,Alameda,001,1643700,209093,193276,9591,202867,1565
2022-01-17,Alpine,003,1148,116,118,0,118,0
2022-01-17,Amador,005,37829,7048,6640,232,6872,73
2022-01-17,Butte,007,227075,28088,26303,5500,31803,348
2022-01-17,Calaveras,009,45235,6025,5584,141,5725,94
2022-01-17,Colusa,011,21464,3002,2905,896,3801,21
2022-01-17,Contra Costa,013,1133247,160137,147993,8841,156834,1086
2022-01-17,Del Norte,015,27424,4316,4209,91,4300,43
2022-01-17,El Dorado,017,186661,23373,21540,2555,24095,175
2022-01-17,Fresno,019,978130,189719,176959,18279,195238,2426
2022-01-17,Glenn,021,27897,4295,4055,1363,5418,39
2022-01-17,Humboldt,023,135768,14021,13120,1789,14909,125
2022-01-17,Imperial,025,180216,46870,44412,7429,51841,821
2022-01-17,Inyo,027,18085,3762,3650,163,3813,49
2022-01-17,Kern,029,883053,166871,157645,36288,193933,1944
2022-01-17,Kings,031,150075,41435,39143,2549,41692,392
2022-01-17,Lake,033,64148,8427,7864,520,8384,117
2022-01-17,Lassen,035,31185,7661,7417,617,8034,55
2022-01-17,Los Angeles,037,10098052,2373089,2205740,106242,2311982,27832
2022-01-17,Madera,039,155013,30345,28568,3487,32055,329
2022-01-17,Marin,041,260295,28554,26633,1654,28287,251
2022-01-17,Mariposa,043,17540,2001,1862,89,1951,6
2022-01-17,Mendocino,045,87422,10786,10030,1511,11541,103
2022-01-17,Merced,047,269075,54078,51227,4360,55587,718
2022-01-17,Modoc,049,8938,644,630,216,846,6
2022-01-17,Mono,051,14174,2755,2642,98,2740,4
2022-01-17,Monterey,053,433212,65394,57318,7225,64543,647
2022-01-17,Napa,055,140530,21075,19647,573,20220,109
2022-01-17,Nevada,057,99092,13529,12414,761,13175,111
2022-01-17,Orange,059,3164182,489544,457418,35536,492954,5933
2022-01-17,Placer,061,380077,53809,50511,6056,56567,508
2022-01-17,Plumas,063,18699,2435,2205,151,2356,12
2022-01-17,Riverside,065,2383286,523356,491322,23926,515248,5600
2022-01-17,Sacramento,067,1510023,238142,221143,16642,237785,2497
2022-01-17,San Benito,069,59416,10974,10432,344,10776,88
2022-01-17,San Bernardino,071,2135413,516313,480243,21192,501435,6259
2022-01-17,San Diego,073,3302833,637674,569241,41886,611127,4545
2022-01-17,San Francisco,075,870044,103939,95292,6436,101728,694
2022-01-17,San Joaquin,077,732212,141698,133414,8195,141609,1958
2022-01-17,San Luis Obispo,079,281455,43457,40425,2695,43120,379
2022-01-17,San Mateo,081,765935,101856,87013,4576,91589,585
2022-01-17,Santa Barbara,083,443738,70557,66704,3231,69935,581
2022-01-17,Santa Clara,085,1922200,256349,237934,8106,246040,1985
2022-01-17,Santa Cruz,087,273765,34451,31714,1690,33404,237
2022-01-17,Shasta,089,179085,26296,25025,4651,29676,448
2022-01-17,Sierra,091,2930,256,242,32,274,0
2022-01-17,Siskiyou,093,43540,3887,3764,1911,5675,62
2022-01-17,Solano,095,438530,66989,61497,3899,65396,391
2022-01-17,Sonoma,097,501317,67601,62763,1737,64500,419
2022-01-17,Stanislaus,099,539301,101641,96951,13102,110053,1379
2022-01-17,Sutter,101,95872,17796,17159,918,18077,198
2022-01-17,Tehama,103,63373,10385,9912,2087,11999,142
2022-01-17,Trinity,105,12862,1010,906,243,1149,19
2022-01-17,Tulare,107,460477,87821,81741,21088,102829,1199
2022-01-17,Tuolumne,109,53932,10198,9416,252,9668,91
2022-01-17,Ventura,111,848112,152036,142070,8266,150336,1234
2022-01-17,Yolo,113,214977,31065,28638,2133,30771,270
2022-01-17,Yuba,115,75493,13466,12871,695,13566,101
2022-01-16,Alameda,001,1643700,206043,190691,9341,200032,1564
2022-01-16,Alpine,003,1148,116,118,0,118,0
2022-01-16,Amador,005,37829,6975,6618,224,6842,73
2022-01-16,Butte,007,227075,27740,26139,5447,31586,348
2022-01-16,Calaveras,009,45235,5924,5537,137,5674,94
2022-01-16,Colusa,011,21464,2985,2886,884,3770,21
2022-01-16,Contra Costa,013,1133247,158121,146307,8627,154934,1086
2022-01-16,Del Norte,015,27424,4274,4177,89,4266,43
2022-01-16,El Dorado,017,186661,23099,21303,2518,23821,175
2022-01-16,Fresno,019,978130,186903,174818,17870,192688,2425
2022-01-16,Glenn,021,27897,4238,4049,1341,5390,39
2022-01-16,Humboldt,023,135768,13874,13075,1770,14845,125
2022-01-16,Imperial,025,180216,46299,44035,7265,51300,821
2022-01-16,Inyo,027,18085,3725,3602,141,3743,49
2022-01-16,Kern,029,883053,165599,156655,35503,192158,1944
2022-01-16,Kings,031,150075,41061,38861,2528,41389,392
2022-01-16,Lake,033,64148,8323,7823,486,8309,117
2022-01-16,Lassen,035,31185,7616,7391,604,7995,55
2022-01-16,Los Angeles,037,10098052,2349894,2174403,104732,2279135,27805
2022-01-16,Madera,039,155013,29975,28313,3437,31750,329
2022-01-16,Marin,041,260295,28260,26292,1639,27931,251
2022-01-16,Mariposa,043,17540,1974,1851,84,1935,6
2022-01-16,Mendocino,045,87422,10639,9992,1395,11387,102
2022-01-16,Merced,047,269075,53462,50882,4327,55209,718
2022-01-16,Modoc,049,8938,641,629,216,845,6
2022-01-16,Mono,051,14174,2751,2614,96,2710,4
2022-01-16,Monterey,053,433212,64628,57012,7081,64093,647
2022-01-16,Napa,055,140530,20809,19521,562,20083,109
2022-01-16,Nevada,057,99092,13316,12307,743,13050,111
2022-01-16,Orange,059,3164182,484152,451962,34986,486948,5932
2022-01-16,Placer,061,380077,53102,50076,5946,56022,508
2022-01-16,Plumas,063,18699,2400,2204,142,2346,12
2022-01-16,Riverside,065,2383286,517844,485191,23706,508897,5600
2022-01-16,Sacramento,067,1510023,235177,218819,15926,234745,2491
2022-01-16,San Benito,069,59416,10815,10377,342,10719,88
2022-01-16,San Bernardino,071,2135413,512278,474425,20937,495362,6259
2022-01-16,San Diego,073,3302833,630084,569241,41446,610687,4545
2022-01-16,San Francisco,075,870044,102418,94139,6298,100437,694
2022-01-16,San Joaquin,077,732212,139896,132214,8052,140266,1958
2022-01-16,San Luis Obispo,079,281455,42800,40113,2656,42769,379
2022-01-16,San Mateo,081,765935,100327,85966,4483,90449,585
2022-01-16,Santa Barbara,083,443738,69529,66111,3190,69301,582
2022-01-16,Santa Clara,085,1922200,252561,234293,7948,242241,1984
2022-01-16,Santa Cruz,087,273765,33822,31469,1668,33137,237
2022-01-16,Shasta,089,179085,26040,24980,4583,29563,449
2022-01-16,Sierra,091,2930,252,238,31,269,0
2022-01-16,Siskiyou,093,43540,3859,3748,1872,5620,62
2022-01-16,Solano,095,438530,66313,60885,3768,64653,391
2022-01-16,Sonoma,097,501317,66523,61842,1720,63562,419
2022-01-16,Stanislaus,099,539301,100579,96370,12936,109306,1379
2022-01-16,Sutter,101,95872,17596,16996,896,17892,198
2022-01-16,Tehama,103,63373,10300,9868,2066,11934,142
2022-01-16,Trinity,105,12862,1005,889,241,1130,19
2022-01-16,Tulare,107,460477,86512,80867,20835,101702,1199
2022-01-16,Tuolumne,109,53932,10093,9369,244,9613,91
2022-01-16,Ventura,111,848112,150459,140715,8188,148903,1234
2022-01-16,Yolo,113,214977,30672,28481,2080,30561,270
2022-01-16,Yuba,115,75493,13288,12760,689,13449,101
2022-01-15,Alameda,001,1643700,204702,177768,9286,187054,1561
2022-01-15,Alpine,003,1148,116,117,0,117,0
2022-01-15,Amador,005,37829,6943,6434,210,6644,72
2022-01-15,Butte,007,227075,27585,25032,5396,30428,348
2022-01-15,Calaveras,009,45235,5892,5258,137,5395,93
2022-01-15,Colusa,011,21464,2971,2796,877,3673,21
2022-01-15,Contra Costa,013,1133247,156854,137643,8579,146222,1082
2022-01-15,Del Norte,015,27424,4259,4065,87,4152,43
2022-01-15,El Dorado,017,186661,22994,20434,2502,22936,175
2022-01-15,Fresno,019,978130,185927,167361,17770,185131,2415
2022-01-15,Glenn,021,27897,4231,3906,1332,5238,39
2022-01-15,Humboldt,023,135768,13771,12419,1754,14173,123
2022-01-15,Imperial,025,180216,46161,42508,7157,49665,817
2022-01-15,Inyo,027,18085,3715,3395,141,3536,49
2022-01-15,Kern,029,883053,164756,150085,35113,185198,1938
2022-01-15,Kings,031,150075,40812,37221,2516,39737,391
2022-01-15,Lake,033,64148,8284,7641,473,8114,117
2022-01-15,Lassen,035,31185,7576,7274,598,7872,55
2022-01-15,Los Angeles,037,10098052,2338356,2047927,103785,2151712,27641
2022-01-15,Madera,039,155013,29829,27294,3413,30707,329
2022-01-15,Marin,041,260295,28073,25248,1632,26880,251
2022-01-15,Mariposa,043,17540,1967,1762,84,1846,6
2022-01-15,Mendocino,045,87422,10566,9534,1389,10923,102
2022-01-15,Merced,047,269075,53290,48904,4315,53219,715
2022-01-15,Modoc,049,8938,639,628,216,844,6
2022-01-15,Mono,051,14174,2746,2508,95,2603,4
2022-01-15,Monterey,053,433212,64114,55315,7017,62332,647
2022-01-15,Napa,055,140530,20688,17648,558,18206,109
2022-01-15,Nevada,057,99092,13256,11773,730,12503,111
2022-01-15,Orange,059,3164182,481552,433141,34713,467854,5914
2022-01-15,Placer,061,380077,52812,47780,5910,53690,501
2022-01-15,Plumas,063,18699,2379,2158,136,2294,12
2022-01-15,Riverside,065,2383286,515163,466381,23571,489952,5578
2022-01-15,Sacramento,067,1510023,234015,208156,15826,223982,2491
2022-01-15,San Benito,069,59416,10715,9868,337,10205,87
2022-01-15,San Bernardino,071,2135413,509903,454395,20789,475184,6233
2022-01-15,San Diego,073,3302833,626298,559385,41190,600575,4540
2022-01-15,San Francisco,075,870044,101423,88004,6163,94167,692
2022-01-15,San Joaquin,077,732212,139323,125136,7955,133091,1954
2022-01-15,San Luis Obispo,079,281455,42611,38231,2643,40874,374
2022-01-15,San Mateo,081,765935,99369,80494,4442,84936,582
2022-01-15,Santa Barbara,083,443738,68933,62312,3179,65491,579
2022-01-15,Santa Clara,085,1922200,250315,218986,7830,226816,1974
2022-01-15,Santa Cruz,087,273765,33468,29414,1660,31074,235
2022-01-15,Shasta,089,179085,25948,24482,4551,29033,445
2022-01-15,Sierra,091,2930,251,232,30,262,0
2022-01-15,Siskiyou,093,43540,3847,3661,1862,5523,62
2022-01-15,Solano,095,438530,66032,58061,3719,61780,389
2022-01-15,Sonoma,097,501317,65937,58181,1714,59895,418
2022-01-15,Stanislaus,099,539301,99998,92986,12833,105819,1379
2022-01-15,Sutter,101,95872,17507,16345,886,17231,197
2022-01-15,Tehama,103,63373,10252,9572,2047,11619,141
2022-01-15,Trinity,105,12862,1002,872,241,1113,19
2022-01-15,Tulare,107,460477,86064,77769,20726,98495,1192
2022-01-15,Tuolumne,109,53932,9992,9042,239,9281,91
2022-01-15,Ventura,111,848112,149684,134736,8150,142886,1227
2022-01-15,Yolo,113,214977,30493,27311,2060,29371,270
2022-01-15,Yuba,115,75493,13224,12200,685,12885,101
2022-01-14,Alameda,001,1643700,202670,177768,9235,187003,1561
2022-01-14,Alpine,003,1148,116,117,0,117,0
2022-01-14,Amador,005,37829,6867,6434,201,6635,72
2022-01-14,Butte,007,227075,27403,25032,5365,30397,348
2022-01-14,Calaveras,009,45235,5855,5258,136,5394,93
2022-01-14,Colusa,011,21464,2962,2796,867,3663,21
2022-01-14,Contra Costa,013,1133247,155328,137643,8473,146116,1082
2022-01-14,Del Norte,015,27424,4234,4065,86,4151,43
2022-01-14,El Dorado,017,186661,22842,20434,2484,22918,175
2022-01-14,Fresno,019,978130,184198,167361,17671,185032,2415
2022-01-14,Glenn,021,27897,4208,3906,1324,5230,39
2022-01-14,Humboldt,023,135768,13665,12419,1722,14141,123
2022-01-14,Imperial,025,180216,45990,42508,7137,49645,817
2022-01-14,Inyo,027,18085,3690,3395,137,3532,49
2022-01-14,Kern,029,883053,163756,150085,34679,184764,1938
2022-01-14,Kings,031,150075,40560,37221,2508,39729,391
2022-01-14,Lake,033,64148,8227,7641,461,8102,117
2022-01-14,Lassen,035,31185,7542,7274,586,7860,55
2022-01-14,Los Angeles,037,10098052,2319037,2047927,102749,2150676,27641
2022-01-14,Madera,039,155013,29593,27294,3385,30679,329
2022-01-14,Marin,041,260295,27814,25248,1597,26845,251
2022-01-14,Mariposa,043,17540,1952,1762,84,1846,6
2022-01-14,Mendocino,045,87422,10454,9534,1376,10910,102
2022-01-14,Merced,047,269075,53103,48904,4299,53203,715
2022-01-14,Modoc,049,8938,638,628,216,844,6
2022-01-14,Mono,051,14174,2725,2508,93,2601,4
2022-01-14,Monterey,053,433212,63416,55315,6924,62239,647
2022-01-14,Napa,055,140530,20518,17648,553,18201,109
2022-01-14,Nevada,057,99092,13133,11773,717,12490,111
2022-01-14,Orange,059,3164182,477817,433141,34394,467535,5914
2022-01-14,Placer,061,380077,52376,47780,5824,53604,501
2022-01-14,Plumas,063,18699,2371,2158,129,2287,12
2022-01-14,Riverside,065,2383286,511643,466381,23427,489808,5578
2022-01-14,Sacramento,067,1510023,232063,208156,15674,223830,2491
2022-01-14,San Benito,069,59416,10663,9868,336,10204,87
2022-01-14,San Bernardino,071,2135413,506695,454395,20602,474997,6233
2022-01-14,San Diego,073,3302833,620649,559385,40881,600266,4540
2022-01-14,San Francisco,075,870044,100250,88004,5988,93992,692
2022-01-14,San Joaquin,077,732212,138467,125136,7875,133011,1954
2022-01-14,San Luis Obispo,079,281455,42444,38231,2622,40853,374
2022-01-14,San Mateo,081,765935,98139,80494,4413,84907,582
2022-01-14,Santa Barbara,083,443738,68414,62312,3169,65481,579
2022-01-14,Santa Clara,085,1922200,247651,218986,7725,226711,1974
2022-01-14,Santa Cruz,087,273765,33090,29414,1651,31065,235
2022-01-14,Shasta,089,179085,25827,24482,4518,29000,445
2022-01-14,Sierra,091,2930,249,232,28,260,0
2022-01-14,Siskiyou,093,43540,3836,3661,1849,5510,62
2022-01-14,Solano,095,438530,65186,58061,3631,61692,389
2022-01-14,Sonoma,097,501317,65396,58181,1688,59869,418
2022-01-14,Stanislaus,099,539301,99392,92986,12725,105711,1379
2022-01-14,Sutter,101,95872,17381,16345,878,17223,197
2022-01-14,Tehama,103,63373,10199,9572,2035,11607,141
2022-01-14,Trinity,105,12862,997,872,239,1111,19
2022-01-14,Tulare,107,460477,85540,77769,20565,98334,1192
2022-01-14,Tuolumne,109,53932,9869,9042,235,9277,91
2022-01-14,Ventura,111,848112,148581,134736,8091,142827,1227
2022-01-14,Yolo,113,214977,30252,27311,2032,29343,270
2022-01-14,Yuba,115,75493,13121,12200,680,12880,101
2022-01-13,Alameda,001,1643700,198412,177768,8891,186659,1561
2022-01-13,Alpine,003,1148,115,117,0,117,0
2022-01-13,Amador,005,37829,6807,6434,180,6614,72
2022-01-13,Butte,007,227075,27097,25032,5252,30284,348
2022-01-13,Calaveras,009,45235,5765,5258,133,5391,93
2022-01-13,Colusa,011,21464,2934,2796,857,3653,21
2022-01-13,Contra Costa,013,1133247,152658,137643,8007,145650,1082
2022-01-13,Del Norte,015,27424,4198,4065,85,4150,43
2022-01-13,El Dorado,017,186661,22596,20434,2438,22872,175
2022-01-13,Fresno,019,978130,181238,167361,17264,184625,2415
2022-01-13,Glenn,021,27897,4161,3906,1298,5204,39
2022-01-13,Humboldt,023,135768,13513,12419,1660,14079,123
2022-01-13,Imperial,025,180216,45448,42508,6926,49434,817
2022-01-13,Inyo,027,18085,3634,3395,120,3515,49
2022-01-13,Kern,029,883053,162171,150085,34090,184175,1938
2022-01-13,Kings,031,150075,40079,37221,2464,39685,391
2022-01-13,Lake,033,64148,8127,7641,440,8081,117
2022-01-13,Lassen,035,31185,7508,7274,570,7844,55
2022-01-13,Los Angeles,037,10098052,2282554,2047927,100963,2148890,27641
2022-01-13,Madera,039,155013,29127,27294,3292,30586,329
2022-01-13,Marin,041,260295,27470,25248,1554,26802,251
2022-01-13,Mariposa,043,17540,1929,1762,81,1843,6
2022-01-13,Mendocino,045,87422,10363,9534,1308,10842,102
2022-01-13,Merced,047,269075,52436,48904,4032,52936,715
2022-01-13,Modoc,049,8938,635,628,216,844,6
2022-01-13,Mono,051,14174,2702,2508,90,2598,4
2022-01-13,Monterey,053,433212,62479,55315,6638,61953,647
2022-01-13,Napa,055,140530,20220,17648,543,18191,109
2022-01-13,Nevada,057,99092,12941,11773,687,12460,111
2022-01-13,Orange,059,3164182,471376,433141,33934,467075,5914
2022-01-13,Placer,061,380077,51747,47780,5709,53489,501
2022-01-13,Plumas,063,18699,2351,2158,119,2277,12
2022-01-13,Riverside,065,2383286,505339,466381,23100,489481,5578
2022-01-13,Sacramento,067,1510023,228970,208156,14888,223044,2491
2022-01-13,San Benito,069,59416,10558,9868,328,10196,87
2022-01-13,San Bernardino,071,2135413,500788,454395,20136,474531,6233
2022-01-13,San Diego,073,3302833,612135,559385,40006,599391,4540
2022-01-13,San Francisco,075,870044,98509,88004,5793,93797,692
2022-01-13,San Joaquin,077,732212,136382,125136,7721,132857,1954
2022-01-13,San Luis Obispo,079,281455,41841,38231,2517,40748,374
2022-01-13,San Mateo,081,765935,96355,80494,4177,84671,582
2022-01-13,Santa Barbara,083,443738,67416,62312,2993,65305,579
2022-01-13,Santa Clara,085,1922200,243230,218986,7397,226383,1974
2022-01-13,Santa Cruz,087,273765,32275,29414,1629,31043,235
2022-01-13,Shasta,089,179085,25617,24482,4446,28928,445
2022-01-13,Sierra,091,2930,248,232,28,260,0
2022-01-13,Siskiyou,093,43540,3814,3661,1809,5470,62
2022-01-13,Solano,095,438530,64052,58061,3520,61581,389
2022-01-13,Sonoma,097,501317,64331,58181,1632,59813,418
2022-01-13,Stanislaus,099,539301,98272,92986,12431,105417,1379
2022-01-13,Sutter,101,95872,17186,16345,814,17159,197
2022-01-13,Tehama,103,63373,10101,9572,1987,11559,141
2022-01-13,Trinity,105,12862,989,872,239,1111,19
2022-01-13,Tulare,107,460477,84260,77769,20277,98046,1192
2022-01-13,Tuolumne,109,53932,9727,9042,217,9259,91
2022-01-13,Ventura,111,848112,146799,134736,7997,142733,1227
2022-01-13,Yolo,113,214977,29836,27311,1988,29299,270
2022-01-13,Yuba,115,75493,12986,12200,651,12851,101
2022-01-12,Alameda,001,1643700,193848,173001,8435,181436,1563
2022-01-12,Alpine,003,1148,115,117,0,117,0
2022-01-12,Amador,005,37829,6759,6354,166,6520,71
2022-01-12,Butte,007,227075,26765,24631,5161,29792,348
2022-01-12,Calaveras,009,45235,5688,5151,127,5278,93
2022-01-12,Colusa,011,21464,2896,2772,844,3616,21
2022-01-12,Contra Costa,013,1133247,149962,134579,7628,142207,1077
2022-01-12,Del Norte,015,27424,4172,4019,83,4102,43
2022-01-12,El Dorado,017,186661,22279,20092,2399,22491,175
2022-01-12,Fresno,019,978130,178331,165316,16825,182141,2413
2022-01-12,Glenn,021,27897,4109,3859,1276,5135,39
2022-01-12,Humboldt,023,135768,13341,12081,1578,13659,122
2022-01-12,Imperial,025,180216,44794,41985,6628,48613,814
2022-01-12,Inyo,027,18085,3588,3334,104,3438,49
2022-01-12,Kern,029,883053,160033,148435,33368,181803,1933
2022-01-12,Kings,031,150075,39449,36780,2422,39202,391
2022-01-12,Lake,033,64148,8011,7535,396,7931,117
2022-01-12,Lassen,035,31185,7466,7223,543,7766,55
2022-01-12,Los Angeles,037,10098052,2242812,2005065,98733,2103798,27601
2022-01-12,Madera,039,155013,28812,26952,3193,30145,329
2022-01-12,Marin,041,260295,26981,24704,1503,26207,251
2022-01-12,Mariposa,043,17540,1900,1725,79,1804,6
2022-01-12,Mendocino,045,87422,10199,9379,1210,10589,103
2022-01-12,Merced,047,269075,51726,48441,3756,52197,710
2022-01-12,Modoc,049,8938,633,627,216,843,6
2022-01-12,Mono,051,14174,2666,2466,86,2552,4
2022-01-12,Monterey,053,433212,61492,54524,6277,60801,647
2022-01-12,Napa,055,140530,19962,17347,520,17867,109
2022-01-12,Nevada,057,99092,12727,11552,641,12193,111
2022-01-12,Orange,059,3164182,464607,425737,33341,459078,5912
2022-01-12,Placer,061,380077,51086,47004,5594,52598,501
2022-01-12,Plumas,063,18699,2311,2135,108,2243,12
2022-01-12,Riverside,065,2383286,498103,458881,22760,481641,5565
2022-01-12,Sacramento,067,1510023,225389,204696,14011,218707,2479
2022-01-12,San Benito,069,59416,10421,9737,316,10053,87
2022-01-12,San Bernardino,071,2135413,494273,447869,19512,467381,6222
2022-01-12,San Diego,073,3302833,601636,551669,39142,590811,4529
2022-01-12,San Francisco,075,870044,96670,85700,5680,91380,691
2022-01-12,San Joaquin,077,732212,134070,122850,7593,130443,1948
2022-01-12,San Luis Obispo,079,281455,41115,37727,2434,40161,373
2022-01-12,San Mateo,081,765935,94322,78476,3803,82279,582
2022-01-12,Santa Barbara,083,443738,66273,60815,2891,63706,578
2022-01-12,Santa Clara,085,1922200,238478,213177,7019,220196,1971
2022-01-12,Santa Cruz,087,273765,31620,28463,1581,30044,235
2022-01-12,Shasta,089,179085,25404,24324,4381,28705,446
2022-01-12,Sierra,091,2930,247,228,28,256,0
2022-01-12,Siskiyou,093,43540,3786,3639,1762,5401,62
2022-01-12,Solano,095,438530,63000,57052,3400,60452,386
2022-01-12,Sonoma,097,501317,63046,56394,1549,57943,417
2022-01-12,Stanislaus,099,539301,97032,91738,12087,103825,1373
2022-01-12,Sutter,101,95872,16992,16135,781,16916,197
2022-01-12,Tehama,103,63373,10012,9475,1926,11401,141
2022-01-12,Trinity,105,12862,985,868,238,1106,19
2022-01-12,Tulare,107,460477,83147,76943,19899,96842,1192
2022-01-12,Tuolumne,109,53932,9598,8870,200,9070,91
2022-01-12,Ventura,111,848112,144894,132180,7911,140091,1220
2022-01-12,Yolo,113,214977,29424,26888,1916,28804,270
2022-01-12,Yuba,115,75493,12825,12015,624,12639,101
2022-01-11,Alameda,001,1643700,189414,169181,8040,177221,1561
2022-01-11,Alpine,003,1148,115,116,0,116,0
2022-01-11,Amador,005,37829,6675,6317,151,6468,71
2022-01-11,Butte,007,227075,26369,24479,5067,29546,347
2022-01-11,Calaveras,009,45235,5559,5083,113,5196,93
2022-01-11,Colusa,011,21464,2871,2766,831,3597,21
2022-01-11,Contra Costa,013,1133247,146813,132410,7134,139544,1077
2022-01-11,Del Norte,015,27424,4139,4006,81,4087,43
2022-01-11,El Dorado,017,186661,21948,19842,2329,22171,174
2022-01-11,Fresno,019,978130,175096,163509,16425,179934,2404
2022-01-11,Glenn,021,27897,4047,3844,1232,5076,39
2022-01-11,Humboldt,023,135768,13122,11960,1485,13445,122
2022-01-11,Imperial,025,180216,44189,41444,6429,47873,813
2022-01-11,Inyo,027,18085,3490,3278,97,3375,49
2022-01-11,Kern,029,883053,157751,146942,32546,179488,1929
2022-01-11,Kings,031,150075,38861,36524,2391,38915,389
2022-01-11,Lake,033,64148,7933,7494,380,7874,117
2022-01-11,Lassen,035,31185,7416,7210,529,7739,55
2022-01-11,Los Angeles,037,10098052,2200337,1966319,96484,2062803,27563
2022-01-11,Madera,039,155013,28397,26688,3114,29802,329
2022-01-11,Marin,041,260295,26624,24387,1458,25845,251
2022-01-11,Mariposa,043,17540,1878,1718,75,1793,6
2022-01-11,Mendocino,045,87422,10038,9301,1112,10413,102
2022-01-11,Merced,047,269075,50941,48068,3572,51640,708
2022-01-11,Modoc,049,8938,632,626,215,841,6
2022-01-11,Mono,051,14174,2623,2425,85,2510,4
2022-01-11,Monterey,053,433212,60449,53911,5929,59840,646
2022-01-11,Napa,055,140530,19525,17020,473,17493,109
2022-01-11,Nevada,057,99092,12501,11467,606,12073,110
2022-01-11,Orange,059,3164182,456936,417703,32705,450408,5909
2022-01-11,Placer,061,380077,50330,46459,5450,51909,500
2022-01-11,Plumas,063,18699,2276,2099,100,2199,12
2022-01-11,Riverside,065,2383286,490369,453766,22446,476212,5551
2022-01-11,Sacramento,067,1510023,221208,201058,12983,214041,2489
2022-01-11,San Benito,069,59416,10241,9624,300,9924,83
2022-01-11,San Bernardino,071,2135413,486298,442960,18901,461861,6198
2022-01-11,San Diego,073,3302833,589635,536954,38024,574978,4520
2022-01-11,San Francisco,075,870044,94474,83678,5523,89201,691
2022-01-11,San Joaquin,077,732212,131671,121139,7422,128561,1944
2022-01-11,San Luis Obispo,079,281455,40340,37183,2315,39498,372
2022-01-11,San Mateo,081,765935,92029,76756,3581,80337,582
2022-01-11,Santa Barbara,083,443738,64968,59758,2754,62512,578
2022-01-11,Santa Clara,085,1922200,232855,208425,6566,214991,1971
2022-01-11,Santa Cruz,087,273765,31110,27709,1531,29240,232
2022-01-11,Shasta,089,179085,25146,24132,4288,28420,446
2022-01-11,Sierra,091,2930,245,228,28,256,0
2022-01-11,Siskiyou,093,43540,3762,3621,1712,5333,62
2022-01-11,Solano,095,438530,61595,56349,3246,59595,388
2022-01-11,Sonoma,097,501317,61528,55411,1469,56880,416
2022-01-11,Stanislaus,099,539301,95661,90998,11714,102712,1372
2022-01-11,Sutter,101,95872,16794,15993,727,16720,197
2022-01-11,Tehama,103,63373,9885,9406,1878,11284,140
2022-01-11,Trinity,105,12862,973,858,236,1094,19
2022-01-11,Tulare,107,460477,81848,76267,19500,95767,1188
2022-01-11,Tuolumne,109,53932,9438,8811,193,9004,91
2022-01-11,Ventura,111,848112,142664,129548,7765,137313,1220
2022-01-11,Yolo,113,214977,28854,26482,1855,28337,270
2022-01-11,Yuba,115,75493,12650,11912,603,12515,101
2022-01-10,Alameda,001,1643700,184358,165657,7519,173176,1559
2022-01-10,Alpine,003,1148,115,116,0,116,0
2022-01-10,Amador,005,37829,6572,6279,136,6415,71
2022-01-10,Butte,007,227075,26027,24217,4971,29188,347
2022-01-10,Calaveras,009,45235,5461,5025,107,5132,93
2022-01-10,Colusa,011,21464,2841,2758,822,3580,21
2022-01-10,Contra Costa,013,1133247,143918,129951,6612,136563,1077
2022-01-10,Del Norte,015,27424,4116,3970,81,4051,43
2022-01-10,El Dorado,017,186661,21410,19606,2274,21880,172
2022-01-10,Fresno,019,978130,171886,161593,15982,177575,2404
2022-01-10,Glenn,021,27897,3988,3807,1218,5025,39
2022-01-10,Humboldt,023,135768,12880,11778,1352,13130,121
2022-01-10,Imperial,025,180216,43461,41080,6212,47292,811
2022-01-10,Inyo,027,18085,3435,3227,85,3312,49
2022-01-10,Kern,029,883053,155181,145744,31803,177547,1929
2022-01-10,Kings,031,150075,38241,36286,2365,38651,389
2022-01-10,Lake,033,64148,7844,7416,356,7772,117
2022-01-10,Lassen,035,31185,7378,7192,507,7699,55
2022-01-10,Los Angeles,037,10098052,2154792,1932475,93993,2026468,27546
2022-01-10,Madera,039,155013,27947,26501,3012,29513,328
2022-01-10,Marin,041,260295,26134,24023,1385,25408,251
2022-01-10,Mariposa,043,17540,1838,1684,70,1754,6
2022-01-10,Mendocino,045,87422,9865,9163,1025,10188,101
2022-01-10,Merced,047,269075,50111,47632,3281,50913,707
2022-01-10,Modoc,049,8938,631,622,213,835,6
2022-01-10,Mono,051,14174,2557,2415,80,2495,4
2022-01-10,Monterey,053,433212,59495,53485,5611,59096,645
2022-01-10,Napa,055,140530,19148,16775,459,17234,109
2022-01-10,Nevada,057,99092,12277,11300,568,11868,110
2022-01-10,Orange,059,3164182,448242,406170,31844,438014,5906
2022-01-10,Placer,061,380077,49483,45642,5288,50930,498
2022-01-10,Plumas,063,18699,2241,2086,98,2184,12
2022-01-10,Riverside,065,2383286,482109,445536,21997,467533,5546
2022-01-10,Sacramento,067,1510023,216690,198023,11934,209957,2474
2022-01-10,San Benito,069,59416,10069,9467,290,9757,83
2022-01-10,San Bernardino,071,2135413,477805,437207,18173,455380,6184
2022-01-10,San Diego,073,3302833,576943,530506,36882,567388,4500
2022-01-10,San Francisco,075,870044,92682,82209,5264,87473,690
2022-01-10,San Joaquin,077,732212,128974,119587,7138,126725,1927
2022-01-10,San Luis Obispo,079,281455,39522,36618,2220,38838,371
2022-01-10,San Mateo,081,765935,89381,75210,3326,78536,582
2022-01-10,Santa Barbara,083,443738,63707,58957,2565,61522,578
2022-01-10,Santa Clara,085,1922200,226794,203540,6089,209629,1971
2022-01-10,Santa Cruz,087,273765,30269,26906,1493,28399,232
2022-01-10,Shasta,089,179085,24949,23983,4211,28194,446
2022-01-10,Sierra,091,2930,242,223,28,251,0
2022-01-10,Siskiyou,093,43540,3729,3592,1668,5260,62
2022-01-10,Solano,095,438530,60553,55663,3049,58712,385
2022-01-10,Sonoma,097,501317,59981,54478,1423,55901,412
2022-01-10,Stanislaus,099,539301,94319,89997,11363,101360,1372
2022-01-10,Sutter,101,95872,16550,15823,681,16504,196
2022-01-10,Tehama,103,63373,9771,9360,1823,11183,140
2022-01-10,Trinity,105,12862,969,849,234,1083,19
2022-01-10,Tulare,107,460477,80359,75498,19124,94622,1186
2022-01-10,Tuolumne,109,53932,9313,8685,181,8866,91
2022-01-10,Ventura,111,848112,140062,126240,7615,133855,1217
2022-01-10,Yolo,113,214977,28262,26065,1802,27867,270
2022-01-10,Yuba,115,75493,12402,11776,569,12345,101
2022-01-09,Alameda,001,1643700,179867,162701,6853,169554,1561
2022-01-09,Alpine,003,1148,115,116,0,116,0
2022-01-09,Amador,005,37829,6484,6215,124,6339,71
2022-01-09,Butte,007,227075,25632,24018,4853,28871,347
2022-01-09,Calaveras,009,45235,5330,4976,98,5074,93
2022-01-09,Colusa,011,21464,2813,2750,799,3549,21
2022-01-09,Contra Costa,013,1133247,140911,128050,5944,133994,1077
2022-01-09,Del Norte,015,27424,4077,3950,77,4027,43
2022-01-09,El Dorado,017,186661,21043,19430,2209,21639,172
2022-01-09,Fresno,019,978130,169128,159989,15561,175550,2405
2022-01-09,Glenn,021,27897,3931,3797,1196,4993,39
2022-01-09,Humboldt,023,135768,12635,11582,1230,12812,121
2022-01-09,Imperial,025,180216,42625,40608,5952,46560,811
2022-01-09,Inyo,027,18085,3332,3149,76,3225,49
2022-01-09,Kern,029,883053,152730,144819,31063,175882,1927
2022-01-09,Kings,031,150075,37566,36041,2328,38369,389
2022-01-09,Lake,033,64148,7733,7393,312,7705,117
2022-01-09,Lassen,035,31185,7314,7172,478,7650,55
2022-01-09,Los Angeles,037,10098052,2106725,1887830,90936,1978766,27532
2022-01-09,Madera,039,155013,27568,26325,2915,29240,328
2022-01-09,Marin,041,260295,25682,23708,1295,25003,251
2022-01-09,Mariposa,043,17540,1788,1660,69,1729,6
2022-01-09,Mendocino,045,87422,9657,9097,914,10011,101
2022-01-09,Merced,047,269075,49228,47294,3005,50299,706
2022-01-09,Modoc,049,8938,629,619,213,832,6
2022-01-09,Mono,051,14174,2522,2390,73,2463,4
2022-01-09,Monterey,053,433212,58432,53251,5343,58594,645
2022-01-09,Napa,055,140530,18653,16614,443,17057,109
2022-01-09,Nevada,057,99092,12023,11152,507,11659,110
2022-01-09,Orange,059,3164182,438241,400563,30891,431454,5905
2022-01-09,Placer,061,380077,48485,45081,5139,50220,498
2022-01-09,Plumas,063,18699,2202,2081,78,2159,12
2022-01-09,Riverside,065,2383286,473119,440413,21456,461869,5546
2022-01-09,Sacramento,067,1510023,211892,195444,10815,206259,2475
2022-01-09,San Benito,069,59416,9883,9363,262,9625,83
2022-01-09,San Bernardino,071,2135413,469293,430257,17354,447611,6180
2022-01-09,San Diego,073,3302833,563828,478206,35024,513230,4500
2022-01-09,San Francisco,075,870044,90807,80463,5019,85482,690
2022-01-09,San Joaquin,077,732212,125874,118422,6971,125393,1927
2022-01-09,San Luis Obispo,079,281455,38717,36291,2114,38405,371
2022-01-09,San Mateo,081,765935,86866,73867,3000,76867,582
2022-01-09,Santa Barbara,083,443738,62022,58280,2303,60583,578
2022-01-09,Santa Clara,085,1922200,220415,199889,5553,205442,1976
2022-01-09,Santa Cruz,087,273765,29519,26513,1461,27974,232
2022-01-09,Shasta,089,179085,24709,23926,4124,28050,446
2022-01-09,Sierra,091,2930,239,223,26,249,0
2022-01-09,Siskiyou,093,43540,3700,3580,1609,5189,62
2022-01-09,Solano,095,438530,59398,54985,2768,57753,384
2022-01-09,Sonoma,097,501317,58308,53543,1386,54929,412
2022-01-09,Stanislaus,099,539301,92945,89248,11066,100314,1372
2022-01-09,Sutter,101,95872,16262,15695,601,16296,196
2022-01-09,Tehama,103,63373,9653,9306,1772,11078,140
2022-01-09,Trinity,105,12862,965,848,232,1080,19
2022-01-09,Tulare,107,460477,78952,75085,18748,93833,1186
2022-01-09,Tuolumne,109,53932,9155,8595,162,8757,91
2022-01-09,Ventura,111,848112,137010,124269,7372,131641,1217
2022-01-09,Yolo,113,214977,27655,25632,1755,27387,270
2022-01-09,Yuba,115,75493,12204,11666,538,12204,101
2022-01-08,Alameda,001,1643700,177966,148560,6712,155272,1558
2022-01-08,Alpine,003,1148,115,114,0,114,0
2022-01-08,Amador,005,37829,6453,6091,119,6210,71
2022-01-08,Butte,007,227075,25441,23429,4812,28241,347
2022-01-08,Calaveras,009,45235,5284,4823,94,4917,93
2022-01-08,Colusa,011,21464,2805,2713,796,3509,21
2022-01-08,Contra Costa,013,1133247,139346,119907,5861,125768,1077
2022-01-08,Del Norte,015,27424,4060,3902,77,3979,43
2022-01-08,El Dorado,017,186661,20858,18599,2175,20774,172
2022-01-08,Fresno,019,978130,168199,155394,15422,170816,2393
2022-01-08,Glenn,021,27897,3923,3732,1191,4923,39
2022-01-08,Humboldt,023,135768,12511,11149,1204,12353,121
2022-01-08,Imperial,025,180216,42437,39429,5810,45239,800
2022-01-08,Inyo,027,18085,3318,3020,73,3093,49
2022-01-08,Kern,029,883053,151593,140410,30632,171042,1921
2022-01-08,Kings,031,150075,37325,35275,2311,37586,390
2022-01-08,Lake,033,64148,7693,7209,304,7513,117
2022-01-08,Lassen,035,31185,7284,7127,462,7589,55
2022-01-08,Los Angeles,037,10098052,2088330,1765787,89202,1854989,27476
2022-01-08,Madera,039,155013,27401,25767,2877,28644,328
2022-01-08,Marin,041,260295,25398,22377,1284,23661,251
2022-01-08,Mariposa,043,17540,1778,1588,69,1657,6
2022-01-08,Mendocino,045,87422,9583,8792,912,9704,101
2022-01-08,Merced,047,269075,49049,46094,2981,49075,703
2022-01-08,Modoc,049,8938,629,610,213,823,6
2022-01-08,Mono,051,14174,2511,2240,68,2308,4
2022-01-08,Monterey,053,433212,58046,51721,5250,56971,644
2022-01-08,Napa,055,140530,18500,15819,417,16236,109
2022-01-08,Nevada,057,99092,11938,10765,494,11259,110
2022-01-08,Orange,059,3164182,434448,375124,30040,405164,5903
2022-01-08,Placer,061,380077,48042,43172,5097,48269,495
2022-01-08,Plumas,063,18699,2192,2053,73,2126,12
2022-01-08,Riverside,065,2383286,469601,422591,21188,443779,5535
2022-01-08,Sacramento,067,1510023,210451,185118,10657,195775,2470
2022-01-08,San Benito,069,59416,9721,9016,259,9275,83
2022-01-08,San Bernardino,071,2135413,465801,411724,16953,428677,6122
2022-01-08,San Diego,073,3302833,558929,472273,34482,506755,4495
2022-01-08,San Francisco,075,870044,89606,73660,4740,78400,690
2022-01-08,San Joaquin,077,732212,124891,112514,6872,119386,1916
2022-01-08,San Luis Obispo,079,281455,38514,34489,2071,36560,369
2022-01-08,San Mateo,081,765935,85481,67918,2913,70831,582
2022-01-08,Santa Barbara,083,443738,61327,54617,2269,56886,575
2022-01-08,Santa Clara,085,1922200,217154,183842,5316,189158,1966
2022-01-08,Santa Cruz,087,273765,29092,24678,1441,26119,230
2022-01-08,Shasta,089,179085,24618,23585,4093,27678,445
2022-01-08,Sierra,091,2930,235,215,25,240,0
2022-01-08,Siskiyou,093,43540,3688,3545,1595,5140,62
2022-01-08,Solano,095,438530,58990,52452,2696,55148,383
2022-01-08,Sonoma,097,501317,57785,50130,1352,51482,411
2022-01-08,Stanislaus,099,539301,92305,87049,10943,97992,1372
2022-01-08,Sutter,101,95872,16143,15261,588,15849,195
2022-01-08,Tehama,103,63373,9622,9109,1764,10873,140
2022-01-08,Trinity,105,12862,959,836,232,1068,19
2022-01-08,Tulare,107,460477,78553,73600,18612,92212,1185
2022-01-08,Tuolumne,109,53932,9049,8360,159,8519,91
2022-01-08,Ventura,111,848112,135840,117229,7238,124467,1216
2022-01-08,Yolo,113,214977,27362,24006,1727,25733,270
2022-01-08,Yuba,115,75493,12116,11277,535,11812,101
2022-01-07,Alameda,001,1643700,175272,148560,6595,155155,1558
2022-01-07,Alpine,003,1148,115,114,0,114,0
2022-01-07,Amador,005,37829,6404,6091,116,6207,71
2022-01-07,Butte,007,227075,25235,23429,4779,28208,347
2022-01-07,Calaveras,009,45235,5245,4823,94,4917,93
2022-01-07,Colusa,011,21464,2796,2713,785,3498,21
2022-01-07,Contra Costa,013,1133247,137395,119907,5737,125644,1077
2022-01-07,Del Norte,015,27424,4044,3902,76,3978,43
2022-01-07,El Dorado,017,186661,20673,18599,2162,20761,172
2022-01-07,Fresno,019,978130,166750,155394,15315,170709,2393
2022-01-07,Glenn,021,27897,3903,3732,1188,4920,39
2022-01-07,Humboldt,023,135768,12367,11149,1177,12326,121
2022-01-07,Imperial,025,180216,42279,39429,5727,45156,800
2022-01-07,Inyo,027,18085,3299,3020,71,3091,49
2022-01-07,Kern,029,883053,150621,140410,30187,170597,1921
2022-01-07,Kings,031,150075,37144,35275,2297,37572,390
2022-01-07,Lake,033,64148,7645,7209,279,7488,117
2022-01-07,Lassen,035,31185,7268,7127,459,7586,55
2022-01-07,Los Angeles,037,10098052,2057152,1765787,87746,1853533,27476
2022-01-07,Madera,039,155013,27219,25767,2840,28607,328
2022-01-07,Marin,041,260295,25017,22377,1266,23643,251
2022-01-07,Mariposa,043,17540,1762,1588,69,1657,6
2022-01-07,Mendocino,045,87422,9490,8792,911,9703,101
2022-01-07,Merced,047,269075,48876,46094,2957,49051,703
2022-01-07,Modoc,049,8938,628,610,213,823,6
2022-01-07,Mono,051,14174,2473,2240,62,2302,4
2022-01-07,Monterey,053,433212,57624,51721,5155,56876,644
2022-01-07,Napa,055,140530,18273,15819,398,16217,109
2022-01-07,Nevada,057,99092,11808,10765,473,11238,110
2022-01-07,Orange,059,3164182,429635,375124,29422,404546,5903
2022-01-07,Placer,061,380077,47537,43172,5047,48219,495
2022-01-07,Plumas,063,18699,2183,2053,72,2125,12
2022-01-07,Riverside,065,2383286,465773,422591,20959,443550,5535
2022-01-07,Sacramento,067,1510023,208182,185118,10504,195622,2470
2022-01-07,San Benito,069,59416,9675,9016,258,9274,83
2022-01-07,San Bernardino,071,2135413,461677,411724,16724,428448,6122
2022-01-07,San Diego,073,3302833,551817,472273,33935,506208,4495
2022-01-07,San Francisco,075,870044,88160,73660,4486,78146,690
2022-01-07,San Joaquin,077,732212,123929,112514,6811,119325,1916
2022-01-07,San Luis Obispo,079,281455,38299,34489,2016,36505,369
2022-01-07,San Mateo,081,765935,84014,67918,2854,70772,582
2022-01-07,Santa Barbara,083,443738,60632,54617,2248,56865,575
2022-01-07,Santa Clara,085,1922200,213682,183842,5201,189043,1966
2022-01-07,Santa Cruz,087,273765,28612,24678,1425,26103,230
2022-01-07,Shasta,089,179085,24519,23585,4059,27644,445
2022-01-07,Sierra,091,2930,232,215,25,240,0
2022-01-07,Siskiyou,093,43540,3677,3545,1583,5128,62
2022-01-07,Solano,095,438530,58306,52452,2651,55103,383
2022-01-07,Sonoma,097,501317,57183,50130,1267,51397,411
2022-01-07,Stanislaus,099,539301,91777,87049,10842,97891,1372
2022-01-07,Sutter,101,95872,15993,15261,575,15836,195
2022-01-07,Tehama,103,63373,9586,9109,1751,10860,140
2022-01-07,Trinity,105,12862,952,836,231,1067,19
2022-01-07,Tulare,107,460477,78125,73600,18472,92072,1185
2022-01-07,Tuolumne,109,53932,8961,8360,155,8515,91
2022-01-07,Ventura,111,848112,134214,117229,7102,124331,1216
2022-01-07,Yolo,113,214977,26990,24006,1708,25714,270
2022-01-07,Yuba,115,75493,12010,11277,530,11807,101
2022-01-06,Alameda,001,1643700,170019,148560,6179,154739,1558
2022-01-06,Alpine,003,1148,114,114,0,114,0
2022-01-06,Amador,005,37829,6353,6091,111,6202,71
2022-01-06,Butte,007,227075,24942,23429,4695,28124,347
2022-01-06,Calaveras,009,45235,5128,4823,92,4915,93
2022-01-06,Colusa,011,21464,2777,2713,777,3490,21
2022-01-06,Contra Costa,013,1133247,134270,119907,5316,125223,1077
2022-01-06,Del Norte,015,27424,4010,3902,74,3976,43
2022-01-06,El Dorado,017,186661,20332,18599,2126,20725,172
2022-01-06,Fresno,019,978130,164464,155394,15045,170439,2393
2022-01-06,Glenn,021,27897,3876,3732,1162,4894,39
2022-01-06,Humboldt,023,135768,12140,11149,1136,12285,121
2022-01-06,Imperial,025,180216,41695,39429,5526,44955,800
2022-01-06,Inyo,027,18085,3261,3020,71,3091,49
2022-01-06,Kern,029,883053,148952,140410,29521,169931,1921
2022-01-06,Kings,031,150075,36819,35275,2272,37547,390
2022-01-06,Lake,033,64148,7571,7209,268,7477,117
2022-01-06,Lassen,035,31185,7245,7127,453,7580,55
2022-01-06,Los Angeles,037,10098052,2002980,1765787,85395,1851182,27476
2022-01-06,Madera,039,155013,26914,25767,2782,28549,328
2022-01-06,Marin,041,260295,24615,22377,1234,23611,251
2022-01-06,Mariposa,043,17540,1743,1588,69,1657,6
2022-01-06,Mendocino,045,87422,9393,8792,872,9664,101
2022-01-06,Merced,047,269075,48315,46094,2811,48905,703
2022-01-06,Modoc,049,8938,627,610,213,823,6
2022-01-06,Mono,051,14174,2450,2240,59,2299,4
2022-01-06,Monterey,053,433212,56901,51721,4904,56625,644
2022-01-06,Napa,055,140530,17876,15819,389,16208,109
2022-01-06,Nevada,057,99092,11610,10765,461,11226,110
2022-01-06,Orange,059,3164182,420183,375124,28671,403795,5903
2022-01-06,Placer,061,380077,46795,43172,4960,48132,495
2022-01-06,Plumas,063,18699,2165,2053,64,2117,12
2022-01-06,Riverside,065,2383286,458302,422591,20671,443262,5535
2022-01-06,Sacramento,067,1510023,204125,185118,9767,194885,2470
2022-01-06,San Benito,069,59416,9574,9016,251,9267,83
2022-01-06,San Bernardino,071,2135413,453997,411724,16235,427959,6122
2022-01-06,San Diego,073,3302833,540188,472273,32933,505206,4495
2022-01-06,San Francisco,075,870044,85829,73660,4231,77891,690
2022-01-06,San Joaquin,077,732212,121737,112514,6728,119242,1916
2022-01-06,San Luis Obispo,079,281455,37600,34489,1946,36435,369
2022-01-06,San Mateo,081,765935,81591,67918,2674,70592,582
2022-01-06,Santa Barbara,083,443738,59464,54617,2189,56806,575
2022-01-06,Santa Clara,085,1922200,208616,183842,4810,188652,1966
2022-01-06,Santa Cruz,087,273765,28051,24678,1401,26079,230
2022-01-06,Shasta,089,179085,24371,23585,4009,27594,445
2022-01-06,Sierra,091,2930,229,215,25,240,0
2022-01-06,Siskiyou,093,43540,3661,3545,1537,5082,62
2022-01-06,Solano,095,438530,57292,52452,2466,54918,383
2022-01-06,Sonoma,097,501317,55790,50130,1234,51364,411
2022-01-06,Stanislaus,099,539301,90626,87049,10671,97720,1372
2022-01-06,Sutter,101,95872,15816,15261,547,15808,195
2022-01-06,Tehama,103,63373,9508,9109,1724,10833,140
2022-01-06,Trinity,105,12862,945,836,230,1066,19
2022-01-06,Tulare,107,460477,77419,73600,18304,91904,1185
2022-01-06,Tuolumne,109,53932,8849,8360,149,8509,91
2022-01-06,Ventura,111,848112,131530,117229,6942,124171,1216
2022-01-06,Yolo,113,214977,26435,24006,1664,25670,270
2022-01-06,Yuba,115,75493,11875,11277,513,11790,101
2022-01-05,Alameda,001,1643700,164912,144824,5754,150578,1548
2022-01-05,Alpine,003,1148,114,112,0,112,0
2022-01-05,Amador,005,37829,6310,6012,108,6120,70
2022-01-05,Butte,007,227075,24628,23134,4633,27767,343
2022-01-05,Calaveras,009,45235,5073,4758,90,4848,90
2022-01-05,Colusa,011,21464,2763,2704,766,3470,21
2022-01-05,Contra Costa,013,1133247,130996,117188,4862,122050,1071
2022-01-05,Del Norte,015,27424,3990,3862,72,3934,43
2022-01-05,El Dorado,017,186661,19937,18367,2096,20463,171
2022-01-05,Fresno,019,978130,162304,153033,14751,167784,2377
2022-01-05,Glenn,021,27897,3827,3700,1152,4852,39
2022-01-05,Humboldt,023,135768,11936,10938,1088,12026,120
2022-01-05,Imperial,025,180216,41069,38789,5374,44163,800
2022-01-05,Inyo,027,18085,3179,2939,67,3006,49
2022-01-05,Kern,029,883053,147169,138186,28951,167137,1913
2022-01-05,Kings,031,150075,36475,34893,2253,37146,387
2022-01-05,Lake,033,64148,7488,7129,252,7381,117
2022-01-05,Lassen,035,31185,7225,7077,445,7522,55
2022-01-05,Los Angeles,037,10098052,1946653,1729640,83018,1812658,27443
2022-01-05,Madera,039,155013,26674,25392,2689,28081,327
2022-01-05,Marin,041,260295,24268,21829,1185,23014,251
2022-01-05,Mariposa,043,17540,1717,1564,68,1632,6
2022-01-05,Mendocino,045,87422,9262,8625,837,9462,101
2022-01-05,Merced,047,269075,47644,45721,2675,48396,700
2022-01-05,Modoc,049,8938,624,603,213,816,6
2022-01-05,Mono,051,14174,2431,2201,55,2256,4
2022-01-05,Monterey,053,433212,56077,51241,4707,55948,639
2022-01-05,Napa,055,140530,17514,15494,359,15853,108
2022-01-05,Nevada,057,99092,11414,10624,444,11068,110
2022-01-05,Orange,059,3164182,410137,366139,27602,393741,5869
2022-01-05,Placer,061,380077,45911,42456,4867,47323,492
2022-01-05,Plumas,063,18699,2145,2020,62,2082,12
2022-01-05,Riverside,065,2383286,450854,415253,20320,435573,5502
2022-01-05,Sacramento,067,1510023,199349,181488,8818,190306,2455
2022-01-05,San Benito,069,59416,9379,8829,238,9067,83
2022-01-05,San Bernardino,071,2135413,445235,405323,15676,420999,6085
2022-01-05,San Diego,073,3302833,526608,466602,31952,498554,4495
2022-01-05,San Francisco,075,870044,83251,71405,4093,75498,686
2022-01-05,San Joaquin,077,732212,119200,110497,6649,117146,1903
2022-01-05,San Luis Obispo,079,281455,36803,34066,1869,35935,369
2022-01-05,San Mateo,081,765935,79403,66018,2476,68494,578
2022-01-05,Santa Barbara,083,443738,58157,53082,2110,55192,570
2022-01-05,Santa Clara,085,1922200,202647,178629,4396,183025,1961
2022-01-05,Santa Cruz,087,273765,27296,24394,1380,25774,229
2022-01-05,Shasta,089,179085,24215,23361,3980,27341,441
2022-01-05,Sierra,091,2930,226,210,23,233,0
2022-01-05,Siskiyou,093,43540,3651,3513,1508,5021,60
2022-01-05,Solano,095,438530,56246,51505,2331,53836,380
2022-01-05,Sonoma,097,501317,54525,49120,1077,50197,412
2022-01-05,Stanislaus,099,539301,89634,86248,10498,96746,1360
2022-01-05,Sutter,101,95872,15615,15117,508,15625,193
2022-01-05,Tehama,103,63373,9411,9011,1693,10704,140
2022-01-05,Trinity,105,12862,941,822,228,1050,19
2022-01-05,Tulare,107,460477,76640,72718,18132,90850,1173
2022-01-05,Tuolumne,109,53932,8757,8223,142,8365,90
2022-01-05,Ventura,111,848112,128782,114752,6734,121486,1211
2022-01-05,Yolo,113,214977,25826,23401,1623,25024,269
2022-01-05,Yuba,115,75493,11693,11138,487,11625,100
2022-01-04,Alameda,001,1643700,159288,143360,5350,148710,1532
2022-01-04,Alpine,003,1148,114,113,0,113,0
2022-01-04,Amador,005,37829,6243,6025,102,6127,71
2022-01-04,Butte,007,227075,24329,23094,4561,27655,346
2022-01-04,Calaveras,009,45235,4999,4767,87,4854,93
2022-01-04,Colusa,011,21464,2746,2689,760,3449,21
2022-01-04,Contra Costa,013,1133247,127646,116005,4493,120498,1075
2022-01-04,Del Norte,015,27424,3958,3882,69,3951,43
2022-01-04,El Dorado,017,186661,19583,18339,2075,20414,172
2022-01-04,Fresno,019,978130,160004,153244,14488,167732,2380
2022-01-04,Glenn,021,27897,3798,3705,1137,4842,39
2022-01-04,Humboldt,023,135768,11690,10865,1038,11903,120
2022-01-04,Imperial,025,180216,40470,38596,5113,43709,800
2022-01-04,Inyo,027,18085,3096,2870,66,2936,49
2022-01-04,Kern,029,883053,145240,138245,28371,166616,1916
2022-01-04,Kings,031,150075,36151,34931,2236,37167,388
2022-01-04,Lake,033,64148,7447,7152,243,7395,117
2022-01-04,Lassen,035,31185,7202,7111,441,7552,55
2022-01-04,Los Angeles,037,10098052,1886694,1705253,80658,1785911,27419
2022-01-04,Madera,039,155013,26330,25425,2618,28043,328
2022-01-04,Marin,041,260295,23788,21675,1126,22801,251
2022-01-04,Mariposa,043,17540,1681,1564,67,1631,6
2022-01-04,Mendocino,045,87422,9139,8636,813,9449,101
2022-01-04,Merced,047,269075,47024,45583,2545,48128,700
2022-01-04,Modoc,049,8938,621,611,213,824,6
2022-01-04,Mono,051,14174,2382,2190,45,2235,4
2022-01-04,Monterey,053,433212,55345,51176,4482,55658,643
2022-01-04,Napa,055,140530,17010,15370,329,15699,107
2022-01-04,Nevada,057,99092,11256,10608,431,11039,110
2022-01-04,Orange,059,3164182,399375,362051,26439,388490,5897
2022-01-04,Placer,061,380077,45072,42285,4751,47036,494
2022-01-04,Plumas,063,18699,2119,2014,60,2074,12
2022-01-04,Riverside,065,2383286,442332,413366,19972,433338,5504
2022-01-04,Sacramento,067,1510023,194351,181271,8095,189366,2453
2022-01-04,San Benito,069,59416,9191,8763,230,8993,79
2022-01-04,San Bernardino,071,2135413,436039,404409,15137,419546,6060
2022-01-04,San Diego,073,3302833,510272,458499,30986,489485,4487
2022-01-04,San Francisco,075,870044,80398,70666,3949,74615,688
2022-01-04,San Joaquin,077,732212,116778,110374,6496,116870,1911
2022-01-04,San Luis Obispo,079,281455,35996,33788,1782,35570,371
2022-01-04,San Mateo,081,765935,77089,65157,2288,67445,582
2022-01-04,Santa Barbara,083,443738,56632,52449,2033,54482,574
2022-01-04,Santa Clara,085,1922200,196408,176854,3932,180786,1964
2022-01-04,Santa Cruz,087,273765,26535,23904,1345,25249,228
2022-01-04,Shasta,089,179085,24070,23366,3926,27292,442
2022-01-04,Sierra,091,2930,225,214,22,236,0
2022-01-04,Siskiyou,093,43540,3636,3509,1489,4998,61
2022-01-04,Solano,095,438530,54936,51300,2134,53434,383
2022-01-04,Sonoma,097,501317,52818,48653,957,49610,410
2022-01-04,Stanislaus,099,539301,88574,86107,10328,96435,1361
2022-01-04,Sutter,101,95872,15462,15032,484,15516,193
2022-01-04,Tehama,103,63373,9333,9020,1671,10691,140
2022-01-04,Trinity,105,12862,936,833,224,1057,18
2022-01-04,Tulare,107,460477,75854,72893,17934,90827,1172
2022-01-04,Tuolumne,109,53932,8645,8235,137,8372,91
2022-01-04,Ventura,111,848112,125724,114079,6504,120583,1213
2022-01-04,Yolo,113,214977,25181,22938,1578,24516,270
2022-01-04,Yuba,115,75493,11513,11104,471,11575,101
2022-01-03,Alameda,001,1643700,153160,142090,4913,147003,1529
2022-01-03,Alpine,003,1148,113,113,0,113,0
2022-01-03,Amador,005,37829,6181,6004,97,6101,71
2022-01-03,Butte,007,227075,24029,22924,4504,27428,345
2022-01-03,Calaveras,009,45235,4938,4742,81,4823,93
2022-01-03,Colusa,011,21464,2736,2683,753,3436,21
2022-01-03,Contra Costa,013,1133247,124205,114966,3904,118870,1073
2022-01-03,Del Norte,015,27424,3938,3873,65,3938,43
2022-01-03,El Dorado,017,186661,19194,18183,2046,20229,172
2022-01-03,Fresno,019,978130,157876,152674,14278,166952,2379
2022-01-03,Glenn,021,27897,3769,3703,1102,4805,39
2022-01-03,Humboldt,023,135768,11480,10784,990,11774,119
2022-01-03,Imperial,025,180216,39839,38411,4937,43348,800
2022-01-03,Inyo,027,18085,3027,2845,62,2907,49
2022-01-03,Kern,029,883053,143244,137773,27774,165547,1916
2022-01-03,Kings,031,150075,35828,34817,2207,37024,387
2022-01-03,Lake,033,64148,7345,7134,225,7359,117
2022-01-03,Lassen,035,31185,7184,7103,438,7541,55
2022-01-03,Los Angeles,037,10098052,1825845,1686203,77909,1764112,27394
2022-01-03,Madera,039,155013,26037,25323,2574,27897,320
2022-01-03,Marin,041,260295,23194,21532,1087,22619,251
2022-01-03,Mariposa,043,17540,1639,1559,67,1626,6
2022-01-03,Mendocino,045,87422,8990,8573,763,9336,101
2022-01-03,Merced,047,269075,46421,45459,2433,47892,696
2022-01-03,Modoc,049,8938,618,602,213,815,6
2022-01-03,Mono,051,14174,2304,2172,40,2212,4
2022-01-03,Monterey,053,433212,54517,51047,4276,55323,644
2022-01-03,Napa,055,140530,16501,15260,297,15557,107
2022-01-03,Nevada,057,99092,11092,10572,422,10994,110
2022-01-03,Orange,059,3164182,388193,358052,25210,383262,5894
2022-01-03,Placer,061,380077,44248,42054,4690,46744,489
2022-01-03,Plumas,063,18699,2099,2005,60,2065,12
2022-01-03,Riverside,065,2383286,433857,410155,19477,429632,5504
2022-01-03,Sacramento,067,1510023,189185,179992,7540,187532,2452
2022-01-03,San Benito,069,59416,9029,8688,223,8911,79
2022-01-03,San Bernardino,071,2135413,427096,401938,14667,416605,6056
2022-01-03,San Diego,073,3302833,494180,451154,30025,481179,4476
2022-01-03,San Francisco,075,870044,77591,69315,3699,73014,686
2022-01-03,San Joaquin,077,732212,114459,109757,6371,116128,1903
2022-01-03,San Luis Obispo,079,281455,35186,33667,1689,35356,367
2022-01-03,San Mateo,081,765935,74372,64470,2131,66601,582
2022-01-03,Santa Barbara,083,443738,55170,51912,1939,53851,571
2022-01-03,Santa Clara,085,1922200,190306,174215,3458,177673,1963
2022-01-03,Santa Cruz,087,273765,25727,23765,1313,25078,228
2022-01-03,Shasta,089,179085,23893,23301,3899,27200,440
2022-01-03,Sierra,091,2930,218,213,21,234,0
2022-01-03,Siskiyou,093,43540,3609,3500,1467,4967,61
2022-01-03,Solano,095,438530,53636,51030,1948,52978,380
2022-01-03,Sonoma,097,501317,51122,48391,861,49252,410
2022-01-03,Stanislaus,099,539301,87578,85793,10138,95931,1332
2022-01-03,Sutter,101,95872,15305,14973,464,15437,193
2022-01-03,Tehama,103,63373,9259,9005,1645,10650,140
2022-01-03,Trinity,105,12862,931,833,223,1056,18
2022-01-03,Tulare,107,460477,75159,72664,17730,90394,1167
2022-01-03,Tuolumne,109,53932,8509,8179,133,8312,91
2022-01-03,Ventura,111,848112,122556,112762,6265,119027,1211
2022-01-03,Yolo,113,214977,24502,22563,1514,24077,270
2022-01-03,Yuba,115,75493,11380,11037,452,11489,99
2022-01-02,Alameda,001,1643700,148592,133486,4421,137907,1528
2022-01-02,Alpine,003,1148,111,113,0,113,0
2022-01-02,Amador,005,37829,6113,5913,92,6005,70
2022-01-02,Butte,007,227075,23689,22469,4442,26911,341
2022-01-02,Calaveras,009,45235,4867,4668,73,4741,93
2022-01-02,Colusa,011,21464,2729,2659,742,3401,21
2022-01-02,Contra Costa,013,1133247,120620,109593,3467,113060,1073
2022-01-02,Del Norte,015,27424,3906,3841,63,3904,43
2022-01-02,El Dorado,017,186661,18859,17621,1995,19616,172
2022-01-02,Fresno,019,978130,156061,149927,14043,163970,2379
2022-01-02,Glenn,021,27897,3750,3663,1093,4756,39
2022-01-02,Humboldt,023,135768,11238,10381,914,11295,119
2022-01-02,Imperial,025,180216,39184,37672,4728,42400,800
2022-01-02,Inyo,027,18085,2957,2726,51,2777,49
2022-01-02,Kern,029,883053,141326,136123,27176,163299,1917
2022-01-02,Kings,031,150075,35505,34318,2172,36490,386
2022-01-02,Lake,033,64148,7274,7060,211,7271,117
2022-01-02,Lassen,035,31185,7168,7089,436,7525,55
2022-01-02,Los Angeles,037,10098052,1774658,1596123,75008,1671131,27371
2022-01-02,Madera,039,155013,25786,25002,2521,27523,320
2022-01-02,Marin,041,260295,22629,20475,1016,21491,249
2022-01-02,Mariposa,043,17540,1608,1509,65,1574,6
2022-01-02,Mendocino,045,87422,8866,8422,745,9167,101
2022-01-02,Merced,047,269075,45878,44769,2333,47102,694
2022-01-02,Modoc,049,8938,616,601,212,813,6
2022-01-02,Mono,051,14174,2275,2101,35,2136,4
2022-01-02,Monterey,053,433212,53890,50251,4066,54317,643
2022-01-02,Napa,055,140530,15961,14439,286,14725,107
2022-01-02,Nevada,057,99092,10904,10299,407,10706,110
2022-01-02,Orange,059,3164182,377165,339526,24051,363577,5890
2022-01-02,Placer,061,380077,43522,40857,4603,45460,489
2022-01-02,Plumas,063,18699,2083,1994,56,2050,12
2022-01-02,Riverside,065,2383286,425517,397124,18960,416084,5501
2022-01-02,Sacramento,067,1510023,185106,173562,6708,180270,2448
2022-01-02,San Benito,069,59416,8848,8320,208,8528,79
2022-01-02,San Bernardino,071,2135413,418947,386278,14110,400388,6051
2022-01-02,San Diego,073,3302833,479155,427087,28846,455933,4469
2022-01-02,San Francisco,075,870044,74642,64498,3458,67956,682
2022-01-02,San Joaquin,077,732212,112571,106640,6229,112869,1902
2022-01-02,San Luis Obispo,079,281455,34450,32342,1606,33948,365
2022-01-02,San Mateo,081,765935,71804,60504,1891,62395,581
2022-01-02,Santa Barbara,083,443738,53735,49555,1878,51433,568
2022-01-02,Santa Clara,085,1922200,184079,164547,3058,167605,1969
2022-01-02,Santa Cruz,087,273765,25058,22980,1280,24260,228
2022-01-02,Shasta,089,179085,23701,23161,3850,27011,435
2022-01-02,Sierra,091,2930,217,206,21,227,0
2022-01-02,Siskiyou,093,43540,3584,3474,1444,4918,61
2022-01-02,Solano,095,438530,52690,48957,1784,50741,379
2022-01-02,Sonoma,097,501317,49803,46040,824,46864,410
2022-01-02,Stanislaus,099,539301,86722,84367,10001,94368,1332
2022-01-02,Sutter,101,95872,15132,14741,445,15186,193
2022-01-02,Tehama,103,63373,9194,8944,1622,10566,139
2022-01-02,Trinity,105,12862,929,832,222,1054,17
2022-01-02,Tulare,107,460477,74497,71941,17536,89477,1160
2022-01-02,Tuolumne,109,53932,8403,8044,128,8172,91
2022-01-02,Ventura,111,848112,119634,107992,6044,114036,1211
2022-01-02,Yolo,113,214977,23828,21747,1448,23195,270
2022-01-02,Yuba,115,75493,11256,10844,436,11280,99
2022-01-01,Alameda,001,1643700,146709,133486,4161,137647,1528
2022-01-01,Alpine,003,1148,111,113,0,113,0
2022-01-01,Amador,005,37829,6077,5913,87,6000,70
2022-01-01,Butte,007,227075,23494,22469,4404,26873,341
2022-01-01,Calaveras,009,45235,4828,4668,71,4739,93
2022-01-01,Colusa,011,21464,2725,2659,732,3391,21
2022-01-01,Contra Costa,013,1133247,119249,109593,3339,112932,1073
2022-01-01,Del Norte,015,27424,3901,3841,63,3904,43
2022-01-01,El Dorado,017,186661,18707,17621,1980,19601,172
2022-01-01,Fresno,019,978130,155371,149927,13961,163888,2379
2022-01-01,Glenn,021,27897,3743,3663,1093,4756,39
2022-01-01,Humboldt,023,135768,11099,10381,893,11274,119
2022-01-01,Imperial,025,180216,39035,37672,4679,42351,800
2022-01-01,Inyo,027,18085,2928,2726,49,2775,49
2022-01-01,Kern,029,883053,140626,136123,26871,162994,1917
2022-01-01,Kings,031,150075,35362,34318,2145,36463,386
2022-01-01,Lake,033,64148,7236,7060,206,7266,117
2022-01-01,Lassen,035,31185,7162,7089,431,7520,55
2022-01-01,Los Angeles,037,10098052,1754515,1596123,73054,1669177,27371
2022-01-01,Madera,039,155013,25702,25002,2507,27509,320
2022-01-01,Marin,041,260295,22317,20475,975,21450,249
2022-01-01,Mariposa,043,17540,1597,1509,65,1574,6
2022-01-01,Mendocino,045,87422,8774,8422,739,9161,101
2022-01-01,Merced,047,269075,45745,44769,2319,47088,694
2022-01-01,Modoc,049,8938,613,601,212,813,6
2022-01-01,Mono,051,14174,2251,2101,30,2131,4
2022-01-01,Monterey,053,433212,53581,50251,3979,54230,643
2022-01-01,Napa,055,140530,15811,14439,271,14710,107
2022-01-01,Nevada,057,99092,10828,10299,400,10699,110
2022-01-01,Orange,059,3164182,372941,339526,23341,362867,5890
2022-01-01,Placer,061,380077,43219,40857,4537,45394,489
2022-01-01,Plumas,063,18699,2071,1994,56,2050,12
2022-01-01,Riverside,065,2383286,422023,397124,18758,415882,5501
2022-01-01,Sacramento,067,1510023,183834,173562,6453,180015,2448
2022-01-01,San Benito,069,59416,8757,8320,208,8528,79
2022-01-01,San Bernardino,071,2135413,415681,386278,13830,400108,6051
2022-01-01,San Diego,073,3302833,473202,427087,28327,455414,4469
2022-01-01,San Francisco,075,870044,73240,64498,3248,67746,682
2022-01-01,San Joaquin,077,732212,111864,106640,6156,112796,1902
2022-01-01,San Luis Obispo,079,281455,34246,32342,1597,33939,365
2022-01-01,San Mateo,081,765935,70339,60504,1742,62246,581
2022-01-01,Santa Barbara,083,443738,52995,49555,1842,51397,568
2022-01-01,Santa Clara,085,1922200,181011,164547,2862,167409,1969
2022-01-01,Santa Cruz,087,273765,24737,22980,1262,24242,228
2022-01-01,Shasta,089,179085,23615,23161,3832,26993,435
2022-01-01,Sierra,091,2930,216,206,21,227,0
2022-01-01,Siskiyou,093,43540,3581,3474,1434,4908,61
2022-01-01,Solano,095,438530,52422,48957,1725,50682,379
2022-01-01,Sonoma,097,501317,49409,46040,794,46834,410
2022-01-01,Stanislaus,099,539301,86315,84367,9914,94281,1332
2022-01-01,Sutter,101,95872,15055,14741,443,15184,193
2022-01-01,Tehama,103,63373,9161,8944,1610,10554,139
2022-01-01,Trinity,105,12862,926,832,222,1054,17
2022-01-01,Tulare,107,460477,74252,71941,17437,89378,1160
2022-01-01,Tuolumne,109,53932,8343,8044,125,8169,91
2022-01-01,Ventura,111,848112,118249,107992,5914,113906,1211
2022-01-01,Yolo,113,214977,23409,21747,1408,23155,270
2022-01-01,Yuba,115,75493,11190,10844,430,11274,99
2021-12-31,Alameda,001,1643700,145889,133486,4061,137547,1528
2021-12-31,Alpine,003,1148,111,113,0,113,0
2021-12-31,Amador,005,37829,6053,5913,86,5999,70
2021-12-31,Butte,007,227075,23387,22469,4369,26838,341
2021-12-31,Calaveras,009,45235,4795,4668,71,4739,93
2021-12-31,Colusa,011,21464,2716,2659,726,3385,21
2021-12-31,Contra Costa,013,1133247,118355,109593,3259,112852,1073
2021-12-31,Del Norte,015,27424,3892,3841,61,3902,43
2021-12-31,El Dorado,017,186661,18619,17621,1962,19583,172
2021-12-31,Fresno,019,978130,155057,149927,13939,163866,2379
2021-12-31,Glenn,021,27897,3742,3663,1091,4754,39
2021-12-31,Humboldt,023,135768,11012,10381,874,11255,119
2021-12-31,Imperial,025,180216,38903,37672,4663,42335,800
2021-12-31,Inyo,027,18085,2901,2726,48,2774,49
2021-12-31,Kern,029,883053,140118,136123,26734,162857,1917
2021-12-31,Kings,031,150075,35252,34318,2135,36453,386
2021-12-31,Lake,033,64148,7213,7060,201,7261,117
2021-12-31,Lassen,035,31185,7148,7089,431,7520,55
2021-12-31,Los Angeles,037,10098052,1743730,1596123,72302,1668425,27371
2021-12-31,Madera,039,155013,25633,25002,2490,27492,320
2021-12-31,Marin,041,260295,22161,20475,944,21419,249
2021-12-31,Mariposa,043,17540,1590,1509,64,1573,6
2021-12-31,Mendocino,045,87422,8741,8422,736,9158,101
2021-12-31,Merced,047,269075,45661,44769,2301,47070,694
2021-12-31,Modoc,049,8938,609,601,210,811,6
2021-12-31,Mono,051,14174,2239,2101,29,2130,4
2021-12-31,Monterey,053,433212,53454,50251,3913,54164,643
2021-12-31,Napa,055,140530,15700,14439,261,14700,107
2021-12-31,Nevada,057,99092,10761,10299,394,10693,110
2021-12-31,Orange,059,3164182,370425,339526,22914,362440,5890
2021-12-31,Placer,061,380077,42986,40857,4471,45328,489
2021-12-31,Plumas,063,18699,2066,1994,56,2050,12
2021-12-31,Riverside,065,2383286,420335,397124,18603,415727,5501
2021-12-31,Sacramento,067,1510023,182966,173562,6347,179909,2448
2021-12-31,San Benito,069,59416,8743,8320,207,8527,79
2021-12-31,San Bernardino,071,2135413,413366,386278,13639,399917,6051
2021-12-31,San Diego,073,3302833,469981,427087,28009,455096,4469
2021-12-31,San Francisco,075,870044,72314,64498,3190,67688,682
2021-12-31,San Joaquin,077,732212,111236,106640,6090,112730,1902
2021-12-31,San Luis Obispo,079,281455,34138,32342,1585,33927,365
2021-12-31,San Mateo,081,765935,69458,60504,1690,62194,581
2021-12-31,Santa Barbara,083,443738,52596,49555,1830,51385,568
2021-12-31,Santa Clara,085,1922200,179028,164547,2721,167268,1969
2021-12-31,Santa Cruz,087,273765,24500,22980,1241,24221,228
2021-12-31,Shasta,089,179085,23553,23161,3811,26972,435
2021-12-31,Sierra,091,2930,216,206,21,227,0
2021-12-31,Siskiyou,093,43540,3574,3474,1423,4897,61
2021-12-31,Solano,095,438530,52266,48957,1699,50656,379
2021-12-31,Sonoma,097,501317,49156,46040,781,46821,410
2021-12-31,Stanislaus,099,539301,85989,84367,9853,94220,1332
2021-12-31,Sutter,101,95872,14994,14741,437,15178,193
2021-12-31,Tehama,103,63373,9129,8944,1601,10545,139
2021-12-31,Trinity,105,12862,925,832,222,1054,17
2021-12-31,Tulare,107,460477,74049,71941,17353,89294,1160
2021-12-31,Tuolumne,109,53932,8298,8044,124,8168,91
2021-12-31,Ventura,111,848112,117275,107992,5832,113824,1211
2021-12-31,Yolo,113,214977,23188,21747,1386,23133,270
2021-12-31,Yuba,115,75493,11133,10844,424,11268,99
2021-12-30,Alameda,001,1643700,144585,133486,3926,137412,1528
2021-12-30,Alpine,003,1148,110,113,0,113,0
2021-12-30,Amador,005,37829,6034,5913,85,5998,70
2021-12-30,Butte,007,227075,23255,22469,4344,26813,341
2021-12-30,Calaveras,009,45235,4776,4668,71,4739,93
2021-12-30,Colusa,011,21464,2715,2659,724,3383,21
2021-12-30,Contra Costa,013,1133247,117259,109593,3148,112741,1073
2021-12-30,Del Norte,015,27424,3881,3841,60,3901,43
2021-12-30,El Dorado,017,186661,18515,17621,1941,19562,172
2021-12-30,Fresno,019,978130,154520,149927,13868,163795,2379
2021-12-30,Glenn,021,27897,3736,3663,1088,4751,39
2021-12-30,Humboldt,023,135768,10945,10381,862,11243,119
2021-12-30,Imperial,025,180216,38735,37672,4553,42225,800
2021-12-30,Inyo,027,18085,2882,2726,46,2772,49
2021-12-30,Kern,029,883053,139585,136123,26434,162557,1917
2021-12-30,Kings,031,150075,35134,34318,2120,36438,386
2021-12-30,Lake,033,64148,7198,7060,196,7256,117
2021-12-30,Lassen,035,31185,7142,7089,431,7520,55
2021-12-30,Los Angeles,037,10098052,1720419,1596123,71035,1667158,27371
2021-12-30,Madera,039,155013,25557,25002,2470,27472,320
2021-12-30,Marin,041,260295,21987,20475,919,21394,249
2021-12-30,Mariposa,043,17540,1584,1509,64,1573,6
2021-12-30,Mendocino,045,87422,8724,8422,725,9147,101
2021-12-30,Merced,047,269075,45559,44769,2286,47055,694
2021-12-30,Modoc,049,8938,608,601,210,811,6
2021-12-30,Mono,051,14174,2234,2101,28,2129,4
2021-12-30,Monterey,053,433212,53141,50251,3852,54103,643
2021-12-30,Napa,055,140530,15556,14439,252,14691,107
2021-12-30,Nevada,057,99092,10697,10299,385,10684,110
2021-12-30,Orange,059,3164182,365378,339526,22360,361886,5890
2021-12-30,Placer,061,380077,42710,40857,4424,45281,489
2021-12-30,Plumas,063,18699,2062,1994,55,2049,12
2021-12-30,Riverside,065,2383286,417067,397124,18451,415575,5501
2021-12-30,Sacramento,067,1510023,181712,173562,6202,179764,2448
2021-12-30,San Benito,069,59416,8696,8320,205,8525,79
2021-12-30,San Bernardino,071,2135413,410743,386278,13492,399770,6051
2021-12-30,San Diego,073,3302833,464834,427087,27498,454585,4469
2021-12-30,San Francisco,075,870044,71226,64498,3118,67616,682
2021-12-30,San Joaquin,077,732212,110640,106640,6046,112686,1902
2021-12-30,San Luis Obispo,079,281455,34019,32342,1572,33914,365
2021-12-30,San Mateo,081,765935,68415,60504,1561,62065,581
2021-12-30,Santa Barbara,083,443738,52118,49555,1811,51366,568
2021-12-30,Santa Clara,085,1922200,176700,164547,2598,167145,1969
2021-12-30,Santa Cruz,087,273765,24261,22980,1207,24187,228
2021-12-30,Shasta,089,179085,23500,23161,3805,26966,435
2021-12-30,Sierra,091,2930,216,206,21,227,0
2021-12-30,Siskiyou,093,43540,3565,3474,1421,4895,61
2021-12-30,Solano,095,438530,51917,48957,1652,50609,379
2021-12-30,Sonoma,097,501317,48821,46040,772,46812,410
2021-12-30,Stanislaus,099,539301,85672,84367,9793,94160,1332
2021-12-30,Sutter,101,95872,14932,14741,436,15177,193
2021-12-30,Tehama,103,63373,9102,8944,1595,10539,139
2021-12-30,Trinity,105,12862,922,832,222,1054,17
2021-12-30,Tulare,107,460477,73861,71941,17276,89217,1160
2021-12-30,Tuolumne,109,53932,8259,8044,124,8168,91
2021-12-30,Ventura,111,848112,116018,107992,5729,113721,1211
2021-12-30,Yolo,113,214977,23049,21747,1360,23107,270
2021-12-30,Yuba,115,75493,11086,10844,422,11266,99
2021-12-29,Alameda,001,1643700,141343,131586,3775,135361,1529
2021-12-29,Alpine,003,1148,110,113,0,113,0
2021-12-29,Amador,005,37829,6011,5905,82,5987,70
2021-12-29,Butte,007,227075,23112,22353,4306,26659,338
2021-12-29,Calaveras,009,45235,4749,4646,69,4715,93
2021-12-29,Colusa,011,21464,2705,2657,719,3376,21
2021-12-29,Contra Costa,013,1133247,115165,108165,3022,111187,1072
2021-12-29,Del Norte,015,27424,3867,3826,58,3884,43
2021-12-29,El Dorado,017,186661,18293,17489,1923,19412,172
2021-12-29,Fresno,019,978130,153386,149318,13753,163071,2364
2021-12-29,Glenn,021,27897,3726,3653,1085,4738,39
2021-12-29,Humboldt,023,135768,10835,10249,840,11089,119
2021-12-29,Imperial,025,180216,38498,37460,4485,41945,800
2021-12-29,Inyo,027,18085,2849,2703,46,2749,49
2021-12-29,Kern,029,883053,138782,135648,26049,161697,1913
2021-12-29,Kings,031,150075,35019,34216,2114,36330,386
2021-12-29,Lake,033,64148,7167,7048,194,7242,117
2021-12-29,Lassen,035,31185,7138,7085,430,7515,55
2021-12-29,Los Angeles,037,10098052,1690424,1576414,69314,1645728,27349
2021-12-29,Madera,039,155013,25453,24923,2459,27382,320
2021-12-29,Marin,041,260295,21632,20025,898,20923,249
2021-12-29,Mariposa,043,17540,1562,1507,64,1571,6
2021-12-29,Mendocino,045,87422,8665,8386,721,9107,99
2021-12-29,Merced,047,269075,45343,44548,2271,46819,693
2021-12-29,Modoc,049,8938,605,600,210,810,6
2021-12-29,Mono,051,14174,2210,2056,27,2083,4
2021-12-29,Monterey,053,433212,52732,50097,3746,53843,641
2021-12-29,Napa,055,140530,15233,14247,234,14481,107
2021-12-29,Nevada,057,99092,10606,10274,384,10658,110
2021-12-29,Orange,059,3164182,357884,334557,21679,356236,5887
2021-12-29,Placer,061,380077,42222,40545,4349,44894,489
2021-12-29,Plumas,063,18699,2050,1990,55,2045,12
2021-12-29,Riverside,065,2383286,411648,392989,18244,411233,5486
2021-12-29,Sacramento,067,1510023,179380,172145,6044,178189,2437
2021-12-29,San Benito,069,59416,8553,8239,204,8443,79
2021-12-29,San Bernardino,071,2135413,405155,382872,13276,396148,6049
2021-12-29,San Diego,073,3302833,454004,421045,26780,447825,4461
2021-12-29,San Francisco,075,870044,69530,63117,3048,66165,684
2021-12-29,San Joaquin,077,732212,109457,106063,5975,112038,1891
2021-12-29,San Luis Obispo,079,281455,33624,31936,1523,33459,365
2021-12-29,San Mateo,081,765935,66788,59478,1453,60931,581
2021-12-29,Santa Barbara,083,443738,51279,49003,1786,50789,568
2021-12-29,Santa Clara,085,1922200,173498,162008,2467,164475,1962
2021-12-29,Santa Cruz,087,273765,23982,22669,1175,23844,228
2021-12-29,Shasta,089,179085,23425,23083,3793,26876,435
2021-12-29,Sierra,091,2930,215,206,21,227,0
2021-12-29,Siskiyou,093,43540,3553,3472,1410,4882,61
2021-12-29,Solano,095,438530,51212,48562,1599,50161,379
2021-12-29,Sonoma,097,501317,48019,45479,750,46229,410
2021-12-29,Stanislaus,099,539301,85184,84083,9733,93816,1332
2021-12-29,Sutter,101,95872,14863,14688,434,15122,193
2021-12-29,Tehama,103,63373,9077,8914,1583,10497,138
2021-12-29,Trinity,105,12862,919,832,222,1054,17
2021-12-29,Tulare,107,460477,73572,71752,17158,88910,1160
2021-12-29,Tuolumne,109,53932,8206,8012,123,8135,91
2021-12-29,Ventura,111,848112,114081,106974,5551,112525,1207
2021-12-29,Yolo,113,214977,22810,21564,1329,22893,270
2021-12-29,Yuba,115,75493,11025,10808,418,11226,99
2021-12-28,Alameda,001,1643700,138177,130427,3622,134049,1522
2021-12-28,Alpine,003,1148,110,113,0,113,0
2021-12-28,Amador,005,37829,5991,5900,81,5981,70
2021-12-28,Butte,007,227075,22968,22285,4289,26574,338
2021-12-28,Calaveras,009,45235,4731,4641,68,4709,91
2021-12-28,Colusa,011,21464,2699,2653,717,3370,21
2021-12-28,Contra Costa,013,1133247,112863,107160,2907,110067,1072
2021-12-28,Del Norte,015,27424,3861,3815,58,3873,43
2021-12-28,El Dorado,017,186661,18070,17419,1913,19332,172
2021-12-28,Fresno,019,978130,152300,148987,13673,162660,2365
2021-12-28,Glenn,021,27897,3701,3639,1081,4720,39
2021-12-28,Humboldt,023,135768,10714,10198,816,11014,119
2021-12-28,Imperial,025,180216,38203,37223,4385,41608,800
2021-12-28,Inyo,027,18085,2791,2676,45,2721,48
2021-12-28,Kern,029,883053,138061,135346,25700,161046,1909
2021-12-28,Kings,031,150075,34883,34165,2099,36264,386
2021-12-28,Lake,033,64148,7148,7044,189,7233,116
2021-12-28,Lassen,035,31185,7129,7083,430,7513,55
2021-12-28,Los Angeles,037,10098052,1658156,1561791,67669,1629460,27323
2021-12-28,Madera,039,155013,25327,24865,2439,27304,320
2021-12-28,Marin,041,260295,21220,19739,868,20607,249
2021-12-28,Mariposa,043,17540,1551,1499,63,1562,6
2021-12-28,Mendocino,045,87422,8605,8366,713,9079,98
2021-12-28,Merced,047,269075,45103,44434,2259,46693,691
2021-12-28,Modoc,049,8938,605,599,209,808,6
2021-12-28,Mono,051,14174,2187,2045,25,2070,4
2021-12-28,Monterey,053,433212,52355,49973,3673,53646,639
2021-12-28,Napa,055,140530,14915,14131,207,14338,107
2021-12-28,Nevada,057,99092,10515,10250,381,10631,110
2021-12-28,Orange,059,3164182,350228,331279,20942,352221,5882
2021-12-28,Placer,061,380077,41753,40410,4279,44689,489
2021-12-28,Plumas,063,18699,2047,1989,55,2044,12
2021-12-28,Riverside,065,2383286,406408,390343,18001,408344,5470
2021-12-28,Sacramento,067,1510023,177093,171290,5915,177205,2426
2021-12-28,San Benito,069,59416,8409,8170,202,8372,79
2021-12-28,San Bernardino,071,2135413,399259,381316,13055,394371,6047
2021-12-28,San Diego,073,3302833,443312,417383,26224,443607,4450
2021-12-28,San Francisco,075,870044,67909,61745,2990,64735,682
2021-12-28,San Joaquin,077,732212,108403,105572,5931,111503,1884
2021-12-28,San Luis Obispo,079,281455,33158,31759,1507,33266,365
2021-12-28,San Mateo,081,765935,65274,58712,1365,60077,582
2021-12-28,Santa Barbara,083,443738,50634,48493,1766,50259,568
2021-12-28,Santa Clara,085,1922200,170294,160811,2372,163183,1962
2021-12-28,Santa Cruz,087,273765,23609,22513,1137,23650,228
2021-12-28,Shasta,089,179085,23354,23035,3788,26823,434
2021-12-28,Sierra,091,2930,212,206,21,227,0
2021-12-28,Siskiyou,093,43540,3544,3468,1405,4873,60
2021-12-28,Solano,095,438530,50298,48318,1545,49863,378
2021-12-28,Sonoma,097,501317,47161,45086,725,45811,410
2021-12-28,Stanislaus,099,539301,84700,83946,9672,93618,1331
2021-12-28,Sutter,101,95872,14814,14662,431,15093,193
2021-12-28,Tehama,103,63373,9059,8893,1581,10474,138
2021-12-28,Trinity,105,12862,917,831,221,1052,17
2021-12-28,Tulare,107,460477,73293,71630,17043,88673,1156
2021-12-28,Tuolumne,109,53932,8164,8006,123,8129,91
2021-12-28,Ventura,111,848112,111975,105883,5421,111304,1207
2021-12-28,Yolo,113,214977,22476,21320,1280,22600,270
2021-12-28,Yuba,115,75493,10969,10778,415,11193,99
2021-12-27,Alameda,001,1643700,135499,129910,3490,133400,1530
2021-12-27,Alpine,003,1148,110,113,0,113,0
2021-12-27,Amador,005,37829,5963,5891,81,5972,70
2021-12-27,Butte,007,227075,22830,22234,4262,26496,335
2021-12-27,Calaveras,009,45235,4706,4630,67,4697,91
2021-12-27,Colusa,011,21464,2688,2652,711,3363,21
2021-12-27,Contra Costa,013,1133247,110696,106692,2824,109516,1071
2021-12-27,Del Norte,015,27424,3852,3802,57,3859,43
2021-12-27,El Dorado,017,186661,17910,17361,1901,19262,172
2021-12-27,Fresno,019,978130,151338,148826,13591,162417,2364
2021-12-27,Glenn,021,27897,3693,3634,1075,4709,39
2021-12-27,Humboldt,023,135768,10600,10164,794,10958,119
2021-12-27,Imperial,025,180216,37962,37180,4291,41471,800
2021-12-27,Inyo,027,18085,2762,2662,43,2705,48
2021-12-27,Kern,029,883053,137411,135119,25397,160516,1907
2021-12-27,Kings,031,150075,34734,34126,2086,36212,382
2021-12-27,Lake,033,64148,7125,7037,179,7216,116
2021-12-27,Lassen,035,31185,7123,7080,430,7510,55
2021-12-27,Los Angeles,037,10098052,1621814,1554074,65916,1619990,27300
2021-12-27,Madera,039,155013,25208,24840,2420,27260,320
2021-12-27,Marin,041,260295,20831,19601,841,20442,249
2021-12-27,Mariposa,043,17540,1536,1495,63,1558,6
2021-12-27,Mendocino,045,87422,8538,8351,708,9059,98
2021-12-27,Merced,047,269075,44872,44383,2241,46624,690
2021-12-27,Modoc,049,8938,603,599,209,808,6
2021-12-27,Mono,051,14174,2124,2026,25,2051,4
2021-12-27,Monterey,053,433212,52055,49918,3622,53540,639
2021-12-27,Napa,055,140530,14646,14083,198,14281,107
2021-12-27,Nevada,057,99092,10446,10239,373,10612,110
2021-12-27,Orange,059,3164182,342737,329222,20137,349359,5875
2021-12-27,Placer,061,380077,41376,40263,4231,44494,489
2021-12-27,Plumas,063,18699,2045,1988,53,2041,12
2021-12-27,Riverside,065,2383286,401823,389096,17745,406841,5470
2021-12-27,Sacramento,067,1510023,175065,170858,5746,176604,2422
2021-12-27,San Benito,069,59416,8290,8133,198,8331,79
2021-12-27,San Bernardino,071,2135413,393274,380526,12854,393380,6047
2021-12-27,San Diego,073,3302833,433104,414968,25732,440700,4445
2021-12-27,San Francisco,075,870044,66158,60920,2925,63845,682
2021-12-27,San Joaquin,077,732212,107483,105413,5867,111280,1876
2021-12-27,San Luis Obispo,079,281455,32713,31671,1486,33157,365
2021-12-27,San Mateo,081,765935,63749,58397,1266,59663,581
2021-12-27,Santa Barbara,083,443738,49848,48209,1746,49955,568
2021-12-27,Santa Clara,085,1922200,167285,159904,2246,162150,1961
2021-12-27,Santa Cruz,087,273765,23322,22456,1119,23575,228
2021-12-27,Shasta,089,179085,23293,23015,3777,26792,432
2021-12-27,Sierra,091,2930,212,206,21,227,0
2021-12-27,Siskiyou,093,43540,3535,3466,1400,4866,60
2021-12-27,Solano,095,438530,49565,48172,1497,49669,378
2021-12-27,Sonoma,097,501317,46585,44990,707,45697,410
2021-12-27,Stanislaus,099,539301,84246,83833,9631,93464,1331
2021-12-27,Sutter,101,95872,14758,14642,426,15068,191
2021-12-27,Tehama,103,63373,9044,8887,1573,10460,136
2021-12-27,Trinity,105,12862,917,827,221,1048,17
2021-12-27,Tulare,107,460477,73027,71562,16948,88510,1146
2021-12-27,Tuolumne,109,53932,8126,7978,122,8100,91
2021-12-27,Ventura,111,848112,109890,105212,5286,110498,1206
2021-12-27,Yolo,113,214977,22185,21300,1246,22546,270
2021-12-27,Yuba,115,75493,10908,10759,414,11173,98
2021-12-26,Alameda,001,1643700,133382,127221,3418,130639,1525
2021-12-26,Alpine,003,1148,110,113,0,113,0
2021-12-26,Amador,005,37829,5947,5861,79,5940,70
2021-12-26,Butte,007,227075,22676,22087,4232,26319,330
2021-12-26,Calaveras,009,45235,4684,4591,67,4658,91
2021-12-26,Colusa,011,21464,2677,2647,705,3352,21
2021-12-26,Contra Costa,013,1133247,108934,105022,2725,107747,1071
2021-12-26,Del Norte,015,27424,3847,3795,57,3852,43
2021-12-26,El Dorado,017,186661,17756,17188,1893,19081,172
2021-12-26,Fresno,019,978130,150629,148027,13511,161538,2358
2021-12-26,Glenn,021,27897,3681,3611,1061,4672,39
2021-12-26,Humboldt,023,135768,10457,10052,771,10823,119
2021-12-26,Imperial,025,180216,37660,36878,4201,41079,800
2021-12-26,Inyo,027,18085,2738,2636,40,2676,47
2021-12-26,Kern,029,883053,136686,134591,25142,159733,1908
2021-12-26,Kings,031,150075,34581,34009,2080,36089,379
2021-12-26,Lake,033,64148,7103,7019,176,7195,116
2021-12-26,Lassen,035,31185,7117,7072,429,7501,55
2021-12-26,Los Angeles,037,10098052,1591930,1515469,64120,1579589,27257
2021-12-26,Madera,039,155013,25089,24741,2404,27145,320
2021-12-26,Marin,041,260295,20452,19085,782,19867,249
2021-12-26,Mariposa,043,17540,1530,1480,63,1543,6
2021-12-26,Mendocino,045,87422,8487,8314,706,9020,98
2021-12-26,Merced,047,269075,44620,44208,2227,46435,690
2021-12-26,Modoc,049,8938,602,597,207,804,6
2021-12-26,Mono,051,14174,2098,2000,25,2025,4
2021-12-26,Monterey,053,433212,51774,49709,3573,53282,638
2021-12-26,Napa,055,140530,14409,13809,193,14002,107
2021-12-26,Nevada,057,99092,10386,10153,366,10519,110
2021-12-26,Orange,059,3164182,336390,322991,19341,342332,5863
2021-12-26,Placer,061,380077,41026,39852,4161,44013,489
2021-12-26,Plumas,063,18699,2037,1987,52,2039,12
2021-12-26,Riverside,065,2383286,397638,384567,17576,402143,5470
2021-12-26,Sacramento,067,1510023,173339,169144,5600,174744,2418
2021-12-26,San Benito,069,59416,8201,7991,194,8185,79
2021-12-26,San Bernardino,071,2135413,388416,376052,12677,388729,6043
2021-12-26,San Diego,073,3302833,424110,406616,25238,431854,4442
2021-12-26,San Francisco,075,870044,64580,58229,2863,61092,682
2021-12-26,San Joaquin,077,732212,106672,104590,5814,110404,1872
2021-12-26,San Luis Obispo,079,281455,32266,31290,1468,32758,365
2021-12-26,San Mateo,081,765935,62346,56973,1219,58192,581
2021-12-26,Santa Barbara,083,443738,49171,47553,1716,49269,567
2021-12-26,Santa Clara,085,1922200,164568,156872,2112,158984,1967
2021-12-26,Santa Cruz,087,273765,23038,22176,1105,23281,228
2021-12-26,Shasta,089,179085,23211,22959,3765,26724,432
2021-12-26,Sierra,091,2930,212,202,21,223,0
2021-12-26,Siskiyou,093,43540,3527,3460,1391,4851,60
2021-12-26,Solano,095,438530,49063,47646,1459,49105,377
2021-12-26,Sonoma,097,501317,46089,44358,675,45033,408
2021-12-26,Stanislaus,099,539301,83872,83368,9589,92957,1331
2021-12-26,Sutter,101,95872,14693,14533,423,14956,191
2021-12-26,Tehama,103,63373,9011,8861,1569,10430,136
2021-12-26,Trinity,105,12862,917,826,220,1046,17
2021-12-26,Tulare,107,460477,72777,71292,16842,88134,1137
2021-12-26,Tuolumne,109,53932,8089,7919,122,8041,91
2021-12-26,Ventura,111,848112,108056,103498,5139,108637,1206
2021-12-26,Yolo,113,214977,21900,21084,1207,22291,270
2021-12-26,Yuba,115,75493,10857,10694,412,11106,98
2021-12-25,Alameda,001,1643700,132293,127221,3353,130574,1525
2021-12-25,Alpine,003,1148,110,113,0,113,0
2021-12-25,Amador,005,37829,5928,5861,79,5940,70
2021-12-25,Butte,007,227075,22578,22087,4215,26302,330
2021-12-25,Calaveras,009,45235,4655,4591,66,4657,91
2021-12-25,Colusa,011,21464,2672,2647,699,3346,21
2021-12-25,Contra Costa,013,1133247,108112,105022,2671,107693,1071
2021-12-25,Del Norte,015,27424,3840,3795,56,3851,43
2021-12-25,El Dorado,017,186661,17702,17188,1882,19070,172
2021-12-25,Fresno,019,978130,150313,148027,13463,161490,2358
2021-12-25,Glenn,021,27897,3670,3611,1057,4668,39
2021-12-25,Humboldt,023,135768,10375,10052,764,10816,119
2021-12-25,Imperial,025,180216,37538,36878,4179,41057,800
2021-12-25,Inyo,027,18085,2718,2636,40,2676,47
2021-12-25,Kern,029,883053,136339,134591,25016,159607,1908
2021-12-25,Kings,031,150075,34491,34009,2073,36082,379
2021-12-25,Lake,033,64148,7091,7019,174,7193,116
2021-12-25,Lassen,035,31185,7115,7072,429,7501,55
2021-12-25,Los Angeles,037,10098052,1579107,1515469,62778,1578247,27257
2021-12-25,Madera,039,155013,25039,24741,2398,27139,320
2021-12-25,Marin,041,260295,20110,19085,733,19818,249
2021-12-25,Mariposa,043,17540,1524,1480,63,1543,6
2021-12-25,Mendocino,045,87422,8449,8314,706,9020,98
2021-12-25,Merced,047,269075,44518,44208,2225,46433,690
2021-12-25,Modoc,049,8938,602,597,207,804,6
2021-12-25,Mono,051,14174,2081,2000,25,2025,4
2021-12-25,Monterey,053,433212,51607,49709,3538,53247,638
2021-12-25,Napa,055,140530,14294,13809,185,13994,107
2021-12-25,Nevada,057,99092,10357,10153,366,10519,110
2021-12-25,Orange,059,3164182,333510,322991,18770,341761,5863
2021-12-25,Placer,061,380077,40842,39852,4127,43979,489
2021-12-25,Plumas,063,18699,2035,1987,52,2039,12
2021-12-25,Riverside,065,2383286,395357,384567,17457,402024,5470
2021-12-25,Sacramento,067,1510023,172523,169144,5495,174639,2418
2021-12-25,San Benito,069,59416,8136,7991,194,8185,79
2021-12-25,San Bernardino,071,2135413,386179,376052,12544,388596,6043
2021-12-25,San Diego,073,3302833,420041,406616,24968,431584,4442
2021-12-25,San Francisco,075,870044,63549,58229,2827,61056,682
2021-12-25,San Joaquin,077,732212,106335,104590,5782,110372,1872
2021-12-25,San Luis Obispo,079,281455,32113,31290,1459,32749,365
2021-12-25,San Mateo,081,765935,61313,56973,1176,58149,581
2021-12-25,Santa Barbara,083,443738,48807,47553,1704,49257,567
2021-12-25,Santa Clara,085,1922200,163082,156872,2045,158917,1967
2021-12-25,Santa Cruz,087,273765,22878,22176,1099,23275,228
2021-12-25,Shasta,089,179085,23178,22959,3759,26718,432
2021-12-25,Sierra,091,2930,212,202,21,223,0
2021-12-25,Siskiyou,093,43540,3524,3460,1385,4845,60
2021-12-25,Solano,095,438530,48938,47646,1441,49087,377
2021-12-25,Sonoma,097,501317,45705,44358,649,45007,408
2021-12-25,Stanislaus,099,539301,83658,83368,9563,92931,1331
2021-12-25,Sutter,101,95872,14652,14533,421,14954,191
2021-12-25,Tehama,103,63373,8991,8861,1565,10426,136
2021-12-25,Trinity,105,12862,916,826,220,1046,17
2021-12-25,Tulare,107,460477,72643,71292,16764,88056,1137
2021-12-25,Tuolumne,109,53932,8058,7919,122,8041,91
2021-12-25,Ventura,111,848112,106883,103498,5033,108531,1206
2021-12-25,Yolo,113,214977,21790,21084,1186,22270,270
2021-12-25,Yuba,115,75493,10830,10694,411,11105,98
2021-12-24,Alameda,001,1643700,131668,127221,3336,130557,1525
2021-12-24,Alpine,003,1148,110,113,0,113,0
2021-12-24,Amador,005,37829,5920,5861,78,5939,70
2021-12-24,Butte,007,227075,22521,22087,4198,26285,330
2021-12-24,Calaveras,009,45235,4649,4591,66,4657,91
2021-12-24,Colusa,011,21464,2670,2647,698,3345,21
2021-12-24,Contra Costa,013,1133247,107794,105022,2638,107660,1071
2021-12-24,Del Norte,015,27424,3833,3795,56,3851,43
2021-12-24,El Dorado,017,186661,17647,17188,1877,19065,172
2021-12-24,Fresno,019,978130,150146,148027,13450,161477,2358
2021-12-24,Glenn,021,27897,3669,3611,1057,4668,39
2021-12-24,Humboldt,023,135768,10320,10052,759,10811,119
2021-12-24,Imperial,025,180216,37455,36878,4175,41053,800
2021-12-24,Inyo,027,18085,2698,2636,40,2676,47
2021-12-24,Kern,029,883053,136216,134591,24974,159565,1908
2021-12-24,Kings,031,150075,34422,34009,2072,36081,379
2021-12-24,Lake,033,64148,7087,7019,174,7193,116
2021-12-24,Lassen,035,31185,7112,7072,429,7501,55
2021-12-24,Los Angeles,037,10098052,1574230,1515469,62251,1577720,27257
2021-12-24,Madera,039,155013,25004,24741,2393,27134,320
2021-12-24,Marin,041,260295,19964,19085,702,19787,249
2021-12-24,Mariposa,043,17540,1522,1480,63,1543,6
2021-12-24,Mendocino,045,87422,8432,8314,706,9020,98
2021-12-24,Merced,047,269075,44468,44208,2223,46431,690
2021-12-24,Modoc,049,8938,602,597,207,804,6
2021-12-24,Mono,051,14174,2068,2000,25,2025,4
2021-12-24,Monterey,053,433212,51511,49709,3512,53221,638
2021-12-24,Napa,055,140530,14229,13809,181,13990,107
2021-12-24,Nevada,057,99092,10331,10153,364,10517,110
2021-12-24,Orange,059,3164182,332445,322991,18610,341601,5863
2021-12-24,Placer,061,380077,40721,39852,4111,43963,489
2021-12-24,Plumas,063,18699,2034,1987,52,2039,12
2021-12-24,Riverside,065,2383286,394360,384567,17367,401934,5470
2021-12-24,Sacramento,067,1510023,172207,169144,5460,174604,2418
2021-12-24,San Benito,069,59416,8127,7991,193,8184,79
2021-12-24,San Bernardino,071,2135413,385035,376052,12471,388523,6043
2021-12-24,San Diego,073,3302833,418918,406616,24841,431457,4442
2021-12-24,San Francisco,075,870044,63042,58229,2810,61039,682
2021-12-24,San Joaquin,077,732212,106140,104590,5774,110364,1872
2021-12-24,San Luis Obispo,079,281455,32051,31290,1449,32739,365
2021-12-24,San Mateo,081,765935,60880,56973,1153,58126,581
2021-12-24,Santa Barbara,083,443738,48602,47553,1697,49250,567
2021-12-24,Santa Clara,085,1922200,162256,156872,2011,158883,1967
2021-12-24,Santa Cruz,087,273765,22795,22176,1096,23272,228
2021-12-24,Shasta,089,179085,23144,22959,3755,26714,432
2021-12-24,Sierra,091,2930,211,202,21,223,0
2021-12-24,Siskiyou,093,43540,3519,3460,1381,4841,60
2021-12-24,Solano,095,438530,48886,47646,1439,49085,377
2021-12-24,Sonoma,097,501317,45539,44358,641,44999,408
2021-12-24,Stanislaus,099,539301,83547,83368,9540,92908,1331
2021-12-24,Sutter,101,95872,14632,14533,418,14951,191
2021-12-24,Tehama,103,63373,8982,8861,1562,10423,136
2021-12-24,Trinity,105,12862,914,826,220,1046,17
2021-12-24,Tulare,107,460477,72575,71292,16722,88014,1137
2021-12-24,Tuolumne,109,53932,8033,7919,122,8041,91
2021-12-24,Ventura,111,848112,106436,103498,4977,108475,1206
2021-12-24,Yolo,113,214977,21716,21084,1168,22252,270
2021-12-24,Yuba,115,75493,10807,10694,410,11104,98
2021-12-23,Alameda,001,1643700,130933,127221,3301,130522,1525
2021-12-23,Alpine,003,1148,110,113,0,113,0
2021-12-23,Amador,005,37829,5908,5861,76,5937,70
2021-12-23,Butte,007,227075,22468,22087,4187,26274,330
2021-12-23,Calaveras,009,45235,4638,4591,66,4657,91
2021-12-23,Colusa,011,21464,2664,2647,694,3341,21
2021-12-23,Contra Costa,013,1133247,107364,105022,2595,107617,1071
2021-12-23,Del Norte,015,27424,3830,3795,56,3851,43
2021-12-23,El Dorado,017,186661,17583,17188,1871,19059,172
2021-12-23,Fresno,019,978130,149941,148027,13432,161459,2358
2021-12-23,Glenn,021,27897,3665,3611,1057,4668,39
2021-12-23,Humboldt,023,135768,10267,10052,756,10808,119
2021-12-23,Imperial,025,180216,37381,36878,4148,41026,800
2021-12-23,Inyo,027,18085,2685,2636,40,2676,47
2021-12-23,Kern,029,883053,136066,134591,24878,159469,1908
2021-12-23,Kings,031,150075,34381,34009,2071,36080,379
2021-12-23,Lake,033,64148,7075,7019,172,7191,116
2021-12-23,Lassen,035,31185,7111,7072,429,7501,55
2021-12-23,Los Angeles,037,10098052,1564670,1515469,61175,1576644,27257
2021-12-23,Madera,039,155013,24971,24741,2389,27130,320
2021-12-23,Marin,041,260295,19830,19085,685,19770,249
2021-12-23,Mariposa,043,17540,1517,1480,63,1543,6
2021-12-23,Mendocino,045,87422,8423,8314,706,9020,98
2021-12-23,Merced,047,269075,44419,44208,2221,46429,690
2021-12-23,Modoc,049,8938,602,597,207,804,6
2021-12-23,Mono,051,14174,2047,2000,24,2024,4
2021-12-23,Monterey,053,433212,51389,49709,3491,53200,638
2021-12-23,Napa,055,140530,14150,13809,176,13985,107
2021-12-23,Nevada,057,99092,10307,10153,363,10516,110
2021-12-23,Orange,059,3164182,330757,322991,18280,341271,5863
2021-12-23,Placer,061,380077,40598,39852,4095,43947,489
2021-12-23,Plumas,063,18699,2034,1987,52,2039,12
2021-12-23,Riverside,065,2383286,393142,384567,17298,401865,5470
2021-12-23,Sacramento,067,1510023,171751,169144,5413,174557,2418
2021-12-23,San Benito,069,59416,8108,7991,191,8182,79
2021-12-23,San Bernardino,071,2135413,383846,376052,12366,388418,6043
2021-12-23,San Diego,073,3302833,417067,406616,24643,431259,4442
2021-12-23,San Francisco,075,870044,62311,58229,2782,61011,682
2021-12-23,San Joaquin,077,732212,105922,104590,5761,110351,1872
2021-12-23,San Luis Obispo,079,281455,31979,31290,1445,32735,365
2021-12-23,San Mateo,081,765935,60318,56973,1133,58106,581
2021-12-23,Santa Barbara,083,443738,48403,47553,1695,49248,567
2021-12-23,Santa Clara,085,1922200,161349,156872,1952,158824,1967
2021-12-23,Santa Cruz,087,273765,22680,22176,1084,23260,228
2021-12-23,Shasta,089,179085,23113,22959,3752,26711,432
2021-12-23,Sierra,091,2930,208,202,21,223,0
2021-12-23,Siskiyou,093,43540,3519,3460,1379,4839,60
2021-12-23,Solano,095,438530,48778,47646,1423,49069,377
2021-12-23,Sonoma,097,501317,45362,44358,640,44998,408
2021-12-23,Stanislaus,099,539301,83418,83368,9520,92888,1331
2021-12-23,Sutter,101,95872,14615,14533,417,14950,191
2021-12-23,Tehama,103,63373,8970,8861,1558,10419,136
2021-12-23,Trinity,105,12862,914,826,220,1046,17
2021-12-23,Tulare,107,460477,72499,71292,16679,87971,1137
2021-12-23,Tuolumne,109,53932,8015,7919,121,8040,91
2021-12-23,Ventura,111,848112,105901,103498,4911,108409,1206
2021-12-23,Yolo,113,214977,21644,21084,1150,22234,270
2021-12-23,Yuba,115,75493,10794,10694,410,11104,98
2021-12-22,Alameda,001,1643700,129976,126533,3218,129751,1522
2021-12-22,Alpine,003,1148,110,112,0,112,0
2021-12-22,Amador,005,37829,5895,5850,75,5925,70
2021-12-22,Butte,007,227075,22416,22070,4173,26243,330
2021-12-22,Calaveras,009,45235,4629,4580,66,4646,91
2021-12-22,Colusa,011,21464,2664,2645,691,3336,21
2021-12-22,Contra Costa,013,1133247,106726,104559,2551,107110,1070
2021-12-22,Del Norte,015,27424,3830,3794,56,3850,43
2021-12-22,El Dorado,017,186661,17521,17140,1862,19002,172
2021-12-22,Fresno,019,978130,149663,147838,13400,161238,2349
2021-12-22,Glenn,021,27897,3660,3604,1057,4661,39
2021-12-22,Humboldt,023,135768,10205,10022,751,10773,119
2021-12-22,Imperial,025,180216,37295,36755,4111,40866,798
2021-12-22,Inyo,027,18085,2667,2632,40,2672,47
2021-12-22,Kern,029,883053,135831,134433,24796,159229,1900
2021-12-22,Kings,031,150075,34331,33953,2064,36017,376
2021-12-22,Lake,033,64148,7068,7008,170,7178,116
2021-12-22,Lassen,035,31185,7106,7069,428,7497,55
2021-12-22,Los Angeles,037,10098052,1551115,1507110,60015,1567125,27234
2021-12-22,Madera,039,155013,24933,24702,2385,27087,320
2021-12-22,Marin,041,260295,19609,18927,662,19589,249
2021-12-22,Mariposa,043,17540,1510,1480,63,1543,6
2021-12-22,Mendocino,045,87422,8414,8299,706,9005,99
2021-12-22,Merced,047,269075,44348,44137,2218,46355,689
2021-12-22,Modoc,049,8938,602,595,207,802,6
2021-12-22,Mono,051,14174,2043,1979,24,2003,4
2021-12-22,Monterey,053,433212,51234,49650,3474,53124,639
2021-12-22,Napa,055,140530,14023,13746,166,13912,107
2021-12-22,Nevada,057,99092,10279,10101,358,10459,110
2021-12-22,Orange,059,3164182,328454,321765,17852,339617,5858
2021-12-22,Placer,061,380077,40416,39758,4058,43816,489
2021-12-22,Plumas,063,18699,2030,1986,52,2038,12
2021-12-22,Riverside,065,2383286,391311,383319,17185,400504,5472
2021-12-22,Sacramento,067,1510023,171092,168695,5353,174048,2422
2021-12-22,San Benito,069,59416,8056,7971,189,8160,79
2021-12-22,San Bernardino,071,2135413,382122,375044,12281,387325,6039
2021-12-22,San Diego,073,3302833,412949,404269,24314,428583,4434
2021-12-22,San Francisco,075,870044,61325,57520,2740,60260,682
2021-12-22,San Joaquin,077,732212,105652,104385,5747,110132,1870
2021-12-22,San Luis Obispo,079,281455,31838,31175,1425,32600,365
2021-12-22,San Mateo,081,765935,59636,56604,1103,57707,581
2021-12-22,Santa Barbara,083,443738,48146,47372,1679,49051,566
2021-12-22,Santa Clara,085,1922200,160225,156258,1911,158169,1954
2021-12-22,Santa Cruz,087,273765,22573,22075,1079,23154,228
2021-12-22,Shasta,089,179085,23084,22937,3747,26684,432
2021-12-22,Sierra,091,2930,208,202,21,223,0
2021-12-22,Siskiyou,093,43540,3516,3458,1376,4834,59
2021-12-22,Solano,095,438530,48549,47531,1410,48941,375
2021-12-22,Sonoma,097,501317,45087,44201,629,44830,408
2021-12-22,Stanislaus,099,539301,83277,83245,9500,92745,1331
2021-12-22,Sutter,101,95872,14579,14513,414,14927,191
2021-12-22,Tehama,103,63373,8957,8853,1554,10407,136
2021-12-22,Trinity,105,12862,914,826,220,1046,17
2021-12-22,Tulare,107,460477,72400,71226,16631,87857,1137
2021-12-22,Tuolumne,109,53932,7994,7903,121,8024,91
2021-12-22,Ventura,111,848112,105295,103089,4806,107895,1206
2021-12-22,Yolo,113,214977,21569,21012,1136,22148,270
2021-12-22,Yuba,115,75493,10777,10681,410,11091,98
2021-12-21,Alameda,001,1643700,128952,126007,3163,129170,1518
2021-12-21,Alpine,003,1148,110,112,0,112,0
2021-12-21,Amador,005,37829,5885,5845,75,5920,70
2021-12-21,Butte,007,227075,22352,22041,4159,26200,330
2021-12-21,Calaveras,009,45235,4616,4575,66,4641,91
2021-12-21,Colusa,011,21464,2662,2643,690,3333,21
2021-12-21,Contra Costa,013,1133247,106097,104255,2486,106741,1068
2021-12-21,Del Norte,015,27424,3829,3793,56,3849,43
2021-12-21,El Dorado,017,186661,17457,17098,1850,18948,172
2021-12-21,Fresno,019,978130,149375,147707,13365,161072,2341
2021-12-21,Glenn,021,27897,3646,3602,1057,4659,39
2021-12-21,Humboldt,023,135768,10141,9989,746,10735,118
2021-12-21,Imperial,025,180216,37197,36580,4070,40650,792
2021-12-21,Inyo,027,18085,2656,2627,40,2667,47
2021-12-21,Kern,029,883053,135622,134321,24691,159012,1892
2021-12-21,Kings,031,150075,34271,33914,2063,35977,376
2021-12-21,Lake,033,64148,7063,7004,168,7172,116
2021-12-21,Lassen,035,31185,7104,7069,428,7497,55
2021-12-21,Los Angeles,037,10098052,1537210,1501169,58994,1560163,27220
2021-12-21,Madera,039,155013,24896,24688,2378,27066,320
2021-12-21,Marin,041,260295,19439,18828,627,19455,249
2021-12-21,Mariposa,043,17540,1509,1480,62,1542,6
2021-12-21,Mendocino,045,87422,8398,8282,704,8986,97
2021-12-21,Merced,047,269075,44276,44096,2214,46310,688
2021-12-21,Modoc,049,8938,600,595,205,800,6
2021-12-21,Mono,051,14174,2024,1979,24,2003,4
2021-12-21,Monterey,053,433212,51143,49586,3457,53043,638
2021-12-21,Napa,055,140530,13922,13703,155,13858,107
2021-12-21,Nevada,057,99092,10250,10095,358,10453,110
2021-12-21,Orange,059,3164182,326318,320705,17404,338109,5855
2021-12-21,Placer,061,380077,40276,39649,4029,43678,487
2021-12-21,Plumas,063,18699,2030,1975,52,2027,12
2021-12-21,Riverside,065,2383286,389584,382415,17066,399481,5465
2021-12-21,Sacramento,067,1510023,170446,168422,5298,173720,2419
2021-12-21,San Benito,069,59416,8017,7950,186,8136,79
2021-12-21,San Bernardino,071,2135413,380447,374219,12169,386388,6026
2021-12-21,San Diego,073,3302833,409219,402386,23976,426362,4424
2021-12-21,San Francisco,075,870044,60362,56950,2707,59657,681
2021-12-21,San Joaquin,077,732212,105367,104238,5728,109966,1870
2021-12-21,San Luis Obispo,079,281455,31674,31103,1413,32516,365
2021-12-21,San Mateo,081,765935,59019,56381,1080,57461,581
2021-12-21,Santa Barbara,083,443738,47918,47194,1664,48858,564
2021-12-21,Santa Clara,085,1922200,159202,155769,1869,157638,1951
2021-12-21,Santa Cruz,087,273765,22456,22028,1069,23097,228
2021-12-21,Shasta,089,179085,23053,22920,3743,26663,429
2021-12-21,Sierra,091,2930,206,201,21,222,0
2021-12-21,Siskiyou,093,43540,3515,3455,1376,4831,59
2021-12-21,Solano,095,438530,48395,47474,1403,48877,372
2021-12-21,Sonoma,097,501317,44865,44051,619,44670,408
2021-12-21,Stanislaus,099,539301,83122,83167,9469,92636,1331
2021-12-21,Sutter,101,95872,14556,14492,413,14905,190
2021-12-21,Tehama,103,63373,8949,8849,1549,10398,136
2021-12-21,Trinity,105,12862,913,826,220,1046,17
2021-12-21,Tulare,107,460477,72306,71166,16590,87756,1137
2021-12-21,Tuolumne,109,53932,7970,7893,121,8014,91
2021-12-21,Ventura,111,848112,104677,102631,4693,107324,1205
2021-12-21,Yolo,113,214977,21463,20944,1132,22076,267
2021-12-21,Yuba,115,75493,10760,10668,410,11078,98
2021-12-20,Alameda,001,1643700,127988,125762,3094,128856,1515
2021-12-20,Alpine,003,1148,110,112,0,112,0
2021-12-20,Amador,005,37829,5871,5838,75,5913,70
2021-12-20,Butte,007,227075,22290,22030,4145,26175,329
2021-12-20,Calaveras,009,45235,4606,4569,66,4635,91
2021-12-20,Colusa,011,21464,2661,2644,690,3334,21
2021-12-20,Contra Costa,013,1133247,105564,104051,2438,106489,1068
2021-12-20,Del Norte,015,27424,3827,3792,56,3848,43
2021-12-20,El Dorado,017,186661,17396,17083,1842,18925,172
2021-12-20,Fresno,019,978130,149134,147605,13335,160940,2341
2021-12-20,Glenn,021,27897,3640,3597,1057,4654,39
2021-12-20,Humboldt,023,135768,10099,9973,742,10715,118
2021-12-20,Imperial,025,180216,37081,36532,4040,40572,792
2021-12-20,Inyo,027,18085,2653,2615,40,2655,47
2021-12-20,Kern,029,883053,135423,134203,24631,158834,1883
2021-12-20,Kings,031,150075,34229,33898,2062,35960,376
2021-12-20,Lake,033,64148,7058,6999,168,7167,116
2021-12-20,Lassen,035,31185,7102,7065,427,7492,55
2021-12-20,Los Angeles,037,10098052,1525721,1495251,58267,1553518,27188
2021-12-20,Madera,039,155013,24867,24668,2374,27042,313
2021-12-20,Marin,041,260295,19224,18747,609,19356,249
2021-12-20,Mariposa,043,17540,1500,1479,62,1541,6
2021-12-20,Mendocino,045,87422,8386,8264,702,8966,96
2021-12-20,Merced,047,269075,44219,44071,2209,46280,687
2021-12-20,Modoc,049,8938,600,595,202,797,6
2021-12-20,Mono,051,14174,2001,1973,24,1997,4
2021-12-20,Monterey,053,433212,51047,49556,3437,52993,636
2021-12-20,Napa,055,140530,13837,13672,145,13817,107
2021-12-20,Nevada,057,99092,10210,10079,357,10436,109
2021-12-20,Orange,059,3164182,324707,320235,17090,337325,5852
2021-12-20,Placer,061,380077,40146,39579,3999,43578,485
2021-12-20,Plumas,063,18699,2027,1971,50,2021,12
2021-12-20,Riverside,065,2383286,388137,381841,16977,398818,5452
2021-12-20,Sacramento,067,1510023,169876,168153,5258,173411,2414
2021-12-20,San Benito,069,59416,7973,7934,184,8118,79
2021-12-20,San Bernardino,071,2135413,378912,373881,12084,385965,6023
2021-12-20,San Diego,073,3302833,406004,401483,23736,425219,4412
2021-12-20,San Francisco,075,870044,59302,56661,2650,59311,681
2021-12-20,San Joaquin,077,732212,105125,104188,5717,109905,1865
2021-12-20,San Luis Obispo,079,281455,31560,31075,1405,32480,365
2021-12-20,San Mateo,081,765935,58471,56247,1061,57308,581
2021-12-20,Santa Barbara,083,443738,47706,47131,1659,48790,562
2021-12-20,Santa Clara,085,1922200,158241,155427,1820,157247,1950
2021-12-20,Santa Cruz,087,273765,22376,21989,1064,23053,227
2021-12-20,Shasta,089,179085,23032,22888,3738,26626,429
2021-12-20,Sierra,091,2930,205,201,21,222,0
2021-12-20,Siskiyou,093,43540,3514,3453,1374,4827,59
2021-12-20,Solano,095,438530,48267,47394,1395,48789,370
2021-12-20,Sonoma,097,501317,44675,43982,611,44593,408
2021-12-20,Stanislaus,099,539301,82996,83110,9440,92550,1331
2021-12-20,Sutter,101,95872,14533,14480,413,14893,190
2021-12-20,Tehama,103,63373,8941,8840,1546,10386,136
2021-12-20,Trinity,105,12862,913,826,220,1046,17
2021-12-20,Tulare,107,460477,72212,71124,16532,87656,1129
2021-12-20,Tuolumne,109,53932,7956,7867,117,7984,91
2021-12-20,Ventura,111,848112,104170,102452,4617,107069,1203
2021-12-20,Yolo,113,214977,21369,20903,1120,22023,267
2021-12-20,Yuba,115,75493,10744,10656,407,11063,97
2021-12-19,Alameda,001,1643700,127095,125464,3054,128518,1519
2021-12-19,Alpine,003,1148,110,112,0,112,0
2021-12-19,Amador,005,37829,5859,5832,74,5906,70
2021-12-19,Butte,007,227075,22235,22022,4137,26159,329
2021-12-19,Calaveras,009,45235,4590,4563,65,4628,91
2021-12-19,Colusa,011,21464,2661,2643,687,3330,21
2021-12-19,Contra Costa,013,1133247,105073,103906,2404,106310,1068
2021-12-19,Del Norte,015,27424,3823,3797,56,3853,43
2021-12-19,El Dorado,017,186661,17337,17067,1840,18907,172
2021-12-19,Fresno,019,978130,148893,147505,13310,160815,2341
2021-12-19,Glenn,021,27897,3636,3596,1056,4652,39
2021-12-19,Humboldt,023,135768,10056,9957,737,10694,118
2021-12-19,Imperial,025,180216,36951,36501,3997,40498,792
2021-12-19,Inyo,027,18085,2644,2613,40,2653,47
2021-12-19,Kern,029,883053,135224,134136,24563,158699,1883
2021-12-19,Kings,031,150075,34170,33874,2058,35932,378
2021-12-19,Lake,033,64148,7049,6999,165,7164,116
2021-12-19,Lassen,035,31185,7098,7065,427,7492,55
2021-12-19,Los Angeles,037,10098052,1516714,1495082,57668,1552750,27189
2021-12-19,Madera,039,155013,24842,24642,2368,27010,313
2021-12-19,Marin,041,260295,19048,18707,586,19293,249
2021-12-19,Mariposa,043,17540,1494,1475,62,1537,6
2021-12-19,Mendocino,045,87422,8369,8257,699,8956,96
2021-12-19,Merced,047,269075,44124,44045,2202,46247,687
2021-12-19,Modoc,049,8938,599,595,202,797,6
2021-12-19,Mono,051,14174,1990,1968,23,1991,4
2021-12-19,Monterey,053,433212,50945,49516,3416,52932,636
2021-12-19,Napa,055,140530,13764,13659,136,13795,107
2021-12-19,Nevada,057,99092,10174,10057,354,10411,109
2021-12-19,Orange,059,3164182,323296,319615,16863,336478,5852
2021-12-19,Placer,061,380077,40025,39525,3983,43508,485
2021-12-19,Plumas,063,18699,2024,1971,50,2021,12
2021-12-19,Riverside,065,2383286,386691,381305,16902,398207,5452
2021-12-19,Sacramento,067,1510023,169381,167933,5229,173162,2415
2021-12-19,San Benito,069,59416,7948,7929,183,8112,79
2021-12-19,San Bernardino,071,2135413,377581,373480,12046,385526,6023
2021-12-19,San Diego,073,3302833,403525,398197,23540,421737,4406
2021-12-19,San Francisco,075,870044,58423,56358,2594,58952,681
2021-12-19,San Joaquin,077,732212,104866,104125,5703,109828,1865
2021-12-19,San Luis Obispo,079,281455,31436,31035,1394,32429,366
2021-12-19,San Mateo,081,765935,58006,56132,1046,57178,581
2021-12-19,Santa Barbara,083,443738,47483,47070,1652,48722,562
2021-12-19,Santa Clara,085,1922200,157353,155049,1794,156843,1950
2021-12-19,Santa Cruz,087,273765,22277,21960,1059,23019,227
2021-12-19,Shasta,089,179085,22995,22875,3734,26609,429
2021-12-19,Sierra,091,2930,204,201,21,222,0
2021-12-19,Siskiyou,093,43540,3511,3452,1374,4826,59
2021-12-19,Solano,095,438530,48145,47341,1389,48730,370
2021-12-19,Sonoma,097,501317,44491,43944,609,44553,408
2021-12-19,Stanislaus,099,539301,82858,83040,9408,92448,1331
2021-12-19,Sutter,101,95872,14493,14475,412,14887,190
2021-12-19,Tehama,103,63373,8933,8840,1546,10386,136
2021-12-19,Trinity,105,12862,913,826,220,1046,17
2021-12-19,Tulare,107,460477,72119,71085,16490,87575,1129
2021-12-19,Tuolumne,109,53932,7939,7865,116,7981,91
2021-12-19,Ventura,111,848112,103590,102170,4552,106722,1203
2021-12-19,Yolo,113,214977,21287,20887,1102,21989,267
2021-12-19,Yuba,115,75493,10727,10646,405,11051,97
2021-12-18,Alameda,001,1643700,126685,124583,3027,127610,1512
2021-12-18,Alpine,003,1148,110,110,0,110,0
2021-12-18,Amador,005,37829,5853,5821,74,5895,69
2021-12-18,Butte,007,227075,22219,21956,4132,26088,328
2021-12-18,Calaveras,009,45235,4583,4534,65,4599,91
2021-12-18,Colusa,011,21464,2657,2635,685,3320,21
2021-12-18,Contra Costa,013,1133247,104858,103380,2390,105770,1065
2021-12-18,Del Norte,015,27424,3820,3791,56,3847,43
2021-12-18,El Dorado,017,186661,17309,16968,1837,18805,171
2021-12-18,Fresno,019,978130,148790,147038,13296,160334,2335
2021-12-18,Glenn,021,27897,3633,3590,1056,4646,39
2021-12-18,Humboldt,023,135768,10040,9889,737,10626,118
2021-12-18,Imperial,025,180216,36878,36280,3985,40265,790
2021-12-18,Inyo,027,18085,2638,2607,40,2647,47
2021-12-18,Kern,029,883053,135134,133754,24518,158272,1873
2021-12-18,Kings,031,150075,34137,33783,2054,35837,374
2021-12-18,Lake,033,64148,7048,6976,165,7141,115
2021-12-18,Lassen,035,31185,7096,7061,426,7487,55
2021-12-18,Los Angeles,037,10098052,1512616,1484840,57354,1542194,27135
2021-12-18,Madera,039,155013,24827,24575,2366,26941,313
2021-12-18,Marin,041,260295,18948,18537,574,19111,249
2021-12-18,Mariposa,043,17540,1493,1468,62,1530,6
2021-12-18,Mendocino,045,87422,8363,8219,699,8918,95
2021-12-18,Merced,047,269075,44089,43929,2201,46130,686
2021-12-18,Modoc,049,8938,597,595,202,797,6
2021-12-18,Mono,051,14174,1988,1956,23,1979,4
2021-12-18,Monterey,053,433212,50887,49343,3411,52754,635
2021-12-18,Napa,055,140530,13738,13581,134,13715,107
2021-12-18,Nevada,057,99092,10152,9991,352,10343,108
2021-12-18,Orange,059,3164182,322629,318149,16727,334876,5844
2021-12-18,Placer,061,380077,39924,39336,3969,43305,485
2021-12-18,Plumas,063,18699,2024,1964,50,2014,13
2021-12-18,Riverside,065,2383286,385994,379354,16861,396215,5439
2021-12-18,Sacramento,067,1510023,169145,167046,5209,172255,2404
2021-12-18,San Benito,069,59416,7933,7894,183,8077,79
2021-12-18,San Bernardino,071,2135413,376911,371658,12018,383676,6017
2021-12-18,San Diego,073,3302833,402560,397130,23488,420618,4399
2021-12-18,San Francisco,075,870044,57929,55562,2564,58126,679
2021-12-18,San Joaquin,077,732212,104779,103698,5693,109391,1858
2021-12-18,San Luis Obispo,079,281455,31394,30873,1388,32261,365
2021-12-18,San Mateo,081,765935,57766,55730,1041,56771,580
2021-12-18,Santa Barbara,083,443738,47387,46776,1650,48426,562
2021-12-18,Santa Clara,085,1922200,156897,154243,1781,156024,1946
2021-12-18,Santa Cruz,087,273765,22225,21805,1057,22862,225
2021-12-18,Shasta,089,179085,22974,22811,3734,26545,429
2021-12-18,Sierra,091,2930,204,199,21,220,0
2021-12-18,Siskiyou,093,43540,3509,3441,1373,4814,58
2021-12-18,Solano,095,438530,48099,47174,1387,48561,369
2021-12-18,Sonoma,097,501317,44381,43658,605,44263,407
2021-12-18,Stanislaus,099,539301,82776,82736,9396,92132,1330
2021-12-18,Sutter,101,95872,14475,14435,412,14847,190
2021-12-18,Tehama,103,63373,8926,8814,1545,10359,136
2021-12-18,Trinity,105,12862,913,823,220,1043,17
2021-12-18,Tulare,107,460477,72081,70922,16465,87387,1120
2021-12-18,Tuolumne,109,53932,7925,7834,116,7950,91
2021-12-18,Ventura,111,848112,103305,101612,4530,106142,1201
2021-12-18,Yolo,113,214977,21247,20793,1097,21890,267
2021-12-18,Yuba,115,75493,10716,10599,405,11004,96
2021-12-17,Alameda,001,1643700,126343,124583,3008,127591,1512
2021-12-17,Alpine,003,1148,110,110,0,110,0
2021-12-17,Amador,005,37829,5846,5821,74,5895,69
2021-12-17,Butte,007,227075,22198,21956,4125,26081,328
2021-12-17,Calaveras,009,45235,4579,4534,65,4599,91
2021-12-17,Colusa,011,21464,2656,2635,684,3319,21
2021-12-17,Contra Costa,013,1133247,104657,103380,2386,105766,1065
2021-12-17,Del Norte,015,27424,3819,3791,56,3847,43
2021-12-17,El Dorado,017,186661,17281,16968,1834,18802,171
2021-12-17,Fresno,019,978130,148687,147038,13296,160334,2335
2021-12-17,Glenn,021,27897,3626,3590,1056,4646,39
2021-12-17,Humboldt,023,135768,10020,9889,735,10624,118
2021-12-17,Imperial,025,180216,36815,36280,3967,40247,790
2021-12-17,Inyo,027,18085,2633,2607,40,2647,47
2021-12-17,Kern,029,883053,135042,133754,24477,158231,1873
2021-12-17,Kings,031,150075,34118,33783,2054,35837,374
2021-12-17,Lake,033,64148,7044,6976,165,7141,115
2021-12-17,Lassen,035,31185,7096,7061,425,7486,55
2021-12-17,Los Angeles,037,10098052,1508671,1484840,57117,1541957,27135
2021-12-17,Madera,039,155013,24811,24575,2361,26936,313
2021-12-17,Marin,041,260295,18872,18537,570,19107,249
2021-12-17,Mariposa,043,17540,1489,1468,62,1530,6
2021-12-17,Mendocino,045,87422,8352,8219,699,8918,95
2021-12-17,Merced,047,269075,44063,43929,2200,46129,686
2021-12-17,Modoc,049,8938,597,595,202,797,6
2021-12-17,Mono,051,14174,1985,1956,23,1979,4
2021-12-17,Monterey,053,433212,50829,49343,3406,52749,635
2021-12-17,Napa,055,140530,13711,13581,133,13714,107
2021-12-17,Nevada,057,99092,10141,9991,352,10343,108
2021-12-17,Orange,059,3164182,322065,318149,16660,334809,5844
2021-12-17,Placer,061,380077,39869,39336,3963,43299,485
2021-12-17,Plumas,063,18699,2023,1964,50,2014,13
2021-12-17,Riverside,065,2383286,385341,379354,16851,396205,5439
2021-12-17,Sacramento,067,1510023,168912,167046,5196,172242,2404
2021-12-17,San Benito,069,59416,7931,7894,183,8077,79
2021-12-17,San Bernardino,071,2135413,376350,371658,12001,383659,6017
2021-12-17,San Diego,073,3302833,401631,397130,23440,420570,4399
2021-12-17,San Francisco,075,870044,57601,55562,2534,58096,679
2021-12-17,San Joaquin,077,732212,104704,103698,5676,109374,1858
2021-12-17,San Luis Obispo,079,281455,31364,30873,1385,32258,365
2021-12-17,San Mateo,081,765935,57578,55730,1034,56764,580
2021-12-17,Santa Barbara,083,443738,47310,46776,1644,48420,562
2021-12-17,Santa Clara,085,1922200,156524,154243,1767,156010,1946
2021-12-17,Santa Cruz,087,273765,22178,21805,1053,22858,225
2021-12-17,Shasta,089,179085,22962,22811,3732,26543,429
2021-12-17,Sierra,091,2930,203,199,21,220,0
2021-12-17,Siskiyou,093,43540,3505,3441,1371,4812,58
2021-12-17,Solano,095,438530,48031,47174,1383,48557,369
2021-12-17,Sonoma,097,501317,44284,43658,602,44260,407
2021-12-17,Stanislaus,099,539301,82725,82736,9389,92125,1330
2021-12-17,Sutter,101,95872,14463,14435,410,14845,190
2021-12-17,Tehama,103,63373,8919,8814,1544,10358,136
2021-12-17,Trinity,105,12862,913,823,220,1043,17
2021-12-17,Tulare,107,460477,72039,70922,16435,87357,1120
2021-12-17,Tuolumne,109,53932,7913,7834,116,7950,91
2021-12-17,Ventura,111,848112,103055,101612,4518,106130,1201
2021-12-17,Yolo,113,214977,21211,20793,1095,21888,267
2021-12-17,Yuba,115,75493,10705,10599,403,11002,96
2021-12-16,Alameda,001,1643700,125962,124583,2993,127576,1512
2021-12-16,Alpine,003,1148,108,110,0,110,0
2021-12-16,Amador,005,37829,5838,5821,74,5895,69
2021-12-16,Butte,007,227075,22178,21956,4121,26077,328
2021-12-16,Calaveras,009,45235,4572,4534,65,4599,91
2021-12-16,Colusa,011,21464,2656,2635,684,3319,21
2021-12-16,Contra Costa,013,1133247,104435,103380,2376,105756,1065
2021-12-16,Del Norte,015,27424,3816,3791,56,3847,43
2021-12-16,El Dorado,017,186661,17246,16968,1829,18797,171
2021-12-16,Fresno,019,978130,148528,147038,13288,160326,2335
2021-12-16,Glenn,021,27897,3626,3590,1053,4643,39
2021-12-16,Humboldt,023,135768,9996,9889,725,10614,118
2021-12-16,Imperial,025,180216,36731,36280,3939,40219,790
2021-12-16,Inyo,027,18085,2629,2607,39,2646,47
2021-12-16,Kern,029,883053,134898,133754,24428,158182,1873
2021-12-16,Kings,031,150075,34094,33783,2053,35836,374
2021-12-16,Lake,033,64148,7040,6976,165,7141,115
2021-12-16,Lassen,035,31185,7093,7061,424,7485,55
2021-12-16,Los Angeles,037,10098052,1504456,1484840,56854,1541694,27135
2021-12-16,Madera,039,155013,24782,24575,2357,26932,313
2021-12-16,Marin,041,260295,18825,18537,563,19100,249
2021-12-16,Mariposa,043,17540,1487,1468,62,1530,6
2021-12-16,Mendocino,045,87422,8341,8219,694,8913,95
2021-12-16,Merced,047,269075,44024,43929,2199,46128,686
2021-12-16,Modoc,049,8938,597,595,202,797,6
2021-12-16,Mono,051,14174,1982,1956,23,1979,4
2021-12-16,Monterey,053,433212,50758,49343,3389,52732,635
2021-12-16,Napa,055,140530,13679,13581,133,13714,107
2021-12-16,Nevada,057,99092,10115,9991,352,10343,108
2021-12-16,Orange,059,3164182,321453,318149,16580,334729,5844
2021-12-16,Placer,061,380077,39792,39336,3958,43294,485
2021-12-16,Plumas,063,18699,2023,1964,50,2014,13
2021-12-16,Riverside,065,2383286,384536,379354,16837,396191,5439
2021-12-16,Sacramento,067,1510023,168629,167046,5172,172218,2404
2021-12-16,San Benito,069,59416,7924,7894,183,8077,79
2021-12-16,San Bernardino,071,2135413,375684,371658,11981,383639,6017
2021-12-16,San Diego,073,3302833,400462,397130,23374,420504,4399
2021-12-16,San Francisco,075,870044,57222,55562,2512,58074,679
2021-12-16,San Joaquin,077,732212,104582,103698,5669,109367,1858
2021-12-16,San Luis Obispo,079,281455,31294,30873,1379,32252,365
2021-12-16,San Mateo,081,765935,57378,55730,1031,56761,580
2021-12-16,Santa Barbara,083,443738,47189,46776,1640,48416,562
2021-12-16,Santa Clara,085,1922200,156192,154243,1757,156000,1946
2021-12-16,Santa Cruz,087,273765,22132,21805,1052,22857,225
2021-12-16,Shasta,089,179085,22932,22811,3730,26541,429
2021-12-16,Sierra,091,2930,203,199,21,220,0
2021-12-16,Siskiyou,093,43540,3504,3441,1367,4808,58
2021-12-16,Solano,095,438530,47963,47174,1376,48550,369
2021-12-16,Sonoma,097,501317,44185,43658,600,44258,407
2021-12-16,Stanislaus,099,539301,82638,82736,9375,92111,1330
2021-12-16,Sutter,101,95872,14449,14435,409,14844,190
2021-12-16,Tehama,103,63373,8912,8814,1543,10357,136
2021-12-16,Trinity,105,12862,913,823,220,1043,17
2021-12-16,Tulare,107,460477,71990,70922,16410,87332,1120
2021-12-16,Tuolumne,109,53932,7892,7834,116,7950,91
2021-12-16,Ventura,111,848112,102788,101612,4511,106123,1201
2021-12-16,Yolo,113,214977,21160,20793,1090,21883,267
2021-12-16,Yuba,115,75493,10689,10599,402,11001,96
2021-12-15,Alameda,001,1643700,125633,124342,2982,127324,1509
2021-12-15,Alpine,003,1148,108,109,0,109,0
2021-12-15,Amador,005,37829,5832,5810,74,5884,69
2021-12-15,Butte,007,227075,22154,21922,4120,26042,327
2021-12-15,Calaveras,009,45235,4566,4523,65,4588,89
2021-12-15,Colusa,011,21464,2655,2632,683,3315,21
2021-12-15,Contra Costa,013,1133247,104216,103236,2373,105609,1064
2021-12-15,Del Norte,015,27424,3815,3789,55,3844,43
2021-12-15,El Dorado,017,186661,17216,16936,1823,18759,171
2021-12-15,Fresno,019,978130,148400,146859,13274,160133,2319
2021-12-15,Glenn,021,27897,3625,3589,1053,4642,39
2021-12-15,Humboldt,023,135768,9976,9854,724,10578,118
2021-12-15,Imperial,025,180216,36651,36187,3895,40082,789
2021-12-15,Inyo,027,18085,2624,2606,39,2645,47
2021-12-15,Kern,029,883053,134760,133590,24382,157972,1866
2021-12-15,Kings,031,150075,34065,33716,2049,35765,374
2021-12-15,Lake,033,64148,7032,6968,164,7132,115
2021-12-15,Lassen,035,31185,7093,7062,424,7486,55
2021-12-15,Los Angeles,037,10098052,1500550,1482735,56654,1539389,27116
2021-12-15,Madera,039,155013,24764,24549,2351,26900,313
2021-12-15,Marin,041,260295,18766,18514,558,19072,249
2021-12-15,Mariposa,043,17540,1484,1463,62,1525,6
2021-12-15,Mendocino,045,87422,8336,8209,691,8900,95
2021-12-15,Merced,047,269075,43982,43890,2187,46077,685
2021-12-15,Modoc,049,8938,597,595,202,797,6
2021-12-15,Mono,051,14174,1978,1955,23,1978,4
2021-12-15,Monterey,053,433212,50703,49279,3371,52650,635
2021-12-15,Napa,055,140530,13650,13557,131,13688,107
2021-12-15,Nevada,057,99092,10094,9958,352,10310,107
2021-12-15,Orange,059,3164182,320870,317808,16538,334346,5838
2021-12-15,Placer,061,380077,39735,39264,3948,43212,485
2021-12-15,Plumas,063,18699,2019,1957,50,2007,12
2021-12-15,Riverside,065,2383286,383815,378769,16826,395595,5438
2021-12-15,Sacramento,067,1510023,168322,166793,5152,171945,2401
2021-12-15,San Benito,069,59416,7909,7877,183,8060,79
2021-12-15,San Bernardino,071,2135413,375118,371122,11948,383070,6013
2021-12-15,San Diego,073,3302833,399267,396546,23304,419850,4395
2021-12-15,San Francisco,075,870044,56904,55414,2494,57908,679
2021-12-15,San Joaquin,077,732212,104431,103579,5659,109238,1853
2021-12-15,San Luis Obispo,079,281455,31245,30784,1372,32156,365
2021-12-15,San Mateo,081,765935,57236,55657,1021,56678,580
2021-12-15,Santa Barbara,083,443738,47108,46681,1638,48319,562
2021-12-15,Santa Clara,085,1922200,155880,153928,1739,155667,1944
2021-12-15,Santa Cruz,087,273765,22092,21753,1045,22798,225
2021-12-15,Shasta,089,179085,22917,22778,3726,26504,427
2021-12-15,Sierra,091,2930,203,199,21,220,0
2021-12-15,Siskiyou,093,43540,3503,3434,1366,4800,58
2021-12-15,Solano,095,438530,47892,47098,1370,48468,367
2021-12-15,Sonoma,097,501317,44103,43580,595,44175,407
2021-12-15,Stanislaus,099,539301,82530,82628,9367,91995,1298
2021-12-15,Sutter,101,95872,14429,14428,408,14836,189
2021-12-15,Tehama,103,63373,8905,8806,1542,10348,136
2021-12-15,Trinity,105,12862,912,822,220,1042,17
2021-12-15,Tulare,107,460477,71938,70846,16381,87227,1120
2021-12-15,Tuolumne,109,53932,7883,7818,115,7933,91
2021-12-15,Ventura,111,848112,102573,101447,4505,105952,1199
2021-12-15,Yolo,113,214977,21131,20749,1086,21835,267
2021-12-15,Yuba,115,75493,10679,10587,401,10988,96
2021-12-14,Alameda,001,1643700,125300,124272,2970,127242,1506
2021-12-14,Alpine,003,1148,107,109,0,109,0
2021-12-14,Amador,005,37829,5826,5808,73,5881,69
2021-12-14,Butte,007,227075,22121,21901,4118,26019,326
2021-12-14,Calaveras,009,45235,4554,4517,65,4582,89
2021-12-14,Colusa,011,21464,2653,2628,683,3311,21
2021-12-14,Contra Costa,013,1133247,104032,103135,2369,105504,1064
2021-12-14,Del Norte,015,27424,3812,3788,55,3843,43
2021-12-14,El Dorado,017,186661,17181,16915,1821,18736,170
2021-12-14,Fresno,019,978130,148229,146756,13266,160022,2316
2021-12-14,Glenn,021,27897,3624,3589,1053,4642,39
2021-12-14,Humboldt,023,135768,9964,9836,716,10552,118
2021-12-14,Imperial,025,180216,36579,36049,3852,39901,789
2021-12-14,Inyo,027,18085,2623,2601,39,2640,46
2021-12-14,Kern,029,883053,134622,133498,24333,157831,1863
2021-12-14,Kings,031,150075,34028,33693,2046,35739,373
2021-12-14,Lake,033,64148,7023,6961,164,7125,115
2021-12-14,Lassen,035,31185,7092,7061,424,7485,55
2021-12-14,Los Angeles,037,10098052,1496881,1481131,56478,1537609,27099
2021-12-14,Madera,039,155013,24737,24535,2343,26878,313
2021-12-14,Marin,041,260295,18718,18491,556,19047,249
2021-12-14,Mariposa,043,17540,1481,1463,61,1524,6
2021-12-14,Mendocino,045,87422,8308,8206,689,8895,95
2021-12-14,Merced,047,269075,43936,43870,2185,46055,684
2021-12-14,Modoc,049,8938,596,595,202,797,6
2021-12-14,Mono,051,14174,1971,1955,23,1978,4
2021-12-14,Monterey,053,433212,50618,49237,3361,52598,635
2021-12-14,Napa,055,140530,13621,13528,131,13659,107
2021-12-14,Nevada,057,99092,10068,9956,351,10307,106
2021-12-14,Orange,059,3164182,320315,317465,16484,333949,5827
2021-12-14,Placer,061,380077,39660,39221,3943,43164,482
2021-12-14,Plumas,063,18699,2015,1950,48,1998,12
2021-12-14,Riverside,065,2383286,383123,378227,16809,395036,5427
2021-12-14,Sacramento,067,1510023,168012,166605,5129,171734,2394
2021-12-14,San Benito,069,59416,7890,7871,183,8054,79
2021-12-14,San Bernardino,071,2135413,374487,370604,11916,382520,6013
2021-12-14,San Diego,073,3302833,398128,395876,23253,419129,4393
2021-12-14,San Francisco,075,870044,56588,55278,2483,57761,679
2021-12-14,San Joaquin,077,732212,104288,103488,5642,109130,1848
2021-12-14,San Luis Obispo,079,281455,31185,30753,1368,32121,363
2021-12-14,San Mateo,081,765935,57072,55601,1014,56615,580
2021-12-14,Santa Barbara,083,443738,47006,46648,1634,48282,560
2021-12-14,Santa Clara,085,1922200,155558,153814,1726,155540,1945
2021-12-14,Santa Cruz,087,273765,22027,21737,1040,22777,225
2021-12-14,Shasta,089,179085,22890,22756,3725,26481,427
2021-12-14,Sierra,091,2930,201,199,21,220,0
2021-12-14,Siskiyou,093,43540,3498,3430,1365,4795,58
2021-12-14,Solano,095,438530,47845,47065,1364,48429,367
2021-12-14,Sonoma,097,501317,44020,43538,593,44131,407
2021-12-14,Stanislaus,099,539301,82443,82581,9351,91932,1293
2021-12-14,Sutter,101,95872,14417,14421,407,14828,189
2021-12-14,Tehama,103,63373,8901,8805,1542,10347,134
2021-12-14,Trinity,105,12862,912,821,220,1041,17
2021-12-14,Tulare,107,460477,71866,70803,16351,87154,1120
2021-12-14,Tuolumne,109,53932,7870,7815,115,7930,91
2021-12-14,Ventura,111,848112,102349,101343,4498,105841,1199
2021-12-14,Yolo,113,214977,21092,20734,1078,21812,267
2021-12-14,Yuba,115,75493,10662,10574,401,10975,92
2021-12-13,Alameda,001,1643700,125010,124174,2953,127127,1501
2021-12-13,Alpine,003,1148,107,109,0,109,0
2021-12-13,Amador,005,37829,5822,5797,73,5870,69
2021-12-13,Butte,007,227075,22097,21889,4114,26003,326
2021-12-13,Calaveras,009,45235,4547,4507,64,4571,89
2021-12-13,Colusa,011,21464,2650,2627,683,3310,21
2021-12-13,Contra Costa,013,1133247,103879,103041,2358,105399,1064
2021-12-13,Del Norte,015,27424,3808,3787,55,3842,42
2021-12-13,El Dorado,017,186661,17158,16896,1819,18715,170
2021-12-13,Fresno,019,978130,148079,146641,13256,159897,2312
2021-12-13,Glenn,021,27897,3620,3589,1051,4640,37
2021-12-13,Humboldt,023,135768,9935,9821,712,10533,118
2021-12-13,Imperial,025,180216,36495,35974,3831,39805,787
2021-12-13,Inyo,027,18085,2622,2592,39,2631,46
2021-12-13,Kern,029,883053,134496,133381,24280,157661,1863
2021-12-13,Kings,031,150075,33985,33680,2041,35721,372
2021-12-13,Lake,033,64148,7021,6958,162,7120,115
2021-12-13,Lassen,035,31185,7091,7057,424,7481,55
2021-12-13,Los Angeles,037,10098052,1494097,1480195,56317,1536512,27085
2021-12-13,Madera,039,155013,24708,24527,2338,26865,311
2021-12-13,Marin,041,260295,18658,18471,553,19024,249
2021-12-13,Mariposa,043,17540,1479,1462,61,1523,6
2021-12-13,Mendocino,045,87422,8295,8196,687,8883,95
2021-12-13,Merced,047,269075,43896,43848,2181,46029,682
2021-12-13,Modoc,049,8938,595,595,202,797,6
2021-12-13,Mono,051,14174,1964,1952,23,1975,4
2021-12-13,Monterey,053,433212,50566,49222,3342,52564,631
2021-12-13,Napa,055,140530,13608,13518,131,13649,107
2021-12-13,Nevada,057,99092,10049,9946,350,10296,106
2021-12-13,Orange,059,3164182,319845,317112,16432,333544,5824
2021-12-13,Placer,061,380077,39599,39168,3932,43100,481
2021-12-13,Plumas,063,18699,2011,1943,48,1991,12
2021-12-13,Riverside,065,2383286,382542,377728,16794,394522,5414
2021-12-13,Sacramento,067,1510023,167733,166439,5097,171536,2392
2021-12-13,San Benito,069,59416,7881,7856,183,8039,79
2021-12-13,San Bernardino,071,2135413,373906,370274,11908,382182,6011
2021-12-13,San Diego,073,3302833,397323,395266,23200,418466,4389
2021-12-13,San Francisco,075,870044,56318,55245,2470,57715,678
2021-12-13,San Joaquin,077,732212,104173,103449,5633,109082,1846
2021-12-13,San Luis Obispo,079,281455,31135,30746,1364,32110,363
2021-12-13,San Mateo,081,765935,56913,55569,1005,56574,580
2021-12-13,Santa Barbara,083,443738,46918,46608,1629,48237,560
2021-12-13,Santa Clara,085,1922200,155293,153672,1715,155387,1944
2021-12-13,Santa Cruz,087,273765,21972,21698,1037,22735,225
2021-12-13,Shasta,089,179085,22869,22731,3723,26454,426
2021-12-13,Sierra,091,2930,201,199,21,220,0
2021-12-13,Siskiyou,093,43540,3494,3426,1362,4788,57
2021-12-13,Solano,095,438530,47771,47045,1359,48404,365
2021-12-13,Sonoma,097,501317,43924,43492,591,44083,407
2021-12-13,Stanislaus,099,539301,82326,82507,9328,91835,1282
2021-12-13,Sutter,101,95872,14410,14408,407,14815,188
2021-12-13,Tehama,103,63373,8889,8800,1542,10342,134
2021-12-13,Trinity,105,12862,912,820,220,1040,17
2021-12-13,Tulare,107,460477,71808,70758,16327,87085,1114
2021-12-13,Tuolumne,109,53932,7859,7804,115,7919,91
2021-12-13,Ventura,111,848112,102124,101180,4487,105667,1197
2021-12-13,Yolo,113,214977,21040,20706,1076,21782,267
2021-12-13,Yuba,115,75493,10645,10570,401,10971,92
2021-12-12,Alameda,001,1643700,124728,124075,2941,127016,1503
2021-12-12,Alpine,003,1148,107,109,0,109,0
2021-12-12,Amador,005,37829,5814,5797,72,5869,69
2021-12-12,Butte,007,227075,22073,21874,4108,25982,326
2021-12-12,Calaveras,009,45235,4536,4501,64,4565,89
2021-12-12,Colusa,011,21464,2645,2627,680,3307,21
2021-12-12,Contra Costa,013,1133247,103691,102976,2356,105332,1065
2021-12-12,Del Norte,015,27424,3805,3793,55,3848,42
2021-12-12,El Dorado,017,186661,17122,16890,1811,18701,170
2021-12-12,Fresno,019,978130,147917,146518,13241,159759,2310
2021-12-12,Glenn,021,27897,3617,3589,1051,4640,37
2021-12-12,Humboldt,023,135768,9910,9804,705,10509,118
2021-12-12,Imperial,025,180216,36361,35926,3800,39726,787
2021-12-12,Inyo,027,18085,2617,2592,39,2631,46
2021-12-12,Kern,029,883053,134330,133314,24239,157553,1861
2021-12-12,Kings,031,150075,33934,33661,2039,35700,372
2021-12-12,Lake,033,64148,7013,6955,161,7116,115
2021-12-12,Lassen,035,31185,7090,7057,424,7481,55
2021-12-12,Los Angeles,037,10098052,1491181,1479054,56140,1535194,27074
2021-12-12,Madera,039,155013,24679,24493,2331,26824,311
2021-12-12,Marin,041,260295,18605,18451,549,19000,249
2021-12-12,Mariposa,043,17540,1478,1461,61,1522,6
2021-12-12,Mendocino,045,87422,8282,8190,686,8876,95
2021-12-12,Merced,047,269075,43863,43821,2174,45995,682
2021-12-12,Modoc,049,8938,595,595,201,796,6
2021-12-12,Mono,051,14174,1960,1947,23,1970,4
2021-12-12,Monterey,053,433212,50513,49192,3316,52508,631
2021-12-12,Napa,055,140530,13565,13508,129,13637,107
2021-12-12,Nevada,057,99092,10023,9938,349,10287,106
2021-12-12,Orange,059,3164182,319339,316918,16368,333286,5825
2021-12-12,Placer,061,380077,39534,39139,3926,43065,481
2021-12-12,Plumas,063,18699,2007,1942,46,1988,12
2021-12-12,Riverside,065,2383286,381864,377467,16769,394236,5414
2021-12-12,Sacramento,067,1510023,167466,166291,5076,171367,2392
2021-12-12,San Benito,069,59416,7861,7853,183,8036,79
2021-12-12,San Bernardino,071,2135413,373260,369977,11884,381861,6011
2021-12-12,San Diego,073,3302833,396428,393307,23162,416469,4378
2021-12-12,San Francisco,075,870044,56062,55180,2458,57638,678
2021-12-12,San Joaquin,077,732212,104033,103405,5623,109028,1846
2021-12-12,San Luis Obispo,079,281455,31082,30719,1362,32081,363
2021-12-12,San Mateo,081,765935,56796,55505,1001,56506,580
2021-12-12,Santa Barbara,083,443738,46843,46586,1627,48213,560
2021-12-12,Santa Clara,085,1922200,155007,153452,1701,155153,1945
2021-12-12,Santa Cruz,087,273765,21923,21671,1035,22706,225
2021-12-12,Shasta,089,179085,22841,22732,3722,26454,426
2021-12-12,Sierra,091,2930,201,199,21,220,0
2021-12-12,Siskiyou,093,43540,3494,3424,1362,4786,57
2021-12-12,Solano,095,438530,47705,47021,1356,48377,365
2021-12-12,Sonoma,097,501317,43831,43424,588,44012,407
2021-12-12,Stanislaus,099,539301,82226,82460,9315,91775,1282
2021-12-12,Sutter,101,95872,14399,14396,407,14803,189
2021-12-12,Tehama,103,63373,8878,8796,1540,10336,134
2021-12-12,Trinity,105,12862,910,820,220,1040,17
2021-12-12,Tulare,107,460477,71732,70733,16285,87018,1115
2021-12-12,Tuolumne,109,53932,7842,7794,115,7909,91
2021-12-12,Ventura,111,848112,101931,101105,4473,105578,1197
2021-12-12,Yolo,113,214977,20983,20685,1071,21756,267
2021-12-12,Yuba,115,75493,10631,10565,398,10963,92
2021-12-11,Alameda,001,1643700,124590,123572,2939,126511,1496
2021-12-11,Alpine,003,1148,107,109,0,109,0
2021-12-11,Amador,005,37829,5809,5787,72,5859,69
2021-12-11,Butte,007,227075,22059,21819,4106,25925,326
2021-12-11,Calaveras,009,45235,4528,4469,63,4532,89
2021-12-11,Colusa,011,21464,2641,2619,679,3298,21
2021-12-11,Contra Costa,013,1133247,103605,102618,2354,104972,1061
2021-12-11,Del Norte,015,27424,3805,3778,55,3833,42
2021-12-11,El Dorado,017,186661,17102,16796,1810,18606,170
2021-12-11,Fresno,019,978130,147829,145988,13232,159220,2294
2021-12-11,Glenn,021,27897,3615,3585,1051,4636,37
2021-12-11,Humboldt,023,135768,9893,9721,702,10423,118
2021-12-11,Imperial,025,180216,36303,35635,3791,39426,782
2021-12-11,Inyo,027,18085,2612,2576,39,2615,46
2021-12-11,Kern,029,883053,134261,132852,24205,157057,1854
2021-12-11,Kings,031,150075,33921,33530,2037,35567,371
2021-12-11,Lake,033,64148,7012,6932,159,7091,114
2021-12-11,Lassen,035,31185,7089,7049,424,7473,55
2021-12-11,Los Angeles,037,10098052,1489966,1474030,56050,1530080,27031
2021-12-11,Madera,039,155013,24673,24417,2330,26747,311
2021-12-11,Marin,041,260295,18571,18339,546,18885,249
2021-12-11,Mariposa,043,17540,1477,1450,61,1511,6
2021-12-11,Mendocino,045,87422,8275,8130,686,8816,95
2021-12-11,Merced,047,269075,43844,43690,2173,45863,681
2021-12-11,Modoc,049,8938,595,594,201,795,6
2021-12-11,Mono,051,14174,1956,1926,23,1949,4
2021-12-11,Monterey,053,433212,50485,49008,3313,52321,631
2021-12-11,Napa,055,140530,13548,13459,129,13588,107
2021-12-11,Nevada,057,99092,10010,9880,349,10229,106
2021-12-11,Orange,059,3164182,319089,315759,16341,332100,5805
2021-12-11,Placer,061,380077,39476,38959,3919,42878,481
2021-12-11,Plumas,063,18699,2001,1934,46,1980,12
2021-12-11,Riverside,065,2383286,381443,375649,16754,392403,5408
2021-12-11,Sacramento,067,1510023,167335,165530,5069,170599,2386
2021-12-11,San Benito,069,59416,7847,7808,183,7991,79
2021-12-11,San Bernardino,071,2135413,372897,368145,11874,380019,6007
2021-12-11,San Diego,073,3302833,396005,392274,23124,415398,4374
2021-12-11,San Francisco,075,870044,55909,54869,2453,57322,678
2021-12-11,San Joaquin,077,732212,103971,103013,5619,108632,1842
2021-12-11,San Luis Obispo,079,281455,31060,30567,1358,31925,362
2021-12-11,San Mateo,081,765935,56717,55284,999,56283,580
2021-12-11,Santa Barbara,083,443738,46808,46309,1627,47936,559
2021-12-11,Santa Clara,085,1922200,154809,152846,1689,154535,1941
2021-12-11,Santa Cruz,087,273765,21899,21557,1035,22592,225
2021-12-11,Shasta,089,179085,22826,22660,3718,26378,419
2021-12-11,Sierra,091,2930,201,199,21,220,0
2021-12-11,Siskiyou,093,43540,3488,3418,1359,4777,57
2021-12-11,Solano,095,438530,47676,46891,1352,48243,365
2021-12-11,Sonoma,097,501317,43783,43227,588,43815,407
2021-12-11,Stanislaus,099,539301,82177,82133,9306,91439,1264
2021-12-11,Sutter,101,95872,14390,14354,407,14761,187
2021-12-11,Tehama,103,63373,8875,8776,1538,10314,134
2021-12-11,Trinity,105,12862,910,819,220,1039,17
2021-12-11,Tulare,107,460477,71688,70523,16275,86798,1103
2021-12-11,Tuolumne,109,53932,7833,7760,115,7875,91
2021-12-11,Ventura,111,848112,101856,100711,4466,105177,1195
2021-12-11,Yolo,113,214977,20964,20608,1067,21675,267
2021-12-11,Yuba,115,75493,10619,10519,397,10916,92
2021-12-10,Alameda,001,1643700,124467,123572,2931,126503,1496
2021-12-10,Alpine,003,1148,106,109,0,109,0
2021-12-10,Amador,005,37829,5802,5787,72,5859,69
2021-12-10,Butte,007,227075,22046,21819,4104,25923,326
2021-12-10,Calaveras,009,45235,4525,4469,63,4532,89
2021-12-10,Colusa,011,21464,2640,2619,679,3298,21
2021-12-10,Contra Costa,013,1133247,103509,102618,2353,104971,1061
2021-12-10,Del Norte,015,27424,3805,3778,55,3833,42
2021-12-10,El Dorado,017,186661,17089,16796,1810,18606,170
2021-12-10,Fresno,019,978130,147741,145988,13221,159209,2294
2021-12-10,Glenn,021,27897,3615,3585,1051,4636,37
2021-12-10,Humboldt,023,135768,9876,9721,700,10421,118
2021-12-10,Imperial,025,180216,36248,35635,3776,39411,782
2021-12-10,Inyo,027,18085,2609,2576,39,2615,46
2021-12-10,Kern,029,883053,134172,132852,24181,157033,1854
2021-12-10,Kings,031,150075,33906,33530,2035,35565,371
2021-12-10,Lake,033,64148,7005,6932,159,7091,114
2021-12-10,Lassen,035,31185,7088,7049,424,7473,55
2021-12-10,Los Angeles,037,10098052,1488878,1474030,55964,1529994,27031
2021-12-10,Madera,039,155013,24655,24417,2328,26745,311
2021-12-10,Marin,041,260295,18549,18339,546,18885,249
2021-12-10,Mariposa,043,17540,1474,1450,61,1511,6
2021-12-10,Mendocino,045,87422,8268,8130,685,8815,95
2021-12-10,Merced,047,269075,43826,43690,2171,45861,681
2021-12-10,Modoc,049,8938,595,594,201,795,6
2021-12-10,Mono,051,14174,1953,1926,23,1949,4
2021-12-10,Monterey,053,433212,50448,49008,3307,52315,631
2021-12-10,Napa,055,140530,13536,13459,128,13587,107
2021-12-10,Nevada,057,99092,10001,9880,349,10229,106
2021-12-10,Orange,059,3164182,318821,315759,16309,332068,5805
2021-12-10,Placer,061,380077,39434,38959,3916,42875,481
2021-12-10,Plumas,063,18699,1999,1934,46,1980,12
2021-12-10,Riverside,065,2383286,381036,375649,16744,392393,5408
2021-12-10,Sacramento,067,1510023,167183,165530,5067,170597,2386
2021-12-10,San Benito,069,59416,7843,7808,183,7991,79
2021-12-10,San Bernardino,071,2135413,372525,368145,11851,379996,6007
2021-12-10,San Diego,073,3302833,395525,392274,23110,415384,4374
2021-12-10,San Francisco,075,870044,55824,54869,2447,57316,678
2021-12-10,San Joaquin,077,732212,103913,103013,5615,108628,1842
2021-12-10,San Luis Obispo,079,281455,31050,30567,1355,31922,362
2021-12-10,San Mateo,081,765935,56660,55284,996,56280,580
2021-12-10,Santa Barbara,083,443738,46772,46309,1626,47935,559
2021-12-10,Santa Clara,085,1922200,154639,152846,1676,154522,1941
2021-12-10,Santa Cruz,087,273765,21879,21557,1034,22591,225
2021-12-10,Shasta,089,179085,22815,22660,3715,26375,419
2021-12-10,Sierra,091,2930,201,199,21,220,0
2021-12-10,Siskiyou,093,43540,3481,3418,1359,4777,57
2021-12-10,Solano,095,438530,47634,46891,1348,48239,365
2021-12-10,Sonoma,097,501317,43749,43227,587,43814,407
2021-12-10,Stanislaus,099,539301,82111,82133,9300,91433,1264
2021-12-10,Sutter,101,95872,14382,14354,407,14761,187
2021-12-10,Tehama,103,63373,8873,8776,1536,10312,134
2021-12-10,Trinity,105,12862,910,819,220,1039,17
2021-12-10,Tulare,107,460477,71659,70523,16251,86774,1103
2021-12-10,Tuolumne,109,53932,7827,7760,115,7875,91
2021-12-10,Ventura,111,848112,101752,100711,4463,105174,1195
2021-12-10,Yolo,113,214977,20950,20608,1065,21673,267
2021-12-10,Yuba,115,75493,10607,10519,396,10915,92
2021-12-09,Alameda,001,1643700,124323,123572,2926,126498,1496
2021-12-09,Alpine,003,1148,106,109,0,109,0
2021-12-09,Amador,005,37829,5799,5787,71,5858,69
2021-12-09,Butte,007,227075,22026,21819,4100,25919,326
2021-12-09,Calaveras,009,45235,4516,4469,63,4532,89
2021-12-09,Colusa,011,21464,2638,2619,679,3298,21
2021-12-09,Contra Costa,013,1133247,103390,102618,2347,104965,1061
2021-12-09,Del Norte,015,27424,3804,3778,55,3833,42
2021-12-09,El Dorado,017,186661,17061,16796,1805,18601,170
2021-12-09,Fresno,019,978130,147593,145988,13209,159197,2294
2021-12-09,Glenn,021,27897,3615,3585,1051,4636,37
2021-12-09,Humboldt,023,135768,9853,9721,699,10420,118
2021-12-09,Imperial,025,180216,36177,35635,3747,39382,782
2021-12-09,Inyo,027,18085,2607,2576,39,2615,46
2021-12-09,Kern,029,883053,134046,132852,24148,157000,1854
2021-12-09,Kings,031,150075,33880,33530,2032,35562,371
2021-12-09,Lake,033,64148,6996,6932,159,7091,114
2021-12-09,Lassen,035,31185,7086,7049,424,7473,55
2021-12-09,Los Angeles,037,10098052,1487338,1474030,55880,1529910,27031
2021-12-09,Madera,039,155013,24630,24417,2325,26742,311
2021-12-09,Marin,041,260295,18535,18339,544,18883,249
2021-12-09,Mariposa,043,17540,1473,1450,61,1511,6
2021-12-09,Mendocino,045,87422,8255,8130,682,8812,95
2021-12-09,Merced,047,269075,43788,43690,2159,45849,681
2021-12-09,Modoc,049,8938,595,594,201,795,6
2021-12-09,Mono,051,14174,1949,1926,23,1949,4
2021-12-09,Monterey,053,433212,50402,49008,3296,52304,631
2021-12-09,Napa,055,140530,13516,13459,124,13583,107
2021-12-09,Nevada,057,99092,9982,9880,349,10229,106
2021-12-09,Orange,059,3164182,318484,315759,16270,332029,5805
2021-12-09,Placer,061,380077,39390,38959,3903,42862,481
2021-12-09,Plumas,063,18699,1991,1934,46,1980,12
2021-12-09,Riverside,065,2383286,380486,375649,16728,392377,5408
2021-12-09,Sacramento,067,1510023,166962,165530,5052,170582,2386
2021-12-09,San Benito,069,59416,7831,7808,182,7990,79
2021-12-09,San Bernardino,071,2135413,372010,368145,11827,379972,6007
2021-12-09,San Diego,073,3302833,394879,392274,23080,415354,4374
2021-12-09,San Francisco,075,870044,55739,54869,2440,57309,678
2021-12-09,San Joaquin,077,732212,103821,103013,5610,108623,1842
2021-12-09,San Luis Obispo,079,281455,31022,30567,1352,31919,362
2021-12-09,San Mateo,081,765935,56572,55284,994,56278,580
2021-12-09,Santa Barbara,083,443738,46692,46309,1620,47929,559
2021-12-09,Santa Clara,085,1922200,154423,152846,1665,154511,1941
2021-12-09,Santa Cruz,087,273765,21851,21557,1034,22591,225
2021-12-09,Shasta,089,179085,22799,22660,3714,26374,419
2021-12-09,Sierra,091,2930,201,199,21,220,0
2021-12-09,Siskiyou,093,43540,3477,3418,1358,4776,57
2021-12-09,Solano,095,438530,47597,46891,1346,48237,365
2021-12-09,Sonoma,097,501317,43692,43227,585,43812,407
2021-12-09,Stanislaus,099,539301,82040,82133,9285,91418,1264
2021-12-09,Sutter,101,95872,14367,14354,407,14761,187
2021-12-09,Tehama,103,63373,8866,8776,1534,10310,134
2021-12-09,Trinity,105,12862,910,819,220,1039,17
2021-12-09,Tulare,107,460477,71603,70523,16222,86745,1103
2021-12-09,Tuolumne,109,53932,7816,7760,114,7874,91
2021-12-09,Ventura,111,848112,101607,100711,4451,105162,1195
2021-12-09,Yolo,113,214977,20927,20608,1057,21665,267
2021-12-09,Yuba,115,75493,10599,10519,393,10912,92
2021-12-08,Alameda,001,1643700,124173,123438,2916,126354,1496
2021-12-08,Alpine,003,1148,106,108,0,108,0
2021-12-08,Amador,005,37829,5794,5781,71,5852,69
2021-12-08,Butte,007,227075,22009,21780,4097,25877,326
2021-12-08,Calaveras,009,45235,4508,4455,63,4518,89
2021-12-08,Colusa,011,21464,2635,2619,678,3297,21
2021-12-08,Contra Costa,013,1133247,103261,102506,2347,104853,1058
2021-12-08,Del Norte,015,27424,3803,3767,55,3822,42
2021-12-08,El Dorado,017,186661,17029,16757,1805,18562,170
2021-12-08,Fresno,019,978130,147433,145830,13195,159025,2293
2021-12-08,Glenn,021,27897,3615,3584,1048,4632,37
2021-12-08,Humboldt,023,135768,9832,9704,697,10401,117
2021-12-08,Imperial,025,180216,36096,35537,3717,39254,782
2021-12-08,Inyo,027,18085,2604,2570,39,2609,46
2021-12-08,Kern,029,883053,133924,132709,24100,156809,1846
2021-12-08,Kings,031,150075,33846,33468,2031,35499,371
2021-12-08,Lake,033,64148,6990,6927,158,7085,114
2021-12-08,Lassen,035,31185,7085,7041,422,7463,55
2021-12-08,Los Angeles,037,10098052,1485791,1472410,55770,1528180,27018
2021-12-08,Madera,039,155013,24609,24396,2318,26714,311
2021-12-08,Marin,041,260295,18514,18305,541,18846,249
2021-12-08,Mariposa,043,17540,1470,1447,61,1508,6
2021-12-08,Mendocino,045,87422,8242,8118,681,8799,95
2021-12-08,Merced,047,269075,43756,43631,2152,45783,680
2021-12-08,Modoc,049,8938,595,594,201,795,6
2021-12-08,Mono,051,14174,1943,1924,23,1947,4
2021-12-08,Monterey,053,433212,50335,48957,3283,52240,631
2021-12-08,Napa,055,140530,13502,13421,124,13545,107
2021-12-08,Nevada,057,99092,9966,9862,349,10211,106
2021-12-08,Orange,059,3164182,318136,315421,16233,331654,5795
2021-12-08,Placer,061,380077,39339,38934,3899,42833,478
2021-12-08,Plumas,063,18699,1989,1924,46,1970,12
2021-12-08,Riverside,065,2383286,379975,375099,16705,391804,5404
2021-12-08,Sacramento,067,1510023,166707,165278,5025,170303,2373
2021-12-08,San Benito,069,59416,7822,7793,182,7975,79
2021-12-08,San Bernardino,071,2135413,371528,367516,11803,379319,6006
2021-12-08,San Diego,073,3302833,394229,391676,23048,414724,4369
2021-12-08,San Francisco,075,870044,55652,54792,2432,57224,677
2021-12-08,San Joaquin,077,732212,103719,102877,5601,108478,1841
2021-12-08,San Luis Obispo,079,281455,30973,30519,1347,31866,361
2021-12-08,San Mateo,081,765935,56505,55220,988,56208,580
2021-12-08,Santa Barbara,083,443738,46637,46250,1617,47867,558
2021-12-08,Santa Clara,085,1922200,154260,152674,1654,154328,1937
2021-12-08,Santa Cruz,087,273765,21805,21505,1032,22537,224
2021-12-08,Shasta,089,179085,22779,22616,3708,26324,419
2021-12-08,Sierra,091,2930,201,199,21,220,0
2021-12-08,Siskiyou,093,43540,3476,3415,1356,4771,57
2021-12-08,Solano,095,438530,47567,46837,1345,48182,365
2021-12-08,Sonoma,097,501317,43630,43179,584,43763,405
2021-12-08,Stanislaus,099,539301,81959,82038,9272,91310,1264
2021-12-08,Sutter,101,95872,14351,14336,405,14741,187
2021-12-08,Tehama,103,63373,8857,8768,1534,10302,133
2021-12-08,Trinity,105,12862,910,818,220,1038,17
2021-12-08,Tulare,107,460477,71540,70472,16197,86669,1102
2021-12-08,Tuolumne,109,53932,7803,7749,114,7863,91
2021-12-08,Ventura,111,848112,101478,100647,4448,105095,1194
2021-12-08,Yolo,113,214977,20900,20575,1052,21627,267
2021-12-08,Yuba,115,75493,10585,10499,390,10889,92
2021-12-07,Alameda,001,1643700,123998,123325,2908,126233,1497
2021-12-07,Alpine,003,1148,106,108,0,108,0
2021-12-07,Amador,005,37829,5791,5778,70,5848,69
2021-12-07,Butte,007,227075,21985,21761,4091,25852,324
2021-12-07,Calaveras,009,45235,4491,4445,63,4508,88
2021-12-07,Colusa,011,21464,2633,2619,678,3297,21
2021-12-07,Contra Costa,013,1133247,103142,102421,2339,104760,1058
2021-12-07,Del Norte,015,27424,3802,3766,55,3821,42
2021-12-07,El Dorado,017,186661,17003,16742,1802,18544,170
2021-12-07,Fresno,019,978130,147285,145715,13181,158896,2289
2021-12-07,Glenn,021,27897,3614,3579,1048,4627,36
2021-12-07,Humboldt,023,135768,9806,9693,692,10385,117
2021-12-07,Imperial,025,180216,36018,35502,3696,39198,778
2021-12-07,Inyo,027,18085,2601,2567,39,2606,46
2021-12-07,Kern,029,883053,133764,132564,24047,156611,1838
2021-12-07,Kings,031,150075,33814,33441,2028,35469,372
2021-12-07,Lake,033,64148,6986,6925,158,7083,113
2021-12-07,Lassen,035,31185,7083,7040,421,7461,55
2021-12-07,Los Angeles,037,10098052,1484015,1470904,55670,1526574,27007
2021-12-07,Madera,039,155013,24586,24367,2311,26678,311
2021-12-07,Marin,041,260295,18481,18284,535,18819,249
2021-12-07,Mariposa,043,17540,1468,1446,61,1507,6
2021-12-07,Mendocino,045,87422,8223,8107,681,8788,95
2021-12-07,Merced,047,269075,43715,43600,2145,45745,675
2021-12-07,Modoc,049,8938,595,594,200,794,6
2021-12-07,Mono,051,14174,1941,1921,23,1944,4
2021-12-07,Monterey,053,433212,50251,48880,3265,52145,631
2021-12-07,Napa,055,140530,13483,13409,124,13533,107
2021-12-07,Nevada,057,99092,9951,9858,348,10206,105
2021-12-07,Orange,059,3164182,317802,315138,16184,331322,5784
2021-12-07,Placer,061,380077,39263,38860,3895,42755,474
2021-12-07,Plumas,063,18699,1985,1915,46,1961,12
2021-12-07,Riverside,065,2383286,379443,374552,16689,391241,5397
2021-12-07,Sacramento,067,1510023,166459,165148,5011,170159,2375
2021-12-07,San Benito,069,59416,7805,7776,182,7958,78
2021-12-07,San Bernardino,071,2135413,370935,366981,11785,378766,6007
2021-12-07,San Diego,073,3302833,393386,391110,23010,414120,4357
2021-12-07,San Francisco,075,870044,55540,54729,2427,57156,676
2021-12-07,San Joaquin,077,732212,103602,102797,5589,108386,1839
2021-12-07,San Luis Obispo,079,281455,30933,30495,1345,31840,361
2021-12-07,San Mateo,081,765935,56413,55163,982,56145,580
2021-12-07,Santa Barbara,083,443738,46565,46205,1615,47820,556
2021-12-07,Santa Clara,085,1922200,154075,152465,1645,154110,1941
2021-12-07,Santa Cruz,087,273765,21758,21493,1032,22525,224
2021-12-07,Shasta,089,179085,22757,22594,3705,26299,418
2021-12-07,Sierra,091,2930,201,199,21,220,0
2021-12-07,Siskiyou,093,43540,3474,3412,1356,4768,57
2021-12-07,Solano,095,438530,47527,46812,1343,48155,365
2021-12-07,Sonoma,097,501317,43556,43154,583,43737,405
2021-12-07,Stanislaus,099,539301,81881,81980,9261,91241,1258
2021-12-07,Sutter,101,95872,14343,14322,404,14726,186
2021-12-07,Tehama,103,63373,8849,8765,1533,10298,133
2021-12-07,Trinity,105,12862,910,818,220,1038,17
2021-12-07,Tulare,107,460477,71485,70411,16170,86581,1103
2021-12-07,Tuolumne,109,53932,7795,7743,114,7857,91
2021-12-07,Ventura,111,848112,101381,100569,4438,105007,1194
2021-12-07,Yolo,113,214977,20873,20560,1050,21610,263
2021-12-07,Yuba,115,75493,10567,10491,389,10880,91
2021-12-06,Alameda,001,1643700,123832,123227,2904,126131,1496
2021-12-06,Alpine,003,1148,106,108,0,108,0
2021-12-06,Amador,005,37829,5784,5769,69,5838,67
2021-12-06,Butte,007,227075,21967,21732,4088,25820,321
2021-12-06,Calaveras,009,45235,4484,4443,63,4506,88
2021-12-06,Colusa,011,21464,2632,2615,674,3289,21
2021-12-06,Contra Costa,013,1133247,103022,102327,2335,104662,1058
2021-12-06,Del Norte,015,27424,3800,3744,55,3799,42
2021-12-06,El Dorado,017,186661,16978,16726,1800,18526,168
2021-12-06,Fresno,019,978130,147088,145539,13170,158709,2285
2021-12-06,Glenn,021,27897,3611,3577,1047,4624,36
2021-12-06,Humboldt,023,135768,9786,9671,685,10356,117
2021-12-06,Imperial,025,180216,35937,35453,3678,39131,778
2021-12-06,Inyo,027,18085,2595,2562,38,2600,46
2021-12-06,Kern,029,883053,133576,132366,23991,156357,1835
2021-12-06,Kings,031,150075,33781,33399,2023,35422,368
2021-12-06,Lake,033,64148,6982,6922,158,7080,113
2021-12-06,Lassen,035,31185,7078,7032,419,7451,51
2021-12-06,Los Angeles,037,10098052,1482355,1470059,55577,1525636,26993
2021-12-06,Madera,039,155013,24559,24334,2308,26642,307
2021-12-06,Marin,041,260295,18453,18252,533,18785,249
2021-12-06,Mariposa,043,17540,1465,1443,61,1504,6
2021-12-06,Mendocino,045,87422,8210,8079,677,8756,95
2021-12-06,Merced,047,269075,43675,43549,2135,45684,672
2021-12-06,Modoc,049,8938,595,593,200,793,6
2021-12-06,Mono,051,14174,1936,1913,23,1936,4
2021-12-06,Monterey,053,433212,50174,48831,3246,52077,626
2021-12-06,Napa,055,140530,13460,13387,122,13509,107
2021-12-06,Nevada,057,99092,9923,9847,347,10194,105
2021-12-06,Orange,059,3164182,317422,314859,16141,331000,5771
2021-12-06,Placer,061,380077,39205,38785,3890,42675,473
2021-12-06,Plumas,063,18699,1977,1913,46,1959,10
2021-12-06,Riverside,065,2383286,378918,374116,16675,390791,5388
2021-12-06,Sacramento,067,1510023,166183,164926,4990,169916,2367
2021-12-06,San Benito,069,59416,7789,7755,182,7937,78
2021-12-06,San Bernardino,071,2135413,370375,366606,11758,378364,5998
2021-12-06,San Diego,073,3302833,392540,390389,22965,413354,4352
2021-12-06,San Francisco,075,870044,55432,54659,2422,57081,674
2021-12-06,San Joaquin,077,732212,103474,102728,5582,108310,1837
2021-12-06,San Luis Obispo,079,281455,30896,30464,1343,31807,361
2021-12-06,San Mateo,081,765935,56339,55112,979,56091,580
2021-12-06,Santa Barbara,083,443738,46472,46146,1614,47760,556
2021-12-06,Santa Clara,085,1922200,153866,152310,1628,153938,1937
2021-12-06,Santa Cruz,087,273765,21723,21450,1029,22479,224
2021-12-06,Shasta,089,179085,22734,22556,3697,26253,416
2021-12-06,Sierra,091,2930,200,198,21,219,0
2021-12-06,Siskiyou,093,43540,3472,3409,1351,4760,57
2021-12-06,Solano,095,438530,47482,46748,1342,48090,360
2021-12-06,Sonoma,097,501317,43485,43114,575,43689,405
2021-12-06,Stanislaus,099,539301,81784,81889,9227,91116,1241
2021-12-06,Sutter,101,95872,14331,14319,404,14723,186
2021-12-06,Tehama,103,63373,8841,8760,1533,10293,133
2021-12-06,Trinity,105,12862,910,815,219,1034,17
2021-12-06,Tulare,107,460477,71408,70285,16130,86415,1101
2021-12-06,Tuolumne,109,53932,7781,7726,114,7840,91
2021-12-06,Ventura,111,848112,101280,100426,4430,104856,1194
2021-12-06,Yolo,113,214977,20848,20548,1050,21598,263
2021-12-06,Yuba,115,75493,10552,10480,384,10864,91
2021-12-05,Alameda,001,1643700,123646,123104,2897,126001,1496
2021-12-05,Alpine,003,1148,105,108,0,108,0
2021-12-05,Amador,005,37829,5781,5761,69,5830,67
2021-12-05,Butte,007,227075,21933,21720,4082,25802,320
2021-12-05,Calaveras,009,45235,4468,4434,63,4497,88
2021-12-05,Colusa,011,21464,2631,2615,673,3288,21
2021-12-05,Contra Costa,013,1133247,102890,102251,2325,104576,1058
2021-12-05,Del Norte,015,27424,3798,3751,55,3806,42
2021-12-05,El Dorado,017,186661,16939,16717,1795,18512,168
2021-12-05,Fresno,019,978130,146914,145452,13149,158601,2284
2021-12-05,Glenn,021,27897,3609,3577,1046,4623,36
2021-12-05,Humboldt,023,135768,9755,9662,682,10344,117
2021-12-05,Imperial,025,180216,35843,35422,3649,39071,778
2021-12-05,Inyo,027,18085,2588,2559,38,2597,46
2021-12-05,Kern,029,883053,133412,132286,23939,156225,1833
2021-12-05,Kings,031,150075,33718,33360,2023,35383,369
2021-12-05,Lake,033,64148,6977,6919,157,7076,113
2021-12-05,Lassen,035,31185,7076,7031,419,7450,51
2021-12-05,Los Angeles,037,10098052,1480511,1468937,55442,1524379,26991
2021-12-05,Madera,039,155013,24518,24311,2305,26616,307
2021-12-05,Marin,041,260295,18406,18216,525,18741,249
2021-12-05,Mariposa,043,17540,1462,1440,60,1500,6
2021-12-05,Mendocino,045,87422,8191,8069,671,8740,95
2021-12-05,Merced,047,269075,43631,43534,2126,45660,672
2021-12-05,Modoc,049,8938,595,593,200,793,6
2021-12-05,Mono,051,14174,1929,1907,23,1930,4
2021-12-05,Monterey,053,433212,50102,48813,3214,52027,626
2021-12-05,Napa,055,140530,13434,13382,119,13501,107
2021-12-05,Nevada,057,99092,9902,9827,346,10173,105
2021-12-05,Orange,059,3164182,316985,314560,16099,330659,5771
2021-12-05,Placer,061,380077,39147,38738,3881,42619,473
2021-12-05,Plumas,063,18699,1973,1913,45,1958,9
2021-12-05,Riverside,065,2383286,378259,373827,16645,390472,5388
2021-12-05,Sacramento,067,1510023,165879,164721,4972,169693,2367
2021-12-05,San Benito,069,59416,7772,7748,181,7929,78
2021-12-05,San Bernardino,071,2135413,369667,366282,11711,377993,5998
2021-12-05,San Diego,073,3302833,391745,387979,22916,410895,4351
2021-12-05,San Francisco,075,870044,55330,54603,2420,57023,674
2021-12-05,San Joaquin,077,732212,103332,102698,5577,108275,1837
2021-12-05,San Luis Obispo,079,281455,30826,30454,1340,31794,360
2021-12-05,San Mateo,081,765935,56250,55050,969,56019,580
2021-12-05,Santa Barbara,083,443738,46389,46097,1606,47703,555
2021-12-05,Santa Clara,085,1922200,153612,152114,1610,153724,1933
2021-12-05,Santa Cruz,087,273765,21673,21424,1029,22453,224
2021-12-05,Shasta,089,179085,22678,22550,3696,26246,416
2021-12-05,Sierra,091,2930,200,198,21,219,0
2021-12-05,Siskiyou,093,43540,3470,3409,1350,4759,57
2021-12-05,Solano,095,438530,47419,46715,1340,48055,360
2021-12-05,Sonoma,097,501317,43408,43038,570,43608,405
2021-12-05,Stanislaus,099,539301,81645,81847,9217,91064,1241
2021-12-05,Sutter,101,95872,14308,14303,399,14702,186
2021-12-05,Tehama,103,63373,8833,8755,1531,10286,133
2021-12-05,Trinity,105,12862,909,815,219,1034,17
2021-12-05,Tulare,107,460477,71327,70254,16082,86336,1102
2021-12-05,Tuolumne,109,53932,7768,7718,114,7832,91
2021-12-05,Ventura,111,848112,101144,100367,4417,104784,1194
2021-12-05,Yolo,113,214977,20805,20512,1049,21561,263
2021-12-05,Yuba,115,75493,10539,10467,377,10844,91
2021-12-04,Alameda,001,1643700,123533,122508,2894,125402,1494
2021-12-04,Alpine,003,1148,105,108,0,108,0
2021-12-04,Amador,005,37829,5778,5729,69,5798,67
2021-12-04,Butte,007,227075,21914,21638,4078,25716,318
2021-12-04,Calaveras,009,45235,4460,4392,62,4454,88
2021-12-04,Colusa,011,21464,2631,2600,671,3271,21
2021-12-04,Contra Costa,013,1133247,102818,101824,2319,104143,1056
2021-12-04,Del Norte,015,27424,3795,3726,55,3781,42
2021-12-04,El Dorado,017,186661,16930,16621,1794,18415,168
2021-12-04,Fresno,019,978130,146824,144734,13141,157875,2270
2021-12-04,Glenn,021,27897,3609,3559,1046,4605,36
2021-12-04,Humboldt,023,135768,9740,9596,678,10274,117
2021-12-04,Imperial,025,180216,35790,35206,3636,38842,776
2021-12-04,Inyo,027,18085,2583,2538,38,2576,46
2021-12-04,Kern,029,883053,133332,131771,23916,155687,1817
2021-12-04,Kings,031,150075,33694,33183,2022,35205,367
2021-12-04,Lake,033,64148,6968,6903,157,7060,113
2021-12-04,Lassen,035,31185,7075,7014,417,7431,51
2021-12-04,Los Angeles,037,10098052,1479634,1463270,55364,1518634,26952
2021-12-04,Madera,039,155013,24504,24188,2301,26489,307
2021-12-04,Marin,041,260295,18385,18075,524,18599,249
2021-12-04,Mariposa,043,17540,1458,1421,60,1481,6
2021-12-04,Mendocino,045,87422,8186,7981,671,8652,91
2021-12-04,Merced,047,269075,43604,43337,2124,45461,671
2021-12-04,Modoc,049,8938,595,591,200,791,6
2021-12-04,Mono,051,14174,1929,1883,23,1906,4
2021-12-04,Monterey,053,433212,50070,48682,3207,51889,626
2021-12-04,Napa,055,140530,13424,13327,118,13445,106
2021-12-04,Nevada,057,99092,9894,9752,346,10098,105
2021-12-04,Orange,059,3164182,316753,313112,16073,329185,5748
2021-12-04,Placer,061,380077,39107,38460,3875,42335,473
2021-12-04,Plumas,063,18699,1970,1903,45,1948,7
2021-12-04,Riverside,065,2383286,377900,371768,16639,388407,5381
2021-12-04,Sacramento,067,1510023,165736,163900,4964,168864,2365
2021-12-04,San Benito,069,59416,7746,7688,181,7869,78
2021-12-04,San Bernardino,071,2135413,369278,364154,11698,375852,5983
2021-12-04,San Diego,073,3302833,391267,386710,22886,409596,4350
2021-12-04,San Francisco,075,870044,55262,54286,2417,56703,674
2021-12-04,San Joaquin,077,732212,103277,102286,5575,107861,1835
2021-12-04,San Luis Obispo,079,281455,30805,30318,1336,31654,360
2021-12-04,San Mateo,081,765935,56201,54774,966,55740,579
2021-12-04,Santa Barbara,083,443738,46344,45774,1606,47380,555
2021-12-04,Santa Clara,085,1922200,153458,151275,1596,152871,1928
2021-12-04,Santa Cruz,087,273765,21647,21286,1028,22314,224
2021-12-04,Shasta,089,179085,22661,22418,3694,26112,414
2021-12-04,Sierra,091,2930,200,196,21,217,0
2021-12-04,Siskiyou,093,43540,3468,3398,1350,4748,57
2021-12-04,Solano,095,438530,47399,46529,1339,47868,360
2021-12-04,Sonoma,097,501317,43363,42778,567,43345,405
2021-12-04,Stanislaus,099,539301,81573,81462,9210,90672,1231
2021-12-04,Sutter,101,95872,14300,14258,398,14656,186
2021-12-04,Tehama,103,63373,8831,8742,1531,10273,131
2021-12-04,Trinity,105,12862,908,801,219,1020,17
2021-12-04,Tulare,107,460477,71289,70014,16054,86068,1100
2021-12-04,Tuolumne,109,53932,7763,7676,114,7790,91
2021-12-04,Ventura,111,848112,101053,99751,4413,104164,1192
2021-12-04,Yolo,113,214977,20782,20442,1047,21489,261
2021-12-04,Yuba,115,75493,10528,10418,376,10794,91
2021-12-03,Alameda,001,1643700,123440,122508,2884,125392,1494
2021-12-03,Alpine,003,1148,105,108,0,108,0
2021-12-03,Amador,005,37829,5773,5729,68,5797,67
2021-12-03,Butte,007,227075,21901,21638,4073,25711,318
2021-12-03,Calaveras,009,45235,4451,4392,62,4454,88
2021-12-03,Colusa,011,21464,2629,2600,671,3271,21
2021-12-03,Contra Costa,013,1133247,102745,101824,2313,104137,1056
2021-12-03,Del Norte,015,27424,3793,3726,55,3781,42
2021-12-03,El Dorado,017,186661,16900,16621,1792,18413,168
2021-12-03,Fresno,019,978130,146710,144734,13138,157872,2270
2021-12-03,Glenn,021,27897,3608,3559,1045,4604,36
2021-12-03,Humboldt,023,135768,9723,9596,676,10272,117
2021-12-03,Imperial,025,180216,35748,35206,3606,38812,776
2021-12-03,Inyo,027,18085,2576,2538,38,2576,46
2021-12-03,Kern,029,883053,133260,131771,23881,155652,1817
2021-12-03,Kings,031,150075,33667,33183,2022,35205,367
2021-12-03,Lake,033,64148,6968,6903,157,7060,113
2021-12-03,Lassen,035,31185,7073,7014,416,7430,51
2021-12-03,Los Angeles,037,10098052,1478688,1463270,55289,1518559,26952
2021-12-03,Madera,039,155013,24478,24188,2297,26485,307
2021-12-03,Marin,041,260295,18352,18075,520,18595,249
2021-12-03,Mariposa,043,17540,1456,1421,60,1481,6
2021-12-03,Mendocino,045,87422,8179,7981,671,8652,91
2021-12-03,Merced,047,269075,43581,43337,2121,45458,671
2021-12-03,Modoc,049,8938,595,591,200,791,6
2021-12-03,Mono,051,14174,1923,1883,23,1906,4
2021-12-03,Monterey,053,433212,50031,48682,3196,51878,626
2021-12-03,Napa,055,140530,13412,13327,118,13445,106
2021-12-03,Nevada,057,99092,9883,9752,346,10098,105
2021-12-03,Orange,059,3164182,316484,313112,16041,329153,5748
2021-12-03,Placer,061,380077,39070,38460,3868,42328,473
2021-12-03,Plumas,063,18699,1967,1903,45,1948,7
2021-12-03,Riverside,065,2383286,377508,371768,16633,388401,5381
2021-12-03,Sacramento,067,1510023,165555,163900,4950,168850,2365
2021-12-03,San Benito,069,59416,7739,7688,181,7869,78
2021-12-03,San Bernardino,071,2135413,368830,364154,11687,375841,5983
2021-12-03,San Diego,073,3302833,390791,386710,22862,409572,4350
2021-12-03,San Francisco,075,870044,55192,54286,2413,56699,674
2021-12-03,San Joaquin,077,732212,103221,102286,5574,107860,1835
2021-12-03,San Luis Obispo,079,281455,30779,30318,1333,31651,360
2021-12-03,San Mateo,081,765935,56136,54774,963,55737,579
2021-12-03,Santa Barbara,083,443738,46308,45774,1606,47380,555
2021-12-03,Santa Clara,085,1922200,153278,151275,1582,152857,1928
2021-12-03,Santa Cruz,087,273765,21620,21286,1028,22314,224
2021-12-03,Shasta,089,179085,22646,22418,3694,26112,414
2021-12-03,Sierra,091,2930,200,196,21,217,0
2021-12-03,Siskiyou,093,43540,3465,3398,1348,4746,57
2021-12-03,Solano,095,438530,47357,46529,1338,47867,360
2021-12-03,Sonoma,097,501317,43327,42778,565,43343,405
2021-12-03,Stanislaus,099,539301,81516,81462,9201,90663,1231
2021-12-03,Sutter,101,95872,14287,14258,396,14654,186
2021-12-03,Tehama,103,63373,8830,8742,1530,10272,131
2021-12-03,Trinity,105,12862,908,801,219,1020,17
2021-12-03,Tulare,107,460477,71250,70014,16023,86037,1100
2021-12-03,Tuolumne,109,53932,7754,7676,114,7790,91
2021-12-03,Ventura,111,848112,100967,99751,4406,104157,1192
2021-12-03,Yolo,113,214977,20765,20442,1046,21488,261
2021-12-03,Yuba,115,75493,10520,10418,376,10794,91
2021-12-02,Alameda,001,1643700,123282,122508,2877,125385,1494
2021-12-02,Alpine,003,1148,105,108,0,108,0
2021-12-02,Amador,005,37829,5768,5729,67,5796,67
2021-12-02,Butte,007,227075,21876,21638,4068,25706,318
2021-12-02,Calaveras,009,45235,4441,4392,61,4453,88
2021-12-02,Colusa,011,21464,2628,2600,671,3271,21
2021-12-02,Contra Costa,013,1133247,102631,101824,2309,104133,1056
2021-12-02,Del Norte,015,27424,3785,3726,55,3781,42
2021-12-02,El Dorado,017,186661,16879,16621,1790,18411,168
2021-12-02,Fresno,019,978130,146540,144734,13124,157858,2270
2021-12-02,Glenn,021,27897,3608,3559,1042,4601,36
2021-12-02,Humboldt,023,135768,9704,9596,675,10271,117
2021-12-02,Imperial,025,180216,35680,35206,3584,38790,776
2021-12-02,Inyo,027,18085,2571,2538,38,2576,46
2021-12-02,Kern,029,883053,133090,131771,23829,155600,1817
2021-12-02,Kings,031,150075,33614,33183,2020,35203,367
2021-12-02,Lake,033,64148,6964,6903,157,7060,113
2021-12-02,Lassen,035,31185,7069,7014,416,7430,51
2021-12-02,Los Angeles,037,10098052,1477171,1463270,55201,1518471,26952
2021-12-02,Madera,039,155013,24441,24188,2288,26476,307
2021-12-02,Marin,041,260295,18321,18075,516,18591,249
2021-12-02,Mariposa,043,17540,1453,1421,60,1481,6
2021-12-02,Mendocino,045,87422,8163,7981,670,8651,91
2021-12-02,Merced,047,269075,43535,43337,2116,45453,671
2021-12-02,Modoc,049,8938,594,591,200,791,6
2021-12-02,Mono,051,14174,1917,1883,23,1906,4
2021-12-02,Monterey,053,433212,49956,48682,3175,51857,626
2021-12-02,Napa,055,140530,13399,13327,118,13445,106
2021-12-02,Nevada,057,99092,9865,9752,345,10097,105
2021-12-02,Orange,059,3164182,316140,313112,16004,329116,5748
2021-12-02,Placer,061,380077,39004,38460,3863,42323,473
2021-12-02,Plumas,063,18699,1964,1903,45,1948,7
2021-12-02,Riverside,065,2383286,376980,371768,16623,388391,5381
2021-12-02,Sacramento,067,1510023,165328,163900,4940,168840,2365
2021-12-02,San Benito,069,59416,7719,7688,181,7869,78
2021-12-02,San Bernardino,071,2135413,368276,364154,11667,375821,5983
2021-12-02,San Diego,073,3302833,390151,386710,22807,409517,4350
2021-12-02,San Francisco,075,870044,55097,54286,2408,56694,674
2021-12-02,San Joaquin,077,732212,103107,102286,5569,107855,1835
2021-12-02,San Luis Obispo,079,281455,30745,30318,1326,31644,360
2021-12-02,San Mateo,081,765935,56055,54774,955,55729,579
2021-12-02,Santa Barbara,083,443738,46227,45774,1603,47377,555
2021-12-02,Santa Clara,085,1922200,153033,151275,1565,152840,1928
2021-12-02,Santa Cruz,087,273765,21569,21286,1027,22313,224
2021-12-02,Shasta,089,179085,22613,22418,3693,26111,414
2021-12-02,Sierra,091,2930,200,196,21,217,0
2021-12-02,Siskiyou,093,43540,3464,3398,1341,4739,57
2021-12-02,Solano,095,438530,47307,46529,1336,47865,360
2021-12-02,Sonoma,097,501317,43253,42778,565,43343,405
2021-12-02,Stanislaus,099,539301,81421,81462,9193,90655,1231
2021-12-02,Sutter,101,95872,14274,14258,393,14651,186
2021-12-02,Tehama,103,63373,8823,8742,1528,10270,131
2021-12-02,Trinity,105,12862,908,801,219,1020,17
2021-12-02,Tulare,107,460477,71163,70014,15973,85987,1100
2021-12-02,Tuolumne,109,53932,7739,7676,113,7789,91
2021-12-02,Ventura,111,848112,100842,99751,4404,104155,1192
2021-12-02,Yolo,113,214977,20737,20442,1046,21488,261
2021-12-02,Yuba,115,75493,10504,10418,373,10791,91
2021-12-01,Alameda,001,1643700,123131,122298,2868,125166,1492
2021-12-01,Alpine,003,1148,105,108,0,108,0
2021-12-01,Amador,005,37829,5761,5723,67,5790,67
2021-12-01,Butte,007,227075,21858,21600,4063,25663,318
2021-12-01,Calaveras,009,45235,4436,4371,61,4432,88
2021-12-01,Colusa,011,21464,2621,2595,669,3264,20
2021-12-01,Contra Costa,013,1133247,102523,101651,2299,103950,1048
2021-12-01,Del Norte,015,27424,3783,3722,55,3777,42
2021-12-01,El Dorado,017,186661,16858,16575,1788,18363,166
2021-12-01,Fresno,019,978130,146333,144507,13115,157622,2264
2021-12-01,Glenn,021,27897,3602,3556,1041,4597,36
2021-12-01,Humboldt,023,135768,9680,9573,670,10243,117
2021-12-01,Imperial,025,180216,35600,35085,3557,38642,776
2021-12-01,Inyo,027,18085,2567,2533,38,2571,46
2021-12-01,Kern,029,883053,132942,131580,23775,155355,1804
2021-12-01,Kings,031,150075,33564,33112,2019,35131,364
2021-12-01,Lake,033,64148,6956,6896,156,7052,112
2021-12-01,Lassen,035,31185,7064,7008,414,7422,51
2021-12-01,Los Angeles,037,10098052,1475579,1461394,55107,1516501,26928
2021-12-01,Madera,039,155013,24410,24134,2279,26413,307
2021-12-01,Marin,041,260295,18283,18038,510,18548,249
2021-12-01,Mariposa,043,17540,1449,1415,60,1475,6
2021-12-01,Mendocino,045,87422,8149,7966,665,8631,90
2021-12-01,Merced,047,269075,43480,43259,2095,45354,670
2021-12-01,Modoc,049,8938,594,576,200,776,5
2021-12-01,Mono,051,14174,1912,1876,23,1899,4
2021-12-01,Monterey,053,433212,49907,48611,3166,51777,626
2021-12-01,Napa,055,140530,13382,13319,115,13434,107
2021-12-01,Nevada,057,99092,9852,9706,345,10051,105
2021-12-01,Orange,059,3164182,315773,312772,15968,328740,5735
2021-12-01,Placer,061,380077,38949,38373,3857,42230,472
2021-12-01,Plumas,063,18699,1960,1893,45,1938,7
2021-12-01,Riverside,065,2383286,376454,371189,16606,387795,5369
2021-12-01,Sacramento,067,1510023,165115,163616,4923,168539,2360
2021-12-01,San Benito,069,59416,7705,7669,181,7850,78
2021-12-01,San Bernardino,071,2135413,367683,363368,11641,375009,5973
2021-12-01,San Diego,073,3302833,389354,386056,22751,408807,4346
2021-12-01,San Francisco,075,870044,55015,54199,2401,56600,672
2021-12-01,San Joaquin,077,732212,102999,102109,5568,107677,1834
2021-12-01,San Luis Obispo,079,281455,30703,30238,1322,31560,360
2021-12-01,San Mateo,081,765935,55974,54711,952,55663,579
2021-12-01,Santa Barbara,083,443738,46157,45681,1601,47282,554
2021-12-01,Santa Clara,085,1922200,152811,150961,1547,152508,1925
2021-12-01,Santa Cruz,087,273765,21540,21191,1026,22217,224
2021-12-01,Shasta,089,179085,22582,22375,3687,26062,410
2021-12-01,Sierra,091,2930,200,195,21,216,0
2021-12-01,Siskiyou,093,43540,3461,3391,1341,4732,55
2021-12-01,Solano,095,438530,47262,46485,1336,47821,360
2021-12-01,Sonoma,097,501317,43178,42713,564,43277,405
2021-12-01,Stanislaus,099,539301,81324,81330,9180,90510,1231
2021-12-01,Sutter,101,95872,14259,14229,392,14621,186
2021-12-01,Tehama,103,63373,8813,8728,1528,10256,130
2021-12-01,Trinity,105,12862,903,801,219,1020,17
2021-12-01,Tulare,107,460477,71088,69953,15933,85886,1098
2021-12-01,Tuolumne,109,53932,7731,7655,113,7768,91
2021-12-01,Ventura,111,848112,100736,99680,4393,104073,1191
2021-12-01,Yolo,113,214977,20709,20393,1046,21439,260
2021-12-01,Yuba,115,75493,10493,10401,373,10774,89
2021-11-30,Alameda,001,1643700,122960,122196,2860,125056,1489
2021-11-30,Alpine,003,1148,105,108,0,108,0
2021-11-30,Amador,005,37829,5753,5716,67,5783,66
2021-11-30,Butte,007,227075,21829,21565,4052,25617,318
2021-11-30,Calaveras,009,45235,4418,4360,61,4421,88
2021-11-30,Colusa,011,21464,2620,2592,669,3261,21
2021-11-30,Contra Costa,013,1133247,102389,101538,2292,103830,1046
2021-11-30,Del Norte,015,27424,3777,3718,55,3773,42
2021-11-30,El Dorado,017,186661,16830,16558,1782,18340,166
2021-11-30,Fresno,019,978130,146133,144384,13106,157490,2259
2021-11-30,Glenn,021,27897,3597,3555,1040,4595,36
2021-11-30,Humboldt,023,135768,9649,9539,664,10203,116
2021-11-30,Imperial,025,180216,35492,34999,3530,38529,773
2021-11-30,Inyo,027,18085,2558,2530,38,2568,46
2021-11-30,Kern,029,883053,132774,131451,23720,155171,1799
2021-11-30,Kings,031,150075,33512,33074,2015,35089,362
2021-11-30,Lake,033,64148,6950,6892,154,7046,110
2021-11-30,Lassen,035,31185,7060,7003,413,7416,51
2021-11-30,Los Angeles,037,10098052,1473780,1460177,55007,1515184,26913
2021-11-30,Madera,039,155013,24376,24108,2274,26382,307
2021-11-30,Marin,041,260295,18239,18010,508,18518,249
2021-11-30,Mariposa,043,17540,1443,1412,60,1472,6
2021-11-30,Mendocino,045,87422,8120,7960,659,8619,89
2021-11-30,Merced,047,269075,43412,43200,2087,45287,668
2021-11-30,Modoc,049,8938,593,576,200,776,5
2021-11-30,Mono,051,14174,1909,1873,23,1896,4
2021-11-30,Monterey,053,433212,49844,48581,3155,51736,626
2021-11-30,Napa,055,140530,13362,13308,115,13423,105
2021-11-30,Nevada,057,99092,9836,9699,344,10043,105
2021-11-30,Orange,059,3164182,315352,312451,15926,328377,5724
2021-11-30,Placer,061,380077,38846,38324,3849,42173,470
2021-11-30,Plumas,063,18699,1955,1887,44,1931,7
2021-11-30,Riverside,065,2383286,375770,370739,16581,387320,5358
2021-11-30,Sacramento,067,1510023,164833,163420,4900,168320,2353
2021-11-30,San Benito,069,59416,7683,7645,180,7825,78
2021-11-30,San Bernardino,071,2135413,366996,363006,11618,374624,5967
2021-11-30,San Diego,073,3302833,388427,385405,22704,408109,4340
2021-11-30,San Francisco,075,870044,54909,54147,2392,56539,672
2021-11-30,San Joaquin,077,732212,102872,101972,5560,107532,1834
2021-11-30,San Luis Obispo,079,281455,30678,30200,1320,31520,360
2021-11-30,San Mateo,081,765935,55869,54656,942,55598,579
2021-11-30,Santa Barbara,083,443738,46061,45628,1595,47223,553
2021-11-30,Santa Clara,085,1922200,152554,150799,1530,152329,1929
2021-11-30,Santa Cruz,087,273765,21481,21169,1022,22191,224
2021-11-30,Shasta,089,179085,22552,22347,3684,26031,401
2021-11-30,Sierra,091,2930,197,195,21,216,0
2021-11-30,Siskiyou,093,43540,3457,3385,1338,4723,55
2021-11-30,Solano,095,438530,47199,46434,1330,47764,358
2021-11-30,Sonoma,097,501317,43099,42663,561,43224,405
2021-11-30,Stanislaus,099,539301,81220,81276,9152,90428,1227
2021-11-30,Sutter,101,95872,14248,14210,389,14599,186
2021-11-30,Tehama,103,63373,8806,8727,1527,10254,130
2021-11-30,Trinity,105,12862,902,799,219,1018,17
2021-11-30,Tulare,107,460477,71001,69900,15887,85787,1099
2021-11-30,Tuolumne,109,53932,7716,7643,113,7756,91
2021-11-30,Ventura,111,848112,100582,99601,4382,103983,1191
2021-11-30,Yolo,113,214977,20664,20376,1043,21419,260
2021-11-30,Yuba,115,75493,10474,10398,368,10766,89
2021-11-29,Alameda,001,1643700,122799,122136,2851,124987,1489
2021-11-29,Alpine,003,1148,105,108,0,108,0
2021-11-29,Amador,005,37829,5746,5706,67,5773,66
2021-11-29,Butte,007,227075,21798,21544,4045,25589,314
2021-11-29,Calaveras,009,45235,4402,4353,61,4414,88
2021-11-29,Colusa,011,21464,2618,2585,666,3251,20
2021-11-29,Contra Costa,013,1133247,102240,101441,2284,103725,1046
2021-11-29,Del Norte,015,27424,3774,3704,55,3759,42
2021-11-29,El Dorado,017,186661,16812,16534,1777,18311,166
2021-11-29,Fresno,019,978130,145926,144282,13083,157365,2254
2021-11-29,Glenn,021,27897,3594,3555,1039,4594,36
2021-11-29,Humboldt,023,135768,9632,9514,657,10171,115
2021-11-29,Imperial,025,180216,35427,34960,3509,38469,773
2021-11-29,Inyo,027,18085,2553,2529,38,2567,46
2021-11-29,Kern,029,883053,132590,131362,23679,155041,1789
2021-11-29,Kings,031,150075,33459,33059,2011,35070,363
2021-11-29,Lake,033,64148,6938,6889,154,7043,110
2021-11-29,Lassen,035,31185,7057,7003,411,7414,51
2021-11-29,Los Angeles,037,10098052,1471933,1459446,54922,1514368,26889
2021-11-29,Madera,039,155013,24340,24069,2266,26335,307
2021-11-29,Marin,041,260295,18192,17980,503,18483,249
2021-11-29,Mariposa,043,17540,1435,1409,60,1469,6
2021-11-29,Mendocino,045,87422,8103,7954,655,8609,89
2021-11-29,Merced,047,269075,43339,43167,2079,45246,667
2021-11-29,Modoc,049,8938,592,569,200,769,5
2021-11-29,Mono,051,14174,1892,1859,23,1882,4
2021-11-29,Monterey,053,433212,49783,48548,3139,51687,626
2021-11-29,Napa,055,140530,13352,13304,115,13419,104
2021-11-29,Nevada,057,99092,9822,9689,344,10033,105
2021-11-29,Orange,059,3164182,314948,312203,15881,328084,5709
2021-11-29,Placer,061,380077,38781,38261,3844,42105,470
2021-11-29,Plumas,063,18699,1952,1884,44,1928,7
2021-11-29,Riverside,065,2383286,375232,370334,16570,386904,5358
2021-11-29,Sacramento,067,1510023,164584,163282,4868,168150,2342
2021-11-29,San Benito,069,59416,7663,7631,179,7810,77
2021-11-29,San Bernardino,071,2135413,366392,362694,11584,374278,5962
2021-11-29,San Diego,073,3302833,387539,384853,22670,407523,4335
2021-11-29,San Francisco,075,870044,54810,54125,2388,56513,669
2021-11-29,San Joaquin,077,732212,102733,101927,5553,107480,1834
2021-11-29,San Luis Obispo,079,281455,30644,30165,1316,31481,359
2021-11-29,San Mateo,081,765935,55766,54622,938,55560,579
2021-11-29,Santa Barbara,083,443738,45964,45576,1591,47167,549
2021-11-29,Santa Clara,085,1922200,152277,150620,1524,152144,1925
2021-11-29,Santa Cruz,087,273765,21443,21149,1021,22170,224
2021-11-29,Shasta,089,179085,22517,22315,3680,25995,399
2021-11-29,Sierra,091,2930,197,195,21,216,0
2021-11-29,Siskiyou,093,43540,3454,3374,1331,4705,55
2021-11-29,Solano,095,438530,47147,46412,1328,47740,357
2021-11-29,Sonoma,097,501317,43022,42624,558,43182,405
2021-11-29,Stanislaus,099,539301,81138,81227,9134,90361,1223
2021-11-29,Sutter,101,95872,14232,14204,386,14590,186
2021-11-29,Tehama,103,63373,8801,8720,1522,10242,130
2021-11-29,Trinity,105,12862,897,798,219,1017,17
2021-11-29,Tulare,107,460477,70921,69850,15853,85703,1096
2021-11-29,Tuolumne,109,53932,7703,7627,113,7740,90
2021-11-29,Ventura,111,848112,100462,99520,4373,103893,1190
2021-11-29,Yolo,113,214977,20619,20344,1041,21385,257
2021-11-29,Yuba,115,75493,10457,10395,367,10762,89
2021-11-28,Alameda,001,1643700,122580,122082,2845,124927,1491
2021-11-28,Alpine,003,1148,105,108,0,108,0
2021-11-28,Amador,005,37829,5736,5703,67,5770,66
2021-11-28,Butte,007,227075,21757,21530,4042,25572,313
2021-11-28,Calaveras,009,45235,4381,4350,61,4411,88
2021-11-28,Colusa,011,21464,2614,2586,665,3251,19
2021-11-28,Contra Costa,013,1133247,102067,101355,2274,103629,1046
2021-11-28,Del Norte,015,27424,3769,3703,55,3758,42
2021-11-28,El Dorado,017,186661,16771,16527,1776,18303,166
2021-11-28,Fresno,019,978130,145680,144164,13056,157220,2252
2021-11-28,Glenn,021,27897,3591,3547,1037,4584,36
2021-11-28,Humboldt,023,135768,9600,9499,653,10152,115
2021-11-28,Imperial,025,180216,35319,34929,3485,38414,773
2021-11-28,Inyo,027,18085,2546,2531,38,2569,46
2021-11-28,Kern,029,883053,132383,131279,23622,154901,1789
2021-11-28,Kings,031,150075,33386,33057,2005,35062,364
2021-11-28,Lake,033,64148,6928,6885,153,7038,110
2021-11-28,Lassen,035,31185,7048,7002,407,7409,51
2021-11-28,Los Angeles,037,10098052,1469769,1458646,54835,1513481,26878
2021-11-28,Madera,039,155013,24292,24055,2259,26314,307
2021-11-28,Marin,041,260295,18145,17962,499,18461,249
2021-11-28,Mariposa,043,17540,1431,1406,60,1466,6
2021-11-28,Mendocino,045,87422,8073,7943,650,8593,89
2021-11-28,Merced,047,269075,43273,43166,2064,45230,667
2021-11-28,Modoc,049,8938,591,569,200,769,5
2021-11-28,Mono,051,14174,1886,1841,23,1864,4
2021-11-28,Monterey,053,433212,49718,48537,3119,51656,626
2021-11-28,Napa,055,140530,13339,13303,115,13418,104
2021-11-28,Nevada,057,99092,9796,9684,343,10027,105
2021-11-28,Orange,059,3164182,314563,312028,15839,327867,5693
2021-11-28,Placer,061,380077,38699,38240,3825,42065,470
2021-11-28,Plumas,063,18699,1946,1884,43,1927,7
2021-11-28,Riverside,065,2383286,374569,370051,16548,386599,5358
2021-11-28,Sacramento,067,1510023,164226,163170,4845,168015,2335
2021-11-28,San Benito,069,59416,7644,7623,178,7801,77
2021-11-28,San Bernardino,071,2135413,365650,362407,11556,373963,5958
2021-11-28,San Diego,073,3302833,386651,383025,22606,405631,4325
2021-11-28,San Francisco,075,870044,54734,54082,2383,56465,669
2021-11-28,San Joaquin,077,732212,102552,101895,5536,107431,1834
2021-11-28,San Luis Obispo,079,281455,30581,30152,1312,31464,358
2021-11-28,San Mateo,081,765935,55672,54567,934,55501,579
2021-11-28,Santa Barbara,083,443738,45885,45551,1580,47131,549
2021-11-28,Santa Clara,085,1922200,151977,150436,1510,151946,1920
2021-11-28,Santa Cruz,087,273765,21372,21110,1020,22130,224
2021-11-28,Shasta,089,179085,22478,22316,3678,25994,400
2021-11-28,Sierra,091,2930,197,195,21,216,0
2021-11-28,Siskiyou,093,43540,3448,3372,1327,4699,55
2021-11-28,Solano,095,438530,47085,46385,1327,47712,356
2021-11-28,Sonoma,097,501317,42936,42583,555,43138,405
2021-11-28,Stanislaus,099,539301,81013,81181,9112,90293,1223
2021-11-28,Sutter,101,95872,14211,14192,380,14572,186
2021-11-28,Tehama,103,63373,8793,8720,1518,10238,130
2021-11-28,Trinity,105,12862,896,797,219,1016,17
2021-11-28,Tulare,107,460477,70824,69833,15801,85634,1095
2021-11-28,Tuolumne,109,53932,7683,7620,113,7733,90
2021-11-28,Ventura,111,848112,100306,99486,4362,103848,1190
2021-11-28,Yolo,113,214977,20575,20333,1041,21374,257
2021-11-28,Yuba,115,75493,10439,10391,365,10756,89
2021-11-27,Alameda,001,1643700,122482,121618,2842,124460,1477
2021-11-27,Alpine,003,1148,105,106,0,106,0
2021-11-27,Amador,005,37829,5735,5670,67,5737,66
2021-11-27,Butte,007,227075,21734,21384,4037,25421,309
2021-11-27,Calaveras,009,45235,4375,4294,61,4355,85
2021-11-27,Colusa,011,21464,2613,2568,663,3231,19
2021-11-27,Contra Costa,013,1133247,101982,100961,2273,103234,1045
2021-11-27,Del Norte,015,27424,3762,3661,55,3716,42
2021-11-27,El Dorado,017,186661,16737,16399,1775,18174,161
2021-11-27,Fresno,019,978130,145568,143386,13050,156436,2246
2021-11-27,Glenn,021,27897,3587,3532,1036,4568,36
2021-11-27,Humboldt,023,135768,9572,9399,651,10050,115
2021-11-27,Imperial,025,180216,35236,34611,3469,38080,769
2021-11-27,Inyo,027,18085,2543,2506,38,2544,45
2021-11-27,Kern,029,883053,132298,130245,23593,153838,1773
2021-11-27,Kings,031,150075,33364,32891,2002,34893,358
2021-11-27,Lake,033,64148,6925,6836,152,6988,110
2021-11-27,Lassen,035,31185,7046,6959,406,7365,47
2021-11-27,Los Angeles,037,10098052,1468763,1454495,54766,1509261,26817
2021-11-27,Madera,039,155013,24271,23880,2254,26134,296
2021-11-27,Marin,041,260295,18106,17857,494,18351,248
2021-11-27,Mariposa,043,17540,1429,1374,60,1434,6
2021-11-27,Mendocino,045,87422,8054,7871,650,8521,89
2021-11-27,Merced,047,269075,43238,42921,2061,44982,664
2021-11-27,Modoc,049,8938,589,551,200,751,5
2021-11-27,Mono,051,14174,1884,1810,23,1833,4
2021-11-27,Monterey,053,433212,49685,48400,3105,51505,625
2021-11-27,Napa,055,140530,13325,13256,115,13371,104
2021-11-27,Nevada,057,99092,9774,9584,342,9926,103
2021-11-27,Orange,059,3164182,314312,310809,15802,326611,5665
2021-11-27,Placer,061,380077,38638,38001,3819,41820,468
2021-11-27,Plumas,063,18699,1942,1860,43,1903,7
2021-11-27,Riverside,065,2383286,374211,367601,16541,384142,5306
2021-11-27,Sacramento,067,1510023,164068,162328,4842,167170,2335
2021-11-27,San Benito,069,59416,7628,7575,178,7753,77
2021-11-27,San Bernardino,071,2135413,365215,360033,11547,371580,5932
2021-11-27,San Diego,073,3302833,386156,382634,22580,405214,4319
2021-11-27,San Francisco,075,870044,54683,53830,2380,56210,669
2021-11-27,San Joaquin,077,732212,102484,101368,5533,106901,1833
2021-11-27,San Luis Obispo,079,281455,30546,29983,1308,31291,358
2021-11-27,San Mateo,081,765935,55615,54360,931,55291,577
2021-11-27,Santa Barbara,083,443738,45831,45318,1578,46896,548
2021-11-27,Santa Clara,085,1922200,151770,149700,1503,151203,1922
2021-11-27,Santa Cruz,087,273765,21332,20929,1017,21946,222
2021-11-27,Shasta,089,179085,22455,22151,3677,25828,396
2021-11-27,Sierra,091,2930,196,194,21,215,0
2021-11-27,Siskiyou,093,43540,3445,3336,1325,4661,54
2021-11-27,Solano,095,438530,47049,46163,1324,47487,356
2021-11-27,Sonoma,097,501317,42873,42368,555,42923,405
2021-11-27,Stanislaus,099,539301,80944,80782,9095,89877,1220
2021-11-27,Sutter,101,95872,14203,14127,379,14506,181
2021-11-27,Tehama,103,63373,8791,8675,1517,10192,129
2021-11-27,Trinity,105,12862,896,789,219,1008,17
2021-11-27,Tulare,107,460477,70771,69377,15785,85162,1082
2021-11-27,Tuolumne,109,53932,7670,7574,113,7687,90
2021-11-27,Ventura,111,848112,100233,99163,4355,103518,1188
2021-11-27,Yolo,113,214977,20547,20237,1039,21276,257
2021-11-27,Yuba,115,75493,10428,10335,365,10700,88
2021-11-26,Alameda,001,1643700,122374,121618,2840,124458,1477
2021-11-26,Alpine,003,1148,105,106,0,106,0
2021-11-26,Amador,005,37829,5731,5670,67,5737,66
2021-11-26,Butte,007,227075,21710,21384,4032,25416,309
2021-11-26,Calaveras,009,45235,4366,4294,61,4355,85
2021-11-26,Colusa,011,21464,2611,2568,662,3230,19
2021-11-26,Contra Costa,013,1133247,101894,100961,2269,103230,1045
2021-11-26,Del Norte,015,27424,3759,3661,55,3716,42
2021-11-26,El Dorado,017,186661,16720,16399,1772,18171,161
2021-11-26,Fresno,019,978130,145435,143386,13040,156426,2246
2021-11-26,Glenn,021,27897,3584,3532,1036,4568,36
2021-11-26,Humboldt,023,135768,9553,9399,647,10046,115
2021-11-26,Imperial,025,180216,35179,34611,3456,38067,769
2021-11-26,Inyo,027,18085,2543,2506,38,2544,45
2021-11-26,Kern,029,883053,132215,130245,23549,153794,1773
2021-11-26,Kings,031,150075,33340,32891,2000,34891,358
2021-11-26,Lake,033,64148,6923,6836,152,6988,110
2021-11-26,Lassen,035,31185,7040,6959,406,7365,47
2021-11-26,Los Angeles,037,10098052,1467914,1454495,54705,1509200,26817
2021-11-26,Madera,039,155013,24244,23880,2252,26132,296
2021-11-26,Marin,041,260295,18077,17857,494,18351,248
2021-11-26,Mariposa,043,17540,1423,1374,59,1433,6
2021-11-26,Mendocino,045,87422,8044,7871,650,8521,89
2021-11-26,Merced,047,269075,43208,42921,2057,44978,664
2021-11-26,Modoc,049,8938,587,551,200,751,5
2021-11-26,Mono,051,14174,1873,1810,23,1833,4
2021-11-26,Monterey,053,433212,49642,48400,3098,51498,625
2021-11-26,Napa,055,140530,13309,13256,115,13371,104
2021-11-26,Nevada,057,99092,9762,9584,342,9926,103
2021-11-26,Orange,059,3164182,314043,310809,15770,326579,5665
2021-11-26,Placer,061,380077,38593,38001,3811,41812,468
2021-11-26,Plumas,063,18699,1937,1860,43,1903,7
2021-11-26,Riverside,065,2383286,373809,367601,16534,384135,5306
2021-11-26,Sacramento,067,1510023,163955,162328,4837,167165,2335
2021-11-26,San Benito,069,59416,7620,7575,178,7753,77
2021-11-26,San Bernardino,071,2135413,364782,360033,11540,371573,5932
2021-11-26,San Diego,073,3302833,385611,382634,22568,405202,4319
2021-11-26,San Francisco,075,870044,54635,53830,2378,56208,669
2021-11-26,San Joaquin,077,732212,102427,101368,5532,106900,1833
2021-11-26,San Luis Obispo,079,281455,30504,29983,1305,31288,358
2021-11-26,San Mateo,081,765935,55552,54360,930,55290,577
2021-11-26,Santa Barbara,083,443738,45784,45318,1577,46895,548
2021-11-26,Santa Clara,085,1922200,151601,149700,1495,151195,1922
2021-11-26,Santa Cruz,087,273765,21292,20929,1017,21946,222
2021-11-26,Shasta,089,179085,22435,22151,3675,25826,396
2021-11-26,Sierra,091,2930,196,194,21,215,0
2021-11-26,Siskiyou,093,43540,3442,3336,1324,4660,54
2021-11-26,Solano,095,438530,47007,46163,1323,47486,356
2021-11-26,Sonoma,097,501317,42823,42368,553,42921,405
2021-11-26,Stanislaus,099,539301,80871,80782,9084,89866,1220
2021-11-26,Sutter,101,95872,14190,14127,378,14505,181
2021-11-26,Tehama,103,63373,8789,8675,1516,10191,129
2021-11-26,Trinity,105,12862,895,789,219,1008,17
2021-11-26,Tulare,107,460477,70725,69377,15753,85130,1082
2021-11-26,Tuolumne,109,53932,7660,7574,113,7687,90
2021-11-26,Ventura,111,848112,100153,99163,4350,103513,1188
2021-11-26,Yolo,113,214977,20527,20237,1033,21270,257
2021-11-26,Yuba,115,75493,10422,10335,365,10700,88
2021-11-25,Alameda,001,1643700,122265,121618,2835,124453,1477
2021-11-25,Alpine,003,1148,105,106,0,106,0
2021-11-25,Amador,005,37829,5723,5670,67,5737,66
2021-11-25,Butte,007,227075,21692,21384,4030,25414,309
2021-11-25,Calaveras,009,45235,4361,4294,61,4355,85
2021-11-25,Colusa,011,21464,2608,2568,660,3228,19
2021-11-25,Contra Costa,013,1133247,101790,100961,2266,103227,1045
2021-11-25,Del Norte,015,27424,3754,3661,55,3716,42
2021-11-25,El Dorado,017,186661,16701,16399,1772,18171,161
2021-11-25,Fresno,019,978130,145302,143386,13031,156417,2246
2021-11-25,Glenn,021,27897,3581,3532,1035,4567,36
2021-11-25,Humboldt,023,135768,9534,9399,644,10043,115
2021-11-25,Imperial,025,180216,35134,34611,3445,38056,769
2021-11-25,Inyo,027,18085,2541,2506,38,2544,45
2021-11-25,Kern,029,883053,132117,130245,23503,153748,1773
2021-11-25,Kings,031,150075,33312,32891,1999,34890,358
2021-11-25,Lake,033,64148,6916,6836,152,6988,110
2021-11-25,Lassen,035,31185,7038,6959,405,7364,47
2021-11-25,Los Angeles,037,10098052,1466944,1454495,54648,1509143,26817
2021-11-25,Madera,039,155013,24208,23880,2251,26131,296
2021-11-25,Marin,041,260295,18050,17857,488,18345,248
2021-11-25,Mariposa,043,17540,1420,1374,59,1433,6
2021-11-25,Mendocino,045,87422,8026,7871,650,8521,89
2021-11-25,Merced,047,269075,43169,42921,2051,44972,664
2021-11-25,Modoc,049,8938,586,551,200,751,5
2021-11-25,Mono,051,14174,1862,1810,23,1833,4
2021-11-25,Monterey,053,433212,49598,48400,3089,51489,625
2021-11-25,Napa,055,140530,13301,13256,115,13371,104
2021-11-25,Nevada,057,99092,9743,9584,339,9923,103
2021-11-25,Orange,059,3164182,313780,310809,15739,326548,5665
2021-11-25,Placer,061,380077,38547,38001,3805,41806,468
2021-11-25,Plumas,063,18699,1935,1860,43,1903,7
2021-11-25,Riverside,065,2383286,373394,367601,16527,384128,5306
2021-11-25,Sacramento,067,1510023,163776,162328,4831,167159,2335
2021-11-25,San Benito,069,59416,7613,7575,178,7753,77
2021-11-25,San Bernardino,071,2135413,364383,360033,11523,371556,5932
2021-11-25,San Diego,073,3302833,385169,382634,22549,405183,4319
2021-11-25,San Francisco,075,870044,54586,53830,2375,56205,669
2021-11-25,San Joaquin,077,732212,102345,101368,5528,106896,1833
2021-11-25,San Luis Obispo,079,281455,30474,29983,1303,31286,358
2021-11-25,San Mateo,081,765935,55503,54360,928,55288,577
2021-11-25,Santa Barbara,083,443738,45745,45318,1575,46893,548
2021-11-25,Santa Clara,085,1922200,151443,149700,1490,151190,1922
2021-11-25,Santa Cruz,087,273765,21259,20929,1017,21946,222
2021-11-25,Shasta,089,179085,22409,22151,3675,25826,396
2021-11-25,Sierra,091,2930,196,194,21,215,0
2021-11-25,Siskiyou,093,43540,3439,3336,1324,4660,54
2021-11-25,Solano,095,438530,46970,46163,1322,47485,356
2021-11-25,Sonoma,097,501317,42766,42368,549,42917,405
2021-11-25,Stanislaus,099,539301,80804,80782,9070,89852,1220
2021-11-25,Sutter,101,95872,14174,14127,377,14504,181
2021-11-25,Tehama,103,63373,8781,8675,1516,10191,129
2021-11-25,Trinity,105,12862,895,789,219,1008,17
2021-11-25,Tulare,107,460477,70657,69377,15727,85104,1082
2021-11-25,Tuolumne,109,53932,7648,7574,113,7687,90
2021-11-25,Ventura,111,848112,100087,99163,4347,103510,1188
2021-11-25,Yolo,113,214977,20496,20237,1030,21267,257
2021-11-25,Yuba,115,75493,10413,10335,364,10699,88
2021-11-24,Alameda,001,1643700,122202,121618,2831,124449,1477
2021-11-24,Alpine,003,1148,105,106,0,106,0
2021-11-24,Amador,005,37829,5713,5670,67,5737,66
2021-11-24,Butte,007,227075,21676,21384,4029,25413,309
2021-11-24,Calaveras,009,45235,4354,4294,61,4355,85
2021-11-24,Colusa,011,21464,2608,2568,659,3227,19
2021-11-24,Contra Costa,013,1133247,101751,100961,2263,103224,1045
2021-11-24,Del Norte,015,27424,3751,3661,55,3716,42
2021-11-24,El Dorado,017,186661,16690,16399,1771,18170,161
2021-11-24,Fresno,019,978130,145248,143386,13030,156416,2246
2021-11-24,Glenn,021,27897,3576,3532,1034,4566,36
2021-11-24,Humboldt,023,135768,9519,9399,644,10043,115
2021-11-24,Imperial,025,180216,35105,34611,3439,38050,769
2021-11-24,Inyo,027,18085,2538,2506,38,2544,45
2021-11-24,Kern,029,883053,132055,130245,23491,153736,1773
2021-11-24,Kings,031,150075,33298,32891,1998,34889,358
2021-11-24,Lake,033,64148,6912,6836,152,6988,110
2021-11-24,Lassen,035,31185,7038,6959,405,7364,47
2021-11-24,Los Angeles,037,10098052,1466459,1454495,54606,1509101,26817
2021-11-24,Madera,039,155013,24185,23880,2245,26125,296
2021-11-24,Marin,041,260295,18038,17857,486,18343,248
2021-11-24,Mariposa,043,17540,1420,1374,59,1433,6
2021-11-24,Mendocino,045,87422,8014,7871,650,8521,89
2021-11-24,Merced,047,269075,43137,42921,2048,44969,664
2021-11-24,Modoc,049,8938,586,551,200,751,5
2021-11-24,Mono,051,14174,1859,1810,23,1833,4
2021-11-24,Monterey,053,433212,49585,48400,3088,51488,625
2021-11-24,Napa,055,140530,13297,13256,115,13371,104
2021-11-24,Nevada,057,99092,9728,9584,339,9923,103
2021-11-24,Orange,059,3164182,313625,310809,15724,326533,5665
2021-11-24,Placer,061,380077,38514,38001,3803,41804,468
2021-11-24,Plumas,063,18699,1933,1860,43,1903,7
2021-11-24,Riverside,065,2383286,373215,367601,16521,384122,5306
2021-11-24,Sacramento,067,1510023,163704,162328,4831,167159,2335
2021-11-24,San Benito,069,59416,7611,7575,178,7753,77
2021-11-24,San Bernardino,071,2135413,364172,360033,11513,371546,5932
2021-11-24,San Diego,073,3302833,384911,382634,22536,405170,4319
2021-11-24,San Francisco,075,870044,54556,53830,2373,56203,669
2021-11-24,San Joaquin,077,732212,102304,101368,5525,106893,1833
2021-11-24,San Luis Obispo,079,281455,30455,29983,1303,31286,358
2021-11-24,San Mateo,081,765935,55473,54360,927,55287,577
2021-11-24,Santa Barbara,083,443738,45718,45318,1575,46893,548
2021-11-24,Santa Clara,085,1922200,151347,149700,1489,151189,1922
2021-11-24,Santa Cruz,087,273765,21236,20929,1016,21945,222
2021-11-24,Shasta,089,179085,22398,22151,3672,25823,396
2021-11-24,Sierra,091,2930,196,194,21,215,0
2021-11-24,Siskiyou,093,43540,3436,3336,1324,4660,54
2021-11-24,Solano,095,438530,46942,46163,1320,47483,356
2021-11-24,Sonoma,097,501317,42734,42368,547,42915,405
2021-11-24,Stanislaus,099,539301,80767,80782,9065,89847,1220
2021-11-24,Sutter,101,95872,14161,14127,375,14502,181
2021-11-24,Tehama,103,63373,8778,8675,1515,10190,129
2021-11-24,Trinity,105,12862,895,789,219,1008,17
2021-11-24,Tulare,107,460477,70633,69377,15708,85085,1082
2021-11-24,Tuolumne,109,53932,7644,7574,113,7687,90
2021-11-24,Ventura,111,848112,100052,99163,4343,103506,1188
2021-11-24,Yolo,113,214977,20487,20237,1030,21267,257
2021-11-24,Yuba,115,75493,10409,10335,363,10698,88
2021-11-23,Alameda,001,1643700,122084,121618,2824,124442,1477
2021-11-23,Alpine,003,1148,105,106,0,106,0
2021-11-23,Amador,005,37829,5706,5670,67,5737,66
2021-11-23,Butte,007,227075,21647,21384,4025,25409,309
2021-11-23,Calaveras,009,45235,4348,4294,60,4354,85
2021-11-23,Colusa,011,21464,2604,2568,657,3225,19
2021-11-23,Contra Costa,013,1133247,101644,100961,2261,103222,1045
2021-11-23,Del Norte,015,27424,3748,3661,55,3716,42
2021-11-23,El Dorado,017,186661,16659,16399,1768,18167,161
2021-11-23,Fresno,019,978130,145109,143386,13021,156407,2246
2021-11-23,Glenn,021,27897,3571,3532,1034,4566,36
2021-11-23,Humboldt,023,135768,9497,9399,641,10040,115
2021-11-23,Imperial,025,180216,35036,34611,3420,38031,769
2021-11-23,Inyo,027,18085,2534,2506,38,2544,45
2021-11-23,Kern,029,883053,131947,130245,23442,153687,1773
2021-11-23,Kings,031,150075,33256,32891,1997,34888,358
2021-11-23,Lake,033,64148,6907,6836,152,6988,110
2021-11-23,Lassen,035,31185,7035,6959,402,7361,47
2021-11-23,Los Angeles,037,10098052,1465450,1454495,54539,1509034,26817
2021-11-23,Madera,039,155013,24159,23880,2243,26123,296
2021-11-23,Marin,041,260295,18008,17857,483,18340,248
2021-11-23,Mariposa,043,17540,1417,1374,59,1433,6
2021-11-23,Mendocino,045,87422,7993,7871,647,8518,89
2021-11-23,Merced,047,269075,43098,42921,2047,44968,664
2021-11-23,Modoc,049,8938,584,551,200,751,5
2021-11-23,Mono,051,14174,1845,1810,23,1833,4
2021-11-23,Monterey,053,433212,49549,48400,3082,51482,625
2021-11-23,Napa,055,140530,13289,13256,115,13371,104
2021-11-23,Nevada,057,99092,9699,9584,338,9922,103
2021-11-23,Orange,059,3164182,313375,310809,15688,326497,5665
2021-11-23,Placer,061,380077,38455,38001,3786,41787,468
2021-11-23,Plumas,063,18699,1929,1860,43,1903,7
2021-11-23,Riverside,065,2383286,372832,367601,16508,384109,5306
2021-11-23,Sacramento,067,1510023,163518,162328,4820,167148,2335
2021-11-23,San Benito,069,59416,7602,7575,176,7751,77
2021-11-23,San Bernardino,071,2135413,363755,360033,11498,371531,5932
2021-11-23,San Diego,073,3302833,384426,382634,22513,405147,4319
2021-11-23,San Francisco,075,870044,54497,53830,2371,56201,669
2021-11-23,San Joaquin,077,732212,102194,101368,5514,106882,1833
2021-11-23,San Luis Obispo,079,281455,30420,29983,1300,31283,358
2021-11-23,San Mateo,081,765935,55423,54360,926,55286,577
2021-11-23,Santa Barbara,083,443738,45665,45318,1575,46893,548
2021-11-23,Santa Clara,085,1922200,151137,149700,1477,151177,1922
2021-11-23,Santa Cruz,087,273765,21198,20929,1016,21945,222
2021-11-23,Shasta,089,179085,22362,22151,3670,25821,396
2021-11-23,Sierra,091,2930,196,194,21,215,0
2021-11-23,Siskiyou,093,43540,3431,3336,1323,4659,54
2021-11-23,Solano,095,438530,46888,46163,1316,47479,356
2021-11-23,Sonoma,097,501317,42683,42368,544,42912,405
2021-11-23,Stanislaus,099,539301,80697,80782,9053,89835,1220
2021-11-23,Sutter,101,95872,14145,14127,374,14501,181
2021-11-23,Tehama,103,63373,8765,8675,1514,10189,129
2021-11-23,Trinity,105,12862,894,789,219,1008,17
2021-11-23,Tulare,107,460477,70586,69377,15678,85055,1082
2021-11-23,Tuolumne,109,53932,7632,7574,112,7686,90
2021-11-23,Ventura,111,848112,99969,99163,4337,103500,1188
2021-11-23,Yolo,113,214977,20464,20237,1024,21261,257
2021-11-23,Yuba,115,75493,10397,10335,363,10698,88
2021-11-22,Alameda,001,1643700,121969,121566,2823,124389,1475
2021-11-22,Alpine,003,1148,105,106,0,106,0
2021-11-22,Amador,005,37829,5693,5670,67,5737,66
2021-11-22,Butte,007,227075,21608,21363,4020,25383,305
2021-11-22,Calaveras,009,45235,4336,4294,60,4354,84
2021-11-22,Colusa,011,21464,2601,2565,657,3222,19
2021-11-22,Contra Costa,013,1133247,101556,100877,2256,103133,1045
2021-11-22,Del Norte,015,27424,3745,3659,55,3714,42
2021-11-22,El Dorado,017,186661,16636,16378,1765,18143,161
2021-11-22,Fresno,019,978130,144976,143290,13013,156303,2243
2021-11-22,Glenn,021,27897,3566,3530,1033,4563,36
2021-11-22,Humboldt,023,135768,9471,9389,636,10025,115
2021-11-22,Imperial,025,180216,34975,34562,3406,37968,766
2021-11-22,Inyo,027,18085,2528,2501,38,2539,44
2021-11-22,Kern,029,883053,131786,130091,23393,153484,1762
2021-11-22,Kings,031,150075,33219,32867,1992,34859,358
2021-11-22,Lake,033,64148,6902,6837,152,6989,110
2021-11-22,Lassen,035,31185,7033,6954,401,7355,47
2021-11-22,Los Angeles,037,10098052,1464385,1453945,54457,1508402,26800
2021-11-22,Madera,039,155013,24125,23872,2235,26107,296
2021-11-22,Marin,041,260295,17977,17842,481,18323,248
2021-11-22,Mariposa,043,17540,1413,1372,59,1431,6
2021-11-22,Mendocino,045,87422,7977,7859,646,8505,89
2021-11-22,Merced,047,269075,43047,42898,2036,44934,660
2021-11-22,Modoc,049,8938,583,551,200,751,5
2021-11-22,Mono,051,14174,1838,1809,23,1832,4
2021-11-22,Monterey,053,433212,49521,48374,3078,51452,611
2021-11-22,Napa,055,140530,13280,13255,114,13369,104
2021-11-22,Nevada,057,99092,9682,9575,336,9911,96
2021-11-22,Orange,059,3164182,313133,310654,15662,326316,5663
2021-11-22,Placer,061,380077,38408,37956,3778,41734,465
2021-11-22,Plumas,063,18699,1926,1858,43,1901,7
2021-11-22,Riverside,065,2383286,372394,367301,16499,383800,5283
2021-11-22,Sacramento,067,1510023,163326,162222,4811,167033,2328
2021-11-22,San Benito,069,59416,7582,7567,176,7743,77
2021-11-22,San Bernardino,071,2135413,363338,359851,11487,371338,5916
2021-11-22,San Diego,073,3302833,383932,382132,22489,404621,4317
2021-11-22,San Francisco,075,870044,54405,53778,2365,56143,669
2021-11-22,San Joaquin,077,732212,102069,101299,5509,106808,1833
2021-11-22,San Luis Obispo,079,281455,30394,29963,1297,31260,358
2021-11-22,San Mateo,081,765935,55366,54330,924,55254,577
2021-11-22,Santa Barbara,083,443738,45589,45279,1575,46854,546
2021-11-22,Santa Clara,085,1922200,150953,149541,1467,151008,1919
2021-11-22,Santa Cruz,087,273765,21157,20891,1016,21907,222
2021-11-22,Shasta,089,179085,22348,22116,3665,25781,393
2021-11-22,Sierra,091,2930,196,193,21,214,0
2021-11-22,Siskiyou,093,43540,3426,3336,1321,4657,54
2021-11-22,Solano,095,438530,46839,46153,1314,47467,356
2021-11-22,Sonoma,097,501317,42622,42344,543,42887,404
2021-11-22,Stanislaus,099,539301,80610,80718,9043,89761,1209
2021-11-22,Sutter,101,95872,14129,14125,372,14497,181
2021-11-22,Tehama,103,63373,8758,8669,1509,10178,127
2021-11-22,Trinity,105,12862,893,785,219,1004,17
2021-11-22,Tulare,107,460477,70526,69314,15642,84956,1075
2021-11-22,Tuolumne,109,53932,7617,7567,112,7679,90
2021-11-22,Ventura,111,848112,99903,99114,4334,103448,1186
2021-11-22,Yolo,113,214977,20441,20227,1022,21249,257
2021-11-22,Yuba,115,75493,10388,10332,362,10694,88
2021-11-21,Alameda,001,1643700,121837,121443,2819,124262,1475
2021-11-21,Alpine,003,1148,103,106,0,106,0
2021-11-21,Amador,005,37829,5688,5662,66,5728,66
2021-11-21,Butte,007,227075,21566,21342,4015,25357,306
2021-11-21,Calaveras,009,45235,4327,4287,60,4347,84
2021-11-21,Colusa,011,21464,2597,2562,656,3218,19
2021-11-21,Contra Costa,013,1133247,101454,100807,2249,103056,1045
2021-11-21,Del Norte,015,27424,3741,3659,55,3714,42
2021-11-21,El Dorado,017,186661,16609,16370,1759,18129,161
2021-11-21,Fresno,019,978130,144804,143203,12993,156196,2242
2021-11-21,Glenn,021,27897,3561,3529,1033,4562,36
2021-11-21,Humboldt,023,135768,9449,9378,635,10013,115
2021-11-21,Imperial,025,180216,34887,34527,3396,37923,766
2021-11-21,Inyo,027,18085,2521,2501,38,2539,44
2021-11-21,Kern,029,883053,131622,130020,23347,153367,1762
2021-11-21,Kings,031,150075,33181,32843,1988,34831,356
2021-11-21,Lake,033,64148,6895,6834,152,6986,110
2021-11-21,Lassen,035,31185,7024,6953,401,7354,47
2021-11-21,Los Angeles,037,10098052,1463325,1453181,54402,1507583,26793
2021-11-21,Madera,039,155013,24100,23856,2230,26086,296
2021-11-21,Marin,041,260295,17948,17829,478,18307,248
2021-11-21,Mariposa,043,17540,1412,1371,58,1429,6
2021-11-21,Mendocino,045,87422,7971,7846,643,8489,89
2021-11-21,Merced,047,269075,42992,42881,2033,44914,660
2021-11-21,Modoc,049,8938,579,551,200,751,5
2021-11-21,Mono,051,14174,1828,1799,22,1821,4
2021-11-21,Monterey,053,433212,49475,48358,3069,51427,611
2021-11-21,Napa,055,140530,13268,13250,114,13364,104
2021-11-21,Nevada,057,99092,9656,9556,335,9891,96
2021-11-21,Orange,059,3164182,312877,310477,15631,326108,5663
2021-11-21,Placer,061,380077,38327,37929,3777,41706,465
2021-11-21,Plumas,063,18699,1921,1858,43,1901,7
2021-11-21,Riverside,065,2383286,371902,367093,16491,383584,5283
2021-11-21,Sacramento,067,1510023,163108,162087,4801,166888,2327
2021-11-21,San Benito,069,59416,7568,7563,175,7738,77
2021-11-21,San Bernardino,071,2135413,362843,359621,11452,371073,5912
2021-11-21,San Diego,073,3302833,383401,380747,22464,403211,4317
2021-11-21,San Francisco,075,870044,54336,53741,2360,56101,669
2021-11-21,San Joaquin,077,732212,101961,101264,5496,106760,1833
2021-11-21,San Luis Obispo,079,281455,30356,29948,1297,31245,358
2021-11-21,San Mateo,081,765935,55314,54290,922,55212,577
2021-11-21,Santa Barbara,083,443738,45529,45237,1572,46809,546
2021-11-21,Santa Clara,085,1922200,150747,149387,1448,150835,1918
2021-11-21,Santa Cruz,087,273765,21113,20866,1014,21880,222
2021-11-21,Shasta,089,179085,22317,22112,3663,25775,393
2021-11-21,Sierra,091,2930,196,193,21,214,0
2021-11-21,Siskiyou,093,43540,3421,3333,1320,4653,54
2021-11-21,Solano,095,438530,46783,46122,1307,47429,356
2021-11-21,Sonoma,097,501317,42562,42298,542,42840,404
2021-11-21,Stanislaus,099,539301,80515,80687,9028,89715,1209
2021-11-21,Sutter,101,95872,14115,14111,372,14483,181
2021-11-21,Tehama,103,63373,8752,8669,1508,10177,127
2021-11-21,Trinity,105,12862,891,784,217,1001,17
2021-11-21,Tulare,107,460477,70443,69285,15604,84889,1075
2021-11-21,Tuolumne,109,53932,7609,7560,111,7671,90
2021-11-21,Ventura,111,848112,99812,99081,4331,103412,1186
2021-11-21,Yolo,113,214977,20413,20209,1019,21228,257
2021-11-21,Yuba,115,75493,10379,10326,362,10688,88
2021-11-20,Alameda,001,1643700,121743,121059,2813,123872,1473
2021-11-20,Alpine,003,1148,103,105,0,105,0
2021-11-20,Amador,005,37829,5682,5652,65,5717,66
2021-11-20,Butte,007,227075,21551,21265,4011,25276,300
2021-11-20,Calaveras,009,45235,4317,4268,60,4328,84
2021-11-20,Colusa,011,21464,2596,2549,655,3204,19
2021-11-20,Contra Costa,013,1133247,101378,100491,2245,102736,1043
2021-11-20,Del Norte,015,27424,3738,3637,55,3692,42
2021-11-20,El Dorado,017,186661,16588,16308,1757,18065,161
2021-11-20,Fresno,019,978130,144735,142579,12984,155563,2233
2021-11-20,Glenn,021,27897,3560,3526,1032,4558,35
2021-11-20,Humboldt,023,135768,9436,9302,633,9935,115
2021-11-20,Imperial,025,180216,34835,34312,3390,37702,766
2021-11-20,Inyo,027,18085,2520,2467,38,2505,44
2021-11-20,Kern,029,883053,131521,129488,23310,152798,1750
2021-11-20,Kings,031,150075,33171,32720,1988,34708,354
2021-11-20,Lake,033,64148,6892,6808,152,6960,110
2021-11-20,Lassen,035,31185,7023,6931,401,7332,47
2021-11-20,Los Angeles,037,10098052,1462706,1448963,54354,1503317,26741
2021-11-20,Madera,039,155013,24086,23720,2226,25946,296
2021-11-20,Marin,041,260295,17933,17774,478,18252,248
2021-11-20,Mariposa,043,17540,1411,1354,58,1412,6
2021-11-20,Mendocino,045,87422,7963,7773,643,8416,89
2021-11-20,Merced,047,269075,42966,42692,2033,44725,656
2021-11-20,Modoc,049,8938,578,550,200,750,5
2021-11-20,Mono,051,14174,1822,1767,22,1789,4
2021-11-20,Monterey,053,433212,49462,48260,3064,51324,609
2021-11-20,Napa,055,140530,13265,13184,114,13298,103
2021-11-20,Nevada,057,99092,9640,9480,335,9815,92
2021-11-20,Orange,059,3164182,312677,309672,15614,325286,5658
2021-11-20,Placer,061,380077,38287,37800,3772,41572,462
2021-11-20,Plumas,063,18699,1917,1841,43,1884,7
2021-11-20,Riverside,065,2383286,371629,365809,16479,382288,5265
2021-11-20,Sacramento,067,1510023,163004,161533,4797,166330,2316
2021-11-20,San Benito,069,59416,7564,7533,175,7708,77
2021-11-20,San Bernardino,071,2135413,362563,358322,11441,369763,5897
2021-11-20,San Diego,073,3302833,383075,380147,22438,402585,4311
2021-11-20,San Francisco,075,870044,54297,53525,2359,55884,669
2021-11-20,San Joaquin,077,732212,101911,100922,5491,106413,1832
2021-11-20,San Luis Obispo,079,281455,30342,29815,1296,31111,355
2021-11-20,San Mateo,081,765935,55280,54132,921,55053,577
2021-11-20,Santa Barbara,083,443738,45497,45074,1572,46646,544
2021-11-20,Santa Clara,085,1922200,150640,148829,1447,150276,1917
2021-11-20,Santa Cruz,087,273765,21095,20756,1014,21770,222
2021-11-20,Shasta,089,179085,22293,21968,3662,25630,383
2021-11-20,Sierra,091,2930,196,191,21,212,0
2021-11-20,Siskiyou,093,43540,3418,3313,1320,4633,54
2021-11-20,Solano,095,438530,46762,46006,1307,47313,356
2021-11-20,Sonoma,097,501317,42531,42151,542,42693,403
2021-11-20,Stanislaus,099,539301,80469,80412,9024,89436,1205
2021-11-20,Sutter,101,95872,14107,14074,372,14446,181
2021-11-20,Tehama,103,63373,8747,8648,1508,10156,125
2021-11-20,Trinity,105,12862,887,771,217,988,17
2021-11-20,Tulare,107,460477,70404,69074,15583,84657,1054
2021-11-20,Tuolumne,109,53932,7601,7511,111,7622,90
2021-11-20,Ventura,111,848112,99763,98893,4324,103217,1186
2021-11-20,Yolo,113,214977,20404,20139,1016,21155,257
2021-11-20,Yuba,115,75493,10373,10290,361,10651,88
2021-11-19,Alameda,001,1643700,121669,121059,2810,123869,1473
2021-11-19,Alpine,003,1148,103,105,0,105,0
2021-11-19,Amador,005,37829,5672,5652,65,5717,66
2021-11-19,Butte,007,227075,21528,21265,4004,25269,300
2021-11-19,Calaveras,009,45235,4310,4268,60,4328,84
2021-11-19,Colusa,011,21464,2594,2549,654,3203,19
2021-11-19,Contra Costa,013,1133247,101321,100491,2240,102731,1043
2021-11-19,Del Norte,015,27424,3733,3637,55,3692,42
2021-11-19,El Dorado,017,186661,16566,16308,1755,18063,161
2021-11-19,Fresno,019,978130,144618,142579,12975,155554,2233
2021-11-19,Glenn,021,27897,3559,3526,1031,4557,35
2021-11-19,Humboldt,023,135768,9424,9302,630,9932,115
2021-11-19,Imperial,025,180216,34798,34312,3383,37695,766
2021-11-19,Inyo,027,18085,2516,2467,38,2505,44
2021-11-19,Kern,029,883053,131418,129488,23267,152755,1750
2021-11-19,Kings,031,150075,33146,32720,1986,34706,354
2021-11-19,Lake,033,64148,6889,6808,152,6960,110
2021-11-19,Lassen,035,31185,7018,6931,400,7331,47
2021-11-19,Los Angeles,037,10098052,1462018,1448963,54301,1503264,26741
2021-11-19,Madera,039,155013,24065,23720,2221,25941,296
2021-11-19,Marin,041,260295,17915,17774,476,18250,248
2021-11-19,Mariposa,043,17540,1409,1354,58,1412,6
2021-11-19,Mendocino,045,87422,7943,7773,643,8416,89
2021-11-19,Merced,047,269075,42940,42692,2032,44724,656
2021-11-19,Modoc,049,8938,577,550,200,750,5
2021-11-19,Mono,051,14174,1811,1767,22,1789,4
2021-11-19,Monterey,053,433212,49440,48260,3064,51324,609
2021-11-19,Napa,055,140530,13254,13184,113,13297,103
2021-11-19,Nevada,057,99092,9627,9480,335,9815,92
2021-11-19,Orange,059,3164182,312523,309672,15589,325261,5658
2021-11-19,Placer,061,380077,38250,37800,3768,41568,462
2021-11-19,Plumas,063,18699,1913,1841,43,1884,7
2021-11-19,Riverside,065,2383286,371355,365809,16475,382284,5265
2021-11-19,Sacramento,067,1510023,162879,161533,4793,166326,2316
2021-11-19,San Benito,069,59416,7558,7533,173,7706,77
2021-11-19,San Bernardino,071,2135413,362240,358322,11432,369754,5897
2021-11-19,San Diego,073,3302833,382684,380147,22412,402559,4311
2021-11-19,San Francisco,075,870044,54259,53525,2359,55884,669
2021-11-19,San Joaquin,077,732212,101854,100922,5487,106409,1832
2021-11-19,San Luis Obispo,079,281455,30324,29815,1294,31109,355
2021-11-19,San Mateo,081,765935,55232,54132,917,55049,577
2021-11-19,Santa Barbara,083,443738,45460,45074,1572,46646,544
2021-11-19,Santa Clara,085,1922200,150493,148829,1444,150273,1917
2021-11-19,Santa Cruz,087,273765,21068,20756,1011,21767,222
2021-11-19,Shasta,089,179085,22281,21968,3661,25629,383
2021-11-19,Sierra,091,2930,196,191,21,212,0
2021-11-19,Siskiyou,093,43540,3415,3313,1320,4633,54
2021-11-19,Solano,095,438530,46731,46006,1303,47309,356
2021-11-19,Sonoma,097,501317,42498,42151,539,42690,403
2021-11-19,Stanislaus,099,539301,80411,80412,9015,89427,1205
2021-11-19,Sutter,101,95872,14105,14074,372,14446,181
2021-11-19,Tehama,103,63373,8744,8648,1508,10156,125
2021-11-19,Trinity,105,12862,885,771,217,988,17
2021-11-19,Tulare,107,460477,70363,69074,15557,84631,1054
2021-11-19,Tuolumne,109,53932,7590,7511,111,7622,90
2021-11-19,Ventura,111,848112,99698,98893,4321,103214,1186
2021-11-19,Yolo,113,214977,20392,20139,1015,21154,257
2021-11-19,Yuba,115,75493,10370,10290,361,10651,88
2021-11-18,Alameda,001,1643700,121545,121059,2803,123862,1473
2021-11-18,Alpine,003,1148,103,105,0,105,0
2021-11-18,Amador,005,37829,5670,5652,65,5717,66
2021-11-18,Butte,007,227075,21511,21265,3997,25262,300
2021-11-18,Calaveras,009,45235,4303,4268,59,4327,84
2021-11-18,Colusa,011,21464,2586,2549,654,3203,19
2021-11-18,Contra Costa,013,1133247,101219,100491,2232,102723,1043
2021-11-18,Del Norte,015,27424,3730,3637,55,3692,42
2021-11-18,El Dorado,017,186661,16545,16308,1752,18060,161
2021-11-18,Fresno,019,978130,144478,142579,12965,155544,2233
2021-11-18,Glenn,021,27897,3558,3526,1030,4556,35
2021-11-18,Humboldt,023,135768,9407,9302,625,9927,115
2021-11-18,Imperial,025,180216,34743,34312,3367,37679,766
2021-11-18,Inyo,027,18085,2508,2467,38,2505,44
2021-11-18,Kern,029,883053,131270,129488,23220,152708,1750
2021-11-18,Kings,031,150075,33109,32720,1983,34703,354
2021-11-18,Lake,033,64148,6884,6808,152,6960,110
2021-11-18,Lassen,035,31185,7015,6931,395,7326,47
2021-11-18,Los Angeles,037,10098052,1461030,1448963,54241,1503204,26741
2021-11-18,Madera,039,155013,24040,23720,2217,25937,296
2021-11-18,Marin,041,260295,17898,17774,472,18246,248
2021-11-18,Mariposa,043,17540,1406,1354,58,1412,6
2021-11-18,Mendocino,045,87422,7921,7773,634,8407,89
2021-11-18,Merced,047,269075,42883,42692,2030,44722,656
2021-11-18,Modoc,049,8938,565,550,200,750,5
2021-11-18,Mono,051,14174,1803,1767,22,1789,4
2021-11-18,Monterey,053,433212,49415,48260,3059,51319,609
2021-11-18,Napa,055,140530,13242,13184,112,13296,103
2021-11-18,Nevada,057,99092,9603,9480,335,9815,92
2021-11-18,Orange,059,3164182,312286,309672,15569,325241,5658
2021-11-18,Placer,061,380077,38207,37800,3757,41557,462
2021-11-18,Plumas,063,18699,1912,1841,43,1884,7
2021-11-18,Riverside,065,2383286,370980,365809,16462,382271,5265
2021-11-18,Sacramento,067,1510023,162651,161533,4778,166311,2316
2021-11-18,San Benito,069,59416,7548,7533,173,7706,77
2021-11-18,San Bernardino,071,2135413,361807,358322,11413,369735,5897
2021-11-18,San Diego,073,3302833,382187,380147,22395,402542,4311
2021-11-18,San Francisco,075,870044,54207,53525,2355,55880,669
2021-11-18,San Joaquin,077,732212,101761,100922,5479,106401,1832
2021-11-18,San Luis Obispo,079,281455,30294,29815,1293,31108,355
2021-11-18,San Mateo,081,765935,55173,54132,914,55046,577
2021-11-18,Santa Barbara,083,443738,45414,45074,1565,46639,544
2021-11-18,Santa Clara,085,1922200,150302,148829,1436,150265,1917
2021-11-18,Santa Cruz,087,273765,21017,20756,1010,21766,222
2021-11-18,Shasta,089,179085,22245,21968,3656,25624,383
2021-11-18,Sierra,091,2930,195,191,21,212,0
2021-11-18,Siskiyou,093,43540,3415,3313,1316,4629,54
2021-11-18,Solano,095,438530,46688,46006,1301,47307,356
2021-11-18,Sonoma,097,501317,42449,42151,537,42688,403
2021-11-18,Stanislaus,099,539301,80344,80412,9007,89419,1205
2021-11-18,Sutter,101,95872,14094,14074,371,14445,181
2021-11-18,Tehama,103,63373,8739,8648,1508,10156,125
2021-11-18,Trinity,105,12862,884,771,217,988,17
2021-11-18,Tulare,107,460477,70289,69074,15513,84587,1054
2021-11-18,Tuolumne,109,53932,7580,7511,111,7622,90
2021-11-18,Ventura,111,848112,99621,98893,4317,103210,1186
2021-11-18,Yolo,113,214977,20375,20139,1011,21150,257
2021-11-18,Yuba,115,75493,10364,10290,361,10651,88
2021-11-17,Alameda,001,1643700,121423,120913,2802,123715,1472
2021-11-17,Alpine,003,1148,103,105,0,105,0
2021-11-17,Amador,005,37829,5664,5646,65,5711,66
2021-11-17,Butte,007,227075,21485,21230,3994,25224,300
2021-11-17,Calaveras,009,45235,4296,4259,59,4318,84
2021-11-17,Colusa,011,21464,2583,2546,653,3199,19
2021-11-17,Contra Costa,013,1133247,101127,100387,2228,102615,1039
2021-11-17,Del Norte,015,27424,3727,3630,55,3685,42
2021-11-17,El Dorado,017,186661,16525,16269,1751,18020,161
2021-11-17,Fresno,019,978130,144294,142366,12952,155318,2230
2021-11-17,Glenn,021,27897,3556,3527,1028,4555,34
2021-11-17,Humboldt,023,135768,9396,9270,622,9892,115
2021-11-17,Imperial,025,180216,34687,34256,3346,37602,766
2021-11-17,Inyo,027,18085,2502,2457,38,2495,44
2021-11-17,Kern,029,883053,131097,129307,23178,152485,1743
2021-11-17,Kings,031,150075,33082,32669,1979,34648,352
2021-11-17,Lake,033,64148,6880,6795,151,6946,110
2021-11-17,Lassen,035,31185,7013,6918,395,7313,47
2021-11-17,Los Angeles,037,10098052,1459933,1447947,54174,1502121,26721
2021-11-17,Madera,039,155013,24007,23673,2215,25888,287
2021-11-17,Marin,041,260295,17878,17757,470,18227,248
2021-11-17,Mariposa,043,17540,1402,1353,58,1411,6
2021-11-17,Mendocino,045,87422,7913,7735,633,8368,89
2021-11-17,Merced,047,269075,42824,42612,2025,44637,654
2021-11-17,Modoc,049,8938,561,540,200,740,5
2021-11-17,Mono,051,14174,1799,1765,22,1787,5
2021-11-17,Monterey,053,433212,49367,48221,3048,51269,609
2021-11-17,Napa,055,140530,13220,13167,112,13279,103
2021-11-17,Nevada,057,99092,9590,9447,335,9782,92
2021-11-17,Orange,059,3164182,312039,309396,15535,324931,5651
2021-11-17,Placer,061,380077,38159,37725,3749,41474,460
2021-11-17,Plumas,063,18699,1907,1833,43,1876,7
2021-11-17,Riverside,065,2383286,370570,365406,16449,381855,5229
2021-11-17,Sacramento,067,1510023,162482,161269,4771,166040,2302
2021-11-17,San Benito,069,59416,7541,7524,173,7697,77
2021-11-17,San Bernardino,071,2135413,361442,357947,11396,369343,5893
2021-11-17,San Diego,073,3302833,381696,379769,22369,402138,4301
2021-11-17,San Francisco,075,870044,54152,53469,2352,55821,667
2021-11-17,San Joaquin,077,732212,101659,100764,5474,106238,1828
2021-11-17,San Luis Obispo,079,281455,30268,29731,1290,31021,354
2021-11-17,San Mateo,081,765935,55105,54092,911,55003,577
2021-11-17,Santa Barbara,083,443738,45375,45000,1565,46565,542
2021-11-17,Santa Clara,085,1922200,150138,148626,1428,150054,1915
2021-11-17,Santa Cruz,087,273765,20982,20700,1010,21710,222
2021-11-17,Shasta,089,179085,22212,21883,3654,25537,382
2021-11-17,Sierra,091,2930,194,189,21,210,0
2021-11-17,Siskiyou,093,43540,3411,3307,1313,4620,54
2021-11-17,Solano,095,438530,46655,45948,1300,47248,353
2021-11-17,Sonoma,097,501317,42403,42093,534,42627,403
2021-11-17,Stanislaus,099,539301,80255,80276,8997,89273,1199
2021-11-17,Sutter,101,95872,14080,14064,369,14433,181
2021-11-17,Tehama,103,63373,8729,8633,1505,10138,125
2021-11-17,Trinity,105,12862,883,765,217,982,17
2021-11-17,Tulare,107,460477,70218,68977,15486,84463,1047
2021-11-17,Tuolumne,109,53932,7563,7485,111,7596,90
2021-11-17,Ventura,111,848112,99559,98812,4311,103123,1183
2021-11-17,Yolo,113,214977,20356,20100,1009,21109,257
2021-11-17,Yuba,115,75493,10352,10275,357,10632,88
2021-11-16,Alameda,001,1643700,121315,120809,2798,123607,1467
2021-11-16,Alpine,003,1148,103,105,0,105,0
2021-11-16,Amador,005,37829,5658,5644,65,5709,66
2021-11-16,Butte,007,227075,21459,21208,3989,25197,297
2021-11-16,Calaveras,009,45235,4287,4249,59,4308,83
2021-11-16,Colusa,011,21464,2577,2538,653,3191,19
2021-11-16,Contra Costa,013,1133247,101006,100320,2225,102545,1038
2021-11-16,Del Norte,015,27424,3721,3630,55,3685,42
2021-11-16,El Dorado,017,186661,16499,16248,1749,17997,159
2021-11-16,Fresno,019,978130,144108,142200,12930,155130,2218
2021-11-16,Glenn,021,27897,3555,3527,1025,4552,34
2021-11-16,Humboldt,023,135768,9376,9252,618,9870,115
2021-11-16,Imperial,025,180216,34604,34177,3332,37509,766
2021-11-16,Inyo,027,18085,2495,2449,38,2487,42
2021-11-16,Kern,029,883053,130937,129136,23117,152253,1735
2021-11-16,Kings,031,150075,33029,32614,1972,34586,350
2021-11-16,Lake,033,64148,6875,6789,151,6940,110
2021-11-16,Lassen,035,31185,7003,6915,395,7310,47
2021-11-16,Los Angeles,037,10098052,1458765,1446815,54102,1500917,26703
2021-11-16,Madera,039,155013,23969,23642,2209,25851,287
2021-11-16,Marin,041,260295,17859,17736,469,18205,248
2021-11-16,Mariposa,043,17540,1394,1349,57,1406,6
2021-11-16,Mendocino,045,87422,7871,7723,629,8352,89
2021-11-16,Merced,047,269075,42787,42578,2018,44596,653
2021-11-16,Modoc,049,8938,560,539,199,738,5
2021-11-16,Mono,051,14174,1790,1767,22,1789,4
2021-11-16,Monterey,053,433212,49337,48195,3034,51229,609
2021-11-16,Napa,055,140530,13209,13151,112,13263,103
2021-11-16,Nevada,057,99092,9573,9435,334,9769,92
2021-11-16,Orange,059,3164182,311772,309170,15501,324671,5651
2021-11-16,Placer,061,380077,38117,37676,3743,41419,459
2021-11-16,Plumas,063,18699,1898,1832,43,1875,7
2021-11-16,Riverside,065,2383286,370148,365078,16427,381505,5208
2021-11-16,Sacramento,067,1510023,162302,161102,4759,165861,2299
2021-11-16,San Benito,069,59416,7527,7513,173,7686,77
2021-11-16,San Bernardino,071,2135413,361017,357528,11343,368871,5901
2021-11-16,San Diego,073,3302833,381141,379435,22342,401777,4287
2021-11-16,San Francisco,075,870044,54079,53415,2344,55759,667
2021-11-16,San Joaquin,077,732212,101519,100637,5459,106096,1807
2021-11-16,San Luis Obispo,079,281455,30236,29703,1287,30990,356
2021-11-16,San Mateo,081,765935,55042,54034,909,54943,577
2021-11-16,Santa Barbara,083,443738,45307,44932,1562,46494,539
2021-11-16,Santa Clara,085,1922200,149956,148452,1416,149868,1916
2021-11-16,Santa Cruz,087,273765,20937,20684,1008,21692,222
2021-11-16,Shasta,089,179085,22173,21853,3650,25503,379
2021-11-16,Sierra,091,2930,194,189,21,210,0
2021-11-16,Siskiyou,093,43540,3408,3304,1311,4615,54
2021-11-16,Solano,095,438530,46615,45908,1299,47207,351
2021-11-16,Sonoma,097,501317,42354,42056,533,42589,401
2021-11-16,Stanislaus,099,539301,80158,80214,8974,89188,1196
2021-11-16,Sutter,101,95872,14068,14058,368,14426,181
2021-11-16,Tehama,103,63373,8722,8621,1498,10119,125
2021-11-16,Trinity,105,12862,883,762,216,978,17
2021-11-16,Tulare,107,460477,70138,68881,15451,84332,1039
2021-11-16,Tuolumne,109,53932,7553,7478,111,7589,90
2021-11-16,Ventura,111,848112,99484,98731,4308,103039,1183
2021-11-16,Yolo,113,214977,20318,20077,1007,21084,257
2021-11-16,Yuba,115,75493,10344,10262,355,10617,85
2021-11-15,Alameda,001,1643700,121157,120731,2794,123525,1464
2021-11-15,Alpine,003,1148,103,105,0,105,0
2021-11-15,Amador,005,37829,5653,5637,65,5702,66
2021-11-15,Butte,007,227075,21435,21182,3984,25166,296
2021-11-15,Calaveras,009,45235,4273,4237,59,4296,83
2021-11-15,Colusa,011,21464,2570,2535,650,3185,19
2021-11-15,Contra Costa,013,1133247,100900,100251,2222,102473,1038
2021-11-15,Del Norte,015,27424,3716,3630,54,3684,42
2021-11-15,El Dorado,017,186661,16475,16236,1745,17981,159
2021-11-15,Fresno,019,978130,143886,142015,12908,154923,2210
2021-11-15,Glenn,021,27897,3553,3526,1025,4551,34
2021-11-15,Humboldt,023,135768,9354,9230,610,9840,115
2021-11-15,Imperial,025,180216,34531,34130,3316,37446,766
2021-11-15,Inyo,027,18085,2490,2442,38,2480,42
2021-11-15,Kern,029,883053,130728,128928,23048,151976,1730
2021-11-15,Kings,031,150075,32995,32584,1967,34551,348
2021-11-15,Lake,033,64148,6871,6784,151,6935,109
2021-11-15,Lassen,035,31185,6992,6915,393,7308,47
2021-11-15,Los Angeles,037,10098052,1457577,1446114,54039,1500153,26677
2021-11-15,Madera,039,155013,23931,23605,2198,25803,287
2021-11-15,Marin,041,260295,17842,17723,468,18191,248
2021-11-15,Mariposa,043,17540,1393,1347,55,1402,6
2021-11-15,Mendocino,045,87422,7851,7694,623,8317,89
2021-11-15,Merced,047,269075,42730,42552,2007,44559,648
2021-11-15,Modoc,049,8938,559,538,198,736,5
2021-11-15,Mono,051,14174,1785,1763,22,1785,4
2021-11-15,Monterey,053,433212,49305,48154,3028,51182,609
2021-11-15,Napa,055,140530,13201,13143,112,13255,103
2021-11-15,Nevada,057,99092,9544,9420,333,9753,92
2021-11-15,Orange,059,3164182,311493,308859,15477,324336,5646
2021-11-15,Placer,061,380077,38054,37610,3739,41349,452
2021-11-15,Plumas,063,18699,1891,1829,43,1872,7
2021-11-15,Riverside,065,2383286,369699,364750,16408,381158,5199
2021-11-15,Sacramento,067,1510023,162081,160937,4747,165684,2293
2021-11-15,San Benito,069,59416,7522,7511,172,7683,77
2021-11-15,San Bernardino,071,2135413,360590,357306,11324,368630,5898
2021-11-15,San Diego,073,3302833,380604,378845,22317,401162,4284
2021-11-15,San Francisco,075,870044,54012,53374,2341,55715,667
2021-11-15,San Joaquin,077,732212,101365,100587,5448,106035,1799
2021-11-15,San Luis Obispo,079,281455,30193,29669,1275,30944,351
2021-11-15,San Mateo,081,765935,54989,54010,907,54917,576
2021-11-15,Santa Barbara,083,443738,45252,44879,1556,46435,539
2021-11-15,Santa Clara,085,1922200,149739,148313,1409,149722,1914
2021-11-15,Santa Cruz,087,273765,20895,20630,1007,21637,223
2021-11-15,Shasta,089,179085,22127,21779,3645,25424,374
2021-11-15,Sierra,091,2930,194,189,21,210,0
2021-11-15,Siskiyou,093,43540,3401,3302,1309,4611,54
2021-11-15,Solano,095,438530,46577,45885,1294,47179,351
2021-11-15,Sonoma,097,501317,42303,42021,532,42553,401
2021-11-15,Stanislaus,099,539301,80073,80129,8960,89089,1174
2021-11-15,Sutter,101,95872,14055,14043,367,14410,181
2021-11-15,Tehama,103,63373,8716,8615,1497,10112,125
2021-11-15,Trinity,105,12862,881,757,214,971,17
2021-11-15,Tulare,107,460477,70051,68826,15407,84233,1039
2021-11-15,Tuolumne,109,53932,7542,7461,111,7572,90
2021-11-15,Ventura,111,848112,99400,98605,4303,102908,1183
2021-11-15,Yolo,113,214977,20287,20065,1003,21068,255
2021-11-15,Yuba,115,75493,10325,10254,351,10605,85
2021-11-14,Alameda,001,1643700,120983,120629,2790,123419,1461
2021-11-14,Alpine,003,1148,102,105,0,105,0
2021-11-14,Amador,005,37829,5646,5632,64,5696,66
2021-11-14,Butte,007,227075,21403,21146,3975,25121,296
2021-11-14,Calaveras,009,45235,4262,4222,59,4281,83
2021-11-14,Colusa,011,21464,2568,2532,647,3179,19
2021-11-14,Contra Costa,013,1133247,100791,100188,2220,102408,1038
2021-11-14,Del Norte,015,27424,3713,3629,54,3683,42
2021-11-14,El Dorado,017,186661,16433,16212,1740,17952,159
2021-11-14,Fresno,019,978130,143604,141869,12874,154743,2209
2021-11-14,Glenn,021,27897,3551,3521,1025,4546,34
2021-11-14,Humboldt,023,135768,9323,9215,600,9815,115
2021-11-14,Imperial,025,180216,34428,34078,3301,37379,766
2021-11-14,Inyo,027,18085,2478,2441,38,2479,42
2021-11-14,Kern,029,883053,130488,128842,22978,151820,1730
2021-11-14,Kings,031,150075,32938,32545,1960,34505,349
2021-11-14,Lake,033,64148,6863,6777,151,6928,109
2021-11-14,Lassen,035,31185,6982,6911,392,7303,47
2021-11-14,Los Angeles,037,10098052,1456213,1445284,53964,1499248,26667
2021-11-14,Madera,039,155013,23881,23566,2189,25755,287
2021-11-14,Marin,041,260295,17827,17712,468,18180,247
2021-11-14,Mariposa,043,17540,1383,1337,51,1388,6
2021-11-14,Mendocino,045,87422,7818,7684,618,8302,89
2021-11-14,Merced,047,269075,42640,42513,2001,44514,648
2021-11-14,Modoc,049,8938,557,538,198,736,5
2021-11-14,Mono,051,14174,1773,1760,22,1782,4
2021-11-14,Monterey,053,433212,49250,48135,3010,51145,609
2021-11-14,Napa,055,140530,13183,13132,112,13244,103
2021-11-14,Nevada,057,99092,9516,9408,333,9741,92
2021-11-14,Orange,059,3164182,311174,308699,15456,324155,5646
2021-11-14,Placer,061,380077,37974,37569,3729,41298,452
2021-11-14,Plumas,063,18699,1888,1829,42,1871,7
2021-11-14,Riverside,065,2383286,369201,364490,16391,380881,5199
2021-11-14,Sacramento,067,1510023,161846,160761,4730,165491,2295
2021-11-14,San Benito,069,59416,7511,7507,171,7678,77
2021-11-14,San Bernardino,071,2135413,360008,357014,11307,368321,5897
2021-11-14,San Diego,073,3302833,380008,377633,22286,399919,4280
2021-11-14,San Francisco,075,870044,53936,53338,2336,55674,667
2021-11-14,San Joaquin,077,732212,101237,100518,5443,105961,1799
2021-11-14,San Luis Obispo,079,281455,30111,29645,1272,30917,352
2021-11-14,San Mateo,081,765935,54936,53978,905,54883,576
2021-11-14,Santa Barbara,083,443738,45173,44842,1553,46395,539
2021-11-14,Santa Clara,085,1922200,149539,148152,1402,149554,1913
2021-11-14,Santa Cruz,087,273765,20841,20609,1005,21614,223
2021-11-14,Shasta,089,179085,22075,21771,3632,25403,373
2021-11-14,Sierra,091,2930,194,189,21,210,0
2021-11-14,Siskiyou,093,43540,3392,3302,1308,4610,54
2021-11-14,Solano,095,438530,46522,45860,1287,47147,351
2021-11-14,Sonoma,097,501317,42237,41974,530,42504,401
2021-11-14,Stanislaus,099,539301,79938,80076,8942,89018,1174
2021-11-14,Sutter,101,95872,14038,14031,363,14394,181
2021-11-14,Tehama,103,63373,8706,8607,1495,10102,125
2021-11-14,Trinity,105,12862,878,754,212,966,17
2021-11-14,Tulare,107,460477,69934,68772,15348,84120,1037
2021-11-14,Tuolumne,109,53932,7524,7439,110,7549,90
2021-11-14,Ventura,111,848112,99285,98550,4302,102852,1183
2021-11-14,Yolo,113,214977,20259,20040,998,21038,255
2021-11-14,Yuba,115,75493,10318,10238,350,10588,85
2021-11-13,Alameda,001,1643700,120914,120407,2789,123196,1454
2021-11-13,Alpine,003,1148,102,105,0,105,0
2021-11-13,Amador,005,37829,5645,5614,64,5678,66
2021-11-13,Butte,007,227075,21382,21104,3972,25076,296
2021-11-13,Calaveras,009,45235,4251,4203,59,4262,83
2021-11-13,Colusa,011,21464,2566,2522,647,3169,19
2021-11-13,Contra Costa,013,1133247,100719,100004,2214,102218,1028
2021-11-13,Del Norte,015,27424,3713,3629,54,3683,42
2021-11-13,El Dorado,017,186661,16420,16163,1737,17900,159
2021-11-13,Fresno,019,978130,143497,141452,12860,154312,2205
2021-11-13,Glenn,021,27897,3551,3514,1024,4538,34
2021-11-13,Humboldt,023,135768,9308,9177,595,9772,115
2021-11-13,Imperial,025,180216,34378,33990,3284,37274,766
2021-11-13,Inyo,027,18085,2472,2436,38,2474,42
2021-11-13,Kern,029,883053,130386,128472,22934,151406,1719
2021-11-13,Kings,031,150075,32921,32452,1959,34411,347
2021-11-13,Lake,033,64148,6858,6769,151,6920,109
2021-11-13,Lassen,035,31185,6977,6897,392,7289,47
2021-11-13,Los Angeles,037,10098052,1455558,1443088,53926,1497014,26649
2021-11-13,Madera,039,155013,23850,23462,2184,25646,287
2021-11-13,Marin,041,260295,17814,17684,466,18150,247
2021-11-13,Mariposa,043,17540,1380,1323,51,1374,6
2021-11-13,Mendocino,045,87422,7799,7652,617,8269,89
2021-11-13,Merced,047,269075,42602,42411,1998,44409,644
2021-11-13,Modoc,049,8938,556,536,198,734,5
2021-11-13,Mono,051,14174,1769,1750,22,1772,4
2021-11-13,Monterey,053,433212,49224,48087,3008,51095,609
2021-11-13,Napa,055,140530,13175,13110,112,13222,103
2021-11-13,Nevada,057,99092,9496,9369,331,9700,92
2021-11-13,Orange,059,3164182,311007,308211,15427,323638,5641
2021-11-13,Placer,061,380077,37924,37453,3726,41179,445
2021-11-13,Plumas,063,18699,1885,1828,42,1870,8
2021-11-13,Riverside,065,2383286,368895,363801,16384,380185,5187
2021-11-13,Sacramento,067,1510023,161710,160397,4718,165115,2291
2021-11-13,San Benito,069,59416,7498,7491,170,7661,77
2021-11-13,San Bernardino,071,2135413,359755,356325,11300,367625,5873
2021-11-13,San Diego,073,3302833,379678,377633,22258,399891,4280
2021-11-13,San Francisco,075,870044,53904,53195,2335,55530,667
2021-11-13,San Joaquin,077,732212,101180,100263,5434,105697,1799
2021-11-13,San Luis Obispo,079,281455,30080,29589,1271,30860,351
2021-11-13,San Mateo,081,765935,54898,53853,904,54757,574
2021-11-13,Santa Barbara,083,443738,45140,44734,1553,46287,537
2021-11-13,Santa Clara,085,1922200,149420,147821,1397,149218,1905
2021-11-13,Santa Cruz,087,273765,20826,20565,1004,21569,223
2021-11-13,Shasta,089,179085,22044,21713,3628,25341,366
2021-11-13,Sierra,091,2930,193,188,21,209,0
2021-11-13,Siskiyou,093,43540,3383,3299,1307,4606,54
2021-11-13,Solano,095,438530,46493,45774,1283,47057,350
2021-11-13,Sonoma,097,501317,42203,41882,529,42411,399
2021-11-13,Stanislaus,099,539301,79863,79872,8928,88800,1174
2021-11-13,Sutter,101,95872,14028,14017,362,14379,181
2021-11-13,Tehama,103,63373,8700,8592,1491,10083,125
2021-11-13,Trinity,105,12862,877,749,212,961,17
2021-11-13,Tulare,107,460477,69868,68619,15325,83944,1033
2021-11-13,Tuolumne,109,53932,7506,7392,110,7502,90
2021-11-13,Ventura,111,848112,99227,98452,4299,102751,1183
2021-11-13,Yolo,113,214977,20242,20009,996,21005,255
2021-11-13,Yuba,115,75493,10308,10218,348,10566,85
2021-11-12,Alameda,001,1643700,120827,120407,2786,123193,1454
2021-11-12,Alpine,003,1148,102,105,0,105,0
2021-11-12,Amador,005,37829,5641,5614,63,5677,66
2021-11-12,Butte,007,227075,21364,21104,3968,25072,296
2021-11-12,Calaveras,009,45235,4240,4203,59,4262,83
2021-11-12,Colusa,011,21464,2562,2522,646,3168,19
2021-11-12,Contra Costa,013,1133247,100665,100004,2213,102217,1028
2021-11-12,Del Norte,015,27424,3712,3629,54,3683,42
2021-11-12,El Dorado,017,186661,16401,16163,1736,17899,159
2021-11-12,Fresno,019,978130,143354,141452,12847,154299,2205
2021-11-12,Glenn,021,27897,3548,3514,1023,4537,34
2021-11-12,Humboldt,023,135768,9301,9177,593,9770,115
2021-11-12,Imperial,025,180216,34351,33990,3275,37265,766
2021-11-12,Inyo,027,18085,2468,2436,38,2474,42
2021-11-12,Kern,029,883053,130249,128472,22901,151373,1719
2021-11-12,Kings,031,150075,32895,32452,1957,34409,347
2021-11-12,Lake,033,64148,6854,6769,151,6920,109
2021-11-12,Lassen,035,31185,6973,6897,391,7288,47
2021-11-12,Los Angeles,037,10098052,1454830,1443088,53882,1496970,26649
2021-11-12,Madera,039,155013,23821,23462,2179,25641,287
2021-11-12,Marin,041,260295,17798,17684,465,18149,247
2021-11-12,Mariposa,043,17540,1373,1323,51,1374,6
2021-11-12,Mendocino,045,87422,7787,7652,614,8266,89
2021-11-12,Merced,047,269075,42573,42411,1996,44407,644
2021-11-12,Modoc,049,8938,555,536,198,734,5
2021-11-12,Mono,051,14174,1767,1750,22,1772,4
2021-11-12,Monterey,053,433212,49192,48087,3002,51089,609
2021-11-12,Napa,055,140530,13166,13110,112,13222,103
2021-11-12,Nevada,057,99092,9483,9369,330,9699,92
2021-11-12,Orange,059,3164182,310819,308211,15409,323620,5641
2021-11-12,Placer,061,380077,37885,37453,3723,41176,445
2021-11-12,Plumas,063,18699,1879,1828,42,1870,8
2021-11-12,Riverside,065,2383286,368628,363801,16380,380181,5187
2021-11-12,Sacramento,067,1510023,161551,160397,4713,165110,2291
2021-11-12,San Benito,069,59416,7498,7491,170,7661,77
2021-11-12,San Bernardino,071,2135413,359446,356325,11290,367615,5873
2021-11-12,San Diego,073,3302833,379311,377633,22236,399869,4280
2021-11-12,San Francisco,075,870044,53870,53195,2331,55526,667
2021-11-12,San Joaquin,077,732212,101135,100263,5427,105690,1799
2021-11-12,San Luis Obispo,079,281455,30051,29589,1270,30859,351
2021-11-12,San Mateo,081,765935,54848,53853,901,54754,574
2021-11-12,Santa Barbara,083,443738,45085,44734,1552,46286,537
2021-11-12,Santa Clara,085,1922200,149278,147821,1393,149214,1905
2021-11-12,Santa Cruz,087,273765,20798,20565,1002,21567,223
2021-11-12,Shasta,089,179085,22011,21713,3625,25338,366
2021-11-12,Sierra,091,2930,192,188,21,209,0
2021-11-12,Siskiyou,093,43540,3382,3299,1305,4604,54
2021-11-12,Solano,095,438530,46465,45774,1279,47053,350
2021-11-12,Sonoma,097,501317,42163,41882,529,42411,399
2021-11-12,Stanislaus,099,539301,79811,79872,8920,88792,1174
2021-11-12,Sutter,101,95872,14021,14017,362,14379,181
2021-11-12,Tehama,103,63373,8696,8592,1490,10082,125
2021-11-12,Trinity,105,12862,870,749,212,961,17
2021-11-12,Tulare,107,460477,69826,68619,15290,83909,1033
2021-11-12,Tuolumne,109,53932,7493,7392,109,7501,90
2021-11-12,Ventura,111,848112,99162,98452,4298,102750,1183
2021-11-12,Yolo,113,214977,20227,20009,991,21000,255
2021-11-12,Yuba,115,75493,10299,10218,347,10565,85
2021-11-11,Alameda,001,1643700,120713,120147,2778,122925,1453
2021-11-11,Alpine,003,1148,102,105,0,105,0
2021-11-11,Amador,005,37829,5638,5603,62,5665,66
2021-11-11,Butte,007,227075,21321,21047,3960,25007,293
2021-11-11,Calaveras,009,45235,4222,4179,59,4238,83
2021-11-11,Colusa,011,21464,2554,2518,644,3162,19
2021-11-11,Contra Costa,013,1133247,100561,99808,2209,102017,1028
2021-11-11,Del Norte,015,27424,3710,3622,54,3676,42
2021-11-11,El Dorado,017,186661,16368,16085,1733,17818,159
2021-11-11,Fresno,019,978130,143150,140833,12813,153646,2202
2021-11-11,Glenn,021,27897,3546,3503,1022,4525,34
2021-11-11,Humboldt,023,135768,9278,9125,590,9715,115
2021-11-11,Imperial,025,180216,34282,33844,3253,37097,766
2021-11-11,Inyo,027,18085,2463,2428,38,2466,42
2021-11-11,Kern,029,883053,130064,128023,22838,150861,1709
2021-11-11,Kings,031,150075,32845,32318,1955,34273,345
2021-11-11,Lake,033,64148,6847,6745,151,6896,107
2021-11-11,Lassen,035,31185,6967,6875,391,7266,47
2021-11-11,Los Angeles,037,10098052,1453734,1440436,53824,1494260,26614
2021-11-11,Madera,039,155013,23774,23316,2171,25487,287
2021-11-11,Marin,041,260295,17788,17639,465,18104,247
2021-11-11,Mariposa,043,17540,1363,1317,51,1368,6
2021-11-11,Mendocino,045,87422,7772,7612,605,8217,89
2021-11-11,Merced,047,269075,42517,42292,1993,44285,643
2021-11-11,Modoc,049,8938,553,536,198,734,5
2021-11-11,Mono,051,14174,1763,1743,22,1765,4
2021-11-11,Monterey,053,433212,49157,48008,2990,50998,609
2021-11-11,Napa,055,140530,13158,13075,112,13187,103
2021-11-11,Nevada,057,99092,9461,9308,330,9638,92
2021-11-11,Orange,059,3164182,310546,307674,15372,323046,5633
2021-11-11,Placer,061,380077,37833,37333,3715,41048,440
2021-11-11,Plumas,063,18699,1875,1814,42,1856,7
2021-11-11,Riverside,065,2383286,368193,362930,16362,379292,5175
2021-11-11,Sacramento,067,1510023,161339,159962,4694,164656,2289
2021-11-11,San Benito,069,59416,7490,7473,170,7643,76
2021-11-11,San Bernardino,071,2135413,359016,355413,11277,366690,5849
2021-11-11,San Diego,073,3302833,378802,376428,22213,398641,4272
2021-11-11,San Francisco,075,870044,53811,53063,2330,55393,666
2021-11-11,San Joaquin,077,732212,101040,99937,5411,105348,1799
2021-11-11,San Luis Obispo,079,281455,30000,29532,1268,30800,351
2021-11-11,San Mateo,081,765935,54800,53722,896,54618,574
2021-11-11,Santa Barbara,083,443738,45028,44603,1549,46152,534
2021-11-11,Santa Clara,085,1922200,149096,147458,1387,148845,1901
2021-11-11,Santa Cruz,087,273765,20753,20479,1002,21481,222
2021-11-11,Shasta,089,179085,21966,21600,3623,25223,364
2021-11-11,Sierra,091,2930,191,186,21,207,0
2021-11-11,Siskiyou,093,43540,3376,3297,1304,4601,53
2021-11-11,Solano,095,438530,46428,45679,1278,46957,350
2021-11-11,Sonoma,097,501317,42126,41774,529,42303,395
2021-11-11,Stanislaus,099,539301,79729,79570,8904,88474,1166
2021-11-11,Sutter,101,95872,14006,13993,361,14354,181
2021-11-11,Tehama,103,63373,8684,8565,1488,10053,125
2021-11-11,Trinity,105,12862,869,748,212,960,17
2021-11-11,Tulare,107,460477,69733,68367,15254,83621,1028
2021-11-11,Tuolumne,109,53932,7480,7354,109,7463,90
2021-11-11,Ventura,111,848112,99084,98297,4291,102588,1182
2021-11-11,Yolo,113,214977,20199,19946,990,20936,255
2021-11-11,Yuba,115,75493,10283,10191,347,10538,85
2021-11-10,Alameda,001,1643700,120603,120147,2769,122916,1453
2021-11-10,Alpine,003,1148,102,105,0,105,0
2021-11-10,Amador,005,37829,5632,5603,62,5665,66
2021-11-10,Butte,007,227075,21294,21047,3956,25003,293
2021-11-10,Calaveras,009,45235,4211,4179,59,4238,83
2021-11-10,Colusa,011,21464,2548,2518,644,3162,19
2021-11-10,Contra Costa,013,1133247,100478,99808,2205,102013,1028
2021-11-10,Del Norte,015,27424,3709,3622,54,3676,42
2021-11-10,El Dorado,017,186661,16352,16085,1732,17817,159
2021-11-10,Fresno,019,978130,142971,140833,12800,153633,2202
2021-11-10,Glenn,021,27897,3546,3503,1021,4524,34
2021-11-10,Humboldt,023,135768,9260,9125,590,9715,115
2021-11-10,Imperial,025,180216,34234,33844,3234,37078,766
2021-11-10,Inyo,027,18085,2456,2428,38,2466,42
2021-11-10,Kern,029,883053,129914,128023,22783,150806,1709
2021-11-10,Kings,031,150075,32812,32318,1953,34271,345
2021-11-10,Lake,033,64148,6837,6745,151,6896,107
2021-11-10,Lassen,035,31185,6962,6875,391,7266,47
2021-11-10,Los Angeles,037,10098052,1452785,1440436,53764,1494200,26614
2021-11-10,Madera,039,155013,23724,23316,2165,25481,287
2021-11-10,Marin,041,260295,17775,17639,463,18102,247
2021-11-10,Mariposa,043,17540,1357,1317,51,1368,6
2021-11-10,Mendocino,045,87422,7760,7612,604,8216,89
2021-11-10,Merced,047,269075,42482,42292,1991,44283,643
2021-11-10,Modoc,049,8938,552,536,197,733,5
2021-11-10,Mono,051,14174,1761,1743,22,1765,4
2021-11-10,Monterey,053,433212,49123,48008,2979,50987,609
2021-11-10,Napa,055,140530,13144,13075,111,13186,103
2021-11-10,Nevada,057,99092,9454,9308,328,9636,92
2021-11-10,Orange,059,3164182,310282,307674,15340,323014,5633
2021-11-10,Placer,061,380077,37787,37333,3708,41041,440
2021-11-10,Plumas,063,18699,1869,1814,41,1855,7
2021-11-10,Riverside,065,2383286,367812,362930,16356,379286,5175
2021-11-10,Sacramento,067,1510023,161184,159962,4684,164646,2289
2021-11-10,San Benito,069,59416,7482,7473,170,7643,76
2021-11-10,San Bernardino,071,2135413,358675,355413,11270,366683,5849
2021-11-10,San Diego,073,3302833,378397,376428,22191,398619,4272
2021-11-10,San Francisco,075,870044,53750,53063,2327,55390,666
2021-11-10,San Joaquin,077,732212,100935,99937,5406,105343,1799
2021-11-10,San Luis Obispo,079,281455,29969,29532,1267,30799,351
2021-11-10,San Mateo,081,765935,54747,53722,895,54617,574
2021-11-10,Santa Barbara,083,443738,44990,44603,1548,46151,534
2021-11-10,Santa Clara,085,1922200,148949,147458,1381,148839,1901
2021-11-10,Santa Cruz,087,273765,20726,20479,1001,21480,222
2021-11-10,Shasta,089,179085,21930,21600,3621,25221,364
2021-11-10,Sierra,091,2930,190,186,21,207,0
2021-11-10,Siskiyou,093,43540,3374,3297,1304,4601,53
2021-11-10,Solano,095,438530,46398,45679,1276,46955,350
2021-11-10,Sonoma,097,501317,42075,41774,529,42303,395
2021-11-10,Stanislaus,099,539301,79627,79570,8888,88458,1166
2021-11-10,Sutter,101,95872,13998,13993,361,14354,181
2021-11-10,Tehama,103,63373,8672,8565,1482,10047,125
2021-11-10,Trinity,105,12862,865,748,211,959,17
2021-11-10,Tulare,107,460477,69672,68367,15215,83582,1028
2021-11-10,Tuolumne,109,53932,7456,7354,109,7463,90
2021-11-10,Ventura,111,848112,99013,98297,4291,102588,1182
2021-11-10,Yolo,113,214977,20180,19946,989,20935,255
2021-11-10,Yuba,115,75493,10274,10191,347,10538,85
2021-11-09,Alameda,001,1643700,120466,120051,2760,122811,1450
2021-11-09,Alpine,003,1148,102,105,0,105,0
2021-11-09,Amador,005,37829,5626,5596,62,5658,66
2021-11-09,Butte,007,227075,21269,21022,3952,24974,291
2021-11-09,Calaveras,009,45235,4207,4174,59,4233,84
2021-11-09,Colusa,011,21464,2543,2517,643,3160,19
2021-11-09,Contra Costa,013,1133247,100382,99732,2198,101930,1028
2021-11-09,Del Norte,015,27424,3708,3620,54,3674,42
2021-11-09,El Dorado,017,186661,16314,16073,1727,17800,160
2021-11-09,Fresno,019,978130,142725,140666,12785,153451,2188
2021-11-09,Glenn,021,27897,3541,3499,1020,4519,34
2021-11-09,Humboldt,023,135768,9239,9112,585,9697,115
2021-11-09,Imperial,025,180216,34181,33751,3220,36971,766
2021-11-09,Inyo,027,18085,2452,2404,38,2442,42
2021-11-09,Kern,029,883053,129668,127901,22721,150622,1694
2021-11-09,Kings,031,150075,32746,32279,1949,34228,344
2021-11-09,Lake,033,64148,6828,6743,151,6894,106
2021-11-09,Lassen,035,31185,6950,6846,391,7237,47
2021-11-09,Los Angeles,037,10098052,1451532,1439125,53703,1492828,26581
2021-11-09,Madera,039,155013,23674,23285,2156,25441,287
2021-11-09,Marin,041,260295,17756,17630,461,18091,247
2021-11-09,Mariposa,043,17540,1349,1317,51,1368,5
2021-11-09,Mendocino,045,87422,7737,7598,598,8196,85
2021-11-09,Merced,047,269075,42441,42251,1985,44236,613
2021-11-09,Modoc,049,8938,551,536,195,731,5
2021-11-09,Mono,051,14174,1756,1738,22,1760,4
2021-11-09,Monterey,053,433212,49087,47975,2955,50930,609
2021-11-09,Napa,055,140530,13126,13051,111,13162,103
2021-11-09,Nevada,057,99092,9435,9288,328,9616,92
2021-11-09,Orange,059,3164182,309998,307412,15313,322725,5621
2021-11-09,Placer,061,380077,37732,37291,3691,40982,440
2021-11-09,Plumas,063,18699,1867,1802,41,1843,7
2021-11-09,Riverside,065,2383286,367347,362557,16342,378899,5160
2021-11-09,Sacramento,067,1510023,160943,159856,4675,164531,2286
2021-11-09,San Benito,069,59416,7472,7471,169,7640,76
2021-11-09,San Bernardino,071,2135413,358225,354972,11253,366225,5839
2021-11-09,San Diego,073,3302833,377902,375997,22165,398162,4272
2021-11-09,San Francisco,075,870044,53676,52996,2322,55318,666
2021-11-09,San Joaquin,077,732212,100761,99848,5393,105241,1794
2021-11-09,San Luis Obispo,079,281455,29929,29488,1266,30754,350
2021-11-09,San Mateo,081,765935,54699,53697,886,54583,574
2021-11-09,Santa Barbara,083,443738,44923,44579,1541,46120,533
2021-11-09,Santa Clara,085,1922200,148743,147281,1374,148655,1901
2021-11-09,Santa Cruz,087,273765,20692,20463,1000,21463,222
2021-11-09,Shasta,089,179085,21875,21558,3616,25174,364
2021-11-09,Sierra,091,2930,190,186,21,207,0
2021-11-09,Siskiyou,093,43540,3372,3295,1302,4597,52
2021-11-09,Solano,095,438530,46343,45639,1275,46914,350
2021-11-09,Sonoma,097,501317,42018,41727,527,42254,395
2021-11-09,Stanislaus,099,539301,79521,79505,8871,88376,1165
2021-11-09,Sutter,101,95872,13983,13988,359,14347,180
2021-11-09,Tehama,103,63373,8654,8555,1480,10035,125
2021-11-09,Trinity,105,12862,864,746,211,957,17
2021-11-09,Tulare,107,460477,69565,68298,15176,83474,1024
2021-11-09,Tuolumne,109,53932,7436,7347,109,7456,90
2021-11-09,Ventura,111,848112,98935,98202,4286,102488,1182
2021-11-09,Yolo,113,214977,20156,19931,985,20916,255
2021-11-09,Yuba,115,75493,10257,10175,341,10516,85
2021-11-08,Alameda,001,1643700,120322,119983,2754,122737,1447
2021-11-08,Alpine,003,1148,102,105,0,105,0
2021-11-08,Amador,005,37829,5620,5590,62,5652,66
2021-11-08,Butte,007,227075,21241,21000,3943,24943,288
2021-11-08,Calaveras,009,45235,4199,4166,59,4225,82
2021-11-08,Colusa,011,21464,2542,2514,642,3156,19
2021-11-08,Contra Costa,013,1133247,100279,99669,2194,101863,1028
2021-11-08,Del Norte,015,27424,3704,3619,54,3673,42
2021-11-08,El Dorado,017,186661,16295,16055,1722,17777,156
2021-11-08,Fresno,019,978130,142424,140466,12763,153229,2179
2021-11-08,Glenn,021,27897,3539,3496,1016,4512,34
2021-11-08,Humboldt,023,135768,9213,9095,575,9670,109
2021-11-08,Imperial,025,180216,34101,33690,3202,36892,766
2021-11-08,Inyo,027,18085,2445,2398,38,2436,41
2021-11-08,Kern,029,883053,129432,127722,22638,150360,1692
2021-11-08,Kings,031,150075,32700,32248,1948,34196,344
2021-11-08,Lake,033,64148,6822,6737,151,6888,106
2021-11-08,Lassen,035,31185,6943,6830,389,7219,46
2021-11-08,Los Angeles,037,10098052,1450194,1438322,53646,1491968,26575
2021-11-08,Madera,039,155013,23625,23253,2145,25398,287
2021-11-08,Marin,041,260295,17739,17617,458,18075,247
2021-11-08,Mariposa,043,17540,1341,1316,50,1366,5
2021-11-08,Mendocino,045,87422,7724,7581,592,8173,85
2021-11-08,Merced,047,269075,42371,42224,1975,44199,607
2021-11-08,Modoc,049,8938,550,529,195,724,5
2021-11-08,Mono,051,14174,1752,1739,22,1761,4
2021-11-08,Monterey,053,433212,49046,47942,2935,50877,602
2021-11-08,Napa,055,140530,13112,13045,111,13156,103
2021-11-08,Nevada,057,99092,9416,9278,326,9604,92
2021-11-08,Orange,059,3164182,309725,307156,15283,322439,5616
2021-11-08,Placer,061,380077,37679,37250,3688,40938,439
2021-11-08,Plumas,063,18699,1866,1788,40,1828,7
2021-11-08,Riverside,065,2383286,366892,362201,16328,378529,5152
2021-11-08,Sacramento,067,1510023,160727,159735,4654,164389,2275
2021-11-08,San Benito,069,59416,7470,7461,169,7630,75
2021-11-08,San Bernardino,071,2135413,357712,354741,11235,365976,5836
2021-11-08,San Diego,073,3302833,377340,375557,22118,397675,4259
2021-11-08,San Francisco,075,870044,53623,52942,2316,55258,666
2021-11-08,San Joaquin,077,732212,100644,99736,5391,105127,1794
2021-11-08,San Luis Obispo,079,281455,29878,29464,1261,30725,350
2021-11-08,San Mateo,081,765935,54626,53658,881,54539,574
2021-11-08,Santa Barbara,083,443738,44869,44548,1540,46088,532
2021-11-08,Santa Clara,085,1922200,148518,147183,1368,148551,1899
2021-11-08,Santa Cruz,087,273765,20663,20435,1000,21435,222
2021-11-08,Shasta,089,179085,21828,21504,3610,25114,354
2021-11-08,Sierra,091,2930,190,183,21,204,0
2021-11-08,Siskiyou,093,43540,3368,3290,1291,4581,50
2021-11-08,Solano,095,438530,46302,45613,1271,46884,350
2021-11-08,Sonoma,097,501317,41950,41669,526,42195,395
2021-11-08,Stanislaus,099,539301,79369,79417,8857,88274,1150
2021-11-08,Sutter,101,95872,13975,13976,355,14331,180
2021-11-08,Tehama,103,63373,8645,8534,1480,10014,123
2021-11-08,Trinity,105,12862,864,743,210,953,13
2021-11-08,Tulare,107,460477,69448,68199,15138,83337,1020
2021-11-08,Tuolumne,109,53932,7417,7328,108,7436,90
2021-11-08,Ventura,111,848112,98842,98144,4284,102428,1182
2021-11-08,Yolo,113,214977,20117,19916,981,20897,255
2021-11-08,Yuba,115,75493,10246,10172,338,10510,83
2021-11-07,Alameda,001,1643700,120163,119902,2748,122650,1444
2021-11-07,Alpine,003,1148,102,105,0,105,0
2021-11-07,Amador,005,37829,5612,5580,60,5640,66
2021-11-07,Butte,007,227075,21200,20969,3934,24903,288
2021-11-07,Calaveras,009,45235,4172,4158,58,4216,82
2021-11-07,Colusa,011,21464,2536,2511,640,3151,19
2021-11-07,Contra Costa,013,1133247,100168,99596,2185,101781,1028
2021-11-07,Del Norte,015,27424,3702,3617,54,3671,42
2021-11-07,El Dorado,017,186661,16258,16040,1719,17759,156
2021-11-07,Fresno,019,978130,142083,140263,12736,152999,2179
2021-11-07,Glenn,021,27897,3532,3493,1015,4508,34
2021-11-07,Humboldt,023,135768,9189,9074,571,9645,109
2021-11-07,Imperial,025,180216,34028,33674,3183,36857,766
2021-11-07,Inyo,027,18085,2432,2394,38,2432,41
2021-11-07,Kern,029,883053,129161,127583,22547,150130,1692
2021-11-07,Kings,031,150075,32608,32221,1945,34166,343
2021-11-07,Lake,033,64148,6806,6734,150,6884,106
2021-11-07,Lassen,035,31185,6935,6819,385,7204,46
2021-11-07,Los Angeles,037,10098052,1448707,1437314,53571,1490885,26573
2021-11-07,Madera,039,155013,23580,23225,2137,25362,287
2021-11-07,Marin,041,260295,17719,17594,457,18051,247
2021-11-07,Mariposa,043,17540,1339,1306,50,1356,5
2021-11-07,Mendocino,045,87422,7696,7567,588,8155,85
2021-11-07,Merced,047,269075,42293,42186,1944,44130,607
2021-11-07,Modoc,049,8938,547,528,194,722,5
2021-11-07,Mono,051,14174,1746,1739,22,1761,4
2021-11-07,Monterey,053,433212,48994,47924,2931,50855,602
2021-11-07,Napa,055,140530,13091,13041,111,13152,103
2021-11-07,Nevada,057,99092,9368,9254,326,9580,92
2021-11-07,Orange,059,3164182,309401,306954,15245,322199,5616
2021-11-07,Placer,061,380077,37603,37202,3673,40875,439
2021-11-07,Plumas,063,18699,1859,1787,39,1826,7
2021-11-07,Riverside,065,2383286,366355,361960,16308,378268,5152
2021-11-07,Sacramento,067,1510023,160493,159549,4637,164186,2277
2021-11-07,San Benito,069,59416,7457,7460,169,7629,75
2021-11-07,San Bernardino,071,2135413,357195,354488,11212,365700,5832
2021-11-07,San Diego,073,3302833,376763,375165,22085,397250,4250
2021-11-07,San Francisco,075,870044,53539,52868,2310,55178,666
2021-11-07,San Joaquin,077,732212,100460,99696,5385,105081,1794
2021-11-07,San Luis Obispo,079,281455,29830,29454,1257,30711,350
2021-11-07,San Mateo,081,765935,54567,53600,879,54479,574
2021-11-07,Santa Barbara,083,443738,44806,44501,1539,46040,532
2021-11-07,Santa Clara,085,1922200,148313,147054,1356,148410,1898
2021-11-07,Santa Cruz,087,273765,20605,20397,999,21396,222
2021-11-07,Shasta,089,179085,21780,21479,3604,25083,354
2021-11-07,Sierra,091,2930,188,183,21,204,0
2021-11-07,Siskiyou,093,43540,3362,3289,1289,4578,51
2021-11-07,Solano,095,438530,46247,45582,1264,46846,350
2021-11-07,Sonoma,097,501317,41900,41630,525,42155,395
2021-11-07,Stanislaus,099,539301,79214,79351,8835,88186,1150
2021-11-07,Sutter,101,95872,13962,13964,352,14316,180
2021-11-07,Tehama,103,63373,8620,8528,1478,10006,121
2021-11-07,Trinity,105,12862,863,742,209,951,13
2021-11-07,Tulare,107,460477,69295,68145,15095,83240,1020
2021-11-07,Tuolumne,109,53932,7399,7300,106,7406,90
2021-11-07,Ventura,111,848112,98751,98085,4282,102367,1182
2021-11-07,Yolo,113,214977,20096,19899,978,20877,255
2021-11-07,Yuba,115,75493,10229,10162,333,10495,83
2021-11-06,Alameda,001,1643700,120099,119499,2745,122244,1436
2021-11-06,Alpine,003,1148,102,105,0,105,0
2021-11-06,Amador,005,37829,5606,5557,60,5617,66
2021-11-06,Butte,007,227075,21180,20796,3930,24726,288
2021-11-06,Calaveras,009,45235,4164,4105,58,4163,82
2021-11-06,Colusa,011,21464,2535,2501,639,3140,19
2021-11-06,Contra Costa,013,1133247,100113,99282,2183,101465,1025
2021-11-06,Del Norte,015,27424,3699,3607,54,3661,42
2021-11-06,El Dorado,017,186661,16241,15958,1719,17677,156
2021-11-06,Fresno,019,978130,141965,139249,12731,151980,2170
2021-11-06,Glenn,021,27897,3529,3479,1015,4494,33
2021-11-06,Humboldt,023,135768,9177,8972,567,9539,109
2021-11-06,Imperial,025,180216,33984,33471,3177,36648,766
2021-11-06,Inyo,027,18085,2426,2353,38,2391,41
2021-11-06,Kern,029,883053,129027,126848,22495,149343,1684
2021-11-06,Kings,031,150075,32575,32018,1940,33958,342
2021-11-06,Lake,033,64148,6804,6695,150,6845,106
2021-11-06,Lassen,035,31185,6930,6796,384,7180,46
2021-11-06,Los Angeles,037,10098052,1447938,1433081,53528,1486609,26533
2021-11-06,Madera,039,155013,23544,22994,2127,25121,287
2021-11-06,Marin,041,260295,17700,17520,454,17974,247
2021-11-06,Mariposa,043,17540,1337,1282,50,1332,5
2021-11-06,Mendocino,045,87422,7674,7486,588,8074,85
2021-11-06,Merced,047,269075,42269,41958,1936,43894,604
2021-11-06,Modoc,049,8938,546,523,194,717,5
2021-11-06,Mono,051,14174,1744,1725,22,1747,4
2021-11-06,Monterey,053,433212,48962,47830,2921,50751,602
2021-11-06,Napa,055,140530,13081,12950,111,13061,103
2021-11-06,Nevada,057,99092,9346,9169,325,9494,91
2021-11-06,Orange,059,3164182,309195,306049,15219,321268,5611
2021-11-06,Placer,061,380077,37562,36967,3670,40637,438
2021-11-06,Plumas,063,18699,1855,1755,38,1793,7
2021-11-06,Riverside,065,2383286,366036,360584,16300,376884,5138
2021-11-06,Sacramento,067,1510023,160400,158766,4632,163398,2263
2021-11-06,San Benito,069,59416,7450,7429,169,7598,75
2021-11-06,San Bernardino,071,2135413,356925,353142,11208,364350,5813
2021-11-06,San Diego,073,3302833,376427,373423,22067,395490,4246
2021-11-06,San Francisco,075,870044,53486,52556,2307,54863,666
2021-11-06,San Joaquin,077,732212,100402,99372,5384,104756,1782
2021-11-06,San Luis Obispo,079,281455,29802,29335,1253,30588,350
2021-11-06,San Mateo,081,765935,54532,53442,878,54320,574
2021-11-06,Santa Barbara,083,443738,44770,44301,1538,45839,532
2021-11-06,Santa Clara,085,1922200,148167,146519,1352,147871,1894
2021-11-06,Santa Cruz,087,273765,20586,20311,997,21308,222
2021-11-06,Shasta,089,179085,21761,21281,3599,24880,349
2021-11-06,Sierra,091,2930,188,181,21,202,0
2021-11-06,Siskiyou,093,43540,3362,3279,1287,4566,48
2021-11-06,Solano,095,438530,46217,45465,1263,46728,350
2021-11-06,Sonoma,097,501317,41850,41398,524,41922,395
2021-11-06,Stanislaus,099,539301,79146,78902,8827,87729,1193
2021-11-06,Sutter,101,95872,13958,13908,351,14259,180
2021-11-06,Tehama,103,63373,8608,8474,1476,9950,120
2021-11-06,Trinity,105,12862,860,732,209,941,11
2021-11-06,Tulare,107,460477,69245,67767,15066,82833,1010
2021-11-06,Tuolumne,109,53932,7387,7245,106,7351,90
2021-11-06,Ventura,111,848112,98684,97770,4277,102047,1180
2021-11-06,Yolo,113,214977,20079,19827,974,20801,255
2021-11-06,Yuba,115,75493,10215,10107,333,10440,83
2021-11-05,Alameda,001,1643700,120015,119499,2743,122242,1436
2021-11-05,Alpine,003,1148,102,105,0,105,0
2021-11-05,Amador,005,37829,5601,5557,60,5617,66
2021-11-05,Butte,007,227075,21167,20796,3929,24725,288
2021-11-05,Calaveras,009,45235,4159,4105,58,4163,82
2021-11-05,Colusa,011,21464,2535,2501,638,3139,19
2021-11-05,Contra Costa,013,1133247,100047,99282,2181,101463,1025
2021-11-05,Del Norte,015,27424,3697,3607,54,3661,42
2021-11-05,El Dorado,017,186661,16224,15958,1713,17671,156
2021-11-05,Fresno,019,978130,141786,139249,12720,151969,2170
2021-11-05,Glenn,021,27897,3528,3479,1014,4493,33
2021-11-05,Humboldt,023,135768,9163,8972,567,9539,109
2021-11-05,Imperial,025,180216,33948,33471,3174,36645,766
2021-11-05,Inyo,027,18085,2418,2353,38,2391,41
2021-11-05,Kern,029,883053,128900,126848,22440,149288,1684
2021-11-05,Kings,031,150075,32551,32018,1939,33957,342
2021-11-05,Lake,033,64148,6798,6695,150,6845,106
2021-11-05,Lassen,035,31185,6926,6796,383,7179,46
2021-11-05,Los Angeles,037,10098052,1447115,1433081,53490,1486571,26533
2021-11-05,Madera,039,155013,23505,22994,2126,25120,287
2021-11-05,Marin,041,260295,17678,17520,453,17973,247
2021-11-05,Mariposa,043,17540,1334,1282,49,1331,5
2021-11-05,Mendocino,045,87422,7663,7486,587,8073,85
2021-11-05,Merced,047,269075,42243,41958,1927,43885,604
2021-11-05,Modoc,049,8938,546,523,194,717,5
2021-11-05,Mono,051,14174,1743,1725,22,1747,4
2021-11-05,Monterey,053,433212,48932,47830,2919,50749,602
2021-11-05,Napa,055,140530,13059,12950,111,13061,103
2021-11-05,Nevada,057,99092,9333,9169,325,9494,91
2021-11-05,Orange,059,3164182,308999,306049,15197,321246,5611
2021-11-05,Placer,061,380077,37535,36967,3661,40628,438
2021-11-05,Plumas,063,18699,1847,1755,38,1793,7
2021-11-05,Riverside,065,2383286,365695,360584,16290,376874,5138
2021-11-05,Sacramento,067,1510023,160278,158766,4625,163391,2263
2021-11-05,San Benito,069,59416,7448,7429,168,7597,75
2021-11-05,San Bernardino,071,2135413,356592,353142,11198,364340,5813
2021-11-05,San Diego,073,3302833,376074,373423,22055,395478,4246
2021-11-05,San Francisco,075,870044,53435,52556,2304,54860,666
2021-11-05,San Joaquin,077,732212,100349,99372,5375,104747,1782
2021-11-05,San Luis Obispo,079,281455,29779,29335,1253,30588,350
2021-11-05,San Mateo,081,765935,54490,53442,876,54318,574
2021-11-05,Santa Barbara,083,443738,44725,44301,1537,45838,532
2021-11-05,Santa Clara,085,1922200,148030,146519,1351,147870,1894
2021-11-05,Santa Cruz,087,273765,20562,20311,996,21307,222
2021-11-05,Shasta,089,179085,21729,21281,3594,24875,349
2021-11-05,Sierra,091,2930,188,181,21,202,0
2021-11-05,Siskiyou,093,43540,3357,3279,1286,4565,48
2021-11-05,Solano,095,438530,46172,45465,1261,46726,350
2021-11-05,Sonoma,097,501317,41810,41398,524,41922,395
2021-11-05,Stanislaus,099,539301,79088,78902,8815,87717,1193
2021-11-05,Sutter,101,95872,13950,13908,350,14258,180
2021-11-05,Tehama,103,63373,8601,8474,1475,9949,120
2021-11-05,Trinity,105,12862,860,732,209,941,11
2021-11-05,Tulare,107,460477,69173,67767,15029,82796,1010
2021-11-05,Tuolumne,109,53932,7370,7245,105,7350,90
2021-11-05,Ventura,111,848112,98644,97770,4275,102045,1180
2021-11-05,Yolo,113,214977,20068,19827,973,20800,255
2021-11-05,Yuba,115,75493,10202,10107,331,10438,83
2021-11-04,Alameda,001,1643700,119900,119499,2737,122236,1436
2021-11-04,Alpine,003,1148,102,105,0,105,0
2021-11-04,Amador,005,37829,5593,5557,60,5617,66
2021-11-04,Butte,007,227075,21126,20796,3917,24713,288
2021-11-04,Calaveras,009,45235,4145,4105,56,4161,82
2021-11-04,Colusa,011,21464,2529,2501,637,3138,19
2021-11-04,Contra Costa,013,1133247,99956,99282,2176,101458,1025
2021-11-04,Del Norte,015,27424,3694,3607,54,3661,42
2021-11-04,El Dorado,017,186661,16198,15958,1709,17667,156
2021-11-04,Fresno,019,978130,141504,139249,12711,151960,2170
2021-11-04,Glenn,021,27897,3523,3479,1013,4492,33
2021-11-04,Humboldt,023,135768,9138,8972,564,9536,109
2021-11-04,Imperial,025,180216,33891,33471,3165,36636,766
2021-11-04,Inyo,027,18085,2410,2353,38,2391,41
2021-11-04,Kern,029,883053,128668,126848,22371,149219,1684
2021-11-04,Kings,031,150075,32472,32018,1930,33948,342
2021-11-04,Lake,033,64148,6788,6695,148,6843,106
2021-11-04,Lassen,035,31185,6916,6796,378,7174,46
2021-11-04,Los Angeles,037,10098052,1445808,1433081,53409,1486490,26533
2021-11-04,Madera,039,155013,23450,22994,2115,25109,287
2021-11-04,Marin,041,260295,17666,17520,451,17971,247
2021-11-04,Mariposa,043,17540,1327,1282,49,1331,5
2021-11-04,Mendocino,045,87422,7650,7486,581,8067,85
2021-11-04,Merced,047,269075,42189,41958,1923,43881,604
2021-11-04,Modoc,049,8938,545,523,194,717,5
2021-11-04,Mono,051,14174,1738,1725,22,1747,4
2021-11-04,Monterey,053,433212,48888,47830,2903,50733,602
2021-11-04,Napa,055,140530,13037,12950,111,13061,103
2021-11-04,Nevada,057,99092,9302,9169,324,9493,91
2021-11-04,Orange,059,3164182,308750,306049,15179,321228,5611
2021-11-04,Placer,061,380077,37463,36967,3652,40619,438
2021-11-04,Plumas,063,18699,1839,1755,34,1789,7
2021-11-04,Riverside,065,2383286,365297,360584,16281,376865,5138
2021-11-04,Sacramento,067,1510023,160043,158766,4606,163372,2263
2021-11-04,San Benito,069,59416,7442,7429,168,7597,75
2021-11-04,San Bernardino,071,2135413,356153,353142,11190,364332,5813
2021-11-04,San Diego,073,3302833,375605,373423,22034,395457,4246
2021-11-04,San Francisco,075,870044,53354,52556,2300,54856,666
2021-11-04,San Joaquin,077,732212,100242,99372,5363,104735,1782
2021-11-04,San Luis Obispo,079,281455,29755,29335,1247,30582,350
2021-11-04,San Mateo,081,765935,54431,53442,870,54312,574
2021-11-04,Santa Barbara,083,443738,44669,44301,1537,45838,532
2021-11-04,Santa Clara,085,1922200,147871,146519,1347,147866,1894
2021-11-04,Santa Cruz,087,273765,20527,20311,996,21307,222
2021-11-04,Shasta,089,179085,21671,21281,3588,24869,349
2021-11-04,Sierra,091,2930,186,181,21,202,0
2021-11-04,Siskiyou,093,43540,3353,3279,1279,4558,48
2021-11-04,Solano,095,438530,46130,45465,1260,46725,350
2021-11-04,Sonoma,097,501317,41750,41398,524,41922,395
2021-11-04,Stanislaus,099,539301,78951,78902,8807,87709,1193
2021-11-04,Sutter,101,95872,13939,13908,348,14256,180
2021-11-04,Tehama,103,63373,8592,8474,1471,9945,120
2021-11-04,Trinity,105,12862,859,732,209,941,11
2021-11-04,Tulare,107,460477,69058,67767,14983,82750,1010
2021-11-04,Tuolumne,109,53932,7348,7245,103,7348,90
2021-11-04,Ventura,111,848112,98556,97770,4272,102042,1180
2021-11-04,Yolo,113,214977,20042,19827,969,20796,255
2021-11-04,Yuba,115,75493,10188,10107,329,10436,83
2021-11-03,Alameda,001,1643700,119759,119356,2733,122089,1428
2021-11-03,Alpine,003,1148,102,105,0,105,0
2021-11-03,Amador,005,37829,5587,5545,59,5604,66
2021-11-03,Butte,007,227075,21081,20769,3908,24677,284
2021-11-03,Calaveras,009,45235,4127,4087,55,4142,82
2021-11-03,Colusa,011,21464,2523,2499,637,3136,20
2021-11-03,Contra Costa,013,1133247,99857,99168,2171,101339,1025
2021-11-03,Del Norte,015,27424,3692,3600,53,3653,42
2021-11-03,El Dorado,017,186661,16171,15915,1705,17620,156
2021-11-03,Fresno,019,978130,141143,138873,12689,151562,2166
2021-11-03,Glenn,021,27897,3520,3470,1013,4483,33
2021-11-03,Humboldt,023,135768,9121,8949,559,9508,109
2021-11-03,Imperial,025,180216,33819,33402,3155,36557,766
2021-11-03,Inyo,027,18085,2389,2344,38,2382,41
2021-11-03,Kern,029,883053,128408,126523,22272,148795,1681
2021-11-03,Kings,031,150075,32418,31923,1923,33846,341
2021-11-03,Lake,033,64148,6772,6685,148,6833,106
2021-11-03,Lassen,035,31185,6900,6782,373,7155,46
2021-11-03,Los Angeles,037,10098052,1444461,1431209,53329,1484538,26517
2021-11-03,Madera,039,155013,23382,22893,2106,24999,287
2021-11-03,Marin,041,260295,17645,17491,447,17938,247
2021-11-03,Mariposa,043,17540,1317,1276,49,1325,5
2021-11-03,Mendocino,045,87422,7634,7457,573,8030,84
2021-11-03,Merced,047,269075,42128,41849,1913,43762,597
2021-11-03,Modoc,049,8938,545,521,192,713,5
2021-11-03,Mono,051,14174,1734,1719,22,1741,4
2021-11-03,Monterey,053,433212,48838,47794,2890,50684,601
2021-11-03,Napa,055,140530,13025,12937,110,13047,103
2021-11-03,Nevada,057,99092,9275,9131,323,9454,91
2021-11-03,Orange,059,3164182,308439,305661,15147,320808,5607
2021-11-03,Placer,061,380077,37393,36868,3647,40515,438
2021-11-03,Plumas,063,18699,1828,1739,33,1772,7
2021-11-03,Riverside,065,2383286,364839,360060,16277,376337,5131
2021-11-03,Sacramento,067,1510023,159819,158311,4596,162907,2259
2021-11-03,San Benito,069,59416,7434,7419,168,7587,75
2021-11-03,San Bernardino,071,2135413,355678,352225,11169,363394,5813
2021-11-03,San Diego,073,3302833,375105,372951,22011,394962,4241
2021-11-03,San Francisco,075,870044,53262,52493,2295,54788,663
2021-11-03,San Joaquin,077,732212,100129,99188,5353,104541,1776
2021-11-03,San Luis Obispo,079,281455,29713,29276,1241,30517,348
2021-11-03,San Mateo,081,765935,54367,53396,864,54260,571
2021-11-03,Santa Barbara,083,443738,44612,44220,1534,45754,531
2021-11-03,Santa Clara,085,1922200,147691,146259,1340,147599,1897
2021-11-03,Santa Cruz,087,273765,20492,20275,996,21271,222
2021-11-03,Shasta,089,179085,21613,21215,3581,24796,346
2021-11-03,Sierra,091,2930,184,180,21,201,0
2021-11-03,Siskiyou,093,43540,3349,3276,1277,4553,46
2021-11-03,Solano,095,438530,46103,45411,1258,46669,351
2021-11-03,Sonoma,097,501317,41673,41326,522,41848,395
2021-11-03,Stanislaus,099,539301,78820,78736,8791,87527,1193
2021-11-03,Sutter,101,95872,13926,13876,346,14222,179
2021-11-03,Tehama,103,63373,8580,8438,1471,9909,118
2021-11-03,Trinity,105,12862,858,730,209,939,11
2021-11-03,Tulare,107,460477,68931,67588,14942,82530,1007
2021-11-03,Tuolumne,109,53932,7330,7218,101,7319,90
2021-11-03,Ventura,111,848112,98448,97682,4268,101950,1178
2021-11-03,Yolo,113,214977,20022,19758,963,20721,250
2021-11-03,Yuba,115,75493,10176,10092,329,10421,83
2021-11-02,Alameda,001,1643700,119612,119241,2727,121968,1425
2021-11-02,Alpine,003,1148,101,105,0,105,0
2021-11-02,Amador,005,37829,5582,5535,59,5594,66
2021-11-02,Butte,007,227075,21037,20744,3896,24640,282
2021-11-02,Calaveras,009,45235,4104,4075,55,4130,82
2021-11-02,Colusa,011,21464,2518,2497,636,3133,19
2021-11-02,Contra Costa,013,1133247,99753,99080,2159,101239,1025
2021-11-02,Del Norte,015,27424,3690,3596,53,3649,42
2021-11-02,El Dorado,017,186661,16142,15883,1705,17588,154
2021-11-02,Fresno,019,978130,140819,138644,12659,151303,2158
2021-11-02,Glenn,021,27897,3512,3469,1010,4479,33
2021-11-02,Humboldt,023,135768,9079,8937,558,9495,109
2021-11-02,Imperial,025,180216,33747,33371,3143,36514,766
2021-11-02,Inyo,027,18085,2382,2324,38,2362,41
2021-11-02,Kern,029,883053,128153,126311,22152,148463,1665
2021-11-02,Kings,031,150075,32359,31896,1918,33814,339
2021-11-02,Lake,033,64148,6767,6681,147,6828,106
2021-11-02,Lassen,035,31185,6888,6777,370,7147,45
2021-11-02,Los Angeles,037,10098052,1443020,1429601,53253,1482854,26496
2021-11-02,Madera,039,155013,23301,22837,2095,24932,287
2021-11-02,Marin,041,260295,17617,17482,447,17929,247
2021-11-02,Mariposa,043,17540,1306,1270,48,1318,5
2021-11-02,Mendocino,045,87422,7610,7447,561,8008,84
2021-11-02,Merced,047,269075,42061,41785,1905,43690,596
2021-11-02,Modoc,049,8938,542,520,191,711,5
2021-11-02,Mono,051,14174,1730,1718,22,1740,4
2021-11-02,Monterey,053,433212,48787,47775,2872,50647,599
2021-11-02,Napa,055,140530,13007,12930,110,13040,104
2021-11-02,Nevada,057,99092,9245,9122,322,9444,91
2021-11-02,Orange,059,3164182,308123,305369,15103,320472,5600
2021-11-02,Placer,061,380077,37321,36817,3632,40449,438
2021-11-02,Plumas,063,18699,1817,1721,33,1754,7
2021-11-02,Riverside,065,2383286,364385,359586,16258,375844,5116
2021-11-02,Sacramento,067,1510023,159562,158112,4574,162686,2250
2021-11-02,San Benito,069,59416,7418,7407,168,7575,75
2021-11-02,San Bernardino,071,2135413,355201,351832,11116,362948,5813
2021-11-02,San Diego,073,3302833,374520,372440,21981,394421,4232
2021-11-02,San Francisco,075,870044,53142,52450,2291,54741,663
2021-11-02,San Joaquin,077,732212,99996,99076,5342,104418,1772
2021-11-02,San Luis Obispo,079,281455,29680,29224,1237,30461,348
2021-11-02,San Mateo,081,765935,54295,53351,861,54212,571
2021-11-02,Santa Barbara,083,443738,44556,44177,1531,45708,531
2021-11-02,Santa Clara,085,1922200,147497,146115,1333,147448,1896
2021-11-02,Santa Cruz,087,273765,20459,20266,995,21261,222
2021-11-02,Shasta,089,179085,21539,21127,3571,24698,344
2021-11-02,Sierra,091,2930,184,180,20,200,0
2021-11-02,Siskiyou,093,43540,3347,3272,1274,4546,46
2021-11-02,Solano,095,438530,46063,45378,1252,46630,350
2021-11-02,Sonoma,097,501317,41592,41288,521,41809,395
2021-11-02,Stanislaus,099,539301,78665,78629,8771,87400,1193
2021-11-02,Sutter,101,95872,13906,13868,346,14214,179
2021-11-02,Tehama,103,63373,8564,8422,1468,9890,116
2021-11-02,Trinity,105,12862,858,729,209,938,11
2021-11-02,Tulare,107,460477,68806,67502,14894,82396,1002
2021-11-02,Tuolumne,109,53932,7308,7204,99,7303,90
2021-11-02,Ventura,111,848112,98343,97574,4264,101838,1178
2021-11-02,Yolo,113,214977,19992,19736,961,20697,250
2021-11-02,Yuba,115,75493,10153,10080,327,10407,83
2021-11-01,Alameda,001,1643700,119474,119159,2725,121884,1421
2021-11-01,Alpine,003,1148,101,105,0,105,0
2021-11-01,Amador,005,37829,5580,5532,59,5591,64
2021-11-01,Butte,007,227075,20987,20710,3890,24600,281
2021-11-01,Calaveras,009,45235,4094,4059,54,4113,82
2021-11-01,Colusa,011,21464,2516,2494,633,3127,19
2021-11-01,Contra Costa,013,1133247,99628,99011,2151,101162,1025
2021-11-01,Del Norte,015,27424,3688,3594,53,3647,42
2021-11-01,El Dorado,017,186661,16118,15858,1700,17558,154
2021-11-01,Fresno,019,978130,140442,138421,12623,151044,2149
2021-11-01,Glenn,021,27897,3505,3461,1008,4469,33
2021-11-01,Humboldt,023,135768,9051,8929,555,9484,108
2021-11-01,Imperial,025,180216,33697,33342,3134,36476,766
2021-11-01,Inyo,027,18085,2370,2307,38,2345,41
2021-11-01,Kern,029,883053,127852,126092,22037,148129,1660
2021-11-01,Kings,031,150075,32306,31866,1914,33780,337
2021-11-01,Lake,033,64148,6756,6676,146,6822,106
2021-11-01,Lassen,035,31185,6873,6775,367,7142,42
2021-11-01,Los Angeles,037,10098052,1441636,1428891,53164,1482055,26483
2021-11-01,Madera,039,155013,23221,22801,2090,24891,283
2021-11-01,Marin,041,260295,17597,17460,446,17906,247
2021-11-01,Mariposa,043,17540,1298,1266,47,1313,5
2021-11-01,Mendocino,045,87422,7577,7422,543,7965,84
2021-11-01,Merced,047,269075,41970,41740,1903,43643,594
2021-11-01,Modoc,049,8938,537,520,189,709,5
2021-11-01,Mono,051,14174,1726,1714,22,1736,3
2021-11-01,Monterey,053,433212,48744,47756,2860,50616,597
2021-11-01,Napa,055,140530,12980,12916,109,13025,101
2021-11-01,Nevada,057,99092,9222,9108,321,9429,91
2021-11-01,Orange,059,3164182,307780,305192,15062,320254,5596
2021-11-01,Placer,061,380077,37238,36747,3620,40367,435
2021-11-01,Plumas,063,18699,1798,1719,33,1752,7
2021-11-01,Riverside,065,2383286,363883,359263,16236,375499,5115
2021-11-01,Sacramento,067,1510023,159289,157893,4552,162445,2239
2021-11-01,San Benito,069,59416,7408,7406,167,7573,73
2021-11-01,San Bernardino,071,2135413,354710,351620,11096,362716,5815
2021-11-01,San Diego,073,3302833,373955,372043,21963,394006,4232
2021-11-01,San Francisco,075,870044,53056,52418,2284,54702,661
2021-11-01,San Joaquin,077,732212,99834,98969,5335,104304,1772
2021-11-01,San Luis Obispo,079,281455,29636,29199,1232,30431,343
2021-11-01,San Mateo,081,765935,54228,53314,857,54171,571
2021-11-01,Santa Barbara,083,443738,44489,44146,1527,45673,529
2021-11-01,Santa Clara,085,1922200,147298,145978,1328,147306,1907
2021-11-01,Santa Cruz,087,273765,20424,20238,995,21233,221
2021-11-01,Shasta,089,179085,21486,21104,3564,24668,338
2021-11-01,Sierra,091,2930,184,180,20,200,0
2021-11-01,Siskiyou,093,43540,3340,3272,1269,4541,46
2021-11-01,Solano,095,438530,46009,45358,1252,46610,350
2021-11-01,Sonoma,097,501317,41519,41234,520,41754,395
2021-11-01,Stanislaus,099,539301,78535,78534,8756,87290,1193
2021-11-01,Sutter,101,95872,13882,13852,344,14196,179
2021-11-01,Tehama,103,63373,8536,8412,1465,9877,116
2021-11-01,Trinity,105,12862,856,727,209,936,11
2021-11-01,Tulare,107,460477,68663,67388,14842,82230,1002
2021-11-01,Tuolumne,109,53932,7292,7175,98,7273,90
2021-11-01,Ventura,111,848112,98253,97507,4262,101769,1178
2021-11-01,Yolo,113,214977,19971,19708,955,20663,250
2021-11-01,Yuba,115,75493,10135,10066,325,10391,83
2021-10-31,Alameda,001,1643700,119330,119071,2721,121792,1419
2021-10-31,Alpine,003,1148,101,105,0,105,0
2021-10-31,Amador,005,37829,5569,5518,59,5577,64
2021-10-31,Butte,007,227075,20925,20689,3879,24568,281
2021-10-31,Calaveras,009,45235,4076,4052,53,4105,82
2021-10-31,Colusa,011,21464,2514,2493,630,3123,18
2021-10-31,Contra Costa,013,1133247,99500,98936,2149,101085,1025
2021-10-31,Del Norte,015,27424,3682,3591,53,3644,42
2021-10-31,El Dorado,017,186661,16072,15841,1697,17538,154
2021-10-31,Fresno,019,978130,140038,138165,12589,150754,2147
2021-10-31,Glenn,021,27897,3498,3459,1008,4467,33
2021-10-31,Humboldt,023,135768,9003,8919,549,9468,108
2021-10-31,Imperial,025,180216,33622,33334,3122,36456,766
2021-10-31,Inyo,027,18085,2351,2309,38,2347,41
2021-10-31,Kern,029,883053,127480,125917,21913,147830,1666
2021-10-31,Kings,031,150075,32220,31814,1902,33716,338
2021-10-31,Lake,033,64148,6745,6665,144,6809,106
2021-10-31,Lassen,035,31185,6858,6768,362,7130,42
2021-10-31,Los Angeles,037,10098052,1440084,1427933,53081,1481014,26474
2021-10-31,Madera,039,155013,23125,22744,2077,24821,283
2021-10-31,Marin,041,260295,17569,17443,445,17888,247
2021-10-31,Mariposa,043,17540,1292,1257,46,1303,5
2021-10-31,Mendocino,045,87422,7536,7403,526,7929,84
2021-10-31,Merced,047,269075,41877,41699,1883,43582,589
2021-10-31,Modoc,049,8938,531,517,186,703,5
2021-10-31,Mono,051,14174,1722,1711,22,1733,3
2021-10-31,Monterey,053,433212,48703,47744,2842,50586,596
2021-10-31,Napa,055,140530,12963,12906,107,13013,101
2021-10-31,Nevada,057,99092,9185,9084,316,9400,91
2021-10-31,Orange,059,3164182,307432,305032,14979,320011,5596
2021-10-31,Placer,061,380077,37141,36698,3607,40305,435
2021-10-31,Plumas,063,18699,1780,1716,33,1749,7
2021-10-31,Riverside,065,2383286,363307,359005,16222,375227,5104
2021-10-31,Sacramento,067,1510023,158937,157667,4539,162206,2243
2021-10-31,San Benito,069,59416,7399,7397,165,7562,73
2021-10-31,San Bernardino,071,2135413,354177,351411,11082,362493,5810
2021-10-31,San Diego,073,3302833,373402,371603,21932,393535,4218
2021-10-31,San Francisco,075,870044,52947,52370,2278,54648,661
2021-10-31,San Joaquin,077,732212,99670,98893,5320,104213,1772
2021-10-31,San Luis Obispo,079,281455,29583,29176,1231,30407,343
2021-10-31,San Mateo,081,765935,54169,53284,855,54139,571
2021-10-31,Santa Barbara,083,443738,44419,44113,1522,45635,529
2021-10-31,Santa Clara,085,1922200,147082,145829,1313,147142,1908
2021-10-31,Santa Cruz,087,273765,20389,20218,994,21212,221
2021-10-31,Shasta,089,179085,21403,21086,3552,24638,338
2021-10-31,Sierra,091,2930,184,180,20,200,0
2021-10-31,Siskiyou,093,43540,3334,3271,1268,4539,46
2021-10-31,Solano,095,438530,45960,45310,1246,46556,350
2021-10-31,Sonoma,097,501317,41449,41183,517,41700,395
2021-10-31,Stanislaus,099,539301,78346,78426,8739,87165,1193
2021-10-31,Sutter,101,95872,13863,13838,341,14179,179
2021-10-31,Tehama,103,63373,8505,8391,1461,9852,116
2021-10-31,Trinity,105,12862,856,724,209,933,11
2021-10-31,Tulare,107,460477,68467,67310,14754,82064,1002
2021-10-31,Tuolumne,109,53932,7263,7141,97,7238,90
2021-10-31,Ventura,111,848112,98131,97460,4257,101717,1178
2021-10-31,Yolo,113,214977,19925,19662,951,20613,250
2021-10-31,Yuba,115,75493,10117,10051,315,10366,83
2021-10-30,Alameda,001,1643700,119270,118632,2718,121350,1419
2021-10-30,Alpine,003,1148,101,105,0,105,0
2021-10-30,Amador,005,37829,5560,5480,58,5538,64
2021-10-30,Butte,007,227075,20910,20516,3872,24388,277
2021-10-30,Calaveras,009,45235,4069,3992,53,4045,82
2021-10-30,Colusa,011,21464,2514,2484,629,3113,19
2021-10-30,Contra Costa,013,1133247,99437,98562,2148,100710,1024
2021-10-30,Del Norte,015,27424,3679,3574,53,3627,42
2021-10-30,El Dorado,017,186661,16056,15752,1693,17445,154
2021-10-30,Fresno,019,978130,139893,136901,12577,149478,2131
2021-10-30,Glenn,021,27897,3494,3442,1008,4450,33
2021-10-30,Humboldt,023,135768,8988,8871,547,9418,105
2021-10-30,Imperial,025,180216,33576,33156,3118,36274,766
2021-10-30,Inyo,027,18085,2348,2249,38,2287,41
2021-10-30,Kern,029,883053,127328,124892,21844,146736,1653
2021-10-30,Kings,031,150075,32186,31578,1898,33476,337
2021-10-30,Lake,033,64148,6740,6610,144,6754,106
2021-10-30,Lassen,035,31185,6852,6719,360,7079,42
2021-10-30,Los Angeles,037,10098052,1439362,1424257,53028,1477285,26625
2021-10-30,Madera,039,155013,23081,22524,2072,24596,283
2021-10-30,Marin,041,260295,17554,17380,443,17823,247
2021-10-30,Mariposa,043,17540,1289,1228,46,1274,5
2021-10-30,Mendocino,045,87422,7513,7338,524,7862,84
2021-10-30,Merced,047,269075,41837,41428,1881,43309,586
2021-10-30,Modoc,049,8938,529,513,185,698,5
2021-10-30,Mono,051,14174,1722,1684,22,1706,3
2021-10-30,Monterey,053,433212,48686,47649,2836,50485,588
2021-10-30,Napa,055,140530,12948,12863,106,12969,101
2021-10-30,Nevada,057,99092,9166,9015,316,9331,91
2021-10-30,Orange,059,3164182,307252,304120,14957,319077,5588
2021-10-30,Placer,061,380077,37096,36400,3601,40001,434
2021-10-30,Plumas,063,18699,1775,1695,33,1728,7
2021-10-30,Riverside,065,2383286,363006,357645,16214,373859,5088
2021-10-30,Sacramento,067,1510023,158780,157125,4530,161655,2233
2021-10-30,San Benito,069,59416,7392,7362,165,7527,71
2021-10-30,San Bernardino,071,2135413,353899,350076,11067,361143,5777
2021-10-30,San Diego,073,3302833,373039,370006,21910,391916,4213
2021-10-30,San Francisco,075,870044,52918,52161,2276,54437,661
2021-10-30,San Joaquin,077,732212,99614,98314,5319,103633,1768
2021-10-30,San Luis Obispo,079,281455,29551,29053,1228,30281,341
2021-10-30,San Mateo,081,765935,54130,53083,855,53938,571
2021-10-30,Santa Barbara,083,443738,44384,43972,1521,45493,528
2021-10-30,Santa Clara,085,1922200,146976,145262,1309,146571,1903
2021-10-30,Santa Cruz,087,273765,20371,20134,992,21126,221
2021-10-30,Shasta,089,179085,21359,20878,3546,24424,332
2021-10-30,Sierra,091,2930,184,175,20,195,0
2021-10-30,Siskiyou,093,43540,3333,3257,1265,4522,46
2021-10-30,Solano,095,438530,45939,45146,1244,46390,346
2021-10-30,Sonoma,097,501317,41410,40924,517,41441,393
2021-10-30,Stanislaus,099,539301,78276,77871,8732,86603,1191
2021-10-30,Sutter,101,95872,13849,13773,341,14114,178
2021-10-30,Tehama,103,63373,8493,8307,1457,9764,114
2021-10-30,Trinity,105,12862,854,708,208,916,11
2021-10-30,Tulare,107,460477,68396,66745,14710,81455,995
2021-10-30,Tuolumne,109,53932,7239,7050,96,7146,90
2021-10-30,Ventura,111,848112,98082,97182,4254,101436,1174
2021-10-30,Yolo,113,214977,19906,19568,949,20517,250
2021-10-30,Yuba,115,75493,10106,9969,315,10284,82
2021-10-29,Alameda,001,1643700,119191,118632,2713,121345,1419
2021-10-29,Alpine,003,1148,101,105,0,105,0
2021-10-29,Amador,005,37829,5549,5480,58,5538,64
2021-10-29,Butte,007,227075,20885,20516,3860,24376,277
2021-10-29,Calaveras,009,45235,4062,3992,53,4045,82
2021-10-29,Colusa,011,21464,2514,2484,627,3111,19
2021-10-29,Contra Costa,013,1133247,99369,98562,2146,100708,1024
2021-10-29,Del Norte,015,27424,3672,3574,53,3627,42
2021-10-29,El Dorado,017,186661,16042,15752,1693,17445,154
2021-10-29,Fresno,019,978130,139678,136901,12564,149465,2131
2021-10-29,Glenn,021,27897,3493,3442,1007,4449,33
2021-10-29,Humboldt,023,135768,8983,8871,546,9417,105
2021-10-29,Imperial,025,180216,33549,33156,3115,36271,766
2021-10-29,Inyo,027,18085,2345,2249,38,2287,41
2021-10-29,Kern,029,883053,127151,124892,21754,146646,1653
2021-10-29,Kings,031,150075,32152,31578,1896,33474,337
2021-10-29,Lake,033,64148,6731,6610,141,6751,106
2021-10-29,Lassen,035,31185,6843,6719,358,7077,42
2021-10-29,Los Angeles,037,10098052,1438521,1424257,52986,1477243,26625
2021-10-29,Madera,039,155013,23029,22524,2067,24591,283
2021-10-29,Marin,041,260295,17538,17380,442,17822,247
2021-10-29,Mariposa,043,17540,1285,1228,46,1274,5
2021-10-29,Mendocino,045,87422,7505,7338,524,7862,84
2021-10-29,Merced,047,269075,41787,41428,1875,43303,586
2021-10-29,Modoc,049,8938,526,513,185,698,5
2021-10-29,Mono,051,14174,1720,1684,22,1706,3
2021-10-29,Monterey,053,433212,48663,47649,2836,50485,588
2021-10-29,Napa,055,140530,12927,12863,106,12969,101
2021-10-29,Nevada,057,99092,9154,9015,316,9331,91
2021-10-29,Orange,059,3164182,307027,304120,14937,319057,5588
2021-10-29,Placer,061,380077,37060,36400,3591,39991,434
2021-10-29,Plumas,063,18699,1769,1695,33,1728,7
2021-10-29,Riverside,065,2383286,362673,357645,16209,373854,5088
2021-10-29,Sacramento,067,1510023,158591,157125,4520,161645,2233
2021-10-29,San Benito,069,59416,7389,7362,165,7527,71
2021-10-29,San Bernardino,071,2135413,353596,350076,11056,361132,5777
2021-10-29,San Diego,073,3302833,372667,370006,21882,391888,4213
2021-10-29,San Francisco,075,870044,52858,52161,2269,54430,661
2021-10-29,San Joaquin,077,732212,99554,98314,5314,103628,1768
2021-10-29,San Luis Obispo,079,281455,29525,29053,1226,30279,341
2021-10-29,San Mateo,081,765935,54087,53083,853,53936,571
2021-10-29,Santa Barbara,083,443738,44344,43972,1518,45490,528
2021-10-29,Santa Clara,085,1922200,146862,145262,1302,146564,1903
2021-10-29,Santa Cruz,087,273765,20364,20134,991,21125,221
2021-10-29,Shasta,089,179085,21321,20878,3540,24418,332
2021-10-29,Sierra,091,2930,182,175,20,195,0
2021-10-29,Siskiyou,093,43540,3333,3257,1264,4521,46
2021-10-29,Solano,095,438530,45902,45146,1243,46389,346
2021-10-29,Sonoma,097,501317,41389,40924,517,41441,393
2021-10-29,Stanislaus,099,539301,78191,77871,8720,86591,1191
2021-10-29,Sutter,101,95872,13830,13773,341,14114,178
2021-10-29,Tehama,103,63373,8480,8307,1456,9763,114
2021-10-29,Trinity,105,12862,853,708,208,916,11
2021-10-29,Tulare,107,460477,68291,66745,14667,81412,995
2021-10-29,Tuolumne,109,53932,7226,7050,96,7146,90
2021-10-29,Ventura,111,848112,98027,97182,4250,101432,1174
2021-10-29,Yolo,113,214977,19885,19568,947,20515,250
2021-10-29,Yuba,115,75493,10098,9969,311,10280,82
2021-10-28,Alameda,001,1643700,119068,118632,2706,121338,1419
2021-10-28,Alpine,003,1148,101,105,0,105,0
2021-10-28,Amador,005,37829,5536,5480,58,5538,64
2021-10-28,Butte,007,227075,20843,20516,3849,24365,277
2021-10-28,Calaveras,009,45235,4049,3992,53,4045,82
2021-10-28,Colusa,011,21464,2511,2484,626,3110,19
2021-10-28,Contra Costa,013,1133247,99239,98562,2142,100704,1024
2021-10-28,Del Norte,015,27424,3671,3574,53,3627,42
2021-10-28,El Dorado,017,186661,16014,15752,1690,17442,154
2021-10-28,Fresno,019,978130,139346,136901,12533,149434,2131
2021-10-28,Glenn,021,27897,3490,3442,1005,4447,33
2021-10-28,Humboldt,023,135768,8967,8871,541,9412,105
2021-10-28,Imperial,025,180216,33483,33156,3108,36264,766
2021-10-28,Inyo,027,18085,2328,2249,38,2287,41
2021-10-28,Kern,029,883053,126903,124892,21642,146534,1653
2021-10-28,Kings,031,150075,32083,31578,1891,33469,337
2021-10-28,Lake,033,64148,6721,6610,141,6751,106
2021-10-28,Lassen,035,31185,6834,6719,355,7074,42
2021-10-28,Los Angeles,037,10098052,1437384,1424257,52912,1477169,26625
2021-10-28,Madera,039,155013,22975,22524,2056,24580,283
2021-10-28,Marin,041,260295,17520,17380,441,17821,247
2021-10-28,Mariposa,043,17540,1281,1228,46,1274,5
2021-10-28,Mendocino,045,87422,7492,7338,513,7851,84
2021-10-28,Merced,047,269075,41702,41428,1865,43293,586
2021-10-28,Modoc,049,8938,525,513,185,698,5
2021-10-28,Mono,051,14174,1714,1684,22,1706,3
2021-10-28,Monterey,053,433212,48632,47649,2819,50468,588
2021-10-28,Napa,055,140530,12918,12863,105,12968,101
2021-10-28,Nevada,057,99092,9136,9015,316,9331,91
2021-10-28,Orange,059,3164182,306740,304120,14873,318993,5588
2021-10-28,Placer,061,380077,36981,36400,3582,39982,434
2021-10-28,Plumas,063,18699,1761,1695,33,1728,7
2021-10-28,Riverside,065,2383286,362233,357645,16186,373831,5088
2021-10-28,Sacramento,067,1510023,158325,157125,4508,161633,2233
2021-10-28,San Benito,069,59416,7381,7362,165,7527,71
2021-10-28,San Bernardino,071,2135413,353180,350076,11033,361109,5777
2021-10-28,San Diego,073,3302833,372211,370006,21859,391865,4213
2021-10-28,San Francisco,075,870044,52812,52161,2262,54423,661
2021-10-28,San Joaquin,077,732212,99426,98314,5313,103627,1768
2021-10-28,San Luis Obispo,079,281455,29496,29053,1223,30276,341
2021-10-28,San Mateo,081,765935,54042,53083,851,53934,571
2021-10-28,Santa Barbara,083,443738,44305,43972,1516,45488,528
2021-10-28,Santa Clara,085,1922200,146703,145262,1297,146559,1903
2021-10-28,Santa Cruz,087,273765,20340,20134,991,21125,221
2021-10-28,Shasta,089,179085,21246,20878,3533,24411,332
2021-10-28,Sierra,091,2930,181,175,20,195,0
2021-10-28,Siskiyou,093,43540,3332,3257,1264,4521,46
2021-10-28,Solano,095,438530,45862,45146,1242,46388,346
2021-10-28,Sonoma,097,501317,41321,40924,516,41440,393
2021-10-28,Stanislaus,099,539301,78038,77871,8704,86575,1191
2021-10-28,Sutter,101,95872,13817,13773,337,14110,178
2021-10-28,Tehama,103,63373,8443,8307,1453,9760,114
2021-10-28,Trinity,105,12862,850,708,208,916,11
2021-10-28,Tulare,107,460477,68152,66745,14611,81356,995
2021-10-28,Tuolumne,109,53932,7195,7050,96,7146,90
2021-10-28,Ventura,111,848112,97942,97182,4247,101429,1174
2021-10-28,Yolo,113,214977,19846,19568,944,20512,250
2021-10-28,Yuba,115,75493,10069,9969,308,10277,82
2021-10-27,Alameda,001,1643700,118946,118487,2704,121191,1414
2021-10-27,Alpine,003,1148,101,105,0,105,0
2021-10-27,Amador,005,37829,5524,5470,57,5527,64
2021-10-27,Butte,007,227075,20798,20446,3834,24280,274
2021-10-27,Calaveras,009,45235,4031,3970,52,4022,82
2021-10-27,Colusa,011,21464,2511,2480,625,3105,18
2021-10-27,Contra Costa,013,1133247,99131,98442,2130,100572,1018
2021-10-27,Del Norte,015,27424,3664,3571,52,3623,42
2021-10-27,El Dorado,017,186661,15983,15723,1685,17408,154
2021-10-27,Fresno,019,978130,138965,136447,12499,148946,2128
2021-10-27,Glenn,021,27897,3488,3435,1004,4439,33
2021-10-27,Humboldt,023,135768,8947,8851,539,9390,105
2021-10-27,Imperial,025,180216,33443,33068,3103,36171,766
2021-10-27,Inyo,027,18085,2308,2236,38,2274,41
2021-10-27,Kern,029,883053,126634,124557,21542,146099,1647
2021-10-27,Kings,031,150075,32017,31437,1885,33322,335
2021-10-27,Lake,033,64148,6695,6589,141,6730,105
2021-10-27,Lassen,035,31185,6821,6706,353,7059,42
2021-10-27,Los Angeles,037,10098052,1436155,1422615,52854,1475469,26604
2021-10-27,Madera,039,155013,22890,22413,2032,24445,283
2021-10-27,Marin,041,260295,17505,17362,441,17803,247
2021-10-27,Mariposa,043,17540,1268,1228,46,1274,5
2021-10-27,Mendocino,045,87422,7478,7321,506,7827,84
2021-10-27,Merced,047,269075,41605,41310,1851,43161,583
2021-10-27,Modoc,049,8938,521,513,185,698,5
2021-10-27,Mono,051,14174,1711,1682,22,1704,3
2021-10-27,Monterey,053,433212,48595,47610,2798,50408,588
2021-10-27,Napa,055,140530,12903,12856,105,12961,101
2021-10-27,Nevada,057,99092,9118,8987,315,9302,90
2021-10-27,Orange,059,3164182,306420,303825,14823,318648,5584
2021-10-27,Placer,061,380077,36916,36296,3575,39871,434
2021-10-27,Plumas,063,18699,1753,1686,33,1719,7
2021-10-27,Riverside,065,2383286,361801,357152,16178,373330,5081
2021-10-27,Sacramento,067,1510023,158057,156830,4487,161317,2230
2021-10-27,San Benito,069,59416,7374,7337,165,7502,71
2021-10-27,San Bernardino,071,2135413,352755,349624,11011,360635,5770
2021-10-27,San Diego,073,3302833,371655,369579,21835,391414,4207
2021-10-27,San Francisco,075,870044,52761,52108,2258,54366,655
2021-10-27,San Joaquin,077,732212,99269,98168,5298,103466,1753
2021-10-27,San Luis Obispo,079,281455,29457,29002,1221,30223,341
2021-10-27,San Mateo,081,765935,53987,53032,843,53875,571
2021-10-27,Santa Barbara,083,443738,44252,43901,1513,45414,527
2021-10-27,Santa Clara,085,1922200,146524,145081,1289,146370,1902
2021-10-27,Santa Cruz,087,273765,20313,20091,989,21080,221
2021-10-27,Shasta,089,179085,21171,20813,3525,24338,331
2021-10-27,Sierra,091,2930,180,176,20,196,0
2021-10-27,Siskiyou,093,43540,3329,3256,1260,4516,46
2021-10-27,Solano,095,438530,45817,45089,1235,46324,346
2021-10-27,Sonoma,097,501317,41245,40829,514,41343,393
2021-10-27,Stanislaus,099,539301,77878,77687,8689,86376,1191
2021-10-27,Sutter,101,95872,13803,13754,337,14091,177
2021-10-27,Tehama,103,63373,8421,8265,1451,9716,113
2021-10-27,Trinity,105,12862,850,706,207,913,11
2021-10-27,Tulare,107,460477,67998,66568,14555,81123,991
2021-10-27,Tuolumne,109,53932,7168,7009,95,7104,90
2021-10-27,Ventura,111,848112,97850,97108,4242,101350,1172
2021-10-27,Yolo,113,214977,19817,19517,937,20454,250
2021-10-27,Yuba,115,75493,10048,9945,306,10251,82
2021-10-26,Alameda,001,1643700,118808,118360,2702,121062,1407
2021-10-26,Alpine,003,1148,101,105,0,105,0
2021-10-26,Amador,005,37829,5516,5465,56,5521,64
2021-10-26,Butte,007,227075,20738,20387,3817,24204,274
2021-10-26,Calaveras,009,45235,4020,3966,52,4018,81
2021-10-26,Colusa,011,21464,2508,2478,624,3102,18
2021-10-26,Contra Costa,013,1133247,99007,98352,2120,100472,1017
2021-10-26,Del Norte,015,27424,3659,3563,52,3615,42
2021-10-26,El Dorado,017,186661,15955,15690,1676,17366,153
2021-10-26,Fresno,019,978130,138518,136211,12451,148662,2122
2021-10-26,Glenn,021,27897,3474,3431,1001,4432,33
2021-10-26,Humboldt,023,135768,8929,8830,533,9363,105
2021-10-26,Imperial,025,180216,33378,33012,3098,36110,766
2021-10-26,Inyo,027,18085,2293,2200,38,2238,41
2021-10-26,Kern,029,883053,126291,124351,21424,145775,1645
2021-10-26,Kings,031,150075,31950,31382,1878,33260,336
2021-10-26,Lake,033,64148,6685,6584,139,6723,105
2021-10-26,Lassen,035,31185,6800,6689,351,7040,42
2021-10-26,Los Angeles,037,10098052,1434815,1421795,52783,1474578,26599
2021-10-26,Madera,039,155013,22800,22363,2021,24384,283
2021-10-26,Marin,041,260295,17488,17354,440,17794,244
2021-10-26,Mariposa,043,17540,1263,1225,45,1270,5
2021-10-26,Mendocino,045,87422,7449,7308,490,7798,83
2021-10-26,Merced,047,269075,41527,41267,1844,43111,583
2021-10-26,Modoc,049,8938,521,513,185,698,5
2021-10-26,Mono,051,14174,1706,1680,22,1702,3
2021-10-26,Monterey,053,433212,48556,47572,2788,50360,588
2021-10-26,Napa,055,140530,12891,12849,105,12954,101
2021-10-26,Nevada,057,99092,9087,8971,314,9285,90
2021-10-26,Orange,059,3164182,306151,303533,14784,318317,5580
2021-10-26,Placer,061,380077,36819,36245,3569,39814,434
2021-10-26,Plumas,063,18699,1744,1645,33,1678,7
2021-10-26,Riverside,065,2383286,361312,356775,16168,372943,5068
2021-10-26,Sacramento,067,1510023,157756,156643,4470,161113,2228
2021-10-26,San Benito,069,59416,7351,7325,165,7490,71
2021-10-26,San Bernardino,071,2135413,352326,349346,10996,360342,5764
2021-10-26,San Diego,073,3302833,371138,369043,21805,390848,4198
2021-10-26,San Francisco,075,870044,52687,52063,2255,54318,655
2021-10-26,San Joaquin,077,732212,99092,98036,5284,103320,1748
2021-10-26,San Luis Obispo,079,281455,29418,28928,1215,30143,337
2021-10-26,San Mateo,081,765935,53915,52974,840,53814,571
2021-10-26,Santa Barbara,083,443738,44206,43835,1512,45347,525
2021-10-26,Santa Clara,085,1922200,146322,144932,1283,146215,1903
2021-10-26,Santa Cruz,087,273765,20282,20067,989,21056,221
2021-10-26,Shasta,089,179085,21110,20725,3507,24232,330
2021-10-26,Sierra,091,2930,180,169,20,189,0
2021-10-26,Siskiyou,093,43540,3323,3254,1258,4512,46
2021-10-26,Solano,095,438530,45761,45044,1234,46278,344
2021-10-26,Sonoma,097,501317,41163,40794,512,41306,393
2021-10-26,Stanislaus,099,539301,77704,77552,8664,86216,1157
2021-10-26,Sutter,101,95872,13774,13739,336,14075,176
2021-10-26,Tehama,103,63373,8393,8247,1446,9693,112
2021-10-26,Trinity,105,12862,846,705,207,912,11
2021-10-26,Tulare,107,460477,67838,66476,14498,80974,991
2021-10-26,Tuolumne,109,53932,7142,6995,93,7088,90
2021-10-26,Ventura,111,848112,97741,97014,4239,101253,1170
2021-10-26,Yolo,113,214977,19786,19490,936,20426,248
2021-10-26,Yuba,115,75493,10030,9927,301,10228,82
2021-10-25,Alameda,001,1643700,118665,118319,2701,121020,1404
2021-10-25,Alpine,003,1148,101,105,0,105,0
2021-10-25,Amador,005,37829,5502,5455,56,5511,64
2021-10-25,Butte,007,227075,20665,20331,3809,24140,273
2021-10-25,Calaveras,009,45235,3990,3942,51,3993,82
2021-10-25,Colusa,011,21464,2506,2471,622,3093,18
2021-10-25,Contra Costa,013,1133247,98890,98267,2116,100383,1017
2021-10-25,Del Norte,015,27424,3652,3562,52,3614,42
2021-10-25,El Dorado,017,186661,15920,15663,1674,17337,149
2021-10-25,Fresno,019,978130,138084,135974,12415,148389,2112
2021-10-25,Glenn,021,27897,3471,3421,1000,4421,33
2021-10-25,Humboldt,023,135768,8906,8825,528,9353,105
2021-10-25,Imperial,025,180216,33317,32968,3087,36055,766
2021-10-25,Inyo,027,18085,2275,2183,38,2221,41
2021-10-25,Kern,029,883053,125940,124078,21285,145363,1649
2021-10-25,Kings,031,150075,31861,31329,1869,33198,335
2021-10-25,Lake,033,64148,6671,6571,139,6710,105
2021-10-25,Lassen,035,31185,6789,6688,349,7037,42
2021-10-25,Los Angeles,037,10098052,1433461,1421061,52717,1473778,26579
2021-10-25,Madera,039,155013,22746,22325,2014,24339,281
2021-10-25,Marin,041,260295,17466,17334,438,17772,244
2021-10-25,Mariposa,043,17540,1249,1220,45,1265,5
2021-10-25,Mendocino,045,87422,7420,7296,486,7782,82
2021-10-25,Merced,047,269075,41459,41207,1817,43024,583
2021-10-25,Modoc,049,8938,519,512,183,695,5
2021-10-25,Mono,051,14174,1698,1677,22,1699,3
2021-10-25,Monterey,053,433212,48523,47547,2786,50333,587
2021-10-25,Napa,055,140530,12878,12841,105,12946,100
2021-10-25,Nevada,057,99092,9061,8958,314,9272,90
2021-10-25,Orange,059,3164182,305853,303279,14747,318026,5574
2021-10-25,Placer,061,380077,36711,36153,3559,39712,431
2021-10-25,Plumas,063,18699,1732,1641,33,1674,7
2021-10-25,Riverside,065,2383286,360883,356381,16153,372534,5056
2021-10-25,Sacramento,067,1510023,157451,156516,4447,160963,2235
2021-10-25,San Benito,069,59416,7338,7314,164,7478,71
2021-10-25,San Bernardino,071,2135413,351818,349075,10984,360059,5748
2021-10-25,San Diego,073,3302833,370569,368386,21777,390163,4196
2021-10-25,San Francisco,075,870044,52614,52041,2249,54290,649
2021-10-25,San Joaquin,077,732212,98891,97980,5275,103255,1740
2021-10-25,San Luis Obispo,079,281455,29370,28907,1210,30117,336
2021-10-25,San Mateo,081,765935,53854,52927,836,53763,571
2021-10-25,Santa Barbara,083,443738,44147,43775,1512,45287,525
2021-10-25,Santa Clara,085,1922200,146130,144895,1278,146173,1901
2021-10-25,Santa Cruz,087,273765,20253,20053,988,21041,221
2021-10-25,Shasta,089,179085,21038,20666,3500,24166,326
2021-10-25,Sierra,091,2930,180,168,20,188,0
2021-10-25,Siskiyou,093,43540,3319,3248,1253,4501,46
2021-10-25,Solano,095,438530,45700,45022,1232,46254,344
2021-10-25,Sonoma,097,501317,41090,40746,510,41256,393
2021-10-25,Stanislaus,099,539301,77512,77452,8636,86088,1145
2021-10-25,Sutter,101,95872,13760,13721,333,14054,176
2021-10-25,Tehama,103,63373,8366,8224,1442,9666,111
2021-10-25,Trinity,105,12862,841,699,206,905,11
2021-10-25,Tulare,107,460477,67643,66357,14436,80793,986
2021-10-25,Tuolumne,109,53932,7108,6952,92,7044,90
2021-10-25,Ventura,111,848112,97650,96932,4236,101168,1167
2021-10-25,Yolo,113,214977,19736,19457,933,20390,248
2021-10-25,Yuba,115,75493,10014,9924,297,10221,82
2021-10-24,Alameda,001,1643700,118533,117816,2696,120512,1397
2021-10-24,Alpine,003,1148,101,105,0,105,0
2021-10-24,Amador,005,37829,5497,5412,56,5468,64
2021-10-24,Butte,007,227075,20593,20101,3797,23898,273
2021-10-24,Calaveras,009,45235,3971,3865,50,3915,81
2021-10-24,Colusa,011,21464,2502,2458,619,3077,18
2021-10-24,Contra Costa,013,1133247,98772,97855,2107,99962,1008
2021-10-24,Del Norte,015,27424,3648,3540,52,3592,42
2021-10-24,El Dorado,017,186661,15883,15540,1670,17210,149
2021-10-24,Fresno,019,978130,137648,134466,12365,146831,2094
2021-10-24,Glenn,021,27897,3463,3399,998,4397,33
2021-10-24,Humboldt,023,135768,8893,8753,522,9275,105
2021-10-24,Imperial,025,180216,33239,32777,3081,35858,766
2021-10-24,Inyo,027,18085,2243,2108,38,2146,41
2021-10-24,Kern,029,883053,125606,122939,21169,144108,1636
2021-10-24,Kings,031,150075,31732,30942,1854,32796,325
2021-10-24,Lake,033,64148,6648,6501,138,6639,105
2021-10-24,Lassen,035,31185,6772,6632,348,6980,27
2021-10-24,Los Angeles,037,10098052,1432027,1415919,52649,1468568,26527
2021-10-24,Madera,039,155013,22669,22062,2002,24064,281
2021-10-24,Marin,041,260295,17450,17264,437,17701,244
2021-10-24,Mariposa,043,17540,1246,1184,45,1229,5
2021-10-24,Mendocino,045,87422,7396,7220,476,7696,82
2021-10-24,Merced,047,269075,41337,40808,1811,42619,581
2021-10-24,Modoc,049,8938,518,507,183,690,5
2021-10-24,Mono,051,14174,1693,1655,22,1677,3
2021-10-24,Monterey,053,433212,48475,47456,2776,50232,586
2021-10-24,Napa,055,140530,12867,12789,105,12894,100
2021-10-24,Nevada,057,99092,9038,8861,311,9172,90
2021-10-24,Orange,059,3164182,305503,302237,14710,316947,5546
2021-10-24,Placer,061,380077,36607,35822,3545,39367,426
2021-10-24,Plumas,063,18699,1722,1623,32,1655,7
2021-10-24,Riverside,065,2383286,360409,354688,16133,370821,5041
2021-10-24,Sacramento,067,1510023,157110,155125,4424,159549,2232
2021-10-24,San Benito,069,59416,7318,7280,164,7444,71
2021-10-24,San Bernardino,071,2135413,351260,347681,10972,358653,5688
2021-10-24,San Diego,073,3302833,369985,366085,21746,387831,4183
2021-10-24,San Francisco,075,870044,52551,51820,2243,54063,649
2021-10-24,San Joaquin,077,732212,98718,97440,5269,102709,1721
2021-10-24,San Luis Obispo,079,281455,29309,28755,1203,29958,333
2021-10-24,San Mateo,081,765935,53782,52719,836,53555,571
2021-10-24,Santa Barbara,083,443738,44080,43552,1510,45062,523
2021-10-24,Santa Clara,085,1922200,145939,144276,1268,145544,1897
2021-10-24,Santa Cruz,087,273765,20215,19967,987,20954,221
2021-10-24,Shasta,089,179085,20940,20386,3494,23880,321
2021-10-24,Sierra,091,2930,180,168,20,188,0
2021-10-24,Siskiyou,093,43540,3312,3231,1249,4480,46
2021-10-24,Solano,095,438530,45651,44861,1227,46088,341
2021-10-24,Sonoma,097,501317,41007,40476,510,40986,393
2021-10-24,Stanislaus,099,539301,77321,76812,8625,85437,1145
2021-10-24,Sutter,101,95872,13733,13616,325,13941,175
2021-10-24,Tehama,103,63373,8318,8105,1431,9536,110
2021-10-24,Trinity,105,12862,837,696,204,900,11
2021-10-24,Tulare,107,460477,67470,65585,14365,79950,978
2021-10-24,Tuolumne,109,53932,7068,6840,90,6930,90
2021-10-24,Ventura,111,848112,97543,96664,4235,100899,1167
2021-10-24,Yolo,113,214977,19685,19280,933,20213,248
2021-10-24,Yuba,115,75493,9990,9838,296,10134,82
2021-10-23,Alameda,001,1643700,118445,117816,2691,120507,1397
2021-10-23,Alpine,003,1148,101,105,0,105,0
2021-10-23,Amador,005,37829,5490,5412,56,5468,64
2021-10-23,Butte,007,227075,20556,20101,3789,23890,273
2021-10-23,Calaveras,009,45235,3964,3865,49,3914,81
2021-10-23,Colusa,011,21464,2500,2458,618,3076,18
2021-10-23,Contra Costa,013,1133247,98720,97855,2103,99958,1008
2021-10-23,Del Norte,015,27424,3646,3540,52,3592,42
2021-10-23,El Dorado,017,186661,15857,15540,1668,17208,149
2021-10-23,Fresno,019,978130,137470,134466,12352,146818,2094
2021-10-23,Glenn,021,27897,3461,3399,997,4396,33
2021-10-23,Humboldt,023,135768,8879,8753,517,9270,105
2021-10-23,Imperial,025,180216,33192,32777,3077,35854,766
2021-10-23,Inyo,027,18085,2232,2108,38,2146,41
2021-10-23,Kern,029,883053,125446,122939,21082,144021,1636
2021-10-23,Kings,031,150075,31686,30942,1852,32794,325
2021-10-23,Lake,033,64148,6643,6501,138,6639,105
2021-10-23,Lassen,035,31185,6769,6632,346,6978,27
2021-10-23,Los Angeles,037,10098052,1431352,1415919,52594,1468513,26527
2021-10-23,Madera,039,155013,22620,22062,1994,24056,281
2021-10-23,Marin,041,260295,17433,17264,437,17701,244
2021-10-23,Mariposa,043,17540,1243,1184,44,1228,5
2021-10-23,Mendocino,045,87422,7389,7220,475,7695,82
2021-10-23,Merced,047,269075,41296,40808,1806,42614,581
2021-10-23,Modoc,049,8938,516,507,183,690,5
2021-10-23,Mono,051,14174,1687,1655,22,1677,3
2021-10-23,Monterey,053,433212,48458,47456,2772,50228,586
2021-10-23,Napa,055,140530,12862,12789,105,12894,100
2021-10-23,Nevada,057,99092,9027,8861,309,9170,90
2021-10-23,Orange,059,3164182,305316,302237,14695,316932,5546
2021-10-23,Placer,061,380077,36545,35822,3539,39361,426
2021-10-23,Plumas,063,18699,1721,1623,32,1655,7
2021-10-23,Riverside,065,2383286,360088,354688,16126,370814,5041
2021-10-23,Sacramento,067,1510023,156981,155125,4416,159541,2232
2021-10-23,San Benito,069,59416,7308,7280,164,7444,71
2021-10-23,San Bernardino,071,2135413,350989,347681,10964,358645,5688
2021-10-23,San Diego,073,3302833,369644,366085,21715,387800,4183
2021-10-23,San Francisco,075,870044,52515,51820,2242,54062,649
2021-10-23,San Joaquin,077,732212,98650,97440,5260,102700,1721
2021-10-23,San Luis Obispo,079,281455,29271,28755,1201,29956,333
2021-10-23,San Mateo,081,765935,53744,52719,835,53554,571
2021-10-23,Santa Barbara,083,443738,44049,43552,1508,45060,523
2021-10-23,Santa Clara,085,1922200,145828,144276,1264,145540,1897
2021-10-23,Santa Cruz,087,273765,20203,19967,987,20954,221
2021-10-23,Shasta,089,179085,20904,20386,3482,23868,321
2021-10-23,Sierra,091,2930,179,168,20,188,0
2021-10-23,Siskiyou,093,43540,3310,3231,1249,4480,46
2021-10-23,Solano,095,438530,45626,44861,1224,46085,341
2021-10-23,Sonoma,097,501317,40967,40476,510,40986,393
2021-10-23,Stanislaus,099,539301,77232,76812,8605,85417,1145
2021-10-23,Sutter,101,95872,13727,13616,324,13940,175
2021-10-23,Tehama,103,63373,8306,8105,1430,9535,110
2021-10-23,Trinity,105,12862,836,696,204,900,11
2021-10-23,Tulare,107,460477,67382,65585,14306,79891,978
2021-10-23,Tuolumne,109,53932,7047,6840,90,6930,90
2021-10-23,Ventura,111,848112,97482,96664,4235,100899,1167
2021-10-23,Yolo,113,214977,19667,19280,931,20211,248
2021-10-23,Yuba,115,75493,9981,9838,296,10134,82
2021-10-22,Alameda,001,1643700,118363,117816,2688,120504,1397
2021-10-22,Alpine,003,1148,101,105,0,105,0
2021-10-22,Amador,005,37829,5479,5412,56,5468,64
2021-10-22,Butte,007,227075,20524,20101,3785,23886,273
2021-10-22,Calaveras,009,45235,3956,3865,49,3914,81
2021-10-22,Colusa,011,21464,2497,2458,618,3076,18
2021-10-22,Contra Costa,013,1133247,98629,97855,2101,99956,1008
2021-10-22,Del Norte,015,27424,3642,3540,52,3592,42
2021-10-22,El Dorado,017,186661,15844,15540,1666,17206,149
2021-10-22,Fresno,019,978130,137255,134466,12331,146797,2094
2021-10-22,Glenn,021,27897,3451,3399,997,4396,33
2021-10-22,Humboldt,023,135768,8865,8753,516,9269,105
2021-10-22,Imperial,025,180216,33148,32777,3077,35854,766
2021-10-22,Inyo,027,18085,2219,2108,38,2146,41
2021-10-22,Kern,029,883053,125259,122939,21009,143948,1636
2021-10-22,Kings,031,150075,31651,30942,1851,32793,325
2021-10-22,Lake,033,64148,6633,6501,138,6639,105
2021-10-22,Lassen,035,31185,6762,6632,343,6975,27
2021-10-22,Los Angeles,037,10098052,1430587,1415919,52536,1468455,26527
2021-10-22,Madera,039,155013,22570,22062,1982,24044,281
2021-10-22,Marin,041,260295,17421,17264,437,17701,244
2021-10-22,Mariposa,043,17540,1240,1184,44,1228,5
2021-10-22,Mendocino,045,87422,7375,7220,474,7694,82
2021-10-22,Merced,047,269075,41259,40808,1799,42607,581
2021-10-22,Modoc,049,8938,516,507,183,690,5
2021-10-22,Mono,051,14174,1685,1655,22,1677,3
2021-10-22,Monterey,053,433212,48424,47456,2770,50226,586
2021-10-22,Napa,055,140530,12856,12789,105,12894,100
2021-10-22,Nevada,057,99092,9010,8861,308,9169,90
2021-10-22,Orange,059,3164182,305100,302237,14665,316902,5546
2021-10-22,Placer,061,380077,36517,35822,3530,39352,426
2021-10-22,Plumas,063,18699,1715,1623,32,1655,7
2021-10-22,Riverside,065,2383286,359777,354688,16121,370809,5041
2021-10-22,Sacramento,067,1510023,156794,155125,4407,159532,2232
2021-10-22,San Benito,069,59416,7303,7280,164,7444,71
2021-10-22,San Bernardino,071,2135413,350659,347681,10949,358630,5688
2021-10-22,San Diego,073,3302833,369246,366085,21697,387782,4183
2021-10-22,San Francisco,075,870044,52477,51820,2235,54055,649
2021-10-22,San Joaquin,077,732212,98589,97440,5257,102697,1721
2021-10-22,San Luis Obispo,079,281455,29241,28755,1201,29956,333
2021-10-22,San Mateo,081,765935,53693,52719,829,53548,571
2021-10-22,Santa Barbara,083,443738,44008,43552,1508,45060,523
2021-10-22,Santa Clara,085,1922200,145671,144276,1257,145533,1897
2021-10-22,Santa Cruz,087,273765,20181,19967,987,20954,221
2021-10-22,Shasta,089,179085,20871,20386,3479,23865,321
2021-10-22,Sierra,091,2930,178,168,19,187,0
2021-10-22,Siskiyou,093,43540,3308,3231,1246,4477,46
2021-10-22,Solano,095,438530,45591,44861,1220,46081,341
2021-10-22,Sonoma,097,501317,40910,40476,510,40986,393
2021-10-22,Stanislaus,099,539301,77129,76812,8588,85400,1145
2021-10-22,Sutter,101,95872,13712,13616,324,13940,175
2021-10-22,Tehama,103,63373,8284,8105,1425,9530,110
2021-10-22,Trinity,105,12862,835,696,204,900,11
2021-10-22,Tulare,107,460477,67295,65585,14254,79839,978
2021-10-22,Tuolumne,109,53932,7012,6840,90,6930,90
2021-10-22,Ventura,111,848112,97429,96664,4229,100893,1167
2021-10-22,Yolo,113,214977,19640,19280,930,20210,248
2021-10-22,Yuba,115,75493,9967,9838,294,10132,82
2021-10-21,Alameda,001,1643700,118248,117816,2682,120498,1397
2021-10-21,Alpine,003,1148,101,105,0,105,0
2021-10-21,Amador,005,37829,5471,5412,56,5468,64
2021-10-21,Butte,007,227075,20440,20101,3770,23871,273
2021-10-21,Calaveras,009,45235,3937,3865,49,3914,81
2021-10-21,Colusa,011,21464,2493,2458,614,3072,18
2021-10-21,Contra Costa,013,1133247,98512,97855,2096,99951,1008
2021-10-21,Del Norte,015,27424,3636,3540,51,3591,42
2021-10-21,El Dorado,017,186661,15815,15540,1659,17199,149
2021-10-21,Fresno,019,978130,136904,134466,12286,146752,2094
2021-10-21,Glenn,021,27897,3447,3399,994,4393,33
2021-10-21,Humboldt,023,135768,8851,8753,512,9265,105
2021-10-21,Imperial,025,180216,33093,32777,3073,35850,766
2021-10-21,Inyo,027,18085,2197,2108,38,2146,41
2021-10-21,Kern,029,883053,125012,122939,20900,143839,1636
2021-10-21,Kings,031,150075,31553,30942,1845,32787,325
2021-10-21,Lake,033,64148,6619,6501,137,6638,105
2021-10-21,Lassen,035,31185,6749,6632,339,6971,27
2021-10-21,Los Angeles,037,10098052,1429467,1415919,52488,1468407,26527
2021-10-21,Madera,039,155013,22512,22062,1972,24034,281
2021-10-21,Marin,041,260295,17403,17264,437,17701,244
2021-10-21,Mariposa,043,17540,1234,1184,43,1227,5
2021-10-21,Mendocino,045,87422,7357,7220,467,7687,82
2021-10-21,Merced,047,269075,41162,40808,1788,42596,581
2021-10-21,Modoc,049,8938,516,507,183,690,5
2021-10-21,Mono,051,14174,1676,1655,22,1677,3
2021-10-21,Monterey,053,433212,48390,47456,2759,50215,586
2021-10-21,Napa,055,140530,12844,12789,105,12894,100
2021-10-21,Nevada,057,99092,8985,8861,308,9169,90
2021-10-21,Orange,059,3164182,304828,302237,14629,316866,5546
2021-10-21,Placer,061,380077,36428,35822,3517,39339,426
2021-10-21,Plumas,063,18699,1701,1623,32,1655,7
2021-10-21,Riverside,065,2383286,359330,354688,16111,370799,5041
2021-10-21,Sacramento,067,1510023,156474,155125,4381,159506,2232
2021-10-21,San Benito,069,59416,7296,7280,162,7442,71
2021-10-21,San Bernardino,071,2135413,350279,347681,10915,358596,5688
2021-10-21,San Diego,073,3302833,368734,366085,21667,387752,4183
2021-10-21,San Francisco,075,870044,52422,51820,2234,54054,649
2021-10-21,San Joaquin,077,732212,98450,97440,5250,102690,1721
2021-10-21,San Luis Obispo,079,281455,29199,28755,1199,29954,333
2021-10-21,San Mateo,081,765935,53646,52719,828,53547,571
2021-10-21,Santa Barbara,083,443738,43942,43552,1506,45058,523
2021-10-21,Santa Clara,085,1922200,145498,144276,1253,145529,1897
2021-10-21,Santa Cruz,087,273765,20157,19967,985,20952,221
2021-10-21,Shasta,089,179085,20810,20386,3464,23850,321
2021-10-21,Sierra,091,2930,177,168,18,186,0
2021-10-21,Siskiyou,093,43540,3303,3231,1244,4475,46
2021-10-21,Solano,095,438530,45539,44861,1218,46079,341
2021-10-21,Sonoma,097,501317,40841,40476,508,40984,393
2021-10-21,Stanislaus,099,539301,76960,76812,8577,85389,1145
2021-10-21,Sutter,101,95872,13684,13616,320,13936,175
2021-10-21,Tehama,103,63373,8257,8105,1418,9523,110
2021-10-21,Trinity,105,12862,833,696,204,900,11
2021-10-21,Tulare,107,460477,67106,65585,14185,79770,978
2021-10-21,Tuolumne,109,53932,6974,6840,89,6929,90
2021-10-21,Ventura,111,848112,97338,96664,4227,100891,1167
2021-10-21,Yolo,113,214977,19594,19280,929,20209,248
2021-10-21,Yuba,115,75493,9943,9838,293,10131,82
2021-10-20,Alameda,001,1643700,118127,117654,2682,120336,1390
2021-10-20,Alpine,003,1148,101,103,0,103,0
2021-10-20,Amador,005,37829,5463,5379,56,5435,64
2021-10-20,Butte,007,227075,20385,20021,3754,23775,270
2021-10-20,Calaveras,009,45235,3917,3844,48,3892,81
2021-10-20,Colusa,011,21464,2489,2454,612,3066,18
2021-10-20,Contra Costa,013,1133247,98397,97721,2092,99813,1008
2021-10-20,Del Norte,015,27424,3632,3536,51,3587,42
2021-10-20,El Dorado,017,186661,15786,15502,1656,17158,149
2021-10-20,Fresno,019,978130,136501,134025,12250,146275,2084
2021-10-20,Glenn,021,27897,3439,3382,993,4375,33
2021-10-20,Humboldt,023,135768,8829,8727,510,9237,105
2021-10-20,Imperial,025,180216,33019,32705,3065,35770,766
2021-10-20,Inyo,027,18085,2178,2077,37,2114,40
2021-10-20,Kern,029,883053,124718,122630,20782,143412,1623
2021-10-20,Kings,031,150075,31476,30805,1835,32640,322
2021-10-20,Lake,033,64148,6597,6475,136,6611,104
2021-10-20,Lassen,035,31185,6734,6622,339,6961,27
2021-10-20,Los Angeles,037,10098052,1428349,1414931,52417,1467348,26506
2021-10-20,Madera,039,155013,22443,21983,1963,23946,281
2021-10-20,Marin,041,260295,17382,17250,435,17685,244
2021-10-20,Mariposa,043,17540,1227,1174,43,1217,5
2021-10-20,Mendocino,045,87422,7329,7189,464,7653,82
2021-10-20,Merced,047,269075,41081,40685,1772,42457,581
2021-10-20,Modoc,049,8938,516,504,183,687,5
2021-10-20,Mono,051,14174,1676,1653,22,1675,3
2021-10-20,Monterey,053,433212,48358,47430,2750,50180,587
2021-10-20,Napa,055,140530,12830,12773,104,12877,100
2021-10-20,Nevada,057,99092,8957,8836,308,9144,90
2021-10-20,Orange,059,3164182,304542,301957,14607,316564,5534
2021-10-20,Placer,061,380077,36339,35729,3508,39237,425
2021-10-20,Plumas,063,18699,1694,1604,32,1636,7
2021-10-20,Riverside,065,2383286,358886,354311,16094,370405,5030
2021-10-20,Sacramento,067,1510023,156174,154822,4357,159179,2222
2021-10-20,San Benito,069,59416,7293,7275,160,7435,71
2021-10-20,San Bernardino,071,2135413,349877,347217,10884,358101,5663
2021-10-20,San Diego,073,3302833,368227,365698,21648,387346,4178
2021-10-20,San Francisco,075,870044,52373,51755,2233,53988,646
2021-10-20,San Joaquin,077,732212,98305,97246,5242,102488,1721
2021-10-20,San Luis Obispo,079,281455,29153,28727,1195,29922,332
2021-10-20,San Mateo,081,765935,53575,52663,820,53483,571
2021-10-20,Santa Barbara,083,443738,43879,43489,1505,44994,523
2021-10-20,Santa Clara,085,1922200,145359,144124,1248,145372,1896
2021-10-20,Santa Cruz,087,273765,20144,19951,985,20936,219
2021-10-20,Shasta,089,179085,20748,20313,3437,23750,320
2021-10-20,Sierra,091,2930,177,168,18,186,0
2021-10-20,Siskiyou,093,43540,3303,3224,1238,4462,46
2021-10-20,Solano,095,438530,45507,44819,1216,46035,341
2021-10-20,Sonoma,097,501317,40794,40404,508,40912,393
2021-10-20,Stanislaus,099,539301,76810,76631,8558,85189,1145
2021-10-20,Sutter,101,95872,13660,13592,314,13906,175
2021-10-20,Tehama,103,63373,8226,8081,1407,9488,110
2021-10-20,Trinity,105,12862,833,693,203,896,11
2021-10-20,Tulare,107,460477,66930,65413,14141,79554,967
2021-10-20,Tuolumne,109,53932,6951,6803,89,6892,89
2021-10-20,Ventura,111,848112,97256,96610,4222,100832,1166
2021-10-20,Yolo,113,214977,19549,19236,927,20163,248
2021-10-20,Yuba,115,75493,9926,9808,290,10098,82
2021-10-19,Alameda,001,1643700,118004,117542,2676,120218,1383
2021-10-19,Alpine,003,1148,101,103,0,103,0
2021-10-19,Amador,005,37829,5447,5367,56,5423,64
2021-10-19,Butte,007,227075,20332,19974,3746,23720,268
2021-10-19,Calaveras,009,45235,3900,3826,47,3873,80
2021-10-19,Colusa,011,21464,2486,2447,610,3057,18
2021-10-19,Contra Costa,013,1133247,98306,97613,2087,99700,1004
2021-10-19,Del Norte,015,27424,3625,3531,51,3582,42
2021-10-19,El Dorado,017,186661,15761,15478,1651,17129,149
2021-10-19,Fresno,019,978130,136137,133813,12201,146014,2073
2021-10-19,Glenn,021,27897,3435,3380,991,4371,33
2021-10-19,Humboldt,023,135768,8805,8714,504,9218,105
2021-10-19,Imperial,025,180216,32953,32632,3061,35693,764
2021-10-19,Inyo,027,18085,2147,2045,37,2082,40
2021-10-19,Kern,029,883053,124401,122391,20658,143049,1613
2021-10-19,Kings,031,150075,31383,30757,1828,32585,322
2021-10-19,Lake,033,64148,6593,6465,136,6601,104
2021-10-19,Lassen,035,31185,6728,6612,335,6947,27
2021-10-19,Los Angeles,037,10098052,1427103,1413882,52345,1466227,26473
2021-10-19,Madera,039,155013,22380,21950,1955,23905,281
2021-10-19,Marin,041,260295,17368,17241,432,17673,244
2021-10-19,Mariposa,043,17540,1221,1171,41,1212,5
2021-10-19,Mendocino,045,87422,7314,7172,461,7633,82
2021-10-19,Merced,047,269075,40966,40628,1751,42379,580
2021-10-19,Modoc,049,8938,514,502,183,685,5
2021-10-19,Mono,051,14174,1672,1651,22,1673,3
2021-10-19,Monterey,053,433212,48321,47412,2739,50151,583
2021-10-19,Napa,055,140530,12823,12769,104,12873,100
2021-10-19,Nevada,057,99092,8936,8829,307,9136,90
2021-10-19,Orange,059,3164182,304285,301700,14574,316274,5527
2021-10-19,Placer,061,380077,36218,35663,3493,39156,422
2021-10-19,Plumas,063,18699,1676,1586,32,1618,8
2021-10-19,Riverside,065,2383286,358465,353891,16087,369978,5020
2021-10-19,Sacramento,067,1510023,155868,154570,4331,158901,2227
2021-10-19,San Benito,069,59416,7278,7264,160,7424,71
2021-10-19,San Bernardino,071,2135413,349475,346814,10855,357669,5627
2021-10-19,San Diego,073,3302833,367646,365285,21617,386902,4170
2021-10-19,San Francisco,075,870044,52310,51704,2231,53935,645
2021-10-19,San Joaquin,077,732212,98137,97105,5231,102336,1721
2021-10-19,San Luis Obispo,079,281455,29105,28670,1192,29862,332
2021-10-19,San Mateo,081,765935,53517,52617,818,53435,571
2021-10-19,Santa Barbara,083,443738,43812,43413,1504,44917,522
2021-10-19,Santa Clara,085,1922200,145183,143989,1241,145230,1898
2021-10-19,Santa Cruz,087,273765,20120,19895,983,20878,218
2021-10-19,Shasta,089,179085,20672,20209,3429,23638,319
2021-10-19,Sierra,091,2930,174,168,18,186,0
2021-10-19,Siskiyou,093,43540,3299,3216,1233,4449,46
2021-10-19,Solano,095,438530,45466,44782,1210,45992,341
2021-10-19,Sonoma,097,501317,40720,40379,507,40886,392
2021-10-19,Stanislaus,099,539301,76668,76526,8546,85072,1145
2021-10-19,Sutter,101,95872,13636,13569,313,13882,174
2021-10-19,Tehama,103,63373,8195,8057,1392,9449,108
2021-10-19,Trinity,105,12862,826,691,203,894,11
2021-10-19,Tulare,107,460477,66743,65253,14073,79326,958
2021-10-19,Tuolumne,109,53932,6922,6782,88,6870,89
2021-10-19,Ventura,111,848112,97180,96539,4217,100756,1166
2021-10-19,Yolo,113,214977,19500,19206,926,20132,248
2021-10-19,Yuba,115,75493,9908,9796,289,10085,82
2021-10-18,Alameda,001,1643700,117867,117506,2666,120172,1381
2021-10-18,Alpine,003,1148,101,103,0,103,0
2021-10-18,Amador,005,37829,5436,5345,56,5401,64
2021-10-18,Butte,007,227075,20282,19921,3734,23655,265
2021-10-18,Calaveras,009,45235,3875,3819,46,3865,80
2021-10-18,Colusa,011,21464,2485,2444,608,3052,18
2021-10-18,Contra Costa,013,1133247,98194,97585,2083,99668,995
2021-10-18,Del Norte,015,27424,3618,3529,51,3580,41
2021-10-18,El Dorado,017,186661,15731,15452,1649,17101,149
2021-10-18,Fresno,019,978130,135736,133688,12159,145847,2063
2021-10-18,Glenn,021,27897,3431,3370,987,4357,32
2021-10-18,Humboldt,023,135768,8785,8699,496,9195,104
2021-10-18,Imperial,025,180216,32862,32558,3061,35619,764
2021-10-18,Inyo,027,18085,2129,2020,37,2057,40
2021-10-18,Kern,029,883053,124102,122231,20564,142795,1605
2021-10-18,Kings,031,150075,31270,30698,1815,32513,320
2021-10-18,Lake,033,64148,6574,6455,132,6587,104
2021-10-18,Lassen,035,31185,6708,6607,332,6939,26
2021-10-18,Los Angeles,037,10098052,1425861,1413291,52268,1465559,26446
2021-10-18,Madera,039,155013,22326,21909,1942,23851,277
2021-10-18,Marin,041,260295,17348,17232,429,17661,244
2021-10-18,Mariposa,043,17540,1213,1160,41,1201,5
2021-10-18,Mendocino,045,87422,7295,7156,453,7609,82
2021-10-18,Merced,047,269075,40843,40573,1740,42313,579
2021-10-18,Modoc,049,8938,514,498,183,681,5
2021-10-18,Mono,051,14174,1666,1648,21,1669,3
2021-10-18,Monterey,053,433212,48299,47389,2734,50123,583
2021-10-18,Napa,055,140530,12808,12762,104,12866,100
2021-10-18,Nevada,057,99092,8917,8816,307,9123,90
2021-10-18,Orange,059,3164182,303946,301573,14539,316112,5524
2021-10-18,Placer,061,380077,36141,35598,3489,39087,420
2021-10-18,Plumas,063,18699,1668,1579,32,1611,6
2021-10-18,Riverside,065,2383286,358050,353699,16073,369772,5008
2021-10-18,Sacramento,067,1510023,155563,154428,4301,158729,2203
2021-10-18,San Benito,069,59416,7266,7253,160,7413,71
2021-10-18,San Bernardino,071,2135413,349055,346742,10841,357583,5606
2021-10-18,San Diego,073,3302833,367090,364948,21579,386527,4169
2021-10-18,San Francisco,075,870044,52247,51671,2225,53896,644
2021-10-18,San Joaquin,077,732212,97972,97041,5221,102262,1721
2021-10-18,San Luis Obispo,079,281455,29066,28644,1189,29833,331
2021-10-18,San Mateo,081,765935,53452,52594,817,53411,571
2021-10-18,Santa Barbara,083,443738,43753,43386,1502,44888,522
2021-10-18,Santa Clara,085,1922200,145028,143891,1233,145124,1895
2021-10-18,Santa Cruz,087,273765,20106,19876,981,20857,218
2021-10-18,Shasta,089,179085,20592,20146,3418,23564,313
2021-10-18,Sierra,091,2930,174,166,18,184,0
2021-10-18,Siskiyou,093,43540,3296,3210,1225,4435,42
2021-10-18,Solano,095,438530,45422,44758,1207,45965,339
2021-10-18,Sonoma,097,501317,40656,40349,504,40853,392
2021-10-18,Stanislaus,099,539301,76503,76466,8532,84998,1145
2021-10-18,Sutter,101,95872,13602,13557,311,13868,172
2021-10-18,Tehama,103,63373,8159,8042,1381,9423,107
2021-10-18,Trinity,105,12862,825,688,203,891,11
2021-10-18,Tulare,107,460477,66568,65171,14009,79180,958
2021-10-18,Tuolumne,109,53932,6893,6755,88,6843,89
2021-10-18,Ventura,111,848112,97085,96506,4214,100720,1165
2021-10-18,Yolo,113,214977,19461,19197,925,20122,248
2021-10-18,Yuba,115,75493,9881,9782,287,10069,82
2021-10-17,Alameda,001,1643700,117716,117423,2661,120084,1376
2021-10-17,Alpine,003,1148,101,103,0,103,0
2021-10-17,Amador,005,37829,5413,5341,56,5397,64
2021-10-17,Butte,007,227075,20198,19897,3723,23620,265
2021-10-17,Calaveras,009,45235,3859,3805,46,3851,80
2021-10-17,Colusa,011,21464,2480,2442,601,3043,18
2021-10-17,Contra Costa,013,1133247,98073,97485,2072,99557,995
2021-10-17,Del Norte,015,27424,3613,3526,51,3577,41
2021-10-17,El Dorado,017,186661,15673,15438,1642,17080,149
2021-10-17,Fresno,019,978130,135268,133429,12115,145544,2063
2021-10-17,Glenn,021,27897,3421,3364,982,4346,32
2021-10-17,Humboldt,023,135768,8765,8690,493,9183,104
2021-10-17,Imperial,025,180216,32780,32520,3054,35574,764
2021-10-17,Inyo,027,18085,2101,2000,37,2037,40
2021-10-17,Kern,029,883053,123752,122085,20466,142551,1603
2021-10-17,Kings,031,150075,31157,30636,1807,32443,315
2021-10-17,Lake,033,64148,6558,6437,132,6569,104
2021-10-17,Lassen,035,31185,6696,6605,328,6933,26
2021-10-17,Los Angeles,037,10098052,1424525,1412371,52196,1464567,26443
2021-10-17,Madera,039,155013,22264,21869,1931,23800,277
2021-10-17,Marin,041,260295,17326,17211,429,17640,243
2021-10-17,Mariposa,043,17540,1206,1150,41,1191,5
2021-10-17,Mendocino,045,87422,7266,7148,447,7595,82
2021-10-17,Merced,047,269075,40717,40531,1724,42255,579
2021-10-17,Modoc,049,8938,511,498,181,679,5
2021-10-17,Mono,051,14174,1664,1640,20,1660,3
2021-10-17,Monterey,053,433212,48258,47369,2724,50093,583
2021-10-17,Napa,055,140530,12792,12753,101,12854,100
2021-10-17,Nevada,057,99092,8900,8794,306,9100,90
2021-10-17,Orange,059,3164182,303631,301414,14506,315920,5524
2021-10-17,Placer,061,380077,36041,35559,3474,39033,420
2021-10-17,Plumas,063,18699,1644,1571,31,1602,6
2021-10-17,Riverside,065,2383286,357565,353500,16059,369559,5008
2021-10-17,Sacramento,067,1510023,155164,154080,4284,158364,2213
2021-10-17,San Benito,069,59416,7257,7250,159,7409,71
2021-10-17,San Bernardino,071,2135413,348619,346524,10821,357345,5597
2021-10-17,San Diego,073,3302833,366499,364675,21551,386226,4163
2021-10-17,San Francisco,075,870044,52175,51625,2216,53841,644
2021-10-17,San Joaquin,077,732212,97799,96950,5212,102162,1721
2021-10-17,San Luis Obispo,079,281455,29014,28604,1181,29785,331
2021-10-17,San Mateo,081,765935,53400,52541,813,53354,571
2021-10-17,Santa Barbara,083,443738,43690,43344,1501,44845,522
2021-10-17,Santa Clara,085,1922200,144850,143768,1224,144992,1895
2021-10-17,Santa Cruz,087,273765,20079,19861,979,20840,218
2021-10-17,Shasta,089,179085,20502,20116,3408,23524,312
2021-10-17,Sierra,091,2930,172,165,18,183,0
2021-10-17,Siskiyou,093,43540,3288,3204,1222,4426,42
2021-10-17,Solano,095,438530,45365,44722,1206,45928,340
2021-10-17,Sonoma,097,501317,40580,40306,503,40809,392
2021-10-17,Stanislaus,099,539301,76305,76354,8518,84872,1145
2021-10-17,Sutter,101,95872,13585,13543,309,13852,172
2021-10-17,Tehama,103,63373,8127,8015,1365,9380,107
2021-10-17,Trinity,105,12862,822,686,202,888,11
2021-10-17,Tulare,107,460477,66385,65057,13937,78994,958
2021-10-17,Tuolumne,109,53932,6859,6735,87,6822,89
2021-10-17,Ventura,111,848112,96985,96458,4211,100669,1165
2021-10-17,Yolo,113,214977,19416,19171,919,20090,248
2021-10-17,Yuba,115,75493,9855,9771,285,10056,82
2021-10-16,Alameda,001,1643700,117627,117027,2659,119686,1365
2021-10-16,Alpine,003,1148,100,102,0,102,0
2021-10-16,Amador,005,37829,5406,5310,56,5366,64
2021-10-16,Butte,007,227075,20167,19612,3713,23325,260
2021-10-16,Calaveras,009,45235,3852,3771,46,3817,80
2021-10-16,Colusa,011,21464,2476,2431,598,3029,18
2021-10-16,Contra Costa,013,1133247,97981,97107,2065,99172,982
2021-10-16,Del Norte,015,27424,3610,3516,51,3567,41
2021-10-16,El Dorado,017,186661,15652,15315,1640,16955,149
2021-10-16,Fresno,019,978130,135114,132433,12098,144531,2051
2021-10-16,Glenn,021,27897,3415,3331,982,4313,26
2021-10-16,Humboldt,023,135768,8754,8621,488,9109,104
2021-10-16,Imperial,025,180216,32765,32368,3052,35420,764
2021-10-16,Inyo,027,18085,2087,1932,37,1969,39
2021-10-16,Kern,029,883053,123596,121354,20385,141739,1590
2021-10-16,Kings,031,150075,31111,30418,1804,32222,314
2021-10-16,Lake,033,64148,6547,6378,132,6510,104
2021-10-16,Lassen,035,31185,6687,6559,324,6883,26
2021-10-16,Los Angeles,037,10098052,1423872,1409418,52143,1461561,26398
2021-10-16,Madera,039,155013,22220,21707,1927,23634,277
2021-10-16,Marin,041,260295,17316,17148,429,17577,243
2021-10-16,Mariposa,043,17540,1203,1096,41,1137,5
2021-10-16,Mendocino,045,87422,7255,7099,447,7546,82
2021-10-16,Merced,047,269075,40685,40265,1722,41987,577
2021-10-16,Modoc,049,8938,508,492,181,673,5
2021-10-16,Mono,051,14174,1660,1628,20,1648,3
2021-10-16,Monterey,053,433212,48241,47293,2716,50009,582
2021-10-16,Napa,055,140530,12781,12706,101,12807,100
2021-10-16,Nevada,057,99092,8880,8739,306,9045,90
2021-10-16,Orange,059,3164182,303455,300722,14481,315203,5509
2021-10-16,Placer,061,380077,35957,35343,3468,38811,412
2021-10-16,Plumas,063,18699,1639,1542,30,1572,6
2021-10-16,Riverside,065,2383286,357295,352435,16047,368482,4990
2021-10-16,Sacramento,067,1510023,154966,153264,4280,157544,2192
2021-10-16,San Benito,069,59416,7244,7210,158,7368,71
2021-10-16,San Bernardino,071,2135413,348411,345418,10813,356231,5566
2021-10-16,San Diego,073,3302833,366183,363109,21535,384644,4151
2021-10-16,San Francisco,075,870044,52128,51436,2212,53648,645
2021-10-16,San Joaquin,077,732212,97727,96507,5209,101716,1708
2021-10-16,San Luis Obispo,079,281455,28988,28460,1180,29640,329
2021-10-16,San Mateo,081,765935,53351,52399,812,53211,569
2021-10-16,Santa Barbara,083,443738,43654,43175,1500,44675,521
2021-10-16,Santa Clara,085,1922200,144750,143282,1216,144498,1890
2021-10-16,Santa Cruz,087,273765,20063,19794,978,20772,218
2021-10-16,Shasta,089,179085,20452,19932,3397,23329,309
2021-10-16,Sierra,091,2930,170,160,18,178,0
2021-10-16,Siskiyou,093,43540,3286,3173,1215,4388,42
2021-10-16,Solano,095,438530,45339,44585,1202,45787,334
2021-10-16,Sonoma,097,501317,40540,40195,503,40698,390
2021-10-16,Stanislaus,099,539301,76219,75868,8508,84376,1142
2021-10-16,Sutter,101,95872,13566,13471,308,13779,169
2021-10-16,Tehama,103,63373,8114,7907,1360,9267,104
2021-10-16,Trinity,105,12862,822,679,202,881,11
2021-10-16,Tulare,107,460477,66247,64489,13906,78395,951
2021-10-16,Tuolumne,109,53932,6827,6666,87,6753,89
2021-10-16,Ventura,111,848112,96953,96181,4206,100387,1164
2021-10-16,Yolo,113,214977,19387,19078,916,19994,247
2021-10-16,Yuba,115,75493,9831,9705,282,9987,82
2021-10-15,Alameda,001,1643700,117555,117027,2655,119682,1365
2021-10-15,Alpine,003,1148,100,102,0,102,0
2021-10-15,Amador,005,37829,5382,5310,56,5366,64
2021-10-15,Butte,007,227075,20131,19612,3705,23317,260
2021-10-15,Calaveras,009,45235,3846,3771,46,3817,80
2021-10-15,Colusa,011,21464,2474,2431,595,3026,18
2021-10-15,Contra Costa,013,1133247,97899,97107,2062,99169,982
2021-10-15,Del Norte,015,27424,3608,3516,51,3567,41
2021-10-15,El Dorado,017,186661,15632,15315,1635,16950,149
2021-10-15,Fresno,019,978130,134861,132433,12088,144521,2051
2021-10-15,Glenn,021,27897,3409,3331,981,4312,26
2021-10-15,Humboldt,023,135768,8745,8621,486,9107,104
2021-10-15,Imperial,025,180216,32718,32368,3048,35416,764
2021-10-15,Inyo,027,18085,2069,1932,37,1969,39
2021-10-15,Kern,029,883053,123460,121354,20311,141665,1590
2021-10-15,Kings,031,150075,31056,30418,1800,32218,314
2021-10-15,Lake,033,64148,6538,6378,132,6510,104
2021-10-15,Lassen,035,31185,6675,6559,323,6882,26
2021-10-15,Los Angeles,037,10098052,1423186,1409418,52096,1461514,26398
2021-10-15,Madera,039,155013,22176,21707,1919,23626,277
2021-10-15,Marin,041,260295,17305,17148,429,17577,243
2021-10-15,Mariposa,043,17540,1195,1096,41,1137,5
2021-10-15,Mendocino,045,87422,7240,7099,447,7546,82
2021-10-15,Merced,047,269075,40655,40265,1719,41984,577
2021-10-15,Modoc,049,8938,507,492,181,673,5
2021-10-15,Mono,051,14174,1657,1628,20,1648,3
2021-10-15,Monterey,053,433212,48219,47293,2714,50007,582
2021-10-15,Napa,055,140530,12777,12706,101,12807,100
2021-10-15,Nevada,057,99092,8865,8739,306,9045,90
2021-10-15,Orange,059,3164182,303287,300722,14463,315185,5509
2021-10-15,Placer,061,380077,35903,35343,3462,38805,412
2021-10-15,Plumas,063,18699,1631,1542,30,1572,6
2021-10-15,Riverside,065,2383286,357053,352435,16042,368477,4990
2021-10-15,Sacramento,067,1510023,154778,153264,4270,157534,2192
2021-10-15,San Benito,069,59416,7241,7210,158,7368,71
2021-10-15,San Bernardino,071,2135413,348179,345418,10810,356228,5566
2021-10-15,San Diego,073,3302833,365824,363109,21510,384619,4151
2021-10-15,San Francisco,075,870044,52088,51436,2205,53641,645
2021-10-15,San Joaquin,077,732212,97649,96507,5202,101709,1708
2021-10-15,San Luis Obispo,079,281455,28967,28460,1178,29638,329
2021-10-15,San Mateo,081,765935,53307,52399,811,53210,569
2021-10-15,Santa Barbara,083,443738,43616,43175,1500,44675,521
2021-10-15,Santa Clara,085,1922200,144629,143282,1208,144490,1890
2021-10-15,Santa Cruz,087,273765,20052,19794,978,20772,218
2021-10-15,Shasta,089,179085,20396,19932,3389,23321,309
2021-10-15,Sierra,091,2930,170,160,18,178,0
2021-10-15,Siskiyou,093,43540,3285,3173,1212,4385,42
2021-10-15,Solano,095,438530,45313,44585,1202,45787,334
2021-10-15,Sonoma,097,501317,40506,40195,502,40697,390
2021-10-15,Stanislaus,099,539301,76139,75868,8492,84360,1142
2021-10-15,Sutter,101,95872,13549,13471,306,13777,169
2021-10-15,Tehama,103,63373,8092,7907,1355,9262,104
2021-10-15,Trinity,105,12862,822,679,202,881,11
2021-10-15,Tulare,107,460477,66168,64489,13869,78358,951
2021-10-15,Tuolumne,109,53932,6804,6666,85,6751,89
2021-10-15,Ventura,111,848112,96911,96181,4203,100384,1164
2021-10-15,Yolo,113,214977,19370,19078,914,19992,247
2021-10-15,Yuba,115,75493,9821,9705,281,9986,82
2021-10-14,Alameda,001,1643700,117447,117027,2650,119677,1365
2021-10-14,Alpine,003,1148,100,102,0,102,0
2021-10-14,Amador,005,37829,5371,5310,56,5366,64
2021-10-14,Butte,007,227075,20079,19612,3699,23311,260
2021-10-14,Calaveras,009,45235,3833,3771,45,3816,80
2021-10-14,Colusa,011,21464,2472,2431,593,3024,18
2021-10-14,Contra Costa,013,1133247,97765,97107,2055,99162,982
2021-10-14,Del Norte,015,27424,3602,3516,51,3567,41
2021-10-14,El Dorado,017,186661,15594,15315,1632,16947,149
2021-10-14,Fresno,019,978130,134566,132433,12059,144492,2051
2021-10-14,Glenn,021,27897,3404,3331,980,4311,26
2021-10-14,Humboldt,023,135768,8728,8621,483,9104,104
2021-10-14,Imperial,025,180216,32655,32368,3041,35409,764
2021-10-14,Inyo,027,18085,2050,1932,37,1969,39
2021-10-14,Kern,029,883053,123188,121354,20212,141566,1590
2021-10-14,Kings,031,150075,30990,30418,1792,32210,314
2021-10-14,Lake,033,64148,6517,6378,131,6509,104
2021-10-14,Lassen,035,31185,6669,6559,322,6881,26
2021-10-14,Los Angeles,037,10098052,1422200,1409418,52046,1461464,26398
2021-10-14,Madera,039,155013,22111,21707,1913,23620,277
2021-10-14,Marin,041,260295,17300,17148,427,17575,243
2021-10-14,Mariposa,043,17540,1182,1096,40,1136,5
2021-10-14,Mendocino,045,87422,7226,7099,445,7544,82
2021-10-14,Merced,047,269075,40566,40265,1705,41970,577
2021-10-14,Modoc,049,8938,507,492,181,673,5
2021-10-14,Mono,051,14174,1650,1628,20,1648,3
2021-10-14,Monterey,053,433212,48194,47293,2709,50002,582
2021-10-14,Napa,055,140530,12762,12706,101,12807,100
2021-10-14,Nevada,057,99092,8838,8739,304,9043,90
2021-10-14,Orange,059,3164182,303079,300722,14446,315168,5509
2021-10-14,Placer,061,380077,35836,35343,3448,38791,412
2021-10-14,Plumas,063,18699,1616,1542,30,1572,6
2021-10-14,Riverside,065,2383286,356656,352435,16031,368466,4990
2021-10-14,Sacramento,067,1510023,154527,153264,4250,157514,2192
2021-10-14,San Benito,069,59416,7230,7210,158,7368,71
2021-10-14,San Bernardino,071,2135413,347822,345418,10803,356221,5566
2021-10-14,San Diego,073,3302833,365384,363109,21483,384592,4151
2021-10-14,San Francisco,075,870044,52032,51436,2201,53637,645
2021-10-14,San Joaquin,077,732212,97520,96507,5193,101700,1708
2021-10-14,San Luis Obispo,079,281455,28923,28460,1174,29634,329
2021-10-14,San Mateo,081,765935,53259,52399,810,53209,569
2021-10-14,Santa Barbara,083,443738,43560,43175,1495,44670,521
2021-10-14,Santa Clara,085,1922200,144488,143282,1202,144484,1890
2021-10-14,Santa Cruz,087,273765,20029,19794,978,20772,218
2021-10-14,Shasta,089,179085,20339,19932,3377,23309,309
2021-10-14,Sierra,091,2930,169,160,18,178,0
2021-10-14,Siskiyou,093,43540,3282,3173,1204,4377,42
2021-10-14,Solano,095,438530,45263,44585,1194,45779,334
2021-10-14,Sonoma,097,501317,40456,40195,499,40694,390
2021-10-14,Stanislaus,099,539301,75993,75868,8479,84347,1142
2021-10-14,Sutter,101,95872,13529,13471,305,13776,169
2021-10-14,Tehama,103,63373,8061,7907,1348,9255,104
2021-10-14,Trinity,105,12862,821,679,201,880,11
2021-10-14,Tulare,107,460477,65984,64489,13822,78311,951
2021-10-14,Tuolumne,109,53932,6772,6666,84,6750,89
2021-10-14,Ventura,111,848112,96843,96181,4197,100378,1164
2021-10-14,Yolo,113,214977,19334,19078,910,19988,247
2021-10-14,Yuba,115,75493,9807,9705,272,9977,82
2021-10-13,Alameda,001,1643700,117341,116914,2644,119558,1360
2021-10-13,Alpine,003,1148,100,102,0,102,0
2021-10-13,Amador,005,37829,5357,5305,56,5361,63
2021-10-13,Butte,007,227075,20003,19546,3693,23239,257
2021-10-13,Calaveras,009,45235,3812,3756,43,3799,79
2021-10-13,Colusa,011,21464,2465,2430,589,3019,18
2021-10-13,Contra Costa,013,1133247,97648,96975,2054,99029,969
2021-10-13,Del Norte,015,27424,3597,3512,51,3563,39
2021-10-13,El Dorado,017,186661,15571,15302,1627,16929,149
2021-10-13,Fresno,019,978130,134232,132055,12027,144082,2048
2021-10-13,Glenn,021,27897,3399,3327,976,4303,26
2021-10-13,Humboldt,023,135768,8717,8604,479,9083,102
2021-10-13,Imperial,025,180216,32595,32317,3039,35356,762
2021-10-13,Inyo,027,18085,2013,1907,37,1944,39
2021-10-13,Kern,029,883053,122943,120956,20120,141076,1586
2021-10-13,Kings,031,150075,30909,30246,1785,32031,312
2021-10-13,Lake,033,64148,6497,6371,131,6502,103
2021-10-13,Lassen,035,31185,6658,6535,316,6851,25
2021-10-13,Los Angeles,037,10098052,1421145,1408384,51992,1460376,26379
2021-10-13,Madera,039,155013,22058,21609,1899,23508,277
2021-10-13,Marin,041,260295,17276,17137,426,17563,243
2021-10-13,Mariposa,043,17540,1168,1090,40,1130,5
2021-10-13,Mendocino,045,87422,7210,7088,437,7525,82
2021-10-13,Merced,047,269075,40481,40164,1693,41857,577
2021-10-13,Modoc,049,8938,505,490,179,669,5
2021-10-13,Mono,051,14174,1650,1612,20,1632,3
2021-10-13,Monterey,053,433212,48174,47273,2702,49975,582
2021-10-13,Napa,055,140530,12751,12695,99,12794,100
2021-10-13,Nevada,057,99092,8816,8725,304,9029,90
2021-10-13,Orange,059,3164182,302872,300468,14430,314898,5503
2021-10-13,Placer,061,380077,35769,35254,3439,38693,412
2021-10-13,Plumas,063,18699,1602,1514,30,1544,6
2021-10-13,Riverside,065,2383286,356326,352044,16018,368062,4978
2021-10-13,Sacramento,067,1510023,154278,153141,4229,157370,2182
2021-10-13,San Benito,069,59416,7224,7196,157,7353,71
2021-10-13,San Bernardino,071,2135413,347497,344951,10786,355737,5562
2021-10-13,San Diego,073,3302833,364953,362564,21461,384025,4141
2021-10-13,San Francisco,075,870044,51988,51379,2197,53576,644
2021-10-13,San Joaquin,077,732212,97376,96343,5189,101532,1696
2021-10-13,San Luis Obispo,079,281455,28885,28397,1171,29568,330
2021-10-13,San Mateo,081,765935,53207,52352,806,53158,569
2021-10-13,Santa Barbara,083,443738,43508,43109,1495,44604,518
2021-10-13,Santa Clara,085,1922200,144348,143064,1201,144265,1886
2021-10-13,Santa Cruz,087,273765,20003,19763,977,20740,217
2021-10-13,Shasta,089,179085,20269,19802,3357,23159,307
2021-10-13,Sierra,091,2930,169,155,18,173,0
2021-10-13,Siskiyou,093,43540,3274,3173,1203,4376,42
2021-10-13,Solano,095,438530,45224,44558,1191,45749,334
2021-10-13,Sonoma,097,501317,40400,40122,499,40621,390
2021-10-13,Stanislaus,099,539301,75851,75698,8469,84167,1136
2021-10-13,Sutter,101,95872,13499,13458,303,13761,169
2021-10-13,Tehama,103,63373,8025,7849,1342,9191,103
2021-10-13,Trinity,105,12862,818,677,201,878,11
2021-10-13,Tulare,107,460477,65803,64297,13768,78065,945
2021-10-13,Tuolumne,109,53932,6758,6644,83,6727,89
2021-10-13,Ventura,111,848112,96769,96099,4191,100290,1162
2021-10-13,Yolo,113,214977,19305,19023,909,19932,247
2021-10-13,Yuba,115,75493,9782,9690,259,9949,80
2021-10-12,Alameda,001,1643700,117238,116813,2640,119453,1357
2021-10-12,Alpine,003,1148,100,102,0,102,0
2021-10-12,Amador,005,37829,5346,5301,56,5357,63
2021-10-12,Butte,007,227075,19931,19506,3681,23187,256
2021-10-12,Calaveras,009,45235,3797,3750,43,3793,75
2021-10-12,Colusa,011,21464,2462,2428,587,3015,18
2021-10-12,Contra Costa,013,1133247,97535,96894,2045,98939,960
2021-10-12,Del Norte,015,27424,3591,3511,51,3562,39
2021-10-12,El Dorado,017,186661,15537,15287,1625,16912,148
2021-10-12,Fresno,019,978130,133870,131848,11996,143844,2042
2021-10-12,Glenn,021,27897,3385,3321,975,4296,26
2021-10-12,Humboldt,023,135768,8690,8587,473,9060,102
2021-10-12,Imperial,025,180216,32543,32267,3037,35304,762
2021-10-12,Inyo,027,18085,1981,1889,37,1926,39
2021-10-12,Kern,029,883053,122656,120826,20011,140837,1580
2021-10-12,Kings,031,150075,30835,30200,1774,31974,312
2021-10-12,Lake,033,64148,6482,6372,129,6501,97
2021-10-12,Lassen,035,31185,6648,6526,315,6841,25
2021-10-12,Los Angeles,037,10098052,1420085,1407462,51946,1459408,26362
2021-10-12,Madera,039,155013,21987,21574,1886,23460,277
2021-10-12,Marin,041,260295,17253,17126,426,17552,242
2021-10-12,Mariposa,043,17540,1154,1088,40,1128,5
2021-10-12,Mendocino,045,87422,7181,7077,434,7511,82
2021-10-12,Merced,047,269075,40402,40113,1687,41800,567
2021-10-12,Modoc,049,8938,500,485,178,663,5
2021-10-12,Mono,051,14174,1648,1608,20,1628,3
2021-10-12,Monterey,053,433212,48143,47254,2694,49948,582
2021-10-12,Napa,055,140530,12737,12671,99,12770,97
2021-10-12,Nevada,057,99092,8804,8720,303,9023,89
2021-10-12,Orange,059,3164182,302617,300256,14405,314661,5499
2021-10-12,Placer,061,380077,35706,35214,3431,38645,404
2021-10-12,Plumas,063,18699,1588,1488,29,1517,6
2021-10-12,Riverside,065,2383286,356000,351771,16004,367775,4973
2021-10-12,Sacramento,067,1510023,153973,152935,4204,157139,2170
2021-10-12,San Benito,069,59416,7210,7193,157,7350,71
2021-10-12,San Bernardino,071,2135413,347184,344788,10776,355564,5563
2021-10-12,San Diego,073,3302833,364440,362256,21432,383688,4137
2021-10-12,San Francisco,075,870044,51924,51301,2196,53497,643
2021-10-12,San Joaquin,077,732212,97240,96237,5184,101421,1690
2021-10-12,San Luis Obispo,079,281455,28838,28379,1170,29549,327
2021-10-12,San Mateo,081,765935,53156,52328,805,53133,569
2021-10-12,Santa Barbara,083,443738,43447,43076,1495,44571,515
2021-10-12,Santa Clara,085,1922200,144195,142954,1199,144153,1882
2021-10-12,Santa Cruz,087,273765,19978,19757,977,20734,218
2021-10-12,Shasta,089,179085,20195,19731,3336,23067,304
2021-10-12,Sierra,091,2930,169,153,18,171,0
2021-10-12,Siskiyou,093,43540,3263,3166,1197,4363,42
2021-10-12,Solano,095,438530,45182,44516,1185,45701,329
2021-10-12,Sonoma,097,501317,40359,40105,498,40603,390
2021-10-12,Stanislaus,099,539301,75699,75589,8457,84046,1126
2021-10-12,Sutter,101,95872,13476,13436,299,13735,168
2021-10-12,Tehama,103,63373,7993,7820,1338,9158,103
2021-10-12,Trinity,105,12862,815,676,201,877,11
2021-10-12,Tulare,107,460477,65618,64216,13713,77929,944
2021-10-12,Tuolumne,109,53932,6741,6637,82,6719,89
2021-10-12,Ventura,111,848112,96668,96022,4186,100208,1160
2021-10-12,Yolo,113,214977,19274,18987,906,19893,247
2021-10-12,Yuba,115,75493,9767,9676,255,9931,70
2021-10-11,Alameda,001,1643700,117095,116759,2639,119398,1358
2021-10-11,Alpine,003,1148,100,102,0,102,0
2021-10-11,Amador,005,37829,5334,5286,56,5342,62
2021-10-11,Butte,007,227075,19871,19452,3676,23128,253
2021-10-11,Calaveras,009,45235,3776,3750,43,3793,75
2021-10-11,Colusa,011,21464,2458,2427,579,3006,18
2021-10-11,Contra Costa,013,1133247,97399,96832,2040,98872,960
2021-10-11,Del Norte,015,27424,3588,3510,47,3557,39
2021-10-11,El Dorado,017,186661,15508,15273,1621,16894,146
2021-10-11,Fresno,019,978130,133540,131703,11961,143664,2036
2021-10-11,Glenn,021,27897,3368,3308,973,4281,26
2021-10-11,Humboldt,023,135768,8665,8571,466,9037,101
2021-10-11,Imperial,025,180216,32493,32207,3031,35238,762
2021-10-11,Inyo,027,18085,1958,1862,36,1898,39
2021-10-11,Kern,029,883053,122419,120684,19916,140600,1575
2021-10-11,Kings,031,150075,30746,30180,1764,31944,309
2021-10-11,Lake,033,64148,6466,6361,125,6486,97
2021-10-11,Lassen,035,31185,6628,6499,312,6811,25
2021-10-11,Los Angeles,037,10098052,1419039,1406826,51895,1458721,26346
2021-10-11,Madera,039,155013,21929,21555,1869,23424,272
2021-10-11,Marin,041,260295,17235,17121,422,17543,242
2021-10-11,Mariposa,043,17540,1124,1083,39,1122,5
2021-10-11,Mendocino,045,87422,7165,7064,430,7494,82
2021-10-11,Merced,047,269075,40286,40064,1662,41726,566
2021-10-11,Modoc,049,8938,497,482,175,657,5
2021-10-11,Mono,051,14174,1638,1604,20,1624,3
2021-10-11,Monterey,053,433212,48114,47241,2687,49928,580
2021-10-11,Napa,055,140530,12715,12654,97,12751,96
2021-10-11,Nevada,057,99092,8784,8716,302,9018,90
2021-10-11,Orange,059,3164182,302386,299941,14374,314315,5499
2021-10-11,Placer,061,380077,35637,35173,3414,38587,404
2021-10-11,Plumas,063,18699,1570,1469,27,1496,6
2021-10-11,Riverside,065,2383286,355655,351444,15999,367443,4973
2021-10-11,Sacramento,067,1510023,153683,152681,4173,156854,2169
2021-10-11,San Benito,069,59416,7189,7184,155,7339,71
2021-10-11,San Bernardino,071,2135413,346799,344594,10768,355362,5549
2021-10-11,San Diego,073,3302833,363928,361712,21400,383112,4124
2021-10-11,San Francisco,075,870044,51853,51275,2193,53468,643
2021-10-11,San Joaquin,077,732212,97085,96152,5173,101325,1681
2021-10-11,San Luis Obispo,079,281455,28790,28355,1165,29520,327
2021-10-11,San Mateo,081,765935,53108,52298,805,53103,569
2021-10-11,Santa Barbara,083,443738,43401,43018,1494,44512,515
2021-10-11,Santa Clara,085,1922200,144033,142836,1195,144031,1882
2021-10-11,Santa Cruz,087,273765,19954,19745,976,20721,217
2021-10-11,Shasta,089,179085,20116,19662,3320,22982,295
2021-10-11,Sierra,091,2930,166,147,17,164,0
2021-10-11,Siskiyou,093,43540,3256,3159,1193,4352,42
2021-10-11,Solano,095,438530,45133,44474,1182,45656,329
2021-10-11,Sonoma,097,501317,40314,40067,498,40565,390
2021-10-11,Stanislaus,099,539301,75528,75478,8436,83914,1118
2021-10-11,Sutter,101,95872,13457,13427,297,13724,165
2021-10-11,Tehama,103,63373,7952,7795,1329,9124,102
2021-10-11,Trinity,105,12862,809,675,200,875,11
2021-10-11,Tulare,107,460477,65439,64094,13646,77740,942
2021-10-11,Tuolumne,109,53932,6703,6602,82,6684,89
2021-10-11,Ventura,111,848112,96571,95876,4179,100055,1160
2021-10-11,Yolo,113,214977,19226,18977,904,19881,247
2021-10-11,Yuba,115,75493,9750,9657,243,9900,69
2021-10-10,Alameda,001,1643700,116976,116679,2635,119314,1358
2021-10-10,Alpine,003,1148,100,102,0,102,0
2021-10-10,Amador,005,37829,5320,5278,56,5334,62
2021-10-10,Butte,007,227075,19806,19430,3661,23091,253
2021-10-10,Calaveras,009,45235,3764,3747,43,3790,75
2021-10-10,Colusa,011,21464,2457,2425,578,3003,18
2021-10-10,Contra Costa,013,1133247,97300,96760,2034,98794,960
2021-10-10,Del Norte,015,27424,3584,3507,47,3554,39
2021-10-10,El Dorado,017,186661,15478,15250,1615,16865,146
2021-10-10,Fresno,019,978130,133209,131434,11930,143364,2035
2021-10-10,Glenn,021,27897,3363,3297,971,4268,26
2021-10-10,Humboldt,023,135768,8644,8554,462,9016,101
2021-10-10,Imperial,025,180216,32418,32167,3030,35197,762
2021-10-10,Inyo,027,18085,1937,1857,36,1893,39
2021-10-10,Kern,029,883053,122093,120552,19813,140365,1573
2021-10-10,Kings,031,150075,30657,30122,1754,31876,308
2021-10-10,Lake,033,64148,6450,6349,124,6473,97
2021-10-10,Lassen,035,31185,6609,6495,311,6806,26
2021-10-10,Los Angeles,037,10098052,1417852,1406034,51821,1457855,26338
2021-10-10,Madera,039,155013,21883,21486,1860,23346,272
2021-10-10,Marin,041,260295,17218,17112,422,17534,242
2021-10-10,Mariposa,043,17540,1121,1074,39,1113,5
2021-10-10,Mendocino,045,87422,7150,7060,422,7482,81
2021-10-10,Merced,047,269075,40203,40036,1643,41679,566
2021-10-10,Modoc,049,8938,497,482,175,657,5
2021-10-10,Mono,051,14174,1637,1596,20,1616,3
2021-10-10,Monterey,053,433212,48085,47228,2686,49914,580
2021-10-10,Napa,055,140530,12692,12641,97,12738,96
2021-10-10,Nevada,057,99092,8772,8689,302,8991,90
2021-10-10,Orange,059,3164182,302124,299787,14346,314133,5499
2021-10-10,Placer,061,380077,35544,35128,3402,38530,404
2021-10-10,Plumas,063,18699,1554,1468,25,1493,6
2021-10-10,Riverside,065,2383286,355281,351248,15981,367229,4973
2021-10-10,Sacramento,067,1510023,153419,152405,4156,156561,2178
2021-10-10,San Benito,069,59416,7184,7180,154,7334,71
2021-10-10,San Bernardino,071,2135413,346486,344423,10760,355183,5551
2021-10-10,San Diego,073,3302833,363412,361038,21353,382391,4113
2021-10-10,San Francisco,075,870044,51806,51216,2191,53407,643
2021-10-10,San Joaquin,077,732212,96914,96084,5159,101243,1681
2021-10-10,San Luis Obispo,079,281455,28746,28343,1165,29508,326
2021-10-10,San Mateo,081,765935,53066,52273,804,53077,569
2021-10-10,Santa Barbara,083,443738,43354,42987,1493,44480,515
2021-10-10,Santa Clara,085,1922200,143867,142768,1188,143956,1881
2021-10-10,Santa Cruz,087,273765,19934,19727,976,20703,217
2021-10-10,Shasta,089,179085,20027,19635,3311,22946,296
2021-10-10,Sierra,091,2930,164,147,17,164,0
2021-10-10,Siskiyou,093,43540,3242,3155,1186,4341,42
2021-10-10,Solano,095,438530,45077,44431,1182,45613,329
2021-10-10,Sonoma,097,501317,40262,40027,498,40525,390
2021-10-10,Stanislaus,099,539301,75350,75403,8422,83825,1118
2021-10-10,Sutter,101,95872,13433,13412,292,13704,165
2021-10-10,Tehama,103,63373,7914,7764,1320,9084,102
2021-10-10,Trinity,105,12862,808,669,199,868,11
2021-10-10,Tulare,107,460477,65269,63930,13597,77527,940
2021-10-10,Tuolumne,109,53932,6679,6580,81,6661,89
2021-10-10,Ventura,111,848112,96482,95829,4179,100008,1160
2021-10-10,Yolo,113,214977,19192,18952,900,19852,247
2021-10-10,Yuba,115,75493,9734,9641,238,9879,69
2021-10-09,Alameda,001,1643700,116878,116253,2633,118886,1356
2021-10-09,Alpine,003,1148,99,102,0,102,0
2021-10-09,Amador,005,37829,5318,5237,55,5292,62
2021-10-09,Butte,007,227075,19776,19277,3657,22934,250
2021-10-09,Calaveras,009,45235,3760,3716,43,3759,75
2021-10-09,Colusa,011,21464,2453,2419,577,2996,18
2021-10-09,Contra Costa,013,1133247,97231,96378,2028,98406,958
2021-10-09,Del Norte,015,27424,3583,3495,47,3542,39
2021-10-09,El Dorado,017,186661,15460,15153,1612,16765,144
2021-10-09,Fresno,019,978130,133077,130508,11912,142420,2018
2021-10-09,Glenn,021,27897,3359,3277,969,4246,26
2021-10-09,Humboldt,023,135768,8630,8448,460,8908,97
2021-10-09,Imperial,025,180216,32384,31989,3028,35017,760
2021-10-09,Inyo,027,18085,1928,1808,36,1844,39
2021-10-09,Kern,029,883053,121952,119795,19786,139581,1559
2021-10-09,Kings,031,150075,30608,29894,1752,31646,308
2021-10-09,Lake,033,64148,6431,6283,123,6406,97
2021-10-09,Lassen,035,31185,6604,6442,310,6752,25
2021-10-09,Los Angeles,037,10098052,1417266,1402810,51784,1454594,26280
2021-10-09,Madera,039,155013,21850,21313,1846,23159,271
2021-10-09,Marin,041,260295,17213,17049,420,17469,242
2021-10-09,Mariposa,043,17540,1114,1042,38,1080,5
2021-10-09,Mendocino,045,87422,7143,7011,421,7432,82
2021-10-09,Merced,047,269075,40160,39784,1643,41427,565
2021-10-09,Modoc,049,8938,495,477,174,651,5
2021-10-09,Mono,051,14174,1634,1577,20,1597,3
2021-10-09,Monterey,053,433212,48073,47168,2683,49851,577
2021-10-09,Napa,055,140530,12688,12586,97,12683,96
2021-10-09,Nevada,057,99092,8761,8613,301,8914,90
2021-10-09,Orange,059,3164182,301943,299089,14327,313416,5457
2021-10-09,Placer,061,380077,35506,34877,3395,38272,393
2021-10-09,Plumas,063,18699,1543,1418,25,1443,6
2021-10-09,Riverside,065,2383286,355029,350082,15965,366047,4965
2021-10-09,Sacramento,067,1510023,153209,151566,4143,155709,2160
2021-10-09,San Benito,069,59416,7176,7123,154,7277,71
2021-10-09,San Bernardino,071,2135413,346298,343452,10756,354208,5556
2021-10-09,San Diego,073,3302833,363107,359909,21348,381257,4111
2021-10-09,San Francisco,075,870044,51758,50960,2184,53144,643
2021-10-09,San Joaquin,077,732212,96848,95606,5154,100760,1669
2021-10-09,San Luis Obispo,079,281455,28729,28197,1163,29360,324
2021-10-09,San Mateo,081,765935,53035,52121,803,52924,569
2021-10-09,Santa Barbara,083,443738,43327,42735,1493,44228,514
2021-10-09,Santa Clara,085,1922200,143743,142298,1182,143480,1873
2021-10-09,Santa Cruz,087,273765,19924,19635,975,20610,217
2021-10-09,Shasta,089,179085,19976,19437,3306,22743,290
2021-10-09,Sierra,091,2930,161,141,17,158,0
2021-10-09,Siskiyou,093,43540,3241,3124,1185,4309,42
2021-10-09,Solano,095,438530,45060,44265,1181,45446,329
2021-10-09,Sonoma,097,501317,40218,39848,498,40346,387
2021-10-09,Stanislaus,099,539301,75260,74899,8411,83310,1114
2021-10-09,Sutter,101,95872,13424,13314,290,13604,165
2021-10-09,Tehama,103,63373,7903,7670,1315,8985,99
2021-10-09,Trinity,105,12862,807,660,199,859,11
2021-10-09,Tulare,107,460477,65161,63398,13576,76974,932
2021-10-09,Tuolumne,109,53932,6660,6521,81,6602,89
2021-10-09,Ventura,111,848112,96428,95542,4176,99718,1158
2021-10-09,Yolo,113,214977,19169,18850,899,19749,247
2021-10-09,Yuba,115,75493,9722,9551,237,9788,69
2021-10-08,Alameda,001,1643700,116796,116253,2629,118882,1356
2021-10-08,Alpine,003,1148,99,102,0,102,0
2021-10-08,Amador,005,37829,5305,5237,55,5292,62
2021-10-08,Butte,007,227075,19747,19277,3653,22930,250
2021-10-08,Calaveras,009,45235,3755,3716,43,3759,75
2021-10-08,Colusa,011,21464,2451,2419,577,2996,18
2021-10-08,Contra Costa,013,1133247,97187,96378,2023,98401,958
2021-10-08,Del Norte,015,27424,3582,3495,47,3542,39
2021-10-08,El Dorado,017,186661,15440,15153,1608,16761,144
2021-10-08,Fresno,019,978130,132881,130508,11891,142399,2018
2021-10-08,Glenn,021,27897,3351,3277,966,4243,26
2021-10-08,Humboldt,023,135768,8619,8448,457,8905,97
2021-10-08,Imperial,025,180216,32355,31989,3024,35013,760
2021-10-08,Inyo,027,18085,1910,1808,36,1844,39
2021-10-08,Kern,029,883053,121815,119795,19744,139539,1559
2021-10-08,Kings,031,150075,30514,29894,1751,31645,308
2021-10-08,Lake,033,64148,6423,6283,123,6406,97
2021-10-08,Lassen,035,31185,6590,6442,307,6749,25
2021-10-08,Los Angeles,037,10098052,1416605,1402810,51752,1454562,26280
2021-10-08,Madera,039,155013,21791,21313,1839,23152,271
2021-10-08,Marin,041,260295,17202,17049,419,17468,242
2021-10-08,Mariposa,043,17540,1107,1042,36,1078,5
2021-10-08,Mendocino,045,87422,7130,7011,421,7432,82
2021-10-08,Merced,047,269075,40128,39784,1640,41424,565
2021-10-08,Modoc,049,8938,493,477,174,651,5
2021-10-08,Mono,051,14174,1631,1577,20,1597,3
2021-10-08,Monterey,053,433212,48046,47168,2681,49849,577
2021-10-08,Napa,055,140530,12672,12586,97,12683,96
2021-10-08,Nevada,057,99092,8749,8613,301,8914,90
2021-10-08,Orange,059,3164182,301796,299089,14307,313396,5457
2021-10-08,Placer,061,380077,35468,34877,3388,38265,393
2021-10-08,Plumas,063,18699,1531,1418,25,1443,6
2021-10-08,Riverside,065,2383286,354760,350082,15954,366036,4965
2021-10-08,Sacramento,067,1510023,153045,151566,4129,155695,2160
2021-10-08,San Benito,069,59416,7172,7123,152,7275,71
2021-10-08,San Bernardino,071,2135413,346089,343452,10748,354200,5556
2021-10-08,San Diego,073,3302833,362781,359909,21329,381238,4111
2021-10-08,San Francisco,075,870044,51711,50960,2177,53137,643
2021-10-08,San Joaquin,077,732212,96780,95606,5148,100754,1669
2021-10-08,San Luis Obispo,079,281455,28702,28197,1162,29359,324
2021-10-08,San Mateo,081,765935,53007,52121,803,52924,569
2021-10-08,Santa Barbara,083,443738,43292,42735,1492,44227,514
2021-10-08,Santa Clara,085,1922200,143630,142298,1177,143475,1873
2021-10-08,Santa Cruz,087,273765,19909,19635,975,20610,217
2021-10-08,Shasta,089,179085,19934,19437,3300,22737,290
2021-10-08,Sierra,091,2930,159,141,15,156,0
2021-10-08,Siskiyou,093,43540,3233,3124,1184,4308,42
2021-10-08,Solano,095,438530,45021,44265,1181,45446,329
2021-10-08,Sonoma,097,501317,40182,39848,498,40346,387
2021-10-08,Stanislaus,099,539301,75191,74899,8402,83301,1114
2021-10-08,Sutter,101,95872,13410,13314,288,13602,165
2021-10-08,Tehama,103,63373,7886,7670,1313,8983,99
2021-10-08,Trinity,105,12862,806,660,199,859,11
2021-10-08,Tulare,107,460477,65043,63398,13544,76942,932
2021-10-08,Tuolumne,109,53932,6637,6521,81,6602,89
2021-10-08,Ventura,111,848112,96377,95542,4170,99712,1158
2021-10-08,Yolo,113,214977,19154,18850,897,19747,247
2021-10-08,Yuba,115,75493,9702,9551,236,9787,69
2021-10-07,Alameda,001,1643700,116676,116253,2628,118881,1356
2021-10-07,Alpine,003,1148,99,102,0,102,0
2021-10-07,Amador,005,37829,5298,5237,55,5292,62
2021-10-07,Butte,007,227075,19699,19277,3642,22919,250
2021-10-07,Calaveras,009,45235,3743,3716,43,3759,75
2021-10-07,Colusa,011,21464,2448,2419,571,2990,18
2021-10-07,Contra Costa,013,1133247,97064,96378,2020,98398,958
2021-10-07,Del Norte,015,27424,3579,3495,47,3542,39
2021-10-07,El Dorado,017,186661,15403,15153,1604,16757,144
2021-10-07,Fresno,019,978130,132607,130508,11867,142375,2018
2021-10-07,Glenn,021,27897,3344,3277,963,4240,26
2021-10-07,Humboldt,023,135768,8593,8448,454,8902,97
2021-10-07,Imperial,025,180216,32284,31989,3011,35000,760
2021-10-07,Inyo,027,18085,1891,1808,36,1844,39
2021-10-07,Kern,029,883053,121583,119795,19680,139475,1559
2021-10-07,Kings,031,150075,30448,29894,1745,31639,308
2021-10-07,Lake,033,64148,6412,6283,123,6406,97
2021-10-07,Lassen,035,31185,6572,6442,305,6747,25
2021-10-07,Los Angeles,037,10098052,1415649,1402810,51707,1454517,26280
2021-10-07,Madera,039,155013,21718,21313,1825,23138,271
2021-10-07,Marin,041,260295,17184,17049,419,17468,242
2021-10-07,Mariposa,043,17540,1099,1042,36,1078,5
2021-10-07,Mendocino,045,87422,7120,7011,417,7428,82
2021-10-07,Merced,047,269075,40061,39784,1623,41407,565
2021-10-07,Modoc,049,8938,490,477,173,650,5
2021-10-07,Mono,051,14174,1623,1577,20,1597,3
2021-10-07,Monterey,053,433212,48021,47168,2672,49840,577
2021-10-07,Napa,055,140530,12657,12586,97,12683,96
2021-10-07,Nevada,057,99092,8721,8613,301,8914,90
2021-10-07,Orange,059,3164182,301570,299089,14293,313382,5457
2021-10-07,Placer,061,380077,35406,34877,3381,38258,393
2021-10-07,Plumas,063,18699,1514,1418,25,1443,6
2021-10-07,Riverside,065,2383286,354428,350082,15942,366024,4965
2021-10-07,Sacramento,067,1510023,152762,151566,4101,155667,2160
2021-10-07,San Benito,069,59416,7156,7123,150,7273,71
2021-10-07,San Bernardino,071,2135413,345815,343452,10740,354192,5556
2021-10-07,San Diego,073,3302833,362386,359909,21308,381217,4111
2021-10-07,San Francisco,075,870044,51640,50960,2174,53134,643
2021-10-07,San Joaquin,077,732212,96626,95606,5140,100746,1669
2021-10-07,San Luis Obispo,079,281455,28651,28197,1160,29357,324
2021-10-07,San Mateo,081,765935,52967,52121,802,52923,569
2021-10-07,Santa Barbara,083,443738,43223,42735,1486,44221,514
2021-10-07,Santa Clara,085,1922200,143480,142298,1171,143469,1873
2021-10-07,Santa Cruz,087,273765,19889,19635,974,20609,217
2021-10-07,Shasta,089,179085,19846,19437,3285,22722,290
2021-10-07,Sierra,091,2930,158,141,15,156,0
2021-10-07,Siskiyou,093,43540,3229,3124,1179,4303,42
2021-10-07,Solano,095,438530,44976,44265,1177,45442,329
2021-10-07,Sonoma,097,501317,40145,39848,496,40344,387
2021-10-07,Stanislaus,099,539301,75029,74899,8377,83276,1114
2021-10-07,Sutter,101,95872,13388,13314,285,13599,165
2021-10-07,Tehama,103,63373,7853,7670,1307,8977,99
2021-10-07,Trinity,105,12862,804,660,199,859,11
2021-10-07,Tulare,107,460477,64878,63398,13508,76906,932
2021-10-07,Tuolumne,109,53932,6615,6521,81,6602,89
2021-10-07,Ventura,111,848112,96304,95542,4167,99709,1158
2021-10-07,Yolo,113,214977,19121,18850,893,19743,247
2021-10-07,Yuba,115,75493,9676,9551,229,9780,69
2021-10-06,Alameda,001,1643700,116539,116058,2622,118680,1353
2021-10-06,Alpine,003,1148,99,102,0,102,0
2021-10-06,Amador,005,37829,5295,5205,55,5260,62
2021-10-06,Butte,007,227075,19637,19208,3635,22843,247
2021-10-06,Calaveras,009,45235,3734,3669,43,3712,75
2021-10-06,Colusa,011,21464,2445,2414,564,2978,18
2021-10-06,Contra Costa,013,1133247,96940,96184,2016,98200,953
2021-10-06,Del Norte,015,27424,3576,3490,44,3534,39
2021-10-06,El Dorado,017,186661,15377,15078,1601,16679,140
2021-10-06,Fresno,019,978130,132317,130074,11842,141916,2008
2021-10-06,Glenn,021,27897,3335,3270,961,4231,26
2021-10-06,Humboldt,023,135768,8578,8416,448,8864,94
2021-10-06,Imperial,025,180216,32231,31930,3001,34931,760
2021-10-06,Inyo,027,18085,1876,1806,36,1842,39
2021-10-06,Kern,029,883053,121326,119491,19589,139080,1552
2021-10-06,Kings,031,150075,30382,29785,1737,31522,308
2021-10-06,Lake,033,64148,6398,6271,123,6394,97
2021-10-06,Lassen,035,31185,6556,6429,304,6733,25
2021-10-06,Los Angeles,037,10098052,1414693,1401675,51658,1453333,26252
2021-10-06,Madera,039,155013,21663,21230,1815,23045,269
2021-10-06,Marin,041,260295,17175,17042,416,17458,242
2021-10-06,Mariposa,043,17540,1092,1036,36,1072,5
2021-10-06,Mendocino,045,87422,7111,6986,415,7401,81
2021-10-06,Merced,047,269075,39986,39666,1611,41277,563
2021-10-06,Modoc,049,8938,490,477,171,648,5
2021-10-06,Mono,051,14174,1611,1568,20,1588,3
2021-10-06,Monterey,053,433212,47988,47136,2667,49803,577
2021-10-06,Napa,055,140530,12633,12552,96,12648,96
2021-10-06,Nevada,057,99092,8705,8582,300,8882,90
2021-10-06,Orange,059,3164182,301331,298785,14281,313066,5448
2021-10-06,Placer,061,380077,35355,34764,3375,38139,390
2021-10-06,Plumas,063,18699,1491,1383,25,1408,6
2021-10-06,Riverside,065,2383286,354072,349645,15921,365566,4953
2021-10-06,Sacramento,067,1510023,152509,151164,4070,155234,2141
2021-10-06,San Benito,069,59416,7141,7108,150,7258,69
2021-10-06,San Bernardino,071,2135413,345523,343022,10733,353755,5551
2021-10-06,San Diego,073,3302833,361894,359564,21282,380846,4104
2021-10-06,San Francisco,075,870044,51576,50894,2171,53065,641
2021-10-06,San Joaquin,077,732212,96492,95418,5128,100546,1658
2021-10-06,San Luis Obispo,079,281455,28602,28170,1154,29324,323
2021-10-06,San Mateo,081,765935,52917,52056,797,52853,569
2021-10-06,Santa Barbara,083,443738,43140,42687,1484,44171,513
2021-10-06,Santa Clara,085,1922200,143329,142124,1166,143290,1872
2021-10-06,Santa Cruz,087,273765,19860,19604,972,20576,217
2021-10-06,Shasta,089,179085,19771,19325,3272,22597,287
2021-10-06,Sierra,091,2930,156,138,15,153,0
2021-10-06,Siskiyou,093,43540,3219,3116,1172,4288,42
2021-10-06,Solano,095,438530,44942,44185,1176,45361,328
2021-10-06,Sonoma,097,501317,40095,39787,495,40282,383
2021-10-06,Stanislaus,099,539301,74887,74699,8364,83063,1114
2021-10-06,Sutter,101,95872,13367,13284,283,13567,164
2021-10-06,Tehama,103,63373,7817,7629,1299,8928,99
2021-10-06,Trinity,105,12862,801,656,199,855,11
2021-10-06,Tulare,107,460477,64698,63198,13452,76650,926
2021-10-06,Tuolumne,109,53932,6588,6486,81,6567,89
2021-10-06,Ventura,111,848112,96213,95449,4159,99608,1158
2021-10-06,Yolo,113,214977,19088,18815,890,19705,247
2021-10-06,Yuba,115,75493,9652,9520,228,9748,69
2021-10-05,Alameda,001,1643700,116395,115968,2617,118585,1350
2021-10-05,Alpine,003,1148,99,102,0,102,0
2021-10-05,Amador,005,37829,5274,5194,54,5248,61
2021-10-05,Butte,007,227075,19588,19137,3620,22757,246
2021-10-05,Calaveras,009,45235,3718,3657,43,3700,73
2021-10-05,Colusa,011,21464,2438,2414,563,2977,18
2021-10-05,Contra Costa,013,1133247,96823,96108,2011,98119,941
2021-10-05,Del Norte,015,27424,3574,3485,43,3528,39
2021-10-05,El Dorado,017,186661,15338,15052,1598,16650,140
2021-10-05,Fresno,019,978130,131978,129957,11806,141763,1987
2021-10-05,Glenn,021,27897,3324,3270,956,4226,26
2021-10-05,Humboldt,023,135768,8547,8398,444,8842,94
2021-10-05,Imperial,025,180216,32184,31909,2996,34905,759
2021-10-05,Inyo,027,18085,1859,1800,36,1836,39
2021-10-05,Kern,029,883053,121062,119260,19488,138748,1540
2021-10-05,Kings,031,150075,30307,29749,1732,31481,301
2021-10-05,Lake,033,64148,6377,6264,122,6386,97
2021-10-05,Lassen,035,31185,6537,6417,302,6719,25
2021-10-05,Los Angeles,037,10098052,1413550,1400300,51605,1451905,26223
2021-10-05,Madera,039,155013,21605,21183,1803,22986,269
2021-10-05,Marin,041,260295,17163,17024,416,17440,242
2021-10-05,Mariposa,043,17540,1073,1033,33,1066,5
2021-10-05,Mendocino,045,87422,7095,6972,408,7380,79
2021-10-05,Merced,047,269075,39920,39608,1603,41211,562
2021-10-05,Modoc,049,8938,486,475,170,645,5
2021-10-05,Mono,051,14174,1603,1565,20,1585,3
2021-10-05,Monterey,053,433212,47971,47087,2657,49744,573
2021-10-05,Napa,055,140530,12609,12533,96,12629,96
2021-10-05,Nevada,057,99092,8675,8576,300,8876,90
2021-10-05,Orange,059,3164182,301054,298589,14249,312838,5441
2021-10-05,Placer,061,380077,35275,34728,3368,38096,382
2021-10-05,Plumas,063,18699,1466,1357,25,1382,6
2021-10-05,Riverside,065,2383286,353713,349365,15906,365271,4942
2021-10-05,Sacramento,067,1510023,152235,151111,4042,155153,2126
2021-10-05,San Benito,069,59416,7123,7103,148,7251,69
2021-10-05,San Bernardino,071,2135413,345197,342711,10726,353437,5557
2021-10-05,San Diego,073,3302833,361319,359194,21255,380449,4092
2021-10-05,San Francisco,075,870044,51477,50826,2168,52994,641
2021-10-05,San Joaquin,077,732212,96339,95276,5102,100378,1651
2021-10-05,San Luis Obispo,079,281455,28558,28113,1152,29265,324
2021-10-05,San Mateo,081,765935,52870,52008,797,52805,569
2021-10-05,Santa Barbara,083,443738,43062,42595,1480,44075,511
2021-10-05,Santa Clara,085,1922200,143167,141971,1159,143130,1873
2021-10-05,Santa Cruz,087,273765,19818,19582,972,20554,216
2021-10-05,Shasta,089,179085,19697,19285,3259,22544,286
2021-10-05,Sierra,091,2930,152,136,15,151,0
2021-10-05,Siskiyou,093,43540,3205,3107,1172,4279,42
2021-10-05,Solano,095,438530,44871,44149,1175,45324,325
2021-10-05,Sonoma,097,501317,40040,39756,490,40246,383
2021-10-05,Stanislaus,099,539301,74725,74599,8347,82946,1114
2021-10-05,Sutter,101,95872,13339,13270,282,13552,164
2021-10-05,Tehama,103,63373,7788,7607,1290,8897,98
2021-10-05,Trinity,105,12862,798,655,199,854,11
2021-10-05,Tulare,107,460477,64490,63093,13399,76492,920
2021-10-05,Tuolumne,109,53932,6572,6473,80,6553,89
2021-10-05,Ventura,111,848112,96107,95351,4158,99509,1155
2021-10-05,Yolo,113,214977,19052,18782,884,19666,245
2021-10-05,Yuba,115,75493,9620,9504,225,9729,69
2021-10-04,Alameda,001,1643700,116234,115845,2614,118459,1347
2021-10-04,Alpine,003,1148,99,102,0,102,0
2021-10-04,Amador,005,37829,5264,5163,53,5216,61
2021-10-04,Butte,007,227075,19510,19081,3609,22690,245
2021-10-04,Calaveras,009,45235,3709,3641,43,3684,73
2021-10-04,Colusa,011,21464,2437,2414,561,2975,18
2021-10-04,Contra Costa,013,1133247,96681,95958,2006,97964,937
2021-10-04,Del Norte,015,27424,3572,3485,39,3524,39
2021-10-04,El Dorado,017,186661,15292,15031,1591,16622,138
2021-10-04,Fresno,019,978130,131667,129665,11777,141442,1978
2021-10-04,Glenn,021,27897,3317,3270,953,4223,26
2021-10-04,Humboldt,023,135768,8515,8355,437,8792,94
2021-10-04,Imperial,025,180216,32135,31866,2989,34855,757
2021-10-04,Inyo,027,18085,1847,1792,34,1826,39
2021-10-04,Kern,029,883053,120771,118984,19368,138352,1531
2021-10-04,Kings,031,150075,30214,29702,1729,31431,303
2021-10-04,Lake,033,64148,6364,6248,122,6370,97
2021-10-04,Lassen,035,31185,6520,6405,302,6707,25
2021-10-04,Los Angeles,037,10098052,1412430,1399604,51549,1451153,26186
2021-10-04,Madera,039,155013,21541,21126,1791,22917,266
2021-10-04,Marin,041,260295,17147,17008,415,17423,242
2021-10-04,Mariposa,043,17540,1061,1024,33,1057,5
2021-10-04,Mendocino,045,87422,7077,6947,405,7352,79
2021-10-04,Merced,047,269075,39803,39565,1587,41152,558
2021-10-04,Modoc,049,8938,483,473,170,643,5
2021-10-04,Mono,051,14174,1595,1561,20,1581,3
2021-10-04,Monterey,053,433212,47950,47058,2650,49708,571
2021-10-04,Napa,055,140530,12586,12506,96,12602,96
2021-10-04,Nevada,057,99092,8655,8563,300,8863,90
2021-10-04,Orange,059,3164182,300758,298165,14217,312382,5438
2021-10-04,Placer,061,380077,35193,34630,3341,37971,379
2021-10-04,Plumas,063,18699,1444,1329,25,1354,6
2021-10-04,Riverside,065,2383286,353333,348828,15896,364724,4923
2021-10-04,Sacramento,067,1510023,151911,150887,4015,154902,2115
2021-10-04,San Benito,069,59416,7110,7099,148,7247,69
2021-10-04,San Bernardino,071,2135413,344836,342418,10715,353133,5551
2021-10-04,San Diego,073,3302833,360753,358525,21224,379749,4090
2021-10-04,San Francisco,075,870044,51382,50798,2164,52962,638
2021-10-04,San Joaquin,077,732212,96142,95198,5082,100280,1649
2021-10-04,San Luis Obispo,079,281455,28513,28090,1146,29236,323
2021-10-04,San Mateo,081,765935,52810,51958,796,52754,569
2021-10-04,Santa Barbara,083,443738,42977,42585,1479,44064,511
2021-10-04,Santa Clara,085,1922200,143020,141840,1153,142993,1869
2021-10-04,Santa Cruz,087,273765,19789,19559,971,20530,216
2021-10-04,Shasta,089,179085,19590,19170,3245,22415,279
2021-10-04,Sierra,091,2930,145,136,14,150,0
2021-10-04,Siskiyou,093,43540,3196,3103,1157,4260,42
2021-10-04,Solano,095,438530,44812,44092,1171,45263,322
2021-10-04,Sonoma,097,501317,39974,39720,490,40210,381
2021-10-04,Stanislaus,099,539301,74574,74444,8328,82772,1106
2021-10-04,Sutter,101,95872,13310,13261,281,13542,164
2021-10-04,Tehama,103,63373,7747,7585,1284,8869,95
2021-10-04,Trinity,105,12862,797,649,198,847,11
2021-10-04,Tulare,107,460477,64304,62957,13331,76288,920
2021-10-04,Tuolumne,109,53932,6546,6442,80,6522,89
2021-10-04,Ventura,111,848112,96015,95170,4152,99322,1153
2021-10-04,Yolo,113,214977,19008,18761,880,19641,242
2021-10-04,Yuba,115,75493,9581,9481,223,9704,68
2021-10-03,Alameda,001,1643700,116091,115751,2604,118355,1349
2021-10-03,Alpine,003,1148,99,102,0,102,0
2021-10-03,Amador,005,37829,5246,5160,51,5211,61
2021-10-03,Butte,007,227075,19437,19066,3590,22656,245
2021-10-03,Calaveras,009,45235,3692,3632,43,3675,73
2021-10-03,Colusa,011,21464,2435,2413,558,2971,18
2021-10-03,Contra Costa,013,1133247,96548,95890,1999,97889,937
2021-10-03,Del Norte,015,27424,3566,3483,38,3521,39
2021-10-03,El Dorado,017,186661,15233,15014,1584,16598,139
2021-10-03,Fresno,019,978130,131286,129365,11736,141101,1978
2021-10-03,Glenn,021,27897,3310,3266,945,4211,26
2021-10-03,Humboldt,023,135768,8469,8352,433,8785,94
2021-10-03,Imperial,025,180216,32068,31844,2981,34825,757
2021-10-03,Inyo,027,18085,1826,1788,34,1822,39
2021-10-03,Kern,029,883053,120466,118851,19246,138097,1535
2021-10-03,Kings,031,150075,30115,29623,1722,31345,300
2021-10-03,Lake,033,64148,6338,6239,122,6361,97
2021-10-03,Lassen,035,31185,6498,6400,300,6700,25
2021-10-03,Los Angeles,037,10098052,1411170,1398790,51495,1450285,26179
2021-10-03,Madera,039,155013,21469,21066,1781,22847,266
2021-10-03,Marin,041,260295,17124,16995,410,17405,242
2021-10-03,Mariposa,043,17540,1054,1011,33,1044,5
2021-10-03,Mendocino,045,87422,7057,6939,397,7336,79
2021-10-03,Merced,047,269075,39696,39516,1567,41083,558
2021-10-03,Modoc,049,8938,482,472,169,641,5
2021-10-03,Mono,051,14174,1591,1554,20,1574,3
2021-10-03,Monterey,053,433212,47925,47049,2639,49688,571
2021-10-03,Napa,055,140530,12557,12489,94,12583,96
2021-10-03,Nevada,057,99092,8620,8545,300,8845,90
2021-10-03,Orange,059,3164182,300476,298027,14197,312224,5447
2021-10-03,Placer,061,380077,35055,34596,3325,37921,379
2021-10-03,Plumas,063,18699,1416,1328,25,1353,6
2021-10-03,Riverside,065,2383286,352902,348593,15876,364469,4924
2021-10-03,Sacramento,067,1510023,151622,150664,3986,154650,2120
2021-10-03,San Benito,069,59416,7101,7095,148,7243,69
2021-10-03,San Bernardino,071,2135413,344418,342302,10708,353010,5555
2021-10-03,San Diego,073,3302833,360173,358153,21192,379345,4081
2021-10-03,San Francisco,075,870044,51297,50733,2161,52894,638
2021-10-03,San Joaquin,077,732212,95954,95133,5074,100207,1649
2021-10-03,San Luis Obispo,079,281455,28447,28065,1141,29206,325
2021-10-03,San Mateo,081,765935,52743,51923,795,52718,569
2021-10-03,Santa Barbara,083,443738,42881,42550,1471,44021,511
2021-10-03,Santa Clara,085,1922200,142849,141737,1146,142883,1869
2021-10-03,Santa Cruz,087,273765,19749,19548,969,20517,216
2021-10-03,Shasta,089,179085,19485,19132,3217,22349,279
2021-10-03,Sierra,091,2930,142,136,14,150,0
2021-10-03,Siskiyou,093,43540,3183,3096,1147,4243,42
2021-10-03,Solano,095,438530,44749,44051,1168,45219,322
2021-10-03,Sonoma,097,501317,39908,39679,490,40169,381
2021-10-03,Stanislaus,099,539301,74386,74366,8310,82676,1106
2021-10-03,Sutter,101,95872,13295,13248,277,13525,164
2021-10-03,Tehama,103,63373,7704,7564,1279,8843,94
2021-10-03,Trinity,105,12862,793,647,196,843,11
2021-10-03,Tulare,107,460477,64101,62860,13259,76119,924
2021-10-03,Tuolumne,109,53932,6517,6430,78,6508,89
2021-10-03,Ventura,111,848112,95910,95108,4149,99257,1153
2021-10-03,Yolo,113,214977,18978,18720,874,19594,242
2021-10-03,Yuba,115,75493,9564,9462,222,9684,68
2021-10-02,Alameda,001,1643700,115983,115185,2599,117784,1343
2021-10-02,Alpine,003,1148,99,102,0,102,0
2021-10-02,Amador,005,37829,5237,5105,51,5156,61
2021-10-02,Butte,007,227075,19407,18911,3582,22493,243
2021-10-02,Calaveras,009,45235,3685,3585,43,3628,72
2021-10-02,Colusa,011,21464,2434,2403,556,2959,18
2021-10-02,Contra Costa,013,1133247,96477,95369,1995,97364,933
2021-10-02,Del Norte,015,27424,3561,3468,38,3506,39
2021-10-02,El Dorado,017,186661,15207,14887,1583,16470,136
2021-10-02,Fresno,019,978130,131115,128450,11723,140173,1964
2021-10-02,Glenn,021,27897,3305,3234,945,4179,26
2021-10-02,Humboldt,023,135768,8451,8244,433,8677,94
2021-10-02,Imperial,025,180216,32033,31674,2978,34652,757
2021-10-02,Inyo,027,18085,1817,1746,34,1780,39
2021-10-02,Kern,029,883053,120333,117962,19165,137127,1524
2021-10-02,Kings,031,150075,30066,29339,1718,31057,301
2021-10-02,Lake,033,64148,6329,6191,122,6313,97
2021-10-02,Lassen,035,31185,6493,6360,300,6660,25
2021-10-02,Los Angeles,037,10098052,1410558,1395070,51459,1446529,26126
2021-10-02,Madera,039,155013,21444,20931,1772,22703,266
2021-10-02,Marin,041,260295,17119,16936,407,17343,242
2021-10-02,Mariposa,043,17540,1052,967,33,1000,5
2021-10-02,Mendocino,045,87422,7047,6869,397,7266,78
2021-10-02,Merced,047,269075,39669,39196,1563,40759,552
2021-10-02,Modoc,049,8938,480,468,169,637,5
2021-10-02,Mono,051,14174,1589,1540,20,1560,3
2021-10-02,Monterey,053,433212,47870,46964,2638,49602,571
2021-10-02,Napa,055,140530,12546,12433,94,12527,96
2021-10-02,Nevada,057,99092,8609,8474,299,8773,87
2021-10-02,Orange,059,3164182,300311,297307,14177,311484,5435
2021-10-02,Placer,061,380077,34989,34377,3316,37693,381
2021-10-02,Plumas,063,18699,1405,1298,25,1323,6
2021-10-02,Riverside,065,2383286,352661,347227,15865,363092,4895
2021-10-02,Sacramento,067,1510023,151449,149897,3978,153875,2099
2021-10-02,San Benito,069,59416,7094,7055,148,7203,69
2021-10-02,San Bernardino,071,2135413,344231,341212,10656,351868,5540
2021-10-02,San Diego,073,3302833,359856,356454,21170,377624,4078
2021-10-02,San Francisco,075,870044,51248,50393,2156,52549,634
2021-10-02,San Joaquin,077,732212,95889,94599,5068,99667,1646
2021-10-02,San Luis Obispo,079,281455,28423,27915,1141,29056,323
2021-10-02,San Mateo,081,765935,52702,51767,791,52558,573
2021-10-02,Santa Barbara,083,443738,42841,42423,1471,43894,508
2021-10-02,Santa Clara,085,1922200,142735,141231,1142,142373,1862
2021-10-02,Santa Cruz,087,273765,19732,19461,968,20429,214
2021-10-02,Shasta,089,179085,19439,18912,3211,22123,270
2021-10-02,Sierra,091,2930,141,131,14,145,0
2021-10-02,Siskiyou,093,43540,3182,3053,1144,4197,42
2021-10-02,Solano,095,438530,44704,43800,1167,44967,321
2021-10-02,Sonoma,097,501317,39874,39497,489,39986,382
2021-10-02,Stanislaus,099,539301,74300,73859,8297,82156,1099
2021-10-02,Sutter,101,95872,13286,13160,276,13436,160
2021-10-02,Tehama,103,63373,7689,7453,1279,8732,93
2021-10-02,Trinity,105,12862,790,625,196,821,10
2021-10-02,Tulare,107,460477,64025,62247,13233,75480,908
2021-10-02,Tuolumne,109,53932,6503,6369,78,6447,89
2021-10-02,Ventura,111,848112,95838,94854,4144,98998,1148
2021-10-02,Yolo,113,214977,18951,18640,872,19512,242
2021-10-02,Yuba,115,75493,9545,9370,221,9591,66
2021-10-01,Alameda,001,1643700,115906,115185,2593,117778,1343
2021-10-01,Alpine,003,1148,99,102,0,102,0
2021-10-01,Amador,005,37829,5217,5105,51,5156,61
2021-10-01,Butte,007,227075,19366,18911,3575,22486,243
2021-10-01,Calaveras,009,45235,3675,3585,43,3628,72
2021-10-01,Colusa,011,21464,2432,2403,556,2959,18
2021-10-01,Contra Costa,013,1133247,96381,95369,1991,97360,933
2021-10-01,Del Norte,015,27424,3558,3468,37,3505,39
2021-10-01,El Dorado,017,186661,15190,14887,1579,16466,136
2021-10-01,Fresno,019,978130,130927,128450,11713,140163,1964
2021-10-01,Glenn,021,27897,3303,3234,944,4178,26
2021-10-01,Humboldt,023,135768,8434,8244,433,8677,94
2021-10-01,Imperial,025,180216,32014,31674,2969,34643,757
2021-10-01,Inyo,027,18085,1808,1746,34,1780,39
2021-10-01,Kern,029,883053,120180,117962,19109,137071,1524
2021-10-01,Kings,031,150075,30032,29339,1713,31052,301
2021-10-01,Lake,033,64148,6319,6191,122,6313,97
2021-10-01,Lassen,035,31185,6482,6360,299,6659,25
2021-10-01,Los Angeles,037,10098052,1409793,1395070,51416,1446486,26126
2021-10-01,Madera,039,155013,21394,20931,1763,22694,266
2021-10-01,Marin,041,260295,17104,16936,406,17342,242
2021-10-01,Mariposa,043,17540,1045,967,33,1000,5
2021-10-01,Mendocino,045,87422,7035,6869,397,7266,78
2021-10-01,Merced,047,269075,39625,39196,1555,40751,552
2021-10-01,Modoc,049,8938,479,468,169,637,5
2021-10-01,Mono,051,14174,1586,1540,20,1560,3
2021-10-01,Monterey,053,433212,47849,46964,2635,49599,571
2021-10-01,Napa,055,140530,12536,12433,93,12526,96
2021-10-01,Nevada,057,99092,8595,8474,298,8772,87
2021-10-01,Orange,059,3164182,300127,297307,14157,311464,5435
2021-10-01,Placer,061,380077,34955,34377,3312,37689,381
2021-10-01,Plumas,063,18699,1396,1298,25,1323,6
2021-10-01,Riverside,065,2383286,352368,347227,15858,363085,4895
2021-10-01,Sacramento,067,1510023,151296,149897,3968,153865,2099
2021-10-01,San Benito,069,59416,7092,7055,146,7201,69
2021-10-01,San Bernardino,071,2135413,344031,341212,10653,351865,5540
2021-10-01,San Diego,073,3302833,359496,356454,21149,377603,4078
2021-10-01,San Francisco,075,870044,51207,50393,2155,52548,634
2021-10-01,San Joaquin,077,732212,95819,94599,5064,99663,1646
2021-10-01,San Luis Obispo,079,281455,28399,27915,1138,29053,323
2021-10-01,San Mateo,081,765935,52662,51767,788,52555,573
2021-10-01,Santa Barbara,083,443738,42805,42423,1471,43894,508
2021-10-01,Santa Clara,085,1922200,142642,141231,1137,142368,1862
2021-10-01,Santa Cruz,087,273765,19712,19461,967,20428,214
2021-10-01,Shasta,089,179085,19385,18912,3204,22116,270
2021-10-01,Sierra,091,2930,141,131,14,145,0
2021-10-01,Siskiyou,093,43540,3181,3053,1141,4194,42
2021-10-01,Solano,095,438530,44651,43800,1161,44961,321
2021-10-01,Sonoma,097,501317,39842,39497,488,39985,382
2021-10-01,Stanislaus,099,539301,74216,73859,8286,82145,1099
2021-10-01,Sutter,101,95872,13270,13160,274,13434,160
2021-10-01,Tehama,103,63373,7677,7453,1277,8730,93
2021-10-01,Trinity,105,12862,788,625,196,821,10
2021-10-01,Tulare,107,460477,63922,62247,13198,75445,908
2021-10-01,Tuolumne,109,53932,6486,6369,78,6447,89
2021-10-01,Ventura,111,848112,95771,94854,4139,98993,1148
2021-10-01,Yolo,113,214977,18928,18640,870,19510,242
2021-10-01,Yuba,115,75493,9523,9370,221,9591,66
2021-09-30,Alameda,001,1643700,115761,115185,2589,117774,1343
2021-09-30,Alpine,003,1148,99,102,0,102,0
2021-09-30,Amador,005,37829,5205,5105,51,5156,61
2021-09-30,Butte,007,227075,19317,18911,3566,22477,243
2021-09-30,Calaveras,009,45235,3661,3585,43,3628,72
2021-09-30,Colusa,011,21464,2429,2403,555,2958,18
2021-09-30,Contra Costa,013,1133247,96276,95369,1986,97355,933
2021-09-30,Del Norte,015,27424,3554,3468,34,3502,39
2021-09-30,El Dorado,017,186661,15164,14887,1571,16458,136
2021-09-30,Fresno,019,978130,130652,128450,11679,140129,1964
2021-09-30,Glenn,021,27897,3293,3234,941,4175,26
2021-09-30,Humboldt,023,135768,8402,8244,427,8671,94
2021-09-30,Imperial,025,180216,31962,31674,2967,34641,757
2021-09-30,Inyo,027,18085,1798,1746,34,1780,39
2021-09-30,Kern,029,883053,119936,117962,19028,136990,1524
2021-09-30,Kings,031,150075,29942,29339,1709,31048,301
2021-09-30,Lake,033,64148,6301,6191,122,6313,97
2021-09-30,Lassen,035,31185,6468,6360,299,6659,25
2021-09-30,Los Angeles,037,10098052,1408584,1395070,51357,1446427,26126
2021-09-30,Madera,039,155013,21311,20931,1748,22679,266
2021-09-30,Marin,041,260295,17084,16936,405,17341,242
2021-09-30,Mariposa,043,17540,1023,967,33,1000,5
2021-09-30,Mendocino,045,87422,7026,6869,388,7257,78
2021-09-30,Merced,047,269075,39529,39196,1550,40746,552
2021-09-30,Modoc,049,8938,479,468,168,636,5
2021-09-30,Mono,051,14174,1578,1540,20,1560,3
2021-09-30,Monterey,053,433212,47819,46964,2624,49588,571
2021-09-30,Napa,055,140530,12516,12433,93,12526,96
2021-09-30,Nevada,057,99092,8578,8474,297,8771,87
2021-09-30,Orange,059,3164182,299855,297307,14119,311426,5435
2021-09-30,Placer,061,380077,34901,34377,3292,37669,381
2021-09-30,Plumas,063,18699,1378,1298,25,1323,6
2021-09-30,Riverside,065,2383286,351934,347227,15837,363064,4895
2021-09-30,Sacramento,067,1510023,151035,149897,3942,153839,2099
2021-09-30,San Benito,069,59416,7086,7055,146,7201,69
2021-09-30,San Bernardino,071,2135413,343718,341212,10639,351851,5540
2021-09-30,San Diego,073,3302833,359015,356454,21123,377577,4078
2021-09-30,San Francisco,075,870044,51130,50393,2151,52544,634
2021-09-30,San Joaquin,077,732212,95687,94599,5056,99655,1646
2021-09-30,San Luis Obispo,079,281455,28351,27915,1134,29049,323
2021-09-30,San Mateo,081,765935,52613,51767,785,52552,573
2021-09-30,Santa Barbara,083,443738,42748,42423,1470,43893,508
2021-09-30,Santa Clara,085,1922200,142493,141231,1134,142365,1862
2021-09-30,Santa Cruz,087,273765,19672,19461,966,20427,214
2021-09-30,Shasta,089,179085,19323,18912,3189,22101,270
2021-09-30,Sierra,091,2930,140,131,14,145,0
2021-09-30,Siskiyou,093,43540,3173,3053,1136,4189,42
2021-09-30,Solano,095,438530,44597,43800,1158,44958,321
2021-09-30,Sonoma,097,501317,39793,39497,488,39985,382
2021-09-30,Stanislaus,099,539301,74056,73859,8267,82126,1099
2021-09-30,Sutter,101,95872,13249,13160,274,13434,160
2021-09-30,Tehama,103,63373,7640,7453,1265,8718,93
2021-09-30,Trinity,105,12862,784,625,196,821,10
2021-09-30,Tulare,107,460477,63746,62247,13141,75388,908
2021-09-30,Tuolumne,109,53932,6463,6369,78,6447,89
2021-09-30,Ventura,111,848112,95666,94854,4132,98986,1148
2021-09-30,Yolo,113,214977,18888,18640,867,19507,242
2021-09-30,Yuba,115,75493,9500,9370,220,9590,66
2021-09-29,Alameda,001,1643700,115615,114998,2586,117584,1339
2021-09-29,Alpine,003,1148,99,101,0,101,0
2021-09-29,Amador,005,37829,5183,5058,51,5109,61
2021-09-29,Butte,007,227075,19263,18835,3559,22394,242
2021-09-29,Calaveras,009,45235,3644,3553,42,3595,72
2021-09-29,Colusa,011,21464,2427,2401,555,2956,18
2021-09-29,Contra Costa,013,1133247,96162,95213,1978,97191,929
2021-09-29,Del Norte,015,27424,3548,3467,34,3501,39
2021-09-29,El Dorado,017,186661,15130,14834,1564,16398,136
2021-09-29,Fresno,019,978130,130352,128068,11658,139726,1957
2021-09-29,Glenn,021,27897,3288,3213,939,4152,26
2021-09-29,Humboldt,023,135768,8379,8203,426,8629,94
2021-09-29,Imperial,025,180216,31897,31600,2962,34562,757
2021-09-29,Inyo,027,18085,1788,1740,33,1773,39
2021-09-29,Kern,029,883053,119701,117605,18952,136557,1513
2021-09-29,Kings,031,150075,29860,29195,1694,30889,299
2021-09-29,Lake,033,64148,6281,6164,122,6286,97
2021-09-29,Lassen,035,31185,6454,6347,299,6646,25
2021-09-29,Los Angeles,037,10098052,1407363,1393617,51289,1444906,26098
2021-09-29,Madera,039,155013,21267,20818,1732,22550,266
2021-09-29,Marin,041,260295,17066,16921,403,17324,242
2021-09-29,Mariposa,043,17540,1008,963,33,996,5
2021-09-29,Mendocino,045,87422,7014,6821,380,7201,78
2021-09-29,Merced,047,269075,39436,39026,1539,40565,552
2021-09-29,Modoc,049,8938,477,468,168,636,5
2021-09-29,Mono,051,14174,1576,1527,20,1547,3
2021-09-29,Monterey,053,433212,47781,46917,2610,49527,571
2021-09-29,Napa,055,140530,12496,12416,90,12506,96
2021-09-29,Nevada,057,99092,8565,8434,297,8731,87
2021-09-29,Orange,059,3164182,299586,296936,14084,311020,5429
2021-09-29,Placer,061,380077,34837,34271,3270,37541,379
2021-09-29,Plumas,063,18699,1359,1289,25,1314,6
2021-09-29,Riverside,065,2383286,351499,346558,15824,362382,4886
2021-09-29,Sacramento,067,1510023,150784,149686,3932,153618,2099
2021-09-29,San Benito,069,59416,7075,7039,146,7185,69
2021-09-29,San Bernardino,071,2135413,343398,340672,10624,351296,5539
2021-09-29,San Diego,073,3302833,358528,355899,21093,376992,4066
2021-09-29,San Francisco,075,870044,51046,50286,2147,52433,629
2021-09-29,San Joaquin,077,732212,95529,94356,5034,99390,1645
2021-09-29,San Luis Obispo,079,281455,28305,27800,1128,28928,323
2021-09-29,San Mateo,081,765935,52553,51673,783,52456,573
2021-09-29,Santa Barbara,083,443738,42676,42328,1467,43795,507
2021-09-29,Santa Clara,085,1922200,142356,141036,1129,142165,1861
2021-09-29,Santa Cruz,087,273765,19654,19425,965,20390,214
2021-09-29,Shasta,089,179085,19257,18805,3178,21983,271
2021-09-29,Sierra,091,2930,136,130,14,144,0
2021-09-29,Siskiyou,093,43540,3160,3043,1129,4172,42
2021-09-29,Solano,095,438530,44541,43724,1151,44875,321
2021-09-29,Sonoma,097,501317,39732,39426,486,39912,370
2021-09-29,Stanislaus,099,539301,73925,73634,8256,81890,1096
2021-09-29,Sutter,101,95872,13222,13135,271,13406,155
2021-09-29,Tehama,103,63373,7610,7409,1250,8659,88
2021-09-29,Trinity,105,12862,780,616,196,812,10
2021-09-29,Tulare,107,460477,63571,62046,13082,75128,908
2021-09-29,Tuolumne,109,53932,6446,6336,78,6414,89
2021-09-29,Ventura,111,848112,95576,94753,4128,98881,1144
2021-09-29,Yolo,113,214977,18854,18587,863,19450,239
2021-09-29,Yuba,115,75493,9469,9351,216,9567,66
2021-09-28,Alameda,001,1643700,115457,114869,2580,117449,1333
2021-09-28,Alpine,003,1148,99,101,0,101,0
2021-09-28,Amador,005,37829,5161,5049,51,5100,61
2021-09-28,Butte,007,227075,19214,18764,3544,22308,241
2021-09-28,Calaveras,009,45235,3624,3530,42,3572,72
2021-09-28,Colusa,011,21464,2424,2399,553,2952,18
2021-09-28,Contra Costa,013,1133247,96021,95115,1973,97088,929
2021-09-28,Del Norte,015,27424,3545,3462,34,3496,39
2021-09-28,El Dorado,017,186661,15084,14793,1560,16353,133
2021-09-28,Fresno,019,978130,130007,127877,11624,139501,1948
2021-09-28,Glenn,021,27897,3283,3205,938,4143,26
2021-09-28,Humboldt,023,135768,8339,8159,423,8582,91
2021-09-28,Imperial,025,180216,31852,31543,2958,34501,757
2021-09-28,Inyo,027,18085,1774,1708,32,1740,39
2021-09-28,Kern,029,883053,119432,117420,18857,136277,1506
2021-09-28,Kings,031,150075,29758,29141,1686,30827,295
2021-09-28,Lake,033,64148,6266,6155,122,6277,95
2021-09-28,Lassen,035,31185,6448,6340,295,6635,25
2021-09-28,Los Angeles,037,10098052,1406074,1392445,51223,1443668,26068
2021-09-28,Madera,039,155013,21213,20764,1717,22481,266
2021-09-28,Marin,041,260295,17047,16887,401,17288,242
2021-09-28,Mariposa,043,17540,1003,952,33,985,5
2021-09-28,Mendocino,045,87422,6992,6804,378,7182,78
2021-09-28,Merced,047,269075,39350,38953,1526,40479,551
2021-09-28,Modoc,049,8938,476,467,168,635,5
2021-09-28,Mono,051,14174,1566,1527,20,1547,3
2021-09-28,Monterey,053,433212,47744,46859,2601,49460,571
2021-09-28,Napa,055,140530,12479,12388,89,12477,96
2021-09-28,Nevada,057,99092,8542,8409,296,8705,84
2021-09-28,Orange,059,3164182,299332,296596,14055,310651,5421
2021-09-28,Placer,061,380077,34772,34187,3252,37439,370
2021-09-28,Plumas,063,18699,1350,1276,25,1301,6
2021-09-28,Riverside,065,2383286,351039,346096,15803,361899,4874
2021-09-28,Sacramento,067,1510023,150493,149310,3910,153220,2086
2021-09-28,San Benito,069,59416,7058,7028,145,7173,69
2021-09-28,San Bernardino,071,2135413,343051,340342,10606,350948,5540
2021-09-28,San Diego,073,3302833,357981,355373,21061,376434,4054
2021-09-28,San Francisco,075,870044,50944,50234,2146,52380,627
2021-09-28,San Joaquin,077,732212,95377,94194,5021,99215,1639
2021-09-28,San Luis Obispo,079,281455,28271,27755,1123,28878,321
2021-09-28,San Mateo,081,765935,52508,51620,783,52403,571
2021-09-28,Santa Barbara,083,443738,42603,42226,1466,43692,506
2021-09-28,Santa Clara,085,1922200,142195,140886,1120,142006,1858
2021-09-28,Santa Cruz,087,273765,19613,19324,964,20288,214
2021-09-28,Shasta,089,179085,19196,18701,3164,21865,267
2021-09-28,Sierra,091,2930,135,130,13,143,0
2021-09-28,Siskiyou,093,43540,3148,3032,1126,4158,42
2021-09-28,Solano,095,438530,44468,43652,1148,44800,316
2021-09-28,Sonoma,097,501317,39685,39395,485,39880,370
2021-09-28,Stanislaus,099,539301,73754,73528,8244,81772,1094
2021-09-28,Sutter,101,95872,13203,13102,267,13369,155
2021-09-28,Tehama,103,63373,7592,7382,1235,8617,88
2021-09-28,Trinity,105,12862,777,613,196,809,10
2021-09-28,Tulare,107,460477,63410,61916,13024,74940,905
2021-09-28,Tuolumne,109,53932,6419,6308,78,6386,89
2021-09-28,Ventura,111,848112,95450,94632,4125,98757,1143
2021-09-28,Yolo,113,214977,18828,18564,859,19423,239
2021-09-28,Yuba,115,75493,9450,9323,215,9538,66
2021-09-27,Alameda,001,1643700,115263,114731,2571,117302,1327
2021-09-27,Alpine,003,1148,99,101,0,101,0
2021-09-27,Amador,005,37829,5147,5017,51,5068,59
2021-09-27,Butte,007,227075,19154,18687,3526,22213,239
2021-09-27,Calaveras,009,45235,3604,3514,41,3555,70
2021-09-27,Colusa,011,21464,2423,2393,552,2945,18
2021-09-27,Contra Costa,013,1133247,95889,94979,1964,96943,924
2021-09-27,Del Norte,015,27424,3543,3468,32,3500,37
2021-09-27,El Dorado,017,186661,15045,14764,1553,16317,132
2021-09-27,Fresno,019,978130,129687,127475,11591,139066,1942
2021-09-27,Glenn,021,27897,3270,3189,934,4123,26
2021-09-27,Humboldt,023,135768,8299,8118,423,8541,91
2021-09-27,Imperial,025,180216,31789,31491,2951,34442,756
2021-09-27,Inyo,027,18085,1762,1698,32,1730,39
2021-09-27,Kern,029,883053,119157,117064,18762,135826,1503
2021-09-27,Kings,031,150075,29660,28998,1674,30672,297
2021-09-27,Lake,033,64148,6246,6126,121,6247,95
2021-09-27,Lassen,035,31185,6433,6327,291,6618,25
2021-09-27,Los Angeles,037,10098052,1404737,1391538,51155,1442693,26040
2021-09-27,Madera,039,155013,21148,20691,1709,22400,262
2021-09-27,Marin,041,260295,17026,16861,400,17261,242
2021-09-27,Mariposa,043,17540,993,931,33,964,5
2021-09-27,Mendocino,045,87422,6966,6761,371,7132,74
2021-09-27,Merced,047,269075,39250,38840,1520,40360,548
2021-09-27,Modoc,049,8938,475,465,166,631,5
2021-09-27,Mono,051,14174,1554,1525,20,1545,3
2021-09-27,Monterey,053,433212,47701,46811,2590,49401,571
2021-09-27,Napa,055,140530,12455,12354,88,12442,95
2021-09-27,Nevada,057,99092,8518,8379,293,8672,84
2021-09-27,Orange,059,3164182,299025,296334,14025,310359,5409
2021-09-27,Placer,061,380077,34685,34087,3247,37334,370
2021-09-27,Plumas,063,18699,1340,1269,25,1294,6
2021-09-27,Riverside,065,2383286,350596,345529,15793,361322,4864
2021-09-27,Sacramento,067,1510023,150177,149096,3888,152984,2076
2021-09-27,San Benito,069,59416,7041,7017,145,7162,67
2021-09-27,San Bernardino,071,2135413,342636,339952,10582,350534,5544
2021-09-27,San Diego,073,3302833,357329,354755,21036,375791,4054
2021-09-27,San Francisco,075,870044,50860,50157,2143,52300,622
2021-09-27,San Joaquin,077,732212,95192,94085,5018,99103,1633
2021-09-27,San Luis Obispo,079,281455,28216,27674,1120,28794,320
2021-09-27,San Mateo,081,765935,52432,51552,783,52335,571
2021-09-27,Santa Barbara,083,443738,42536,42012,1462,43474,505
2021-09-27,Santa Clara,085,1922200,142014,140802,1110,141912,1853
2021-09-27,Santa Cruz,087,273765,19589,19292,963,20255,214
2021-09-27,Shasta,089,179085,19115,18599,3137,21736,267
2021-09-27,Sierra,091,2930,135,128,13,141,0
2021-09-27,Siskiyou,093,43540,3136,3015,1121,4136,42
2021-09-27,Solano,095,438530,44392,43582,1143,44725,314
2021-09-27,Sonoma,097,501317,39631,39347,485,39832,370
2021-09-27,Stanislaus,099,539301,73600,73370,8224,81594,1091
2021-09-27,Sutter,101,95872,13172,13082,264,13346,155
2021-09-27,Tehama,103,63373,7552,7345,1226,8571,88
2021-09-27,Trinity,105,12862,766,605,195,800,9
2021-09-27,Tulare,107,460477,63210,61708,12953,74661,904
2021-09-27,Tuolumne,109,53932,6397,6264,78,6342,89
2021-09-27,Ventura,111,848112,95325,94477,4121,98598,1138
2021-09-27,Yolo,113,214977,18793,18524,859,19383,239
2021-09-27,Yuba,115,75493,9413,9292,211,9503,64
2021-09-26,Alameda,001,1643700,115069,114601,2564,117165,1326
2021-09-26,Alpine,003,1148,99,101,0,101,0
2021-09-26,Amador,005,37829,5115,5001,50,5051,59
2021-09-26,Butte,007,227075,19079,18634,3506,22140,238
2021-09-26,Calaveras,009,45235,3582,3505,41,3546,70
2021-09-26,Colusa,011,21464,2418,2392,550,2942,18
2021-09-26,Contra Costa,013,1133247,95714,94877,1951,96828,924
2021-09-26,Del Norte,015,27424,3538,3466,31,3497,37
2021-09-26,El Dorado,017,186661,15003,14738,1545,16283,132
2021-09-26,Fresno,019,978130,129331,127235,11545,138780,1939
2021-09-26,Glenn,021,27897,3262,3182,930,4112,26
2021-09-26,Humboldt,023,135768,8262,8098,422,8520,91
2021-09-26,Imperial,025,180216,31729,31462,2950,34412,756
2021-09-26,Inyo,027,18085,1747,1685,32,1717,39
2021-09-26,Kern,029,883053,118818,116927,18652,135579,1502
2021-09-26,Kings,031,150075,29559,28930,1663,30593,293
2021-09-26,Lake,033,64148,6229,6113,121,6234,95
2021-09-26,Lassen,035,31185,6423,6319,286,6605,25
2021-09-26,Los Angeles,037,10098052,1403247,1390577,51088,1441665,26035
2021-09-26,Madera,039,155013,21073,20629,1690,22319,262
2021-09-26,Marin,041,260295,17003,16860,400,17260,242
2021-09-26,Mariposa,043,17540,987,929,33,962,5
2021-09-26,Mendocino,045,87422,6932,6744,356,7100,74
2021-09-26,Merced,047,269075,39089,38717,1512,40229,548
2021-09-26,Modoc,049,8938,475,465,165,630,5
2021-09-26,Mono,051,14174,1550,1516,20,1536,3
2021-09-26,Monterey,053,433212,47654,46792,2577,49369,571
2021-09-26,Napa,055,140530,12431,12340,87,12427,95
2021-09-26,Nevada,057,99092,8487,8356,288,8644,84
2021-09-26,Orange,059,3164182,298683,296085,13992,310077,5409
2021-09-26,Placer,061,380077,34591,34043,3238,37281,370
2021-09-26,Plumas,063,18699,1322,1268,25,1293,6
2021-09-26,Riverside,065,2383286,350064,345257,15779,361036,4864
2021-09-26,Sacramento,067,1510023,149771,148745,3869,152614,2071
2021-09-26,San Benito,069,59416,7024,7012,144,7156,67
2021-09-26,San Bernardino,071,2135413,342177,339771,10568,350339,5545
2021-09-26,San Diego,073,3302833,356707,354414,20995,375409,4051
2021-09-26,San Francisco,075,870044,50734,50092,2134,52226,622
2021-09-26,San Joaquin,077,732212,94988,93935,5004,98939,1633
2021-09-26,San Luis Obispo,079,281455,28143,27624,1115,28739,319
2021-09-26,San Mateo,081,765935,52363,51496,781,52277,571
2021-09-26,Santa Barbara,083,443738,42450,41946,1459,43405,505
2021-09-26,Santa Clara,085,1922200,141813,140667,1107,141774,1852
2021-09-26,Santa Cruz,087,273765,19564,19279,963,20242,214
2021-09-26,Shasta,089,179085,19006,18566,3114,21680,266
2021-09-26,Sierra,091,2930,135,128,13,141,0
2021-09-26,Siskiyou,093,43540,3122,2998,1111,4109,42
2021-09-26,Solano,095,438530,44325,43537,1142,44679,314
2021-09-26,Sonoma,097,501317,39572,39302,485,39787,370
2021-09-26,Stanislaus,099,539301,73400,73243,8196,81439,1091
2021-09-26,Sutter,101,95872,13135,13045,263,13308,155
2021-09-26,Tehama,103,63373,7495,7323,1215,8538,88
2021-09-26,Trinity,105,12862,763,591,195,786,9
2021-09-26,Tulare,107,460477,62989,61560,12876,74436,904
2021-09-26,Tuolumne,109,53932,6369,6236,76,6312,89
2021-09-26,Ventura,111,848112,95211,94391,4114,98505,1138
2021-09-26,Yolo,113,214977,18756,18496,852,19348,239
2021-09-26,Yuba,115,75493,9386,9275,211,9486,64
2021-09-25,Alameda,001,1643700,114990,114014,2561,116575,1324
2021-09-25,Alpine,003,1148,99,101,0,101,0
2021-09-25,Amador,005,37829,5101,4934,50,4984,59
2021-09-25,Butte,007,227075,19050,18396,3498,21894,236
2021-09-25,Calaveras,009,45235,3579,3461,41,3502,70
2021-09-25,Colusa,011,21464,2415,2387,548,2935,16
2021-09-25,Contra Costa,013,1133247,95643,94337,1947,96284,924
2021-09-25,Del Norte,015,27424,3537,3404,31,3435,35
2021-09-25,El Dorado,017,186661,14980,14641,1541,16182,130
2021-09-25,Fresno,019,978130,129186,126299,11529,137828,1927
2021-09-25,Glenn,021,27897,3257,3144,929,4073,25
2021-09-25,Humboldt,023,135768,8243,8014,420,8434,88
2021-09-25,Imperial,025,180216,31702,31280,2950,34230,755
2021-09-25,Inyo,027,18085,1739,1657,32,1689,39
2021-09-25,Kern,029,883053,118663,116021,18585,134606,1485
2021-09-25,Kings,031,150075,29508,28636,1660,30296,293
2021-09-25,Lake,033,64148,6223,6046,120,6166,92
2021-09-25,Lassen,035,31185,6411,6248,285,6533,25
2021-09-25,Los Angeles,037,10098052,1402538,1386417,51046,1437463,25964
2021-09-25,Madera,039,155013,21048,20432,1684,22116,262
2021-09-25,Marin,041,260295,16994,16802,398,17200,242
2021-09-25,Mariposa,043,17540,982,906,33,939,5
2021-09-25,Mendocino,045,87422,6913,6657,355,7012,74
2021-09-25,Merced,047,269075,39043,38393,1510,39903,546
2021-09-25,Modoc,049,8938,475,460,165,625,5
2021-09-25,Mono,051,14174,1547,1501,20,1521,3
2021-09-25,Monterey,053,433212,47624,46653,2575,49228,567
2021-09-25,Napa,055,140530,12411,12266,87,12353,95
2021-09-25,Nevada,057,99092,8470,8285,288,8573,84
2021-09-25,Orange,059,3164182,298510,294514,13975,308489,5374
2021-09-25,Placer,061,380077,34527,33764,3236,37000,367
2021-09-25,Plumas,063,18699,1318,1238,25,1263,6
2021-09-25,Riverside,065,2383286,349741,343463,15771,359234,4843
2021-09-25,Sacramento,067,1510023,149596,147728,3861,151589,2049
2021-09-25,San Benito,069,59416,7019,6965,144,7109,67
2021-09-25,San Bernardino,071,2135413,341939,338413,10555,348968,5540
2021-09-25,San Diego,073,3302833,356362,352017,20969,372986,4039
2021-09-25,San Francisco,075,870044,50690,49840,2133,51973,615
2021-09-25,San Joaquin,077,732212,94902,93273,5002,98275,1628
2021-09-25,San Luis Obispo,079,281455,28105,27447,1111,28558,318
2021-09-25,San Mateo,081,765935,52299,51266,779,52045,568
2021-09-25,Santa Barbara,083,443738,42392,41728,1459,43187,505
2021-09-25,Santa Clara,085,1922200,141706,140023,1105,141128,1844
2021-09-25,Santa Cruz,087,273765,19548,19200,961,20161,214
2021-09-25,Shasta,089,179085,18955,18256,3105,21361,262
2021-09-25,Sierra,091,2930,134,127,13,140,0
2021-09-25,Siskiyou,093,43540,3115,2956,1101,4057,41
2021-09-25,Solano,095,438530,44284,43331,1139,44470,312
2021-09-25,Sonoma,097,501317,39532,39112,485,39597,369
2021-09-25,Stanislaus,099,539301,73290,72628,8182,80810,1091
2021-09-25,Sutter,101,95872,13117,12976,260,13236,154
2021-09-25,Tehama,103,63373,7479,7200,1213,8413,86
2021-09-25,Trinity,105,12862,763,576,195,771,9
2021-09-25,Tulare,107,460477,62907,60909,12833,73742,898
2021-09-25,Tuolumne,109,53932,6357,6168,76,6244,89
2021-09-25,Ventura,111,848112,95144,94059,4110,98169,1129
2021-09-25,Yolo,113,214977,18734,18393,851,19244,239
2021-09-25,Yuba,115,75493,9366,9191,211,9402,61
2021-09-24,Alameda,001,1643700,114885,114014,2557,116571,1324
2021-09-24,Alpine,003,1148,99,101,0,101,0
2021-09-24,Amador,005,37829,5071,4934,50,4984,59
2021-09-24,Butte,007,227075,18997,18396,3487,21883,236
2021-09-24,Calaveras,009,45235,3572,3461,40,3501,70
2021-09-24,Colusa,011,21464,2412,2387,547,2934,16
2021-09-24,Contra Costa,013,1133247,95533,94337,1943,96280,924
2021-09-24,Del Norte,015,27424,3534,3404,31,3435,35
2021-09-24,El Dorado,017,186661,14962,14641,1539,16180,130
2021-09-24,Fresno,019,978130,128988,126299,11517,137816,1927
2021-09-24,Glenn,021,27897,3249,3144,929,4073,25
2021-09-24,Humboldt,023,135768,8224,8014,417,8431,88
2021-09-24,Imperial,025,180216,31664,31280,2948,34228,755
2021-09-24,Inyo,027,18085,1730,1657,32,1689,39
2021-09-24,Kern,029,883053,118527,116021,18519,134540,1485
2021-09-24,Kings,031,150075,29467,28636,1656,30292,293
2021-09-24,Lake,033,64148,6215,6046,120,6166,92
2021-09-24,Lassen,035,31185,6403,6248,284,6532,25
2021-09-24,Los Angeles,037,10098052,1401651,1386417,51005,1437422,25964
2021-09-24,Madera,039,155013,21017,20432,1675,22107,262
2021-09-24,Marin,041,260295,16980,16802,397,17199,242
2021-09-24,Mariposa,043,17540,970,906,33,939,5
2021-09-24,Mendocino,045,87422,6900,6657,355,7012,74
2021-09-24,Merced,047,269075,38999,38393,1510,39903,546
2021-09-24,Modoc,049,8938,475,460,164,624,5
2021-09-24,Mono,051,14174,1542,1501,20,1521,3
2021-09-24,Monterey,053,433212,47603,46653,2567,49220,567
2021-09-24,Napa,055,140530,12391,12266,87,12353,95
2021-09-24,Nevada,057,99092,8456,8285,285,8570,84
2021-09-24,Orange,059,3164182,298303,294514,13957,308471,5374
2021-09-24,Placer,061,380077,34472,33764,3224,36988,367
2021-09-24,Plumas,063,18699,1314,1238,25,1263,6
2021-09-24,Riverside,065,2383286,349407,343463,15764,359227,4843
2021-09-24,Sacramento,067,1510023,149410,147728,3857,151585,2049
2021-09-24,San Benito,069,59416,7013,6965,144,7109,67
2021-09-24,San Bernardino,071,2135413,341670,338413,10545,348958,5540
2021-09-24,San Diego,073,3302833,356011,352017,20954,372971,4039
2021-09-24,San Francisco,075,870044,50626,49840,2126,51966,615
2021-09-24,San Joaquin,077,732212,94789,93273,5000,98273,1628
2021-09-24,San Luis Obispo,079,281455,28073,27447,1107,28554,318
2021-09-24,San Mateo,081,765935,52239,51266,778,52044,568
2021-09-24,Santa Barbara,083,443738,42352,41728,1458,43186,505
2021-09-24,Santa Clara,085,1922200,141593,140023,1104,141127,1844
2021-09-24,Santa Cruz,087,273765,19525,19200,960,20160,214
2021-09-24,Shasta,089,179085,18901,18256,3091,21347,262
2021-09-24,Sierra,091,2930,133,127,13,140,0
2021-09-24,Siskiyou,093,43540,3106,2956,1095,4051,41
2021-09-24,Solano,095,438530,44246,43331,1137,44468,312
2021-09-24,Sonoma,097,501317,39499,39112,485,39597,369
2021-09-24,Stanislaus,099,539301,73174,72628,8167,80795,1091
2021-09-24,Sutter,101,95872,13098,12976,259,13235,154
2021-09-24,Tehama,103,63373,7466,7200,1208,8408,86
2021-09-24,Trinity,105,12862,760,576,195,771,9
2021-09-24,Tulare,107,460477,62818,60909,12791,73700,898
2021-09-24,Tuolumne,109,53932,6328,6168,76,6244,89
2021-09-24,Ventura,111,848112,95066,94059,4103,98162,1129
2021-09-24,Yolo,113,214977,18703,18393,847,19240,239
2021-09-24,Yuba,115,75493,9347,9191,211,9402,61
2021-09-23,Alameda,001,1643700,114728,114014,2551,116565,1324
2021-09-23,Alpine,003,1148,99,101,0,101,0
2021-09-23,Amador,005,37829,5058,4934,50,4984,59
2021-09-23,Butte,007,227075,18935,18396,3459,21855,236
2021-09-23,Calaveras,009,45235,3551,3461,40,3501,70
2021-09-23,Colusa,011,21464,2410,2387,544,2931,16
2021-09-23,Contra Costa,013,1133247,95392,94337,1936,96273,924
2021-09-23,Del Norte,015,27424,3525,3404,30,3434,35
2021-09-23,El Dorado,017,186661,14936,14641,1533,16174,130
2021-09-23,Fresno,019,978130,128691,126299,11498,137797,1927
2021-09-23,Glenn,021,27897,3235,3144,926,4070,25
2021-09-23,Humboldt,023,135768,8201,8014,415,8429,88
2021-09-23,Imperial,025,180216,31628,31280,2948,34228,755
2021-09-23,Inyo,027,18085,1716,1657,32,1689,39
2021-09-23,Kern,029,883053,118269,116021,18439,134460,1485
2021-09-23,Kings,031,150075,29363,28636,1647,30283,293
2021-09-23,Lake,033,64148,6205,6046,120,6166,92
2021-09-23,Lassen,035,31185,6394,6248,279,6527,25
2021-09-23,Los Angeles,037,10098052,1400454,1386417,50941,1437358,25964
2021-09-23,Madera,039,155013,20933,20432,1671,22103,262
2021-09-23,Marin,041,260295,16965,16802,394,17196,242
2021-09-23,Mariposa,043,17540,957,906,33,939,5
2021-09-23,Mendocino,045,87422,6877,6657,350,7007,74
2021-09-23,Merced,047,269075,38894,38393,1503,39896,546
2021-09-23,Modoc,049,8938,474,460,164,624,5
2021-09-23,Mono,051,14174,1539,1501,20,1521,3
2021-09-23,Monterey,053,433212,47554,46653,2556,49209,567
2021-09-23,Napa,055,140530,12374,12266,87,12353,95
2021-09-23,Nevada,057,99092,8429,8285,285,8570,84
2021-09-23,Orange,059,3164182,298006,294514,13933,308447,5374
2021-09-23,Placer,061,380077,34396,33764,3218,36982,367
2021-09-23,Plumas,063,18699,1297,1238,24,1262,6
2021-09-23,Riverside,065,2383286,348954,343463,15757,359220,4843
2021-09-23,Sacramento,067,1510023,149087,147728,3838,151566,2049
2021-09-23,San Benito,069,59416,7002,6965,144,7109,67
2021-09-23,San Bernardino,071,2135413,341304,338413,10529,348942,5540
2021-09-23,San Diego,073,3302833,355555,352017,20915,372932,4039
2021-09-23,San Francisco,075,870044,50553,49840,2124,51964,615
2021-09-23,San Joaquin,077,732212,94616,93273,4985,98258,1628
2021-09-23,San Luis Obispo,079,281455,28030,27447,1105,28552,318
2021-09-23,San Mateo,081,765935,52164,51266,777,52043,568
2021-09-23,Santa Barbara,083,443738,42274,41728,1455,43183,505
2021-09-23,Santa Clara,085,1922200,141441,140023,1097,141120,1844
2021-09-23,Santa Cruz,087,273765,19494,19200,960,20160,214
2021-09-23,Shasta,089,179085,18821,18256,3074,21330,262
2021-09-23,Sierra,091,2930,133,127,13,140,0
2021-09-23,Siskiyou,093,43540,3102,2956,1084,4040,41
2021-09-23,Solano,095,438530,44178,43331,1134,44465,312
2021-09-23,Sonoma,097,501317,39440,39112,482,39594,369
2021-09-23,Stanislaus,099,539301,73017,72628,8135,80763,1091
2021-09-23,Sutter,101,95872,13069,12976,259,13235,154
2021-09-23,Tehama,103,63373,7425,7200,1203,8403,86
2021-09-23,Trinity,105,12862,746,576,194,770,9
2021-09-23,Tulare,107,460477,62641,60909,12737,73646,898
2021-09-23,Tuolumne,109,53932,6303,6168,75,6243,89
2021-09-23,Ventura,111,848112,94962,94059,4096,98155,1129
2021-09-23,Yolo,113,214977,18672,18393,843,19236,239
2021-09-23,Yuba,115,75493,9318,9191,210,9401,61
2021-09-22,Alameda,001,1643700,114573,113862,2547,116409,1322
2021-09-22,Alpine,003,1148,99,100,0,100,0
2021-09-22,Amador,005,37829,5042,4915,50,4965,59
2021-09-22,Butte,007,227075,18875,18337,3441,21778,235
2021-09-22,Calaveras,009,45235,3535,3448,40,3488,70
2021-09-22,Colusa,011,21464,2405,2384,543,2927,16
2021-09-22,Contra Costa,013,1133247,95205,94209,1927,96136,924
2021-09-22,Del Norte,015,27424,3514,3386,29,3415,35
2021-09-22,El Dorado,017,186661,14900,14605,1527,16132,127
2021-09-22,Fresno,019,978130,128435,126006,11483,137489,1908
2021-09-22,Glenn,021,27897,3228,3138,925,4063,25
2021-09-22,Humboldt,023,135768,8179,7998,407,8405,80
2021-09-22,Imperial,025,180216,31576,31243,2941,34184,755
2021-09-22,Inyo,027,18085,1706,1651,32,1683,39
2021-09-22,Kern,029,883053,118027,115757,18317,134074,1477
2021-09-22,Kings,031,150075,29278,28589,1641,30230,292
2021-09-22,Lake,033,64148,6193,6035,120,6155,93
2021-09-22,Lassen,035,31185,6374,6209,275,6484,25
2021-09-22,Los Angeles,037,10098052,1399131,1384719,50886,1435605,25930
2021-09-22,Madera,039,155013,20876,20382,1661,22043,262
2021-09-22,Marin,041,260295,16954,16782,391,17173,242
2021-09-22,Mariposa,043,17540,951,901,33,934,5
2021-09-22,Mendocino,045,87422,6851,6624,344,6968,70
2021-09-22,Merced,047,269075,38763,38305,1501,39806,541
2021-09-22,Modoc,049,8938,471,458,164,622,5
2021-09-22,Mono,051,14174,1530,1496,19,1515,3
2021-09-22,Monterey,053,433212,47503,46615,2549,49164,566
2021-09-22,Napa,055,140530,12352,12248,86,12334,95
2021-09-22,Nevada,057,99092,8406,8273,282,8555,84
2021-09-22,Orange,059,3164182,297730,294214,13916,308130,5366
2021-09-22,Placer,061,380077,34308,33661,3205,36866,367
2021-09-22,Plumas,063,18699,1284,1230,24,1254,6
2021-09-22,Riverside,065,2383286,348419,342946,15732,358678,4830
2021-09-22,Sacramento,067,1510023,148782,147533,3809,151342,2043
2021-09-22,San Benito,069,59416,6991,6961,142,7103,67
2021-09-22,San Bernardino,071,2135413,340910,337938,10520,348458,5528
2021-09-22,San Diego,073,3302833,355104,351132,20891,372023,4027
2021-09-22,San Francisco,075,870044,50468,49734,2119,51853,610
2021-09-22,San Joaquin,077,732212,94384,93010,4961,97971,1626
2021-09-22,San Luis Obispo,079,281455,27980,27398,1101,28499,315
2021-09-22,San Mateo,081,765935,52091,51197,773,51970,568
2021-09-22,Santa Barbara,083,443738,42211,41678,1454,43132,504
2021-09-22,Santa Clara,085,1922200,141276,139803,1090,140893,1844
2021-09-22,Santa Cruz,087,273765,19456,19177,959,20136,214
2021-09-22,Shasta,089,179085,18731,18153,3063,21216,260
2021-09-22,Sierra,091,2930,133,127,13,140,0
2021-09-22,Siskiyou,093,43540,3085,2947,1074,4021,41
2021-09-22,Solano,095,438530,44112,43269,1134,44403,312
2021-09-22,Sonoma,097,501317,39387,39063,481,39544,369
2021-09-22,Stanislaus,099,539301,72852,72355,8116,80471,1091
2021-09-22,Sutter,101,95872,13049,12960,256,13216,153
2021-09-22,Tehama,103,63373,7398,7173,1200,8373,86
2021-09-22,Trinity,105,12862,745,572,194,766,9
2021-09-22,Tulare,107,460477,62430,60776,12668,73444,896
2021-09-22,Tuolumne,109,53932,6282,6155,74,6229,89
2021-09-22,Ventura,111,848112,94856,93978,4091,98069,1122
2021-09-22,Yolo,113,214977,18633,18342,836,19178,239
2021-09-22,Yuba,115,75493,9289,9169,205,9374,61
2021-09-21,Alameda,001,1643700,114420,113765,2547,116312,1321
2021-09-21,Alpine,003,1148,99,100,0,100,0
2021-09-21,Amador,005,37829,5020,4897,50,4947,59
2021-09-21,Butte,007,227075,18779,18229,3397,21626,232
2021-09-21,Calaveras,009,45235,3518,3437,40,3477,70
2021-09-21,Colusa,011,21464,2402,2378,542,2920,16
2021-09-21,Contra Costa,013,1133247,95011,94101,1913,96014,924
2021-09-21,Del Norte,015,27424,3502,3378,29,3407,34
2021-09-21,El Dorado,017,186661,14870,14578,1520,16098,127
2021-09-21,Fresno,019,978130,128083,125789,11456,137245,1892
2021-09-21,Glenn,021,27897,3221,3134,921,4055,25
2021-09-21,Humboldt,023,135768,8147,7955,402,8357,80
2021-09-21,Imperial,025,180216,31520,31185,2939,34124,755
2021-09-21,Inyo,027,18085,1696,1646,32,1678,39
2021-09-21,Kern,029,883053,117734,115534,18204,133738,1467
2021-09-21,Kings,031,150075,29190,28545,1633,30178,291
2021-09-21,Lake,033,64148,6170,6013,120,6133,90
2021-09-21,Lassen,035,31185,6356,6159,271,6430,25
2021-09-21,Los Angeles,037,10098052,1397676,1383277,50832,1434109,25893
2021-09-21,Madera,039,155013,20816,20317,1651,21968,262
2021-09-21,Marin,041,260295,16939,16748,390,17138,242
2021-09-21,Mariposa,043,17540,946,894,32,926,5
2021-09-21,Mendocino,045,87422,6813,6580,333,6913,68
2021-09-21,Merced,047,269075,38637,38225,1497,39722,539
2021-09-21,Modoc,049,8938,468,458,164,622,5
2021-09-21,Mono,051,14174,1528,1495,18,1513,3
2021-09-21,Monterey,053,433212,47435,46583,2537,49120,565
2021-09-21,Napa,055,140530,12331,12238,86,12324,95
2021-09-21,Nevada,057,99092,8379,8259,274,8533,84
2021-09-21,Orange,059,3164182,297398,293898,13886,307784,5357
2021-09-21,Placer,061,380077,34207,33609,3194,36803,365
2021-09-21,Plumas,063,18699,1277,1225,24,1249,5
2021-09-21,Riverside,065,2383286,347860,342460,15708,358168,4817
2021-09-21,Sacramento,067,1510023,148401,147378,3781,151159,2027
2021-09-21,San Benito,069,59416,6980,6950,141,7091,67
2021-09-21,San Bernardino,071,2135413,340470,337387,10503,347890,5520
2021-09-21,San Diego,073,3302833,354498,350265,20865,371130,4021
2021-09-21,San Francisco,075,870044,50370,49653,2115,51768,609
2021-09-21,San Joaquin,077,732212,94150,92762,4950,97712,1621
2021-09-21,San Luis Obispo,079,281455,27920,27318,1098,28416,314
2021-09-21,San Mateo,081,765935,52022,51136,773,51909,568
2021-09-21,Santa Barbara,083,443738,42142,41644,1450,43094,503
2021-09-21,Santa Clara,085,1922200,141059,139657,1086,140743,1843
2021-09-21,Santa Cruz,087,273765,19426,19140,958,20098,212
2021-09-21,Shasta,089,179085,18603,18027,3039,21066,258
2021-09-21,Sierra,091,2930,133,127,13,140,0
2021-09-21,Siskiyou,093,43540,3071,2927,1060,3987,36
2021-09-21,Solano,095,438530,44036,43220,1134,44354,311
2021-09-21,Sonoma,097,501317,39334,39042,481,39523,369
2021-09-21,Stanislaus,099,539301,72668,72211,8096,80307,1091
2021-09-21,Sutter,101,95872,13026,12930,253,13183,153
2021-09-21,Tehama,103,63373,7352,7151,1196,8347,85
2021-09-21,Trinity,105,12862,734,572,192,764,9
2021-09-21,Tulare,107,460477,62215,60607,12607,73214,896
2021-09-21,Tuolumne,109,53932,6249,6139,74,6213,89
2021-09-21,Ventura,111,848112,94751,93818,4083,97901,1120
2021-09-21,Yolo,113,214977,18597,18313,833,19146,239
2021-09-21,Yuba,115,75493,9261,9135,205,9340,61
2021-09-20,Alameda,001,1643700,114239,113637,2543,116180,1320
2021-09-20,Alpine,003,1148,99,100,0,100,0
2021-09-20,Amador,005,37829,5002,4883,49,4932,59
2021-09-20,Butte,007,227075,18698,18135,3382,21517,231
2021-09-20,Calaveras,009,45235,3496,3395,39,3434,66
2021-09-20,Colusa,011,21464,2400,2376,539,2915,16
2021-09-20,Contra Costa,013,1133247,94862,93919,1907,95826,924
2021-09-20,Del Norte,015,27424,3494,3374,28,3402,34
2021-09-20,El Dorado,017,186661,14837,14545,1508,16053,127
2021-09-20,Fresno,019,978130,127669,125287,11430,136717,1889
2021-09-20,Glenn,021,27897,3210,3112,918,4030,25
2021-09-20,Humboldt,023,135768,8112,7938,397,8335,80
2021-09-20,Imperial,025,180216,31437,31146,2938,34084,755
2021-09-20,Inyo,027,18085,1688,1641,31,1672,39
2021-09-20,Kern,029,883053,117395,115271,18073,133344,1459
2021-09-20,Kings,031,150075,29103,28471,1627,30098,285
2021-09-20,Lake,033,64148,6155,5984,119,6103,87
2021-09-20,Lassen,035,31185,6326,6132,271,6403,25
2021-09-20,Los Angeles,037,10098052,1396153,1382206,50752,1432958,25858
2021-09-20,Madera,039,155013,20763,20203,1644,21847,257
2021-09-20,Marin,041,260295,16914,16732,388,17120,242
2021-09-20,Mariposa,043,17540,935,887,32,919,5
2021-09-20,Mendocino,045,87422,6779,6568,328,6896,67
2021-09-20,Merced,047,269075,38526,38144,1486,39630,536
2021-09-20,Modoc,049,8938,467,457,162,619,5
2021-09-20,Mono,051,14174,1522,1480,18,1498,3
2021-09-20,Monterey,053,433212,47393,46506,2519,49025,565
2021-09-20,Napa,055,140530,12306,12209,85,12294,95
2021-09-20,Nevada,057,99092,8359,8228,272,8500,84
2021-09-20,Orange,059,3164182,297055,293642,13859,307501,5354
2021-09-20,Placer,061,380077,34117,33531,3179,36710,364
2021-09-20,Plumas,063,18699,1272,1211,24,1235,5
2021-09-20,Riverside,065,2383286,347360,341961,15695,357656,4802
2021-09-20,Sacramento,067,1510023,148028,147016,3747,150763,2016
2021-09-20,San Benito,069,59416,6971,6947,140,7087,67
2021-09-20,San Bernardino,071,2135413,340067,337059,10487,347546,5507
2021-09-20,San Diego,073,3302833,353825,349579,20828,370407,4009
2021-09-20,San Francisco,075,870044,50264,49559,2114,51673,605
2021-09-20,San Joaquin,077,732212,93907,92614,4937,97551,1615
2021-09-20,San Luis Obispo,079,281455,27844,27259,1090,28349,313
2021-09-20,San Mateo,081,765935,51935,51100,770,51870,567
2021-09-20,Santa Barbara,083,443738,42043,41589,1446,43035,500
2021-09-20,Santa Clara,085,1922200,140859,139578,1084,140662,1841
2021-09-20,Santa Cruz,087,273765,19394,19121,958,20079,211
2021-09-20,Shasta,089,179085,18504,17893,3009,20902,258
2021-09-20,Sierra,091,2930,131,126,13,139,0
2021-09-20,Siskiyou,093,43540,3049,2902,1047,3949,35
2021-09-20,Solano,095,438530,43968,43152,1126,44278,312
2021-09-20,Sonoma,097,501317,39288,38991,481,39472,369
2021-09-20,Stanislaus,099,539301,72469,72031,8077,80108,1091
2021-09-20,Sutter,101,95872,12990,12896,248,13144,153
2021-09-20,Tehama,103,63373,7320,7121,1184,8305,84
2021-09-20,Trinity,105,12862,728,568,191,759,7
2021-09-20,Tulare,107,460477,62013,60302,12554,72856,896
2021-09-20,Tuolumne,109,53932,6223,6113,74,6187,89
2021-09-20,Ventura,111,848112,94638,93700,4077,97777,1120
2021-09-20,Yolo,113,214977,18551,18287,831,19118,239
2021-09-20,Yuba,115,75493,9226,9107,203,9310,61
2021-09-19,Alameda,001,1643700,114026,113446,2538,115984,1320
2021-09-19,Alpine,003,1148,99,100,0,100,0
2021-09-19,Amador,005,37829,4962,4875,48,4923,59
2021-09-19,Butte,007,227075,18606,18063,3354,21417,230
2021-09-19,Calaveras,009,45235,3472,3390,36,3426,66
2021-09-19,Colusa,011,21464,2398,2375,537,2912,16
2021-09-19,Contra Costa,013,1133247,94676,93788,1897,95685,924
2021-09-19,Del Norte,015,27424,3468,3344,27,3371,34
2021-09-19,El Dorado,017,186661,14784,14512,1502,16014,127
2021-09-19,Fresno,019,978130,127264,124985,11385,136370,1888
2021-09-19,Glenn,021,27897,3201,3102,915,4017,25
2021-09-19,Humboldt,023,135768,8066,7914,395,8309,80
2021-09-19,Imperial,025,180216,31368,31122,2935,34057,755
2021-09-19,Inyo,027,18085,1679,1639,31,1670,39
2021-09-19,Kern,029,883053,117083,115074,17967,133041,1459
2021-09-19,Kings,031,150075,28976,28416,1618,30034,284
2021-09-19,Lake,033,64148,6124,5962,119,6081,87
2021-09-19,Lassen,035,31185,6306,6129,265,6394,25
2021-09-19,Los Angeles,037,10098052,1394172,1381200,50658,1431858,25852
2021-09-19,Madera,039,155013,20685,20161,1634,21795,257
2021-09-19,Marin,041,260295,16885,16711,386,17097,242
2021-09-19,Mariposa,043,17540,927,881,32,913,5
2021-09-19,Mendocino,045,87422,6734,6538,322,6860,67
2021-09-19,Merced,047,269075,38369,38068,1477,39545,535
2021-09-19,Modoc,049,8938,464,457,160,617,5
2021-09-19,Mono,051,14174,1517,1480,18,1498,3
2021-09-19,Monterey,053,433212,47338,46486,2516,49002,565
2021-09-19,Napa,055,140530,12285,12190,83,12273,95
2021-09-19,Nevada,057,99092,8331,8203,270,8473,84
2021-09-19,Orange,059,3164182,296686,293258,13837,307095,5354
2021-09-19,Placer,061,380077,34004,33406,3161,36567,364
2021-09-19,Plumas,063,18699,1264,1211,24,1235,5
2021-09-19,Riverside,065,2383286,346767,341566,15686,357252,4804
2021-09-19,Sacramento,067,1510023,147665,146603,3702,150305,2012
2021-09-19,San Benito,069,59416,6952,6942,140,7082,67
2021-09-19,San Bernardino,071,2135413,339571,336688,10475,347163,5506
2021-09-19,San Diego,073,3302833,353121,349225,20791,370016,4006
2021-09-19,San Francisco,075,870044,50155,49458,2105,51563,605
2021-09-19,San Joaquin,077,732212,93611,92467,4926,97393,1615
2021-09-19,San Luis Obispo,079,281455,27743,27208,1081,28289,313
2021-09-19,San Mateo,081,765935,51837,51028,769,51797,567
2021-09-19,Santa Barbara,083,443738,41937,41512,1446,42958,500
2021-09-19,Santa Clara,085,1922200,140672,139410,1079,140489,1841
2021-09-19,Santa Cruz,087,273765,19355,19096,958,20054,211
2021-09-19,Shasta,089,179085,18390,17813,2974,20787,258
2021-09-19,Sierra,091,2930,130,126,13,139,0
2021-09-19,Siskiyou,093,43540,3023,2882,1038,3920,35
2021-09-19,Solano,095,438530,43879,43056,1121,44177,312
2021-09-19,Sonoma,097,501317,39217,38956,477,39433,369
2021-09-19,Stanislaus,099,539301,72224,71830,8052,79882,1091
2021-09-19,Sutter,101,95872,12963,12868,241,13109,153
2021-09-19,Tehama,103,63373,7266,7081,1175,8256,84
2021-09-19,Trinity,105,12862,717,562,189,751,7
2021-09-19,Tulare,107,460477,61752,60160,12461,72621,896
2021-09-19,Tuolumne,109,53932,6182,6097,74,6171,89
2021-09-19,Ventura,111,848112,94476,93491,4068,97559,1120
2021-09-19,Yolo,113,214977,18502,18238,826,19064,239
2021-09-19,Yuba,115,75493,9200,9087,202,9289,61
2021-09-18,Alameda,001,1643700,113926,113300,2537,115837,1320
2021-09-18,Alpine,003,1148,99,100,0,100,0
2021-09-18,Amador,005,37829,4952,4850,48,4898,59
2021-09-18,Butte,007,227075,18567,17961,3338,21299,230
2021-09-18,Calaveras,009,45235,3467,3361,35,3396,66
2021-09-18,Colusa,011,21464,2398,2373,536,2909,16
2021-09-18,Contra Costa,013,1133247,94586,93656,1893,95549,924
2021-09-18,Del Norte,015,27424,3460,3326,25,3351,34
2021-09-18,El Dorado,017,186661,14761,14472,1499,15971,127
2021-09-18,Fresno,019,978130,127122,124771,11367,136138,1889
2021-09-18,Glenn,021,27897,3192,3086,912,3998,25
2021-09-18,Humboldt,023,135768,8052,7881,394,8275,80
2021-09-18,Imperial,025,180216,31344,31096,2934,34030,755
2021-09-18,Inyo,027,18085,1673,1636,31,1667,39
2021-09-18,Kern,029,883053,116928,114781,17903,132684,1459
2021-09-18,Kings,031,150075,28928,28330,1613,29943,285
2021-09-18,Lake,033,64148,6107,5936,119,6055,87
2021-09-18,Lassen,035,31185,6296,6121,263,6384,25
2021-09-18,Los Angeles,037,10098052,1393409,1379880,50608,1430488,25849
2021-09-18,Madera,039,155013,20641,20126,1624,21750,257
2021-09-18,Marin,041,260295,16868,16685,385,17070,242
2021-09-18,Mariposa,043,17540,924,871,32,903,5
2021-09-18,Mendocino,045,87422,6713,6523,322,6845,67
2021-09-18,Merced,047,269075,38333,37977,1471,39448,535
2021-09-18,Modoc,049,8938,464,457,159,616,5
2021-09-18,Mono,051,14174,1514,1480,18,1498,3
2021-09-18,Monterey,053,433212,47300,46466,2513,48979,565
2021-09-18,Napa,055,140530,12273,12168,83,12251,95
2021-09-18,Nevada,057,99092,8314,8183,270,8453,84
2021-09-18,Orange,059,3164182,296492,293005,13823,306828,5354
2021-09-18,Placer,061,380077,33932,33309,3158,36467,364
2021-09-18,Plumas,063,18699,1263,1204,24,1228,5
2021-09-18,Riverside,065,2383286,346382,341136,15672,356808,4802
2021-09-18,Sacramento,067,1510023,147482,146162,3693,149855,2016
2021-09-18,San Benito,069,59416,6948,6937,140,7077,67
2021-09-18,San Bernardino,071,2135413,339297,336380,10462,346842,5501
2021-09-18,San Diego,073,3302833,352730,348848,20778,369626,4006
2021-09-18,San Francisco,075,870044,50092,49359,2100,51459,605
2021-09-18,San Joaquin,077,732212,93501,92242,4914,97156,1615
2021-09-18,San Luis Obispo,079,281455,27706,27181,1078,28259,313
2021-09-18,San Mateo,081,765935,51787,50961,767,51728,567
2021-09-18,Santa Barbara,083,443738,41872,41465,1446,42911,500
2021-09-18,Santa Clara,085,1922200,140552,139233,1076,140309,1841
2021-09-18,Santa Cruz,087,273765,19335,19079,958,20037,211
2021-09-18,Shasta,089,179085,18327,17777,2958,20735,258
2021-09-18,Sierra,091,2930,129,125,13,138,0
2021-09-18,Siskiyou,093,43540,3020,2875,1032,3907,35
2021-09-18,Solano,095,438530,43839,42966,1118,44084,312
2021-09-18,Sonoma,097,501317,39182,38891,475,39366,369
2021-09-18,Stanislaus,099,539301,72079,71587,8030,79617,1091
2021-09-18,Sutter,101,95872,12949,12829,241,13070,153
2021-09-18,Tehama,103,63373,7252,7055,1168,8223,84
2021-09-18,Trinity,105,12862,715,561,189,750,7
2021-09-18,Tulare,107,460477,61676,60003,12411,72414,896
2021-09-18,Tuolumne,109,53932,6167,6069,74,6143,89
2021-09-18,Ventura,111,848112,94408,93424,4063,97487,1120
2021-09-18,Yolo,113,214977,18474,18213,822,19035,239
2021-09-18,Yuba,115,75493,9186,9061,201,9262,61
2021-09-17,Alameda,001,1643700,113800,113070,2535,115605,1320
2021-09-17,Alpine,003,1148,99,99,0,99,0
2021-09-17,Amador,005,37829,4936,4835,47,4882,58
2021-09-17,Butte,007,227075,18515,17870,3327,21197,230
2021-09-17,Calaveras,009,45235,3455,3338,34,3372,66
2021-09-17,Colusa,011,21464,2397,2369,531,2900,16
2021-09-17,Contra Costa,013,1133247,94483,93485,1890,95375,924
2021-09-17,Del Norte,015,27424,3455,3311,23,3334,34
2021-09-17,El Dorado,017,186661,14742,14421,1497,15918,127
2021-09-17,Fresno,019,978130,126903,124296,11351,135647,1882
2021-09-17,Glenn,021,27897,3175,3072,908,3980,25
2021-09-17,Humboldt,023,135768,8031,7850,394,8244,80
2021-09-17,Imperial,025,180216,31318,31031,2933,33964,755
2021-09-17,Inyo,027,18085,1665,1634,31,1665,39
2021-09-17,Kern,029,883053,116737,114303,17806,132109,1456
2021-09-17,Kings,031,150075,28863,28240,1611,29851,281
2021-09-17,Lake,033,64148,6094,5915,119,6034,87
2021-09-17,Lassen,035,31185,6281,6080,261,6341,25
2021-09-17,Los Angeles,037,10098052,1392430,1377905,50542,1428447,25820
2021-09-17,Madera,039,155013,20591,20040,1612,21652,257
2021-09-17,Marin,041,260295,16855,16658,383,17041,242
2021-09-17,Mariposa,043,17540,922,869,32,901,5
2021-09-17,Mendocino,045,87422,6694,6498,322,6820,67
2021-09-17,Merced,047,269075,38287,37803,1469,39272,533
2021-09-17,Modoc,049,8938,464,456,159,615,5
2021-09-17,Mono,051,14174,1510,1457,18,1475,3
2021-09-17,Monterey,053,433212,47277,46421,2512,48933,564
2021-09-17,Napa,055,140530,12252,12153,83,12236,95
2021-09-17,Nevada,057,99092,8299,8157,270,8427,84
2021-09-17,Orange,059,3164182,296273,292685,13805,306490,5346
2021-09-17,Placer,061,380077,33872,33188,3148,36336,362
2021-09-17,Plumas,063,18699,1254,1192,23,1215,5
2021-09-17,Riverside,065,2383286,345982,340445,15661,356106,4792
2021-09-17,Sacramento,067,1510023,147282,145985,3682,149667,1999
2021-09-17,San Benito,069,59416,6945,6929,140,7069,67
2021-09-17,San Bernardino,071,2135413,338937,335810,10455,346265,5488
2021-09-17,San Diego,073,3302833,352307,348098,20761,368859,4002
2021-09-17,San Francisco,075,870044,50041,49249,2095,51344,605
2021-09-17,San Joaquin,077,732212,93363,91977,4903,96880,1610
2021-09-17,San Luis Obispo,079,281455,27672,27102,1067,28169,311
2021-09-17,San Mateo,081,765935,51734,50854,766,51620,564
2021-09-17,Santa Barbara,083,443738,41809,41354,1445,42799,498
2021-09-17,Santa Clara,085,1922200,140403,138939,1075,140014,1838
2021-09-17,Santa Cruz,087,273765,19311,19039,958,19997,211
2021-09-17,Shasta,089,179085,18257,17617,2945,20562,254
2021-09-17,Sierra,091,2930,129,124,13,137,0
2021-09-17,Siskiyou,093,43540,3005,2852,1032,3884,35
2021-09-17,Solano,095,438530,43776,42898,1114,44012,312
2021-09-17,Sonoma,097,501317,39145,38808,474,39282,369
2021-09-17,Stanislaus,099,539301,71972,71408,8012,79420,1091
2021-09-17,Sutter,101,95872,12933,12799,238,13037,153
2021-09-17,Tehama,103,63373,7229,7020,1156,8176,84
2021-09-17,Trinity,105,12862,710,556,188,744,7
2021-09-17,Tulare,107,460477,61561,59689,12376,72065,895
2021-09-17,Tuolumne,109,53932,6148,6047,74,6121,89
2021-09-17,Ventura,111,848112,94296,93273,4061,97334,1116
2021-09-17,Yolo,113,214977,18443,18177,818,18995,239
2021-09-17,Yuba,115,75493,9159,9019,200,9219,61
2021-09-16,Alameda,001,1643700,113624,112770,2532,115302,1318
2021-09-16,Alpine,003,1148,99,99,0,99,0
2021-09-16,Amador,005,37829,4916,4819,47,4866,58
2021-09-16,Butte,007,227075,18440,17750,3311,21061,230
2021-09-16,Calaveras,009,45235,3424,3313,34,3347,66
2021-09-16,Colusa,011,21464,2395,2363,529,2892,16
2021-09-16,Contra Costa,013,1133247,94311,93213,1882,95095,917
2021-09-16,Del Norte,015,27424,3437,3285,23,3308,34
2021-09-16,El Dorado,017,186661,14701,14372,1489,15861,127
2021-09-16,Fresno,019,978130,126546,123853,11310,135163,1868
2021-09-16,Glenn,021,27897,3165,3068,906,3974,24
2021-09-16,Humboldt,023,135768,7998,7809,386,8195,80
2021-09-16,Imperial,025,180216,31275,30966,2925,33891,753
2021-09-16,Inyo,027,18085,1663,1623,31,1654,39
2021-09-16,Kern,029,883053,116465,113828,17739,131567,1448
2021-09-16,Kings,031,150075,28777,28114,1603,29717,280
2021-09-16,Lake,033,64148,6070,5890,116,6006,87
2021-09-16,Lassen,035,31185,6246,6028,256,6284,25
2021-09-16,Los Angeles,037,10098052,1391038,1376277,50477,1426754,25796
2021-09-16,Madera,039,155013,20513,19974,1607,21581,257
2021-09-16,Marin,041,260295,16828,16625,382,17007,242
2021-09-16,Mariposa,043,17540,916,849,32,881,6
2021-09-16,Mendocino,045,87422,6656,6445,311,6756,67
2021-09-16,Merced,047,269075,38180,37675,1467,39142,532
2021-09-16,Modoc,049,8938,462,455,159,614,5
2021-09-16,Mono,051,14174,1504,1449,18,1467,3
2021-09-16,Monterey,053,433212,47223,46342,2506,48848,562
2021-09-16,Napa,055,140530,12227,12115,79,12194,95
2021-09-16,Nevada,057,99092,8272,8121,269,8390,84
2021-09-16,Orange,059,3164182,295927,292183,13785,305968,5340
2021-09-16,Placer,061,380077,33776,33037,3128,36165,354
2021-09-16,Plumas,063,18699,1245,1178,23,1201,5
2021-09-16,Riverside,065,2383286,345452,339770,15647,355417,4786
2021-09-16,Sacramento,067,1510023,146926,145754,3650,149404,1996
2021-09-16,San Benito,069,59416,6933,6913,139,7052,67
2021-09-16,San Bernardino,071,2135413,338514,335129,10448,345577,5474
2021-09-16,San Diego,073,3302833,351693,347472,20722,368194,3994
2021-09-16,San Francisco,075,870044,49955,49133,2087,51220,605
2021-09-16,San Joaquin,077,732212,93125,91650,4860,96510,1608
2021-09-16,San Luis Obispo,079,281455,27599,27044,1063,28107,310
2021-09-16,San Mateo,081,765935,51657,50773,764,51537,564
2021-09-16,Santa Barbara,083,443738,41743,41272,1442,42714,497
2021-09-16,Santa Clara,085,1922200,140249,138685,1071,139756,1835
2021-09-16,Santa Cruz,087,273765,19284,19011,958,19969,211
2021-09-16,Shasta,089,179085,18132,17438,2912,20350,251
2021-09-16,Sierra,091,2930,129,123,13,136,0
2021-09-16,Siskiyou,093,43540,2985,2819,1025,3844,35
2021-09-16,Solano,095,438530,43704,42792,1105,43897,312
2021-09-16,Sonoma,097,501317,39082,38707,473,39180,369
2021-09-16,Stanislaus,099,539301,71739,71105,7996,79101,1091
2021-09-16,Sutter,101,95872,12889,12729,233,12962,152
2021-09-16,Tehama,103,63373,7189,6953,1145,8098,83
2021-09-16,Trinity,105,12862,707,547,187,734,7
2021-09-16,Tulare,107,460477,61339,59459,12304,71763,894
2021-09-16,Tuolumne,109,53932,6126,5999,73,6072,89
2021-09-16,Ventura,111,848112,94156,93087,4057,97144,1110
2021-09-16,Yolo,113,214977,18411,18135,816,18951,239
2021-09-16,Yuba,115,75493,9125,8981,197,9178,61
2021-09-15,Alameda,001,1643700,113458,112498,2525,115023,1317
2021-09-15,Alpine,003,1148,99,99,0,99,0
2021-09-15,Amador,005,37829,4908,4792,47,4839,58
2021-09-15,Butte,007,227075,18342,17664,3291,20955,228
2021-09-15,Calaveras,009,45235,3395,3293,32,3325,66
2021-09-15,Colusa,011,21464,2393,2352,526,2878,16
2021-09-15,Contra Costa,013,1133247,94129,92989,1871,94860,913
2021-09-15,Del Norte,015,27424,3424,3271,21,3292,34
2021-09-15,El Dorado,017,186661,14674,14309,1480,15789,127
2021-09-15,Fresno,019,978130,126167,123370,11254,134624,1867
2021-09-15,Glenn,021,27897,3153,3051,901,3952,20
2021-09-15,Humboldt,023,135768,7962,7754,381,8135,52
2021-09-15,Imperial,025,180216,31220,30891,2920,33811,753
2021-09-15,Inyo,027,18085,1659,1614,31,1645,39
2021-09-15,Kern,029,883053,116119,113546,17641,131187,1434
2021-09-15,Kings,031,150075,28698,27991,1595,29586,279
2021-09-15,Lake,033,64148,6037,5852,115,5967,85
2021-09-15,Lassen,035,31185,6186,6018,251,6269,25
2021-09-15,Los Angeles,037,10098052,1389534,1374307,50408,1424715,25767
2021-09-15,Madera,039,155013,20438,19880,1600,21480,257
2021-09-15,Marin,041,260295,16793,16592,377,16969,242
2021-09-15,Mariposa,043,17540,904,843,32,875,5
2021-09-15,Mendocino,045,87422,6626,6399,306,6705,66
2021-09-15,Merced,047,269075,38072,37508,1465,38973,529
2021-09-15,Modoc,049,8938,462,454,159,613,5
2021-09-15,Mono,051,14174,1498,1445,18,1463,3
2021-09-15,Monterey,053,433212,47153,46317,2495,48812,562
2021-09-15,Napa,055,140530,12206,12082,79,12161,95
2021-09-15,Nevada,057,99092,8250,8081,266,8347,84
2021-09-15,Orange,059,3164182,295603,291834,13766,305600,5328
2021-09-15,Placer,061,380077,33664,32860,3107,35967,352
2021-09-15,Plumas,063,18699,1240,1164,22,1186,5
2021-09-15,Riverside,065,2383286,344869,339077,15623,354700,4769
2021-09-15,Sacramento,067,1510023,146500,145202,3618,148820,1981
2021-09-15,San Benito,069,59416,6930,6902,139,7041,67
2021-09-15,San Bernardino,071,2135413,338052,334556,10434,344990,5470
2021-09-15,San Diego,073,3302833,351073,346933,20694,367627,3983
2021-09-15,San Francisco,075,870044,49844,48999,2082,51081,605
2021-09-15,San Joaquin,077,732212,92849,91322,4820,96142,1607
2021-09-15,San Luis Obispo,079,281455,27516,26943,1057,28000,306
2021-09-15,San Mateo,081,765935,51575,50691,761,51452,564
2021-09-15,Santa Barbara,083,443738,41640,41077,1438,42515,497
2021-09-15,Santa Clara,085,1922200,140075,138410,1066,139476,1833
2021-09-15,Santa Cruz,087,273765,19246,18984,956,19940,210
2021-09-15,Shasta,089,179085,18021,17317,2891,20208,250
2021-09-15,Sierra,091,2930,129,123,13,136,0
2021-09-15,Siskiyou,093,43540,2965,2804,995,3799,35
2021-09-15,Solano,095,438530,43632,42682,1100,43782,312
2021-09-15,Sonoma,097,501317,39025,38629,473,39102,369
2021-09-15,Stanislaus,099,539301,71515,70852,7974,78826,1091
2021-09-15,Sutter,101,95872,12856,12699,228,12927,151
2021-09-15,Tehama,103,63373,7148,6894,1136,8030,79
2021-09-15,Trinity,105,12862,705,541,185,726,7
2021-09-15,Tulare,107,460477,61080,59149,12243,71392,890
2021-09-15,Tuolumne,109,53932,6100,5969,73,6042,89
2021-09-15,Ventura,111,848112,94013,92960,4050,97010,1109
2021-09-15,Yolo,113,214977,18377,18064,810,18874,239
2021-09-15,Yuba,115,75493,9091,8953,197,9150,61
2021-09-14,Alameda,001,1643700,113251,112329,2522,114851,1316
2021-09-14,Alpine,003,1148,99,98,0,98,0
2021-09-14,Amador,005,37829,4888,4790,47,4837,57
2021-09-14,Butte,007,227075,18208,17516,3267,20783,226
2021-09-14,Calaveras,009,45235,3375,3280,29,3309,66
2021-09-14,Colusa,011,21464,2389,2344,523,2867,16
2021-09-14,Contra Costa,013,1133247,93931,92822,1863,94685,908
2021-09-14,Del Norte,015,27424,3408,3252,21,3273,32
2021-09-14,El Dorado,017,186661,14621,14247,1472,15719,123
2021-09-14,Fresno,019,978130,125692,123151,11202,134353,1856
2021-09-14,Glenn,021,27897,3136,3045,897,3942,20
2021-09-14,Humboldt,023,135768,7928,7717,376,8093,52
2021-09-14,Imperial,025,180216,31171,30845,2917,33762,752
2021-09-14,Inyo,027,18085,1650,1605,30,1635,39
2021-09-14,Kern,029,883053,115736,113250,17518,130768,1428
2021-09-14,Kings,031,150075,28622,27955,1587,29542,278
2021-09-14,Lake,033,64148,6005,5845,115,5960,83
2021-09-14,Lassen,035,31185,6172,5977,246,6223,25
2021-09-14,Los Angeles,037,10098052,1387698,1372831,50328,1423159,25729
2021-09-14,Madera,039,155013,20356,19800,1589,21389,254
2021-09-14,Marin,041,260295,16765,16584,375,16959,242
2021-09-14,Mariposa,043,17540,893,834,31,865,5
2021-09-14,Mendocino,045,87422,6590,6372,295,6667,65
2021-09-14,Merced,047,269075,37921,37430,1461,38891,526
2021-09-14,Modoc,049,8938,461,453,159,612,5
2021-09-14,Mono,051,14174,1494,1440,18,1458,4
2021-09-14,Monterey,053,433212,47112,46224,2484,48708,558
2021-09-14,Napa,055,140530,12173,12070,78,12148,91
2021-09-14,Nevada,057,99092,8216,8056,266,8322,83
2021-09-14,Orange,059,3164182,295210,291423,13742,305165,5319
2021-09-14,Placer,061,380077,33532,32735,3087,35822,350
2021-09-14,Plumas,063,18699,1225,1148,22,1170,5
2021-09-14,Riverside,065,2383286,344228,338534,15592,354126,4748
2021-09-14,Sacramento,067,1510023,146115,145051,3569,148620,1977
2021-09-14,San Benito,069,59416,6920,6887,139,7026,64
2021-09-14,San Bernardino,071,2135413,337555,333968,10409,344377,5465
2021-09-14,San Diego,073,3302833,350413,346204,20643,366847,3966
2021-09-14,San Francisco,075,870044,49710,48998,2080,51078,603
2021-09-14,San Joaquin,077,732212,92610,91128,4811,95939,1596
2021-09-14,San Luis Obispo,079,281455,27443,26845,1052,27897,304
2021-09-14,San Mateo,081,765935,51478,50602,758,51360,564
2021-09-14,Santa Barbara,083,443738,41544,40783,1429,42212,495
2021-09-14,Santa Clara,085,1922200,139840,138321,1063,139384,1828
2021-09-14,Santa Cruz,087,273765,19206,18965,954,19919,210
2021-09-14,Shasta,089,179085,17890,17152,2870,20022,246
2021-09-14,Sierra,091,2930,129,123,13,136,0
2021-09-14,Siskiyou,093,43540,2941,2756,978,3734,35
2021-09-14,Solano,095,438530,43549,42599,1097,43696,307
2021-09-14,Sonoma,097,501317,38956,38595,469,39064,369
2021-09-14,Stanislaus,099,539301,71255,70697,7946,78643,1091
2021-09-14,Sutter,101,95872,12814,12670,221,12891,149
2021-09-14,Tehama,103,63373,7094,6859,1128,7987,80
2021-09-14,Trinity,105,12862,699,538,184,722,7
2021-09-14,Tulare,107,460477,60827,58961,12172,71133,888
2021-09-14,Tuolumne,109,53932,6079,5951,71,6022,89
2021-09-14,Ventura,111,848112,93828,92841,4033,96874,1107
2021-09-14,Yolo,113,214977,18333,18039,805,18844,239
2021-09-14,Yuba,115,75493,9055,8928,197,9125,61
2021-09-13,Alameda,001,1643700,113037,112159,2517,114676,1309
2021-09-13,Alpine,003,1148,98,98,0,98,0
2021-09-13,Amador,005,37829,4870,4761,47,4808,56
2021-09-13,Butte,007,227075,18084,17393,3239,20632,225
2021-09-13,Calaveras,009,45235,3349,3253,27,3280,65
2021-09-13,Colusa,011,21464,2380,2346,519,2865,16
2021-09-13,Contra Costa,013,1133247,93685,92658,1858,94516,908
2021-09-13,Del Norte,015,27424,3372,3232,21,3253,28
2021-09-13,El Dorado,017,186661,14560,14194,1464,15658,119
2021-09-13,Fresno,019,978130,125225,122650,11136,133786,1853
2021-09-13,Glenn,021,27897,3122,3026,891,3917,20
2021-09-13,Humboldt,023,135768,7895,7659,373,8032,52
2021-09-13,Imperial,025,180216,31118,30802,2914,33716,751
2021-09-13,Inyo,027,18085,1643,1602,30,1632,39
2021-09-13,Kern,029,883053,115352,112930,17396,130326,1424
2021-09-13,Kings,031,150075,28512,27858,1575,29433,275
2021-09-13,Lake,033,64148,5983,5809,115,5924,82
2021-09-13,Lassen,035,31185,6137,5953,245,6198,25
2021-09-13,Los Angeles,037,10098052,1385833,1371423,50262,1421685,25703
2021-09-13,Madera,039,155013,20286,19735,1574,21309,252
2021-09-13,Marin,041,260295,16729,16557,374,16931,242
2021-09-13,Mariposa,043,17540,879,825,31,856,5
2021-09-13,Mendocino,045,87422,6555,6323,286,6609,61
2021-09-13,Merced,047,269075,37771,37291,1456,38747,521
2021-09-13,Modoc,049,8938,460,451,159,610,5
2021-09-13,Mono,051,14174,1488,1435,18,1453,3
2021-09-13,Monterey,053,433212,47022,46188,2471,48659,558
2021-09-13,Napa,055,140530,12155,12039,78,12117,91
2021-09-13,Nevada,057,99092,8190,8021,264,8285,83
2021-09-13,Orange,059,3164182,294777,291128,13720,304848,5312
2021-09-13,Placer,061,380077,33367,32617,3070,35687,343
2021-09-13,Plumas,063,18699,1216,1142,22,1164,5
2021-09-13,Riverside,065,2383286,343582,337876,15574,353450,4731
2021-09-13,Sacramento,067,1510023,145627,144537,3536,148073,1956
2021-09-13,San Benito,069,59416,6904,6867,138,7005,64
2021-09-13,San Bernardino,071,2135413,337064,333613,10384,343997,5441
2021-09-13,San Diego,073,3302833,349626,345647,20591,366238,3961
2021-09-13,San Francisco,075,870044,49580,48914,2074,50988,603
2021-09-13,San Joaquin,077,732212,92325,90966,4793,95759,1581
2021-09-13,San Luis Obispo,079,281455,27346,26805,1049,27854,300
2021-09-13,San Mateo,081,765935,51386,50525,753,51278,564
2021-09-13,Santa Barbara,083,443738,41425,40661,1422,42083,494
2021-09-13,Santa Clara,085,1922200,139595,138152,1058,139210,1820
2021-09-13,Santa Cruz,087,273765,19166,18917,953,19870,210
2021-09-13,Shasta,089,179085,17760,17033,2830,19863,243
2021-09-13,Sierra,091,2930,129,123,13,136,0
2021-09-13,Siskiyou,093,43540,2926,2745,966,3711,35
2021-09-13,Solano,095,438530,43445,42501,1094,43595,306
2021-09-13,Sonoma,097,501317,38889,38513,466,38979,368
2021-09-13,Stanislaus,099,539301,71000,70477,7910,78387,1091
2021-09-13,Sutter,101,95872,12756,12624,217,12841,145
2021-09-13,Tehama,103,63373,7031,6803,1116,7919,79
2021-09-13,Trinity,105,12862,697,533,182,715,7
2021-09-13,Tulare,107,460477,60543,58768,12112,70880,887
2021-09-13,Tuolumne,109,53932,6049,5909,71,5980,89
2021-09-13,Ventura,111,848112,93667,92679,4026,96705,1107
2021-09-13,Yolo,113,214977,18289,17974,799,18773,239
2021-09-13,Yuba,115,75493,9010,8884,196,9080,61
2021-09-12,Alameda,001,1643700,112776,111961,2514,114475,1309
2021-09-12,Alpine,003,1148,98,98,0,98,0
2021-09-12,Amador,005,37829,4849,4752,47,4799,56
2021-09-12,Butte,007,227075,17939,17257,3192,20449,221
2021-09-12,Calaveras,009,45235,3318,3236,23,3259,65
2021-09-12,Colusa,011,21464,2377,2344,518,2862,16
2021-09-12,Contra Costa,013,1133247,93417,92498,1846,94344,908
2021-09-12,Del Norte,015,27424,3337,3200,21,3221,28
2021-09-12,El Dorado,017,186661,14487,14167,1448,15615,119
2021-09-12,Fresno,019,978130,124707,122407,11079,133486,1853
2021-09-12,Glenn,021,27897,3105,3016,885,3901,20
2021-09-12,Humboldt,023,135768,7825,7636,362,7998,52
2021-09-12,Imperial,025,180216,31055,30790,2909,33699,751
2021-09-12,Inyo,027,18085,1633,1596,30,1626,39
2021-09-12,Kern,029,883053,114940,112602,17237,129839,1424
2021-09-12,Kings,031,150075,28401,27764,1558,29322,274
2021-09-12,Lake,033,64148,5943,5781,113,5894,82
2021-09-12,Lassen,035,31185,6100,5943,236,6179,25
2021-09-12,Los Angeles,037,10098052,1383774,1365968,50189,1416157,25630
2021-09-12,Madera,039,155013,20199,19691,1562,21253,252
2021-09-12,Marin,041,260295,16706,16526,374,16900,242
2021-09-12,Mariposa,043,17540,868,811,29,840,5
2021-09-12,Mendocino,045,87422,6515,6283,277,6560,61
2021-09-12,Merced,047,269075,37599,37172,1445,38617,521
2021-09-12,Modoc,049,8938,460,451,158,609,5
2021-09-12,Mono,051,14174,1481,1431,18,1449,3
2021-09-12,Monterey,053,433212,46923,46167,2461,48628,558
2021-09-12,Napa,055,140530,12125,12011,78,12089,91
2021-09-12,Nevada,057,99092,8150,7987,263,8250,83
2021-09-12,Orange,059,3164182,294315,290718,13699,304417,5312
2021-09-12,Placer,061,380077,33218,32520,3048,35568,343
2021-09-12,Plumas,063,18699,1197,1138,22,1160,5
2021-09-12,Riverside,065,2383286,342898,337332,15540,352872,4731
2021-09-12,Sacramento,067,1510023,145120,144030,3497,147527,1959
2021-09-12,San Benito,069,59416,6885,6852,137,6989,64
2021-09-12,San Bernardino,071,2135413,336454,333049,10371,343420,5439
2021-09-12,San Diego,073,3302833,348816,345058,20515,365573,3942
2021-09-12,San Francisco,075,870044,49469,48819,2067,50886,603
2021-09-12,San Joaquin,077,732212,91996,90730,4785,95515,1581
2021-09-12,San Luis Obispo,079,281455,27227,26729,1036,27765,299
2021-09-12,San Mateo,081,765935,51275,50432,749,51181,564
2021-09-12,Santa Barbara,083,443738,41313,40600,1415,42015,494
2021-09-12,Santa Clara,085,1922200,139338,137899,1055,138954,1820
2021-09-12,Santa Cruz,087,273765,19133,18892,952,19844,210
2021-09-12,Shasta,089,179085,17595,16957,2772,19729,243
2021-09-12,Sierra,091,2930,129,123,13,136,0
2021-09-12,Siskiyou,093,43540,2898,2730,951,3681,35
2021-09-12,Solano,095,438530,43339,42409,1091,43500,306
2021-09-12,Sonoma,097,501317,38809,38456,464,38920,368
2021-09-12,Stanislaus,099,539301,70701,70184,7871,78055,1091
2021-09-12,Sutter,101,95872,12714,12589,211,12800,145
2021-09-12,Tehama,103,63373,6967,6732,1104,7836,79
2021-09-12,Trinity,105,12862,693,529,180,709,7
2021-09-12,Tulare,107,460477,60190,58582,12052,70634,887
2021-09-12,Tuolumne,109,53932,6016,5888,71,5959,89
2021-09-12,Ventura,111,848112,93540,92496,4020,96516,1107
2021-09-12,Yolo,113,214977,18223,17943,791,18734,239
2021-09-12,Yuba,115,75493,8975,8842,196,9038,61
2021-09-11,Alameda,001,1643700,112652,111715,2512,114227,1309
2021-09-11,Alpine,003,1148,98,98,0,98,0
2021-09-11,Amador,005,37829,4836,4728,46,4774,56
2021-09-11,Butte,007,227075,17856,17218,3165,20383,221
2021-09-11,Calaveras,009,45235,3310,3208,22,3230,65
2021-09-11,Colusa,011,21464,2376,2338,515,2853,16
2021-09-11,Contra Costa,013,1133247,93298,92269,1842,94111,908
2021-09-11,Del Norte,015,27424,3321,3184,21,3205,28
2021-09-11,El Dorado,017,186661,14468,14117,1441,15558,119
2021-09-11,Fresno,019,978130,124528,122224,11054,133278,1853
2021-09-11,Glenn,021,27897,3095,3007,882,3889,20
2021-09-11,Humboldt,023,135768,7803,7615,359,7974,52
2021-09-11,Imperial,025,180216,31030,30760,2906,33666,751
2021-09-11,Inyo,027,18085,1630,1590,30,1620,39
2021-09-11,Kern,029,883053,114690,112205,17123,129328,1424
2021-09-11,Kings,031,150075,28352,27631,1552,29183,275
2021-09-11,Lake,033,64148,5922,5761,113,5874,82
2021-09-11,Lassen,035,31185,6085,5930,232,6162,25
2021-09-11,Los Angeles,037,10098052,1382801,1365831,50124,1415955,25630
2021-09-11,Madera,039,155013,20147,19648,1557,21205,252
2021-09-11,Marin,041,260295,16678,16496,373,16869,242
2021-09-11,Mariposa,043,17540,863,799,29,828,5
2021-09-11,Mendocino,045,87422,6491,6257,277,6534,61
2021-09-11,Merced,047,269075,37545,37042,1442,38484,521
2021-09-11,Modoc,049,8938,460,449,158,607,5
2021-09-11,Mono,051,14174,1475,1431,18,1449,3
2021-09-11,Monterey,053,433212,46886,46140,2458,48598,558
2021-09-11,Napa,055,140530,12102,11991,78,12069,91
2021-09-11,Nevada,057,99092,8135,7967,263,8230,83
2021-09-11,Orange,059,3164182,294013,290429,13683,304112,5306
2021-09-11,Placer,061,380077,33135,32414,3037,35451,344
2021-09-11,Plumas,063,18699,1190,1112,22,1134,5
2021-09-11,Riverside,065,2383286,342460,336585,15527,352112,4731
2021-09-11,Sacramento,067,1510023,144820,143557,3485,147042,1955
2021-09-11,San Benito,069,59416,6872,6844,137,6981,64
2021-09-11,San Bernardino,071,2135413,336111,332512,10357,342869,5430
2021-09-11,San Diego,073,3302833,348332,344355,20491,364846,3942
2021-09-11,San Francisco,075,870044,49414,48660,2063,50723,603
2021-09-11,San Joaquin,077,732212,91853,90482,4778,95260,1581
2021-09-11,San Luis Obispo,079,281455,27181,26651,1035,27686,299
2021-09-11,San Mateo,081,765935,51203,50341,748,51089,564
2021-09-11,Santa Barbara,083,443738,41240,40451,1415,41866,494
2021-09-11,Santa Clara,085,1922200,139185,137659,1052,138711,1820
2021-09-11,Santa Cruz,087,273765,19104,18865,952,19817,210
2021-09-11,Shasta,089,179085,17501,16877,2752,19629,243
2021-09-11,Sierra,091,2930,129,123,13,136,0
2021-09-11,Siskiyou,093,43540,2881,2717,948,3665,35
2021-09-11,Solano,095,438530,43288,42344,1088,43432,306
2021-09-11,Sonoma,097,501317,38762,38399,462,38861,368
2021-09-11,Stanislaus,099,539301,70576,69974,7858,77832,1091
2021-09-11,Sutter,101,95872,12688,12538,208,12746,145
2021-09-11,Tehama,103,63373,6946,6703,1096,7799,79
2021-09-11,Trinity,105,12862,686,526,180,706,7
2021-09-11,Tulare,107,460477,60078,58321,12006,70327,889
2021-09-11,Tuolumne,109,53932,5997,5879,68,5947,89
2021-09-11,Ventura,111,848112,93458,92328,4015,96343,1107
2021-09-11,Yolo,113,214977,18198,17906,788,18694,239
2021-09-11,Yuba,115,75493,8950,8813,196,9009,61
2021-09-10,Alameda,001,1643700,112461,111386,2511,113897,1306
2021-09-10,Alpine,003,1148,97,97,0,97,0
2021-09-10,Amador,005,37829,4824,4706,46,4752,56
2021-09-10,Butte,007,227075,17781,17051,3147,20198,222
2021-09-10,Calaveras,009,45235,3302,3183,22,3205,65
2021-09-10,Colusa,011,21464,2372,2327,512,2839,16
2021-09-10,Contra Costa,013,1133247,93175,92024,1840,93864,908
2021-09-10,Del Norte,015,27424,3306,3128,20,3148,28
2021-09-10,El Dorado,017,186661,14438,14051,1437,15488,119
2021-09-10,Fresno,019,978130,124204,121659,11026,132685,1846
2021-09-10,Glenn,021,27897,3088,2977,881,3858,20
2021-09-10,Humboldt,023,135768,7771,7543,355,7898,52
2021-09-10,Imperial,025,180216,31007,30716,2904,33620,751
2021-09-10,Inyo,027,18085,1626,1590,30,1620,39
2021-09-10,Kern,029,883053,114436,111832,17007,128839,1419
2021-09-10,Kings,031,150075,28278,27473,1545,29018,274
2021-09-10,Lake,033,64148,5906,5713,111,5824,79
2021-09-10,Lassen,035,31185,6077,5914,229,6143,25
2021-09-10,Los Angeles,037,10098052,1381596,1365709,50060,1415769,25630
2021-09-10,Madera,039,155013,20101,19520,1550,21070,252
2021-09-10,Marin,041,260295,16658,16458,370,16828,242
2021-09-10,Mariposa,043,17540,858,795,29,824,5
2021-09-10,Mendocino,045,87422,6459,6184,276,6460,61
2021-09-10,Merced,047,269075,37493,36884,1441,38325,521
2021-09-10,Modoc,049,8938,460,448,158,606,5
2021-09-10,Mono,051,14174,1470,1422,18,1440,3
2021-09-10,Monterey,053,433212,46842,46084,2456,48540,557
2021-09-10,Napa,055,140530,12077,11948,78,12026,90
2021-09-10,Nevada,057,99092,8117,7932,262,8194,83
2021-09-10,Orange,059,3164182,293706,290022,13673,303695,5302
2021-09-10,Placer,061,380077,33033,32264,3024,35288,343
2021-09-10,Plumas,063,18699,1182,1111,22,1133,5
2021-09-10,Riverside,065,2383286,341987,335988,15520,351508,4720
2021-09-10,Sacramento,067,1510023,144477,143244,3477,146721,1950
2021-09-10,San Benito,069,59416,6868,6824,137,6961,64
2021-09-10,San Bernardino,071,2135413,335692,331894,10348,342242,5422
2021-09-10,San Diego,073,3302833,347785,343173,20454,363627,3941
2021-09-10,San Francisco,075,870044,49335,48518,2056,50574,602
2021-09-10,San Joaquin,077,732212,91673,90208,4772,94980,1573
2021-09-10,San Luis Obispo,079,281455,27148,26526,1033,27559,299
2021-09-10,San Mateo,081,765935,51136,50251,747,50998,564
2021-09-10,Santa Barbara,083,443738,41187,40321,1412,41733,492
2021-09-10,Santa Clara,085,1922200,139002,137337,1051,138388,1817
2021-09-10,Santa Cruz,087,273765,19085,18785,951,19736,210
2021-09-10,Shasta,089,179085,17407,16667,2724,19391,242
2021-09-10,Sierra,091,2930,129,117,13,130,0
2021-09-10,Siskiyou,093,43540,2869,2702,944,3646,35
2021-09-10,Solano,095,438530,43214,42230,1081,43311,305
2021-09-10,Sonoma,097,501317,38704,38271,461,38732,368
2021-09-10,Stanislaus,099,539301,70420,69617,7834,77451,1091
2021-09-10,Sutter,101,95872,12654,12468,208,12676,145
2021-09-10,Tehama,103,63373,6913,6652,1090,7742,77
2021-09-10,Trinity,105,12862,682,524,180,704,7
2021-09-10,Tulare,107,460477,59930,57930,11957,69887,883
2021-09-10,Tuolumne,109,53932,5977,5842,68,5910,89
2021-09-10,Ventura,111,848112,93361,92145,4011,96156,1104
2021-09-10,Yolo,113,214977,18172,17825,784,18609,239
2021-09-10,Yuba,115,75493,8931,8760,195,8955,62
2021-09-09,Alameda,001,1643700,112242,111014,2507,113521,1306
2021-09-09,Alpine,003,1148,97,94,0,94,0
2021-09-09,Amador,005,37829,4803,4698,45,4743,56
2021-09-09,Butte,007,227075,17634,16874,3120,19994,221
2021-09-09,Calaveras,009,45235,3268,3165,22,3187,65
2021-09-09,Colusa,011,21464,2365,2321,511,2832,16
2021-09-09,Contra Costa,013,1133247,92965,91687,1835,93522,904
2021-09-09,Del Norte,015,27424,3283,3102,20,3122,28
2021-09-09,El Dorado,017,186661,14381,13970,1427,15397,119
2021-09-09,Fresno,019,978130,123729,121040,10980,132020,1838
2021-09-09,Glenn,021,27897,3076,2947,877,3824,20
2021-09-09,Humboldt,023,135768,7721,7471,349,7820,52
2021-09-09,Imperial,025,180216,30969,30661,2901,33562,751
2021-09-09,Inyo,027,18085,1619,1586,30,1616,39
2021-09-09,Kern,029,883053,114089,111390,16851,128241,1414
2021-09-09,Kings,031,150075,28176,27282,1534,28816,273
2021-09-09,Lake,033,64148,5882,5638,109,5747,79
2021-09-09,Lassen,035,31185,6027,5860,223,6083,25
2021-09-09,Los Angeles,037,10098052,1379728,1363735,49987,1413722,25583
2021-09-09,Madera,039,155013,20028,19401,1537,20938,252
2021-09-09,Marin,041,260295,16635,16416,367,16783,242
2021-09-09,Mariposa,043,17540,845,779,28,807,5
2021-09-09,Mendocino,045,87422,6425,6089,267,6356,61
2021-09-09,Merced,047,269075,37339,36634,1428,38062,516
2021-09-09,Modoc,049,8938,460,448,158,606,5
2021-09-09,Mono,051,14174,1460,1420,18,1438,3
2021-09-09,Monterey,053,433212,46788,45991,2445,48436,556
2021-09-09,Napa,055,140530,12045,11878,78,11956,90
2021-09-09,Nevada,057,99092,8079,7855,262,8117,82
2021-09-09,Orange,059,3164182,293297,289109,13642,302751,5299
2021-09-09,Placer,061,380077,32914,32048,3009,35057,342
2021-09-09,Plumas,063,18699,1171,1098,22,1120,5
2021-09-09,Riverside,065,2383286,341348,334774,15502,350276,4701
2021-09-09,Sacramento,067,1510023,143996,142728,3432,146160,1929
2021-09-09,San Benito,069,59416,6858,6820,136,6956,64
2021-09-09,San Bernardino,071,2135413,335119,331040,10335,341375,5417
2021-09-09,San Diego,073,3302833,347071,342149,20397,362546,3929
2021-09-09,San Francisco,075,870044,49221,48404,2047,50451,597
2021-09-09,San Joaquin,077,732212,91400,89874,4754,94628,1570
2021-09-09,San Luis Obispo,079,281455,27066,26472,1030,27502,296
2021-09-09,San Mateo,081,765935,51015,50143,744,50887,561
2021-09-09,Santa Barbara,083,443738,41081,40180,1408,41588,490
2021-09-09,Santa Clara,085,1922200,138779,137017,1046,138063,1816
2021-09-09,Santa Cruz,087,273765,19039,18728,951,19679,210
2021-09-09,Shasta,089,179085,17261,16401,2683,19084,238
2021-09-09,Sierra,091,2930,129,115,13,128,0
2021-09-09,Siskiyou,093,43540,2846,2683,930,3613,35
2021-09-09,Solano,095,438530,43098,42081,1077,43158,303
2021-09-09,Sonoma,097,501317,38636,38171,460,38631,360
2021-09-09,Stanislaus,099,539301,70141,69178,7802,76980,1074
2021-09-09,Sutter,101,95872,12599,12396,206,12602,144
2021-09-09,Tehama,103,63373,6859,6554,1085,7639,75
2021-09-09,Trinity,105,12862,676,523,178,701,6
2021-09-09,Tulare,107,460477,59689,57564,11898,69462,879
2021-09-09,Tuolumne,109,53932,5949,5802,67,5869,89
2021-09-09,Ventura,111,848112,93216,91610,4002,95612,1098
2021-09-09,Yolo,113,214977,18115,17724,781,18505,239
2021-09-09,Yuba,115,75493,8886,8707,192,8899,55
2021-09-08,Alameda,001,1643700,111998,110781,2505,113286,1305
2021-09-08,Alpine,003,1148,97,94,0,94,0
2021-09-08,Amador,005,37829,4791,4693,45,4738,56
2021-09-08,Butte,007,227075,17500,16775,3100,19875,220
2021-09-08,Calaveras,009,45235,3250,3157,22,3179,63
2021-09-08,Colusa,011,21464,2363,2308,511,2819,16
2021-09-08,Contra Costa,013,1133247,92685,91471,1830,93301,900
2021-09-08,Del Norte,015,27424,3260,3085,20,3105,25
2021-09-08,El Dorado,017,186661,14301,13928,1407,15335,119
2021-09-08,Fresno,019,978130,123230,120644,10916,131560,1831
2021-09-08,Glenn,021,27897,3061,2942,868,3810,20
2021-09-08,Humboldt,023,135768,7676,7438,341,7779,52
2021-09-08,Imperial,025,180216,30936,30609,2888,33497,751
2021-09-08,Inyo,027,18085,1608,1580,30,1610,39
2021-09-08,Kern,029,883053,113691,110933,16713,127646,1409
2021-09-08,Kings,031,150075,28047,27235,1520,28755,267
2021-09-08,Lake,033,64148,5851,5618,107,5725,79
2021-09-08,Lassen,035,31185,6009,5848,216,6064,25
2021-09-08,Los Angeles,037,10098052,1377657,1362029,49901,1411930,25533
2021-09-08,Madera,039,155013,19967,19352,1524,20876,252
2021-09-08,Marin,041,260295,16607,16386,366,16752,242
2021-09-08,Mariposa,043,17540,833,777,27,804,5
2021-09-08,Mendocino,045,87422,6381,6069,258,6327,61
2021-09-08,Merced,047,269075,37178,36500,1416,37916,516
2021-09-08,Modoc,049,8938,460,448,158,606,5
2021-09-08,Mono,051,14174,1454,1418,18,1436,3
2021-09-08,Monterey,053,433212,46739,45959,2439,48398,554
2021-09-08,Napa,055,140530,12010,11842,76,11918,90
2021-09-08,Nevada,057,99092,8044,7843,261,8104,82
2021-09-08,Orange,059,3164182,292887,288511,13619,302130,5290
2021-09-08,Placer,061,380077,32777,31852,2992,34844,337
2021-09-08,Plumas,063,18699,1164,1072,22,1094,5
2021-09-08,Riverside,065,2383286,340590,334037,15477,349514,4683
2021-09-08,Sacramento,067,1510023,143517,142448,3384,145832,1921
2021-09-08,San Benito,069,59416,6840,6800,136,6936,64
2021-09-08,San Bernardino,071,2135413,334513,330279,10318,340597,5411
2021-09-08,San Diego,073,3302833,346154,341437,20346,361783,3926
2021-09-08,San Francisco,075,870044,49082,48263,2043,50306,589
2021-09-08,San Joaquin,077,732212,91119,89631,4730,94361,1561
2021-09-08,San Luis Obispo,079,281455,26972,26303,1025,27328,294
2021-09-08,San Mateo,081,765935,50910,50051,744,50795,561
2021-09-08,Santa Barbara,083,443738,40969,40000,1404,41404,490
2021-09-08,Santa Clara,085,1922200,138546,136836,1042,137878,1810
2021-09-08,Santa Cruz,087,273765,19002,18699,951,19650,210
2021-09-08,Shasta,089,179085,17106,16227,2636,18863,234
2021-09-08,Sierra,091,2930,129,113,13,126,0
2021-09-08,Siskiyou,093,43540,2813,2643,919,3562,35
2021-09-08,Solano,095,438530,43004,41971,1075,43046,302
2021-09-08,Sonoma,097,501317,38552,38075,459,38534,360
2021-09-08,Stanislaus,099,539301,69909,68945,7763,76708,1074
2021-09-08,Sutter,101,95872,12534,12349,203,12552,144
2021-09-08,Tehama,103,63373,6792,6520,1067,7587,75
2021-09-08,Trinity,105,12862,673,520,174,694,6
2021-09-08,Tulare,107,460477,59366,57425,11841,69266,876
2021-09-08,Tuolumne,109,53932,5917,5783,65,5848,89
2021-09-08,Ventura,111,848112,93064,91345,3984,95329,1096
2021-09-08,Yolo,113,214977,18033,17680,777,18457,239
2021-09-08,Yuba,115,75493,8844,8675,190,8865,55
2021-09-07,Alameda,001,1643700,111699,110550,2498,113048,1301
2021-09-07,Alpine,003,1148,96,94,0,94,0
2021-09-07,Amador,005,37829,4764,4679,45,4724,53
2021-09-07,Butte,007,227075,17344,16723,3064,19787,220
2021-09-07,Calaveras,009,45235,3209,3140,20,3160,63
2021-09-07,Colusa,011,21464,2353,2306,509,2815,16
2021-09-07,Contra Costa,013,1133247,92419,91167,1824,92991,891
2021-09-07,Del Norte,015,27424,3246,3081,20,3101,24
2021-09-07,El Dorado,017,186661,14229,13892,1392,15284,119
2021-09-07,Fresno,019,978130,122672,120268,10822,131090,1828
2021-09-07,Glenn,021,27897,3049,2937,862,3799,20
2021-09-07,Humboldt,023,135768,7616,7397,324,7721,52
2021-09-07,Imperial,025,180216,30896,30584,2880,33464,751
2021-09-07,Inyo,027,18085,1602,1579,29,1608,39
2021-09-07,Kern,029,883053,113259,110674,16555,127229,1408
2021-09-07,Kings,031,150075,27923,27169,1502,28671,267
2021-09-07,Lake,033,64148,5808,5597,99,5696,78
2021-09-07,Lassen,035,31185,5991,5842,210,6052,21
2021-09-07,Los Angeles,037,10098052,1375426,1360407,49810,1410217,25486
2021-09-07,Madera,039,155013,19880,19316,1516,20832,249
2021-09-07,Marin,041,260295,16568,16363,366,16729,242
2021-09-07,Mariposa,043,17540,817,771,27,798,5
2021-09-07,Mendocino,045,87422,6321,6036,248,6284,61
2021-09-07,Merced,047,269075,37003,36400,1410,37810,513
2021-09-07,Modoc,049,8938,458,449,158,607,5
2021-09-07,Mono,051,14174,1445,1416,18,1434,3
2021-09-07,Monterey,053,433212,46656,45911,2427,48338,543
2021-09-07,Napa,055,140530,11969,11814,76,11890,90
2021-09-07,Nevada,057,99092,8017,7829,261,8090,82
2021-09-07,Orange,059,3164182,292458,288225,13589,301814,5274
2021-09-07,Placer,061,380077,32624,31710,2964,34674,337
2021-09-07,Plumas,063,18699,1149,1071,22,1093,5
2021-09-07,Riverside,065,2383286,339802,333390,15458,348848,4666
2021-09-07,Sacramento,067,1510023,142979,142364,3337,145701,1905
2021-09-07,San Benito,069,59416,6822,6786,136,6922,64
2021-09-07,San Bernardino,071,2135413,333761,329962,10293,340255,5407
2021-09-07,San Diego,073,3302833,345156,340709,20280,360989,3922
2021-09-07,San Francisco,075,870044,48942,48175,2038,50213,589
2021-09-07,San Joaquin,077,732212,90783,89468,4716,94184,1548
2021-09-07,San Luis Obispo,079,281455,26855,26253,1016,27269,287
2021-09-07,San Mateo,081,765935,50814,49913,743,50656,561
2021-09-07,Santa Barbara,083,443738,40843,39957,1399,41356,489
2021-09-07,Santa Clara,085,1922200,138257,136631,1037,137668,1807
2021-09-07,Santa Cruz,087,273765,18953,18669,949,19618,210
2021-09-07,Shasta,089,179085,16950,16096,2584,18680,226
2021-09-07,Sierra,091,2930,129,111,13,124,0
2021-09-07,Siskiyou,093,43540,2787,2607,902,3509,34
2021-09-07,Solano,095,438530,42874,41862,1071,42933,300
2021-09-07,Sonoma,097,501317,38468,38013,457,38470,358
2021-09-07,Stanislaus,099,539301,69638,68831,7736,76567,1074
2021-09-07,Sutter,101,95872,12460,12310,197,12507,138
2021-09-07,Tehama,103,63373,6740,6482,1047,7529,74
2021-09-07,Trinity,105,12862,667,517,174,691,6
2021-09-07,Tulare,107,460477,59016,57228,11762,68990,874
2021-09-07,Tuolumne,109,53932,5880,5759,65,5824,88
2021-09-07,Ventura,111,848112,92853,91246,3974,95220,1093
2021-09-07,Yolo,113,214977,17963,17653,775,18428,235
2021-09-07,Yuba,115,75493,8801,8642,185,8827,55
2021-09-06,Alameda,001,1643700,111386,110357,2490,112847,1301
2021-09-06,Alpine,003,1148,94,94,0,94,0
2021-09-06,Amador,005,37829,4748,4648,44,4692,53
2021-09-06,Butte,007,227075,17153,16588,3021,19609,218
2021-09-06,Calaveras,009,45235,3187,3122,20,3142,63
2021-09-06,Colusa,011,21464,2346,2306,505,2811,16
2021-09-06,Contra Costa,013,1133247,92123,90971,1814,92785,891
2021-09-06,Del Norte,015,27424,3205,3037,19,3056,24
2021-09-06,El Dorado,017,186661,14160,13848,1376,15224,119
2021-09-06,Fresno,019,978130,122095,119738,10747,130485,1828
2021-09-06,Glenn,021,27897,3020,2912,854,3766,20
2021-09-06,Humboldt,023,135768,7540,7320,306,7626,52
2021-09-06,Imperial,025,180216,30834,30576,2874,33450,751
2021-09-06,Inyo,027,18085,1593,1578,17,1595,39
2021-09-06,Kern,029,883053,112746,110347,16367,126714,1408
2021-09-06,Kings,031,150075,27780,27094,1487,28581,264
2021-09-06,Lake,033,64148,5744,5548,92,5640,78
2021-09-06,Lassen,035,31185,5965,5822,200,6022,21
2021-09-06,Los Angeles,037,10098052,1373050,1359348,49696,1409044,25477
2021-09-06,Madera,039,155013,19777,19191,1493,20684,249
2021-09-06,Marin,041,260295,16528,16356,366,16722,242
2021-09-06,Mariposa,043,17540,805,764,27,791,5
2021-09-06,Mendocino,045,87422,6251,5984,235,6219,61
2021-09-06,Merced,047,269075,36789,36300,1396,37696,513
2021-09-06,Modoc,049,8938,455,449,158,607,5
2021-09-06,Mono,051,14174,1441,1416,18,1434,3
2021-09-06,Monterey,053,433212,46562,45833,2411,48244,541
2021-09-06,Napa,055,140530,11926,11792,75,11867,90
2021-09-06,Nevada,057,99092,7969,7748,259,8007,82
2021-09-06,Orange,059,3164182,291964,287948,13538,301486,5274
2021-09-06,Placer,061,380077,32447,31595,2926,34521,337
2021-09-06,Plumas,063,18699,1128,1068,19,1087,5
2021-09-06,Riverside,065,2383286,338986,333052,15438,348490,4666
2021-09-06,Sacramento,067,1510023,142343,141730,3269,144999,1905
2021-09-06,San Benito,069,59416,6799,6777,133,6910,64
2021-09-06,San Bernardino,071,2135413,332871,329693,10262,339955,5398
2021-09-06,San Diego,073,3302833,344157,340222,20183,360405,3922
2021-09-06,San Francisco,075,870044,48808,48120,2033,50153,589
2021-09-06,San Joaquin,077,732212,90439,89293,4690,93983,1548
2021-09-06,San Luis Obispo,079,281455,26726,26183,1012,27195,286
2021-09-06,San Mateo,081,765935,50684,49859,741,50600,561
2021-09-06,Santa Barbara,083,443738,40712,39876,1390,41266,489
2021-09-06,Santa Clara,085,1922200,137965,136458,1035,137493,1807
2021-09-06,Santa Cruz,087,273765,18905,18615,946,19561,210
2021-09-06,Shasta,089,179085,16769,15985,2530,18515,226
2021-09-06,Sierra,091,2930,129,109,13,122,0
2021-09-06,Siskiyou,093,43540,2743,2595,868,3463,34
2021-09-06,Solano,095,438530,42726,41774,1065,42839,300
2021-09-06,Sonoma,097,501317,38347,37929,456,38385,358
2021-09-06,Stanislaus,099,539301,69296,68596,7692,76288,1074
2021-09-06,Sutter,101,95872,12398,12238,188,12426,138
2021-09-06,Tehama,103,63373,6678,6413,1020,7433,74
2021-09-06,Trinity,105,12862,664,515,172,687,6
2021-09-06,Tulare,107,460477,58655,57068,11681,68749,874
2021-09-06,Tuolumne,109,53932,5844,5697,65,5762,88
2021-09-06,Ventura,111,848112,92676,91132,3962,95094,1093
2021-09-06,Yolo,113,214977,17877,17576,770,18346,235
2021-09-06,Yuba,115,75493,8751,8584,181,8765,55
2021-09-05,Alameda,001,1643700,111193,110173,2487,112660,1301
2021-09-05,Alpine,003,1148,94,94,0,94,0
2021-09-05,Amador,005,37829,4736,4642,44,4686,53
2021-09-05,Butte,007,227075,17063,16504,2992,19496,218
2021-09-05,Calaveras,009,45235,3181,3106,20,3126,63
2021-09-05,Colusa,011,21464,2338,2305,503,2808,16
2021-09-05,Contra Costa,013,1133247,91938,90862,1809,92671,891
2021-09-05,Del Norte,015,27424,3185,3023,19,3042,24
2021-09-05,El Dorado,017,186661,14131,13827,1363,15190,119
2021-09-05,Fresno,019,978130,121797,119384,10706,130090,1828
2021-09-05,Glenn,021,27897,3006,2899,852,3751,20
2021-09-05,Humboldt,023,135768,7507,7312,303,7615,52
2021-09-05,Imperial,025,180216,30805,30548,2872,33420,751
2021-09-05,Inyo,027,18085,1590,1572,17,1589,39
2021-09-05,Kern,029,883053,112447,110073,16208,126281,1408
2021-09-05,Kings,031,150075,27703,26989,1483,28472,264
2021-09-05,Lake,033,64148,5724,5525,92,5617,78
2021-09-05,Lassen,035,31185,5943,5820,196,6016,21
2021-09-05,Los Angeles,037,10098052,1371753,1357748,49629,1407377,25465
2021-09-05,Madera,039,155013,19736,19155,1482,20637,249
2021-09-05,Marin,041,260295,16509,16342,365,16707,242
2021-09-05,Mariposa,043,17540,801,761,27,788,5
2021-09-05,Mendocino,045,87422,6217,5965,235,6200,61
2021-09-05,Merced,047,269075,36714,36243,1394,37637,513
2021-09-05,Modoc,049,8938,455,447,158,605,5
2021-09-05,Mono,051,14174,1441,1416,18,1434,3
2021-09-05,Monterey,053,433212,46534,45795,2402,48197,540
2021-09-05,Napa,055,140530,11901,11770,75,11845,90
2021-09-05,Nevada,057,99092,7947,7722,258,7980,82
2021-09-05,Orange,059,3164182,291676,287614,13521,301135,5274
2021-09-05,Placer,061,380077,32320,31487,2912,34399,337
2021-09-05,Plumas,063,18699,1121,1067,19,1086,5
2021-09-05,Riverside,065,2383286,338531,332604,15426,348030,4654
2021-09-05,Sacramento,067,1510023,141905,141276,3251,144527,1905
2021-09-05,San Benito,069,59416,6798,6764,133,6897,64
2021-09-05,San Bernardino,071,2135413,332487,329062,10246,339308,5392
2021-09-05,San Diego,073,3302833,343605,339427,20142,359569,3914
2021-09-05,San Francisco,075,870044,48729,48035,2029,50064,589
2021-09-05,San Joaquin,077,732212,90273,89121,4673,93794,1548
2021-09-05,San Luis Obispo,079,281455,26676,26098,1011,27109,285
2021-09-05,San Mateo,081,765935,50616,49809,737,50546,561
2021-09-05,Santa Barbara,083,443738,40645,39762,1388,41150,489
2021-09-05,Santa Clara,085,1922200,137755,136146,1033,137179,1807
2021-09-05,Santa Cruz,087,273765,18885,18588,944,19532,210
2021-09-05,Shasta,089,179085,16687,15960,2504,18464,226
2021-09-05,Sierra,091,2930,128,109,13,122,0
2021-09-05,Siskiyou,093,43540,2726,2585,854,3439,34
2021-09-05,Solano,095,438530,42631,41687,1060,42747,300
2021-09-05,Sonoma,097,501317,38262,37881,455,38336,358
2021-09-05,Stanislaus,099,539301,69156,68434,7668,76102,1074
2021-09-05,Sutter,101,95872,12368,12179,182,12361,138
2021-09-05,Tehama,103,63373,6651,6400,1014,7414,74
2021-09-05,Trinity,105,12862,658,505,171,676,6
2021-09-05,Tulare,107,460477,58486,56915,11637,68552,874
2021-09-05,Tuolumne,109,53932,5832,5688,65,5753,88
2021-09-05,Ventura,111,848112,92540,91004,3958,94962,1093
2021-09-05,Yolo,113,214977,17840,17557,765,18322,235
2021-09-05,Yuba,115,75493,8725,8521,179,8700,55
2021-09-04,Alameda,001,1643700,111070,109944,2480,112424,1301
2021-09-04,Alpine,003,1148,94,94,0,94,0
2021-09-04,Amador,005,37829,4718,4637,43,4680,53
2021-09-04,Butte,007,227075,17005,16403,2977,19380,218
2021-09-04,Calaveras,009,45235,3169,3087,19,3106,63
2021-09-04,Colusa,011,21464,2336,2301,503,2804,16
2021-09-04,Contra Costa,013,1133247,91821,90623,1806,92429,891
2021-09-04,Del Norte,015,27424,3174,2984,19,3003,24
2021-09-04,El Dorado,017,186661,14105,13782,1355,15137,119
2021-09-04,Fresno,019,978130,121602,119033,10686,129719,1828
2021-09-04,Glenn,021,27897,2996,2878,846,3724,20
2021-09-04,Humboldt,023,135768,7476,7298,297,7595,52
2021-09-04,Imperial,025,180216,30782,30526,2870,33396,751
2021-09-04,Inyo,027,18085,1588,1571,17,1588,39
2021-09-04,Kern,029,883053,112204,109751,16078,125829,1408
2021-09-04,Kings,031,150075,27616,26896,1477,28373,263
2021-09-04,Lake,033,64148,5706,5507,92,5599,78
2021-09-04,Lassen,035,31185,5928,5814,188,6002,21
2021-09-04,Los Angeles,037,10098052,1370796,1355634,49572,1405206,25454
2021-09-04,Madera,039,155013,19703,19112,1475,20587,249
2021-09-04,Marin,041,260295,16493,16319,364,16683,242
2021-09-04,Mariposa,043,17540,796,759,27,786,5
2021-09-04,Mendocino,045,87422,6181,5933,235,6168,61
2021-09-04,Merced,047,269075,36670,36083,1389,37472,513
2021-09-04,Modoc,049,8938,455,447,158,605,5
2021-09-04,Mono,051,14174,1438,1417,18,1435,3
2021-09-04,Monterey,053,433212,46503,45756,2398,48154,540
2021-09-04,Napa,055,140530,11876,11760,73,11833,90
2021-09-04,Nevada,057,99092,7932,7691,257,7948,82
2021-09-04,Orange,059,3164182,291413,287244,13500,300744,5274
2021-09-04,Placer,061,380077,32216,31374,2895,34269,337
2021-09-04,Plumas,063,18699,1113,1067,19,1086,5
2021-09-04,Riverside,065,2383286,338061,331958,15414,347372,4654
2021-09-04,Sacramento,067,1510023,141611,140735,3243,143978,1896
2021-09-04,San Benito,069,59416,6789,6758,133,6891,64
2021-09-04,San Bernardino,071,2135413,332155,328425,10232,338657,5393
2021-09-04,San Diego,073,3302833,343170,338748,20120,358868,3914
2021-09-04,San Francisco,075,870044,48654,47937,2021,49958,589
2021-09-04,San Joaquin,077,732212,90158,88846,4665,93511,1548
2021-09-04,San Luis Obispo,079,281455,26644,26020,1011,27031,285
2021-09-04,San Mateo,081,765935,50562,49721,737,50458,560
2021-09-04,Santa Barbara,083,443738,40579,39667,1386,41053,489
2021-09-04,Santa Clara,085,1922200,137570,135845,1030,136875,1806
2021-09-04,Santa Cruz,087,273765,18867,18579,940,19519,210
2021-09-04,Shasta,089,179085,16610,15924,2478,18402,226
2021-09-04,Sierra,091,2930,126,108,13,121,0
2021-09-04,Siskiyou,093,43540,2700,2563,843,3406,34
2021-09-04,Solano,095,438530,42558,41614,1058,42672,300
2021-09-04,Sonoma,097,501317,38229,37809,455,38264,358
2021-09-04,Stanislaus,099,539301,69009,68210,7643,75853,1074
2021-09-04,Sutter,101,95872,12327,12137,181,12318,138
2021-09-04,Tehama,103,63373,6626,6367,996,7363,74
2021-09-04,Trinity,105,12862,656,497,171,668,6
2021-09-04,Tulare,107,460477,58378,56719,11594,68313,874
2021-09-04,Tuolumne,109,53932,5813,5667,63,5730,88
2021-09-04,Ventura,111,848112,92405,90904,3955,94859,1090
2021-09-04,Yolo,113,214977,17804,17522,761,18283,235
2021-09-04,Yuba,115,75493,8696,8475,178,8653,55
2021-09-03,Alameda,001,1643700,110910,109636,2478,112114,1301
2021-09-03,Alpine,003,1148,94,94,0,94,0
2021-09-03,Amador,005,37829,4696,4614,43,4657,53
2021-09-03,Butte,007,227075,16914,16259,2951,19210,215
2021-09-03,Calaveras,009,45235,3159,3069,19,3088,63
2021-09-03,Colusa,011,21464,2331,2295,502,2797,16
2021-09-03,Contra Costa,013,1133247,91669,90299,1803,92102,886
2021-09-03,Del Norte,015,27424,3146,2943,18,2961,24
2021-09-03,El Dorado,017,186661,14072,13710,1351,15061,119
2021-09-03,Fresno,019,978130,121266,118508,10664,129172,1822
2021-09-03,Glenn,021,27897,2987,2867,838,3705,20
2021-09-03,Humboldt,023,135768,7451,7194,292,7486,52
2021-09-03,Imperial,025,180216,30758,30475,2865,33340,751
2021-09-03,Inyo,027,18085,1583,1567,17,1584,39
2021-09-03,Kern,029,883053,111988,109296,15967,125263,1407
2021-09-03,Kings,031,150075,27532,26753,1474,28227,263
2021-09-03,Lake,033,64148,5686,5479,90,5569,78
2021-09-03,Lassen,035,31185,5911,5789,184,5973,21
2021-09-03,Los Angeles,037,10098052,1369465,1351185,49507,1400692,25384
2021-09-03,Madera,039,155013,19618,19021,1469,20490,247
2021-09-03,Marin,041,260295,16471,16293,363,16656,242
2021-09-03,Mariposa,043,17540,789,753,25,778,5
2021-09-03,Mendocino,045,87422,6146,5891,235,6126,61
2021-09-03,Merced,047,269075,36616,35941,1380,37321,512
2021-09-03,Modoc,049,8938,455,445,158,603,5
2021-09-03,Mono,051,14174,1437,1410,18,1428,3
2021-09-03,Monterey,053,433212,46465,45707,2394,48101,540
2021-09-03,Napa,055,140530,11855,11733,73,11806,89
2021-09-03,Nevada,057,99092,7898,7632,257,7889,82
2021-09-03,Orange,059,3164182,291095,286818,13473,300291,5253
2021-09-03,Placer,061,380077,32109,31238,2871,34109,335
2021-09-03,Plumas,063,18699,1102,1057,19,1076,5
2021-09-03,Riverside,065,2383286,337529,331011,15398,346409,4653
2021-09-03,Sacramento,067,1510023,141247,139982,3225,143207,1886
2021-09-03,San Benito,069,59416,6783,6746,133,6879,64
2021-09-03,San Bernardino,071,2135413,331738,327599,10222,337821,5381
2021-09-03,San Diego,073,3302833,342550,337627,20087,357714,3911
2021-09-03,San Francisco,075,870044,48578,47822,2015,49837,589
2021-09-03,San Joaquin,077,732212,90005,88366,4657,93023,1540
2021-09-03,San Luis Obispo,079,281455,26569,25917,1009,26926,283
2021-09-03,San Mateo,081,765935,50467,49617,735,50352,560
2021-09-03,Santa Barbara,083,443738,40512,39507,1383,40890,489
2021-09-03,Santa Clara,085,1922200,137368,135522,1026,136548,1801
2021-09-03,Santa Cruz,087,273765,18842,18532,940,19472,210
2021-09-03,Shasta,089,179085,16535,15778,2454,18232,226
2021-09-03,Sierra,091,2930,124,105,13,118,0
2021-09-03,Siskiyou,093,43540,2688,2529,830,3359,34
2021-09-03,Solano,095,438530,42462,41457,1055,42512,300
2021-09-03,Sonoma,097,501317,38166,37699,455,38154,358
2021-09-03,Stanislaus,099,539301,68833,67887,7617,75504,1074
2021-09-03,Sutter,101,95872,12288,12073,180,12253,139
2021-09-03,Tehama,103,63373,6587,6334,989,7323,72
2021-09-03,Trinity,105,12862,654,490,167,657,6
2021-09-03,Tulare,107,460477,58252,56401,11542,67943,872
2021-09-03,Tuolumne,109,53932,5771,5630,63,5693,88
2021-09-03,Ventura,111,848112,92271,90742,3951,94693,1088
2021-09-03,Yolo,113,214977,17780,17446,757,18203,235
2021-09-03,Yuba,115,75493,8665,8412,178,8590,55
2021-09-02,Alameda,001,1643700,110652,109377,2475,111852,1301
2021-09-02,Alpine,003,1148,93,92,0,92,0
2021-09-02,Amador,005,37829,4680,4606,43,4649,53
2021-09-02,Butte,007,227075,16787,16154,2932,19086,215
2021-09-02,Calaveras,009,45235,3146,3042,19,3061,62
2021-09-02,Colusa,011,21464,2327,2290,502,2792,16
2021-09-02,Contra Costa,013,1133247,91487,90038,1792,91830,886
2021-09-02,Del Norte,015,27424,3115,2891,18,2909,24
2021-09-02,El Dorado,017,186661,14014,13641,1326,14967,119
2021-09-02,Fresno,019,978130,120778,117974,10610,128584,1804
2021-09-02,Glenn,021,27897,2971,2855,832,3687,20
2021-09-02,Humboldt,023,135768,7404,7141,281,7422,52
2021-09-02,Imperial,025,180216,30714,30449,2860,33309,751
2021-09-02,Inyo,027,18085,1578,1564,16,1580,39
2021-09-02,Kern,029,883053,111575,108930,15823,124753,1404
2021-09-02,Kings,031,150075,27439,26638,1464,28102,263
2021-09-02,Lake,033,64148,5656,5432,86,5518,78
2021-09-02,Lassen,035,31185,5897,5747,177,5924,21
2021-09-02,Los Angeles,037,10098052,1367608,1351105,49415,1400520,25382
2021-09-02,Madera,039,155013,19527,18937,1451,20388,247
2021-09-02,Marin,041,260295,16458,16244,361,16605,242
2021-09-02,Mariposa,043,17540,782,745,22,767,5
2021-09-02,Mendocino,045,87422,6104,5848,232,6080,61
2021-09-02,Merced,047,269075,36453,35820,1373,37193,508
2021-09-02,Modoc,049,8938,455,437,158,595,5
2021-09-02,Mono,051,14174,1437,1409,18,1427,3
2021-09-02,Monterey,053,433212,46399,45648,2379,48027,539
2021-09-02,Napa,055,140530,11826,11684,73,11757,88
2021-09-02,Nevada,057,99092,7846,7575,256,7831,82
2021-09-02,Orange,059,3164182,290635,286326,13439,299765,5240
2021-09-02,Placer,061,380077,31971,31067,2842,33909,330
2021-09-02,Plumas,063,18699,1091,1045,18,1063,5
2021-09-02,Riverside,065,2383286,336813,330190,15374,345564,4644
2021-09-02,Sacramento,067,1510023,140666,139274,3185,142459,1882
2021-09-02,San Benito,069,59416,6778,6734,132,6866,64
2021-09-02,San Bernardino,071,2135413,331128,326940,10149,337089,5369
2021-09-02,San Diego,073,3302833,341592,336382,20034,356416,3909
2021-09-02,San Francisco,075,870044,48468,47674,2011,49685,587
2021-09-02,San Joaquin,077,732212,89721,88056,4633,92689,1540
2021-09-02,San Luis Obispo,079,281455,26484,25851,1004,26855,283
2021-09-02,San Mateo,081,765935,50366,49490,733,50223,558
2021-09-02,Santa Barbara,083,443738,40422,39386,1370,40756,486
2021-09-02,Santa Clara,085,1922200,137067,135216,1020,136236,1799
2021-09-02,Santa Cruz,087,273765,18808,18473,937,19410,210
2021-09-02,Shasta,089,179085,16397,15670,2425,18095,224
2021-09-02,Sierra,091,2930,124,105,13,118,0
2021-09-02,Siskiyou,093,43540,2667,2513,802,3315,34
2021-09-02,Solano,095,438530,42356,41293,1052,42345,294
2021-09-02,Sonoma,097,501317,38085,37558,455,38013,352
2021-09-02,Stanislaus,099,539301,68592,67576,7597,75173,1074
2021-09-02,Sutter,101,95872,12219,11995,176,12171,138
2021-09-02,Tehama,103,63373,6529,6265,970,7235,72
2021-09-02,Trinity,105,12862,650,484,165,649,6
2021-09-02,Tulare,107,460477,58022,56105,11489,67594,872
2021-09-02,Tuolumne,109,53932,5714,5578,63,5641,88
2021-09-02,Ventura,111,848112,92088,90610,3946,94556,1084
2021-09-02,Yolo,113,214977,17705,17357,751,18108,235
2021-09-02,Yuba,115,75493,8605,8363,178,8541,55
2021-09-01,Alameda,001,1643700,110384,109075,2470,111545,1299
2021-09-01,Alpine,003,1148,93,92,0,92,0
2021-09-01,Amador,005,37829,4664,4599,42,4641,53
2021-09-01,Butte,007,227075,16672,16046,2904,18950,215
2021-09-01,Calaveras,009,45235,3134,3023,19,3042,59
2021-09-01,Colusa,011,21464,2322,2281,501,2782,16
2021-09-01,Contra Costa,013,1133247,91251,89834,1785,91619,877
2021-09-01,Del Norte,015,27424,3082,2860,18,2878,24
2021-09-01,El Dorado,017,186661,13958,13577,1297,14874,119
2021-09-01,Fresno,019,978130,120287,117492,10540,128032,1800
2021-09-01,Glenn,021,27897,2946,2846,824,3670,20
2021-09-01,Humboldt,023,135768,7357,7090,274,7364,52
2021-09-01,Imperial,025,180216,30676,30393,2855,33248,750
2021-09-01,Inyo,027,18085,1574,1561,15,1576,39
2021-09-01,Kern,029,883053,111145,108449,15685,124134,1400
2021-09-01,Kings,031,150075,27326,26443,1453,27896,263
2021-09-01,Lake,033,64148,5615,5396,81,5477,77
2021-09-01,Lassen,035,31185,5875,5731,173,5904,21
2021-09-01,Los Angeles,037,10098052,1365343,1348589,49314,1397903,25341
2021-09-01,Madera,039,155013,19449,18852,1436,20288,247
2021-09-01,Marin,041,260295,16436,16224,356,16580,240
2021-09-01,Mariposa,043,17540,774,735,22,757,5
2021-09-01,Mendocino,045,87422,6061,5821,227,6048,59
2021-09-01,Merced,047,269075,36275,35686,1363,37049,500
2021-09-01,Modoc,049,8938,449,436,156,592,5
2021-09-01,Mono,051,14174,1437,1400,18,1418,3
2021-09-01,Monterey,053,433212,46319,45590,2364,47954,539
2021-09-01,Napa,055,140530,11793,11653,73,11726,88
2021-09-01,Nevada,057,99092,7793,7508,255,7763,82
2021-09-01,Orange,059,3164182,290161,285840,13402,299242,5233
2021-09-01,Placer,061,380077,31814,30902,2828,33730,330
2021-09-01,Plumas,063,18699,1083,1033,18,1051,5
2021-09-01,Riverside,065,2383286,336001,329388,15344,344732,4634
2021-09-01,Sacramento,067,1510023,140058,138499,3140,141639,1875
2021-09-01,San Benito,069,59416,6761,6716,132,6848,64
2021-09-01,San Bernardino,071,2135413,330482,326250,10120,336370,5364
2021-09-01,San Diego,073,3302833,340570,335302,19978,355280,3908
2021-09-01,San Francisco,075,870044,48360,47538,2004,49542,584
2021-09-01,San Joaquin,077,732212,89399,87640,4610,92250,1540
2021-09-01,San Luis Obispo,079,281455,26388,25691,999,26690,283
2021-09-01,San Mateo,081,765935,50247,49394,727,50121,558
2021-09-01,Santa Barbara,083,443738,40304,39263,1354,40617,483
2021-09-01,Santa Clara,085,1922200,136799,134855,1014,135869,1796
2021-09-01,Santa Cruz,087,273765,18761,18453,935,19388,210
2021-09-01,Shasta,089,179085,16265,15552,2385,17937,221
2021-09-01,Sierra,091,2930,123,98,13,111,0
2021-09-01,Siskiyou,093,43540,2637,2482,782,3264,34
2021-09-01,Solano,095,438530,42205,41194,1046,42240,293
2021-09-01,Sonoma,097,501317,37991,37454,454,37908,352
2021-09-01,Stanislaus,099,539301,68307,67287,7566,74853,1075
2021-09-01,Sutter,101,95872,12155,11945,169,12114,136
2021-09-01,Tehama,103,63373,6495,6228,953,7181,72
2021-09-01,Trinity,105,12862,649,482,162,644,5
2021-09-01,Tulare,107,460477,57739,55768,11452,67220,870
2021-09-01,Tuolumne,109,53932,5675,5553,63,5616,88
2021-09-01,Ventura,111,848112,91873,90471,3930,94401,1089
2021-09-01,Yolo,113,214977,17645,17264,749,18013,235
2021-09-01,Yuba,115,75493,8543,8308,178,8486,55
2021-08-31,Alameda,001,1643700,110091,108837,2464,111301,1297
2021-08-31,Alpine,003,1148,91,92,0,92,0
2021-08-31,Amador,005,37829,4643,4555,42,4597,53
2021-08-31,Butte,007,227075,16531,15896,2863,18759,216
2021-08-31,Calaveras,009,45235,3094,3008,19,3027,59
2021-08-31,Colusa,011,21464,2320,2275,499,2774,16
2021-08-31,Contra Costa,013,1133247,90956,89546,1773,91319,871
2021-08-31,Del Norte,015,27424,3046,2830,18,2848,19
2021-08-31,El Dorado,017,186661,13887,13539,1279,14818,119
2021-08-31,Fresno,019,978130,119711,117155,10460,127615,1801
2021-08-31,Glenn,021,27897,2930,2829,814,3643,20
2021-08-31,Humboldt,023,135768,7282,7030,261,7291,52
2021-08-31,Imperial,025,180216,30639,30348,2847,33195,750
2021-08-31,Inyo,027,18085,1570,1550,15,1565,39
2021-08-31,Kern,029,883053,110643,108151,15506,123657,1393
2021-08-31,Kings,031,150075,27185,26405,1439,27844,260
2021-08-31,Lake,033,64148,5571,5359,80,5439,74
2021-08-31,Lassen,035,31185,5849,5702,170,5872,21
2021-08-31,Los Angeles,037,10098052,1362751,1346686,49237,1395923,25303
2021-08-31,Madera,039,155013,19359,18811,1419,20230,247
2021-08-31,Marin,041,260295,16407,16215,353,16568,240
2021-08-31,Mariposa,043,17540,766,732,22,754,5
2021-08-31,Mendocino,045,87422,6019,5777,226,6003,59
2021-08-31,Merced,047,269075,36105,35512,1358,36870,498
2021-08-31,Modoc,049,8938,448,436,156,592,5
2021-08-31,Mono,051,14174,1425,1398,18,1416,3
2021-08-31,Monterey,053,433212,46235,45550,2351,47901,539
2021-08-31,Napa,055,140530,11745,11618,73,11691,88
2021-08-31,Nevada,057,99092,7727,7460,255,7715,82
2021-08-31,Orange,059,3164182,289562,285310,13370,298680,5229
2021-08-31,Placer,061,380077,31624,30745,2791,33536,325
2021-08-31,Plumas,063,18699,1079,1018,17,1035,5
2021-08-31,Riverside,065,2383286,335029,328556,15311,343867,4627
2021-08-31,Sacramento,067,1510023,139374,137879,3108,140987,1863
2021-08-31,San Benito,069,59416,6749,6694,130,6824,64
2021-08-31,San Bernardino,071,2135413,329733,325446,10100,335546,5350
2021-08-31,San Diego,073,3302833,339317,334377,19920,354297,3888
2021-08-31,San Francisco,075,870044,48210,47440,1993,49433,581
2021-08-31,San Joaquin,077,732212,88955,87365,4595,91960,1540
2021-08-31,San Luis Obispo,079,281455,26265,25518,995,26513,282
2021-08-31,San Mateo,081,765935,50135,49299,727,50026,556
2021-08-31,Santa Barbara,083,443738,40154,39091,1348,40439,481
2021-08-31,Santa Clara,085,1922200,136446,134637,1007,135644,1793
2021-08-31,Santa Cruz,087,273765,18723,18419,932,19351,210
2021-08-31,Shasta,089,179085,16113,15368,2358,17726,220
2021-08-31,Sierra,091,2930,120,95,13,108,0
2021-08-31,Siskiyou,093,43540,2617,2435,766,3201,33
2021-08-31,Solano,095,438530,42065,41067,1040,42107,289
2021-08-31,Sonoma,097,501317,37895,37379,453,37832,352
2021-08-31,Stanislaus,099,539301,67952,67004,7531,74535,1075
2021-08-31,Sutter,101,95872,12090,11901,165,12066,136
2021-08-31,Tehama,103,63373,6434,6169,922,7091,72
2021-08-31,Trinity,105,12862,643,480,162,642,3
2021-08-31,Tulare,107,460477,57405,55567,11382,66949,870
2021-08-31,Tuolumne,109,53932,5639,5516,63,5579,88
2021-08-31,Ventura,111,848112,91654,90292,3918,94210,1081
2021-08-31,Yolo,113,214977,17559,17205,747,17952,234
2021-08-31,Yuba,115,75493,8489,8253,178,8431,54
2021-08-30,Alameda,001,1643700,109774,107734,2453,110187,1296
2021-08-30,Alpine,003,1148,91,92,0,92,0
2021-08-30,Amador,005,37829,4632,4507,42,4549,53
2021-08-30,Butte,007,227075,16379,15719,2830,18549,214
2021-08-30,Calaveras,009,45235,3079,2975,19,2994,59
2021-08-30,Colusa,011,21464,2311,2271,496,2767,16
2021-08-30,Contra Costa,013,1133247,90696,87679,1763,89442,872
2021-08-30,Del Norte,015,27424,3004,2796,17,2813,11
2021-08-30,El Dorado,017,186661,13818,13217,1262,14479,119
2021-08-30,Fresno,019,978130,119140,115867,10388,126255,1790
2021-08-30,Glenn,021,27897,2919,2804,808,3612,20
2021-08-30,Humboldt,023,135768,7228,6930,255,7185,52
2021-08-30,Imperial,025,180216,30601,30311,2842,33153,750
2021-08-30,Inyo,027,18085,1565,1544,15,1559,39
2021-08-30,Kern,029,883053,110165,107615,15344,122959,1389
2021-08-30,Kings,031,150075,27069,26236,1424,27660,259
2021-08-30,Lake,033,64148,5536,5323,77,5400,74
2021-08-30,Lassen,035,31185,5827,5667,164,5831,21
2021-08-30,Los Angeles,037,10098052,1360292,1344949,49152,1394101,25269
2021-08-30,Madera,039,155013,19277,18622,1399,20021,247
2021-08-30,Marin,041,260295,16376,16160,353,16513,240
2021-08-30,Mariposa,043,17540,760,715,21,736,5
2021-08-30,Mendocino,045,87422,5985,5721,222,5943,55
2021-08-30,Merced,047,269075,35977,35335,1354,36689,497
2021-08-30,Modoc,049,8938,446,436,155,591,5
2021-08-30,Mono,051,14174,1424,1390,18,1408,3
2021-08-30,Monterey,053,433212,46173,45463,2334,47797,539
2021-08-30,Napa,055,140530,11696,11579,71,11650,87
2021-08-30,Nevada,057,99092,7668,7356,252,7608,82
2021-08-30,Orange,059,3164182,288980,284750,13321,298071,5223
2021-08-30,Placer,061,380077,31459,29825,2768,32593,319
2021-08-30,Plumas,063,18699,1062,998,17,1015,5
2021-08-30,Riverside,065,2383286,334139,327593,15280,342873,4623
2021-08-30,Sacramento,067,1510023,138716,134571,3062,137633,1847
2021-08-30,San Benito,069,59416,6740,6663,130,6793,64
2021-08-30,San Bernardino,071,2135413,329055,324870,10070,334940,5348
2021-08-30,San Diego,073,3302833,338046,333011,19840,352851,3885
2021-08-30,San Francisco,075,870044,48069,46966,1980,48946,581
2021-08-30,San Joaquin,077,732212,88624,86203,4574,90777,1528
2021-08-30,San Luis Obispo,079,281455,26140,25422,988,26410,280
2021-08-30,San Mateo,081,765935,50009,48839,721,49560,554
2021-08-30,Santa Barbara,083,443738,40002,38998,1343,40341,481
2021-08-30,Santa Clara,085,1922200,136125,133281,1000,134281,1789
2021-08-30,Santa Cruz,087,273765,18669,18326,928,19254,210
2021-08-30,Shasta,089,179085,15984,15238,2319,17557,217
2021-08-30,Sierra,091,2930,118,91,13,104,0
2021-08-30,Siskiyou,093,43540,2604,2411,755,3166,33
2021-08-30,Solano,095,438530,41904,39986,1036,41022,290
2021-08-30,Sonoma,097,501317,37790,36764,453,37217,352
2021-08-30,Stanislaus,099,539301,67613,66173,7500,73673,1074
2021-08-30,Sutter,101,95872,12020,11791,158,11949,136
2021-08-30,Tehama,103,63373,6355,6085,898,6983,71
2021-08-30,Trinity,105,12862,632,468,159,627,3
2021-08-30,Tulare,107,460477,57093,55140,11307,66447,870
2021-08-30,Tuolumne,109,53932,5593,5492,63,5555,74
2021-08-30,Ventura,111,848112,91438,90149,3906,94055,1082
2021-08-30,Yolo,113,214977,17497,17071,743,17814,231
2021-08-30,Yuba,115,75493,8415,8129,177,8306,54
2021-08-29,Alameda,001,1643700,109442,107494,2442,109936,1296
2021-08-29,Alpine,003,1148,91,92,0,92,0
2021-08-29,Amador,005,37829,4618,4501,42,4543,53
2021-08-29,Butte,007,227075,16209,15602,2793,18395,214
2021-08-29,Calaveras,009,45235,3047,2970,19,2989,59
2021-08-29,Colusa,011,21464,2304,2260,490,2750,16
2021-08-29,Contra Costa,013,1133247,90399,87439,1758,89197,872
2021-08-29,Del Norte,015,27424,2961,2752,17,2769,11
2021-08-29,El Dorado,017,186661,13762,13166,1251,14417,119
2021-08-29,Fresno,019,978130,118543,115502,10318,125820,1790
2021-08-29,Glenn,021,27897,2901,2778,801,3579,20
2021-08-29,Humboldt,023,135768,7184,6922,240,7162,52
2021-08-29,Imperial,025,180216,30540,30293,2831,33124,750
2021-08-29,Inyo,027,18085,1555,1543,14,1557,39
2021-08-29,Kern,029,883053,109714,107324,15174,122498,1389
2021-08-29,Kings,031,150075,26915,26143,1410,27553,259
2021-08-29,Lake,033,64148,5496,5293,67,5360,74
2021-08-29,Lassen,035,31185,5804,5666,160,5826,21
2021-08-29,Los Angeles,037,10098052,1357544,1342541,49041,1391582,25263
2021-08-29,Madera,039,155013,19190,18594,1383,19977,247
2021-08-29,Marin,041,260295,16345,16134,351,16485,240
2021-08-29,Mariposa,043,17540,754,709,19,728,5
2021-08-29,Mendocino,045,87422,5927,5689,209,5898,55
2021-08-29,Merced,047,269075,35738,35250,1342,36592,497
2021-08-29,Modoc,049,8938,443,436,155,591,5
2021-08-29,Mono,051,14174,1417,1387,18,1405,3
2021-08-29,Monterey,053,433212,46068,45424,2311,47735,539
2021-08-29,Napa,055,140530,11665,11552,71,11623,87
2021-08-29,Nevada,057,99092,7611,7294,251,7545,82
2021-08-29,Orange,059,3164182,288352,284432,13279,297711,5223
2021-08-29,Placer,061,380077,31286,29674,2727,32401,319
2021-08-29,Plumas,063,18699,1051,996,17,1013,5
2021-08-29,Riverside,065,2383286,333280,326987,15259,342246,4623
2021-08-29,Sacramento,067,1510023,137963,133981,3013,136994,1843
2021-08-29,San Benito,069,59416,6715,6646,130,6776,64
2021-08-29,San Bernardino,071,2135413,328270,324266,10037,334303,5347
2021-08-29,San Diego,073,3302833,336940,332014,19745,351759,3880
2021-08-29,San Francisco,075,870044,47934,46885,1968,48853,581
2021-08-29,San Joaquin,077,732212,88176,85922,4554,90476,1528
2021-08-29,San Luis Obispo,079,281455,25942,25288,980,26268,280
2021-08-29,San Mateo,081,765935,49896,48737,716,49453,554
2021-08-29,Santa Barbara,083,443738,39836,38900,1339,40239,481
2021-08-29,Santa Clara,085,1922200,135772,132979,994,133973,1789
2021-08-29,Santa Cruz,087,273765,18622,18285,926,19211,210
2021-08-29,Shasta,089,179085,15830,15198,2292,17490,217
2021-08-29,Sierra,091,2930,116,91,13,104,0
2021-08-29,Siskiyou,093,43540,2557,2407,735,3142,33
2021-08-29,Solano,095,438530,41750,39887,1029,40916,290
2021-08-29,Sonoma,097,501317,37655,36650,449,37099,352
2021-08-29,Stanislaus,099,539301,67268,65956,7464,73420,1074
2021-08-29,Sutter,101,95872,11961,11719,151,11870,136
2021-08-29,Tehama,103,63373,6284,6040,875,6915,71
2021-08-29,Trinity,105,12862,629,468,156,624,3
2021-08-29,Tulare,107,460477,56759,54974,11223,66197,870
2021-08-29,Tuolumne,109,53932,5567,5478,62,5540,74
2021-08-29,Ventura,111,848112,91180,90114,3897,94011,1082
2021-08-29,Yolo,113,214977,17397,17015,730,17745,231
2021-08-29,Yuba,115,75493,8351,8042,177,8219,54
2021-08-28,Alameda,001,1643700,109279,107007,2433,109440,1296
2021-08-28,Alpine,003,1148,91,92,0,92,0
2021-08-28,Amador,005,37829,4599,4484,41,4525,53
2021-08-28,Butte,007,227075,16149,15487,2765,18252,214
2021-08-28,Calaveras,009,45235,3037,2926,19,2945,59
2021-08-28,Colusa,011,21464,2300,2252,488,2740,16
2021-08-28,Contra Costa,013,1133247,90188,86938,1755,88693,872
2021-08-28,Del Norte,015,27424,2934,2734,16,2750,11
2021-08-28,El Dorado,017,186661,13723,13089,1245,14334,119
2021-08-28,Fresno,019,978130,118302,115079,10287,125366,1792
2021-08-28,Glenn,021,27897,2892,2773,794,3567,20
2021-08-28,Humboldt,023,135768,7149,6887,235,7122,52
2021-08-28,Imperial,025,180216,30513,30260,2828,33088,750
2021-08-28,Inyo,027,18085,1553,1539,14,1553,39
2021-08-28,Kern,029,883053,109476,107012,15034,122046,1389
2021-08-28,Kings,031,150075,26848,26059,1407,27466,257
2021-08-28,Lake,033,64148,5473,5267,63,5330,74
2021-08-28,Lassen,035,31185,5789,5665,159,5824,21
2021-08-28,Los Angeles,037,10098052,1356329,1337097,48970,1386067,25234
2021-08-28,Madera,039,155013,19139,18553,1369,19922,247
2021-08-28,Marin,041,260295,16330,16106,351,16457,240
2021-08-28,Mariposa,043,17540,752,704,19,723,5
2021-08-28,Mendocino,045,87422,5902,5658,209,5867,55
2021-08-28,Merced,047,269075,35686,35108,1339,36447,497
2021-08-28,Modoc,049,8938,443,436,154,590,5
2021-08-28,Mono,051,14174,1414,1385,18,1403,3
2021-08-28,Monterey,053,433212,46026,45394,2306,47700,539
2021-08-28,Napa,055,140530,11642,11512,70,11582,88
2021-08-28,Nevada,057,99092,7587,7238,249,7487,82
2021-08-28,Orange,059,3164182,287995,283953,13231,297184,5222
2021-08-28,Placer,061,380077,31177,29428,2714,32142,319
2021-08-28,Plumas,063,18699,1044,991,17,1008,5
2021-08-28,Riverside,065,2383286,332692,326222,15249,341471,4623
2021-08-28,Sacramento,067,1510023,137572,132985,2995,135980,1844
2021-08-28,San Benito,069,59416,6708,6636,130,6766,64
2021-08-28,San Bernardino,071,2135413,327822,323672,10029,333701,5348
2021-08-28,San Diego,073,3302833,336356,331330,19709,351039,3880
2021-08-28,San Francisco,075,870044,47862,46654,1961,48615,581
2021-08-28,San Joaquin,077,732212,88006,85481,4545,90026,1527
2021-08-28,San Luis Obispo,079,281455,25875,25138,975,26113,280
2021-08-28,San Mateo,081,765935,49822,48575,712,49287,554
2021-08-28,Santa Barbara,083,443738,39765,38780,1339,40119,481
2021-08-28,Santa Clara,085,1922200,135566,132488,992,133480,1789
2021-08-28,Santa Cruz,087,273765,18604,18240,923,19163,210
2021-08-28,Shasta,089,179085,15727,15147,2274,17421,217
2021-08-28,Sierra,091,2930,112,91,13,104,0
2021-08-28,Siskiyou,093,43540,2549,2402,724,3126,33
2021-08-28,Solano,095,438530,41701,39610,1028,40638,290
2021-08-28,Sonoma,097,501317,37582,36466,447,36913,352
2021-08-28,Stanislaus,099,539301,67110,65670,7447,73117,1074
2021-08-28,Sutter,101,95872,11940,11669,150,11819,136
2021-08-28,Tehama,103,63373,6258,6004,864,6868,71
2021-08-28,Trinity,105,12862,625,463,155,618,3
2021-08-28,Tulare,107,460477,56629,54746,11181,65927,870
2021-08-28,Tuolumne,109,53932,5551,5469,62,5531,74
2021-08-28,Ventura,111,848112,91062,89934,3895,93829,1081
2021-08-28,Yolo,113,214977,17362,16907,723,17630,231
2021-08-28,Yuba,115,75493,8320,7985,176,8161,55
2021-08-27,Alameda,001,1643700,109068,106622,2431,109053,1296
2021-08-27,Alpine,003,1148,91,92,0,92,0
2021-08-27,Amador,005,37829,4583,4458,40,4498,53
2021-08-27,Butte,007,227075,16069,15277,2744,18021,214
2021-08-27,Calaveras,009,45235,3023,2903,19,2922,59
2021-08-27,Colusa,011,21464,2294,2240,486,2726,16
2021-08-27,Contra Costa,013,1133247,89990,86386,1752,88138,872
2021-08-27,Del Norte,015,27424,2902,2695,16,2711,11
2021-08-27,El Dorado,017,186661,13684,12968,1241,14209,119
2021-08-27,Fresno,019,978130,117867,114481,10266,124747,1774
2021-08-27,Glenn,021,27897,2874,2754,785,3539,20
2021-08-27,Humboldt,023,135768,7116,6782,232,7014,52
2021-08-27,Imperial,025,180216,30493,30201,2826,33027,750
2021-08-27,Inyo,027,18085,1552,1529,14,1543,39
2021-08-27,Kern,029,883053,109182,106570,14924,121494,1385
2021-08-27,Kings,031,150075,26769,25957,1405,27362,257
2021-08-27,Lake,033,64148,5448,5228,62,5290,74
2021-08-27,Lassen,035,31185,5773,5646,154,5800,21
2021-08-27,Los Angeles,037,10098052,1354800,1337006,48909,1385915,25230
2021-08-27,Madera,039,155013,19083,18476,1356,19832,247
2021-08-27,Marin,041,260295,16314,16055,349,16404,240
2021-08-27,Mariposa,043,17540,746,690,19,709,5
2021-08-27,Mendocino,045,87422,5871,5602,208,5810,55
2021-08-27,Merced,047,269075,35632,34906,1331,36237,495
2021-08-27,Modoc,049,8938,443,434,154,588,5
2021-08-27,Mono,051,14174,1409,1385,18,1403,3
2021-08-27,Monterey,053,433212,45977,45337,2298,47635,539
2021-08-27,Napa,055,140530,11608,11460,70,11530,87
2021-08-27,Nevada,057,99092,7547,7169,247,7416,82
2021-08-27,Orange,059,3164182,287635,283407,13192,296599,5206
2021-08-27,Placer,061,380077,31047,29157,2695,31852,320
2021-08-27,Plumas,063,18699,1038,984,17,1001,5
2021-08-27,Riverside,065,2383286,332174,325379,15234,340613,4622
2021-08-27,Sacramento,067,1510023,137137,131921,2982,134903,1838
2021-08-27,San Benito,069,59416,6702,6622,130,6752,64
2021-08-27,San Bernardino,071,2135413,327296,322893,10011,332904,5342
2021-08-27,San Diego,073,3302833,335575,330162,19655,349817,3877
2021-08-27,San Francisco,075,870044,47786,46456,1943,48399,581
2021-08-27,San Joaquin,077,732212,87823,84949,4526,89475,1524
2021-08-27,San Luis Obispo,079,281455,25826,24952,972,25924,280
2021-08-27,San Mateo,081,765935,49747,48424,708,49132,553
2021-08-27,Santa Barbara,083,443738,39673,38675,1337,40012,480
2021-08-27,Santa Clara,085,1922200,135337,132011,989,133000,1783
2021-08-27,Santa Cruz,087,273765,18564,18163,919,19082,210
2021-08-27,Shasta,089,179085,15648,14996,2258,17254,217
2021-08-27,Sierra,091,2930,111,91,13,104,0
2021-08-27,Siskiyou,093,43540,2534,2358,710,3068,33
2021-08-27,Solano,095,438530,41587,39347,1024,40371,287
2021-08-27,Sonoma,097,501317,37511,36326,446,36772,342
2021-08-27,Stanislaus,099,539301,66901,65167,7410,72577,1061
2021-08-27,Sutter,101,95872,11894,11590,148,11738,135
2021-08-27,Tehama,103,63373,6226,5964,849,6813,71
2021-08-27,Trinity,105,12862,625,458,154,612,3
2021-08-27,Tulare,107,460477,56493,54443,11136,65579,870
2021-08-27,Tuolumne,109,53932,5519,5438,62,5500,74
2021-08-27,Ventura,111,848112,90933,89774,3891,93665,1076
2021-08-27,Yolo,113,214977,17320,16805,718,17523,231
2021-08-27,Yuba,115,75493,8263,7926,176,8102,54
2021-08-26,Alameda,001,1643700,108800,106146,2423,108569,1296
2021-08-26,Alpine,003,1148,91,92,0,92,0
2021-08-26,Amador,005,37829,4568,4442,39,4481,53
2021-08-26,Butte,007,227075,15935,15159,2705,17864,214
2021-08-26,Calaveras,009,45235,3012,2873,19,2892,59
2021-08-26,Colusa,011,21464,2287,2234,482,2716,16
2021-08-26,Contra Costa,013,1133247,89630,85808,1746,87554,866
2021-08-26,Del Norte,015,27424,2866,2625,16,2641,8
2021-08-26,El Dorado,017,186661,13615,12863,1227,14090,118
2021-08-26,Fresno,019,978130,117366,113854,10212,124066,1770
2021-08-26,Glenn,021,27897,2856,2740,776,3516,20
2021-08-26,Humboldt,023,135768,7058,6695,222,6917,53
2021-08-26,Imperial,025,180216,30444,30121,2819,32940,748
2021-08-26,Inyo,027,18085,1542,1521,13,1534,39
2021-08-26,Kern,029,883053,108754,106051,14782,120833,1380
2021-08-26,Kings,031,150075,26646,25838,1396,27234,260
2021-08-26,Lake,033,64148,5402,5196,59,5255,74
2021-08-26,Lassen,035,31185,5761,5626,152,5778,21
2021-08-26,Los Angeles,037,10098052,1352525,1334372,48816,1383188,25199
2021-08-26,Madera,039,155013,19013,18393,1343,19736,247
2021-08-26,Marin,041,260295,16285,15983,346,16329,240
2021-08-26,Mariposa,043,17540,736,677,19,696,5
2021-08-26,Mendocino,045,87422,5833,5533,203,5736,55
2021-08-26,Merced,047,269075,35464,34755,1310,36065,495
2021-08-26,Modoc,049,8938,443,433,154,587,5
2021-08-26,Mono,051,14174,1405,1385,18,1403,3
2021-08-26,Monterey,053,433212,45904,45265,2287,47552,539
2021-08-26,Napa,055,140530,11585,11394,69,11463,87
2021-08-26,Nevada,057,99092,7489,7086,244,7330,80
2021-08-26,Orange,059,3164182,287143,282814,13168,295982,5200
2021-08-26,Placer,061,380077,30877,28898,2669,31567,319
2021-08-26,Plumas,063,18699,1031,971,16,987,5
2021-08-26,Riverside,065,2383286,331382,324486,15214,339700,4615
2021-08-26,Sacramento,067,1510023,136603,130977,2941,133918,1827
2021-08-26,San Benito,069,59416,6692,6604,130,6734,64
2021-08-26,San Bernardino,071,2135413,326638,322100,9986,332086,5339
2021-08-26,San Diego,073,3302833,334548,328276,19589,347865,3869
2021-08-26,San Francisco,075,870044,47660,46288,1937,48225,581
2021-08-26,San Joaquin,077,732212,87445,84429,4505,88934,1513
2021-08-26,San Luis Obispo,079,281455,25676,24831,965,25796,278
2021-08-26,San Mateo,081,765935,49618,48263,706,48969,553
2021-08-26,Santa Barbara,083,443738,39588,38566,1336,39902,479
2021-08-26,Santa Clara,085,1922200,135012,131443,985,132428,1782
2021-08-26,Santa Cruz,087,273765,18504,18072,917,18989,210
2021-08-26,Shasta,089,179085,15526,14891,2230,17121,217
2021-08-26,Sierra,091,2930,109,90,13,103,0
2021-08-26,Siskiyou,093,43540,2512,2342,697,3039,33
2021-08-26,Solano,095,438530,41438,39027,1015,40042,286
2021-08-26,Sonoma,097,501317,37422,36102,446,36548,337
2021-08-26,Stanislaus,099,539301,66601,64785,7369,72154,1061
2021-08-26,Sutter,101,95872,11834,11499,145,11644,135
2021-08-26,Tehama,103,63373,6168,5913,836,6749,68
2021-08-26,Trinity,105,12862,620,450,152,602,3
2021-08-26,Tulare,107,460477,56236,54157,11089,65246,870
2021-08-26,Tuolumne,109,53932,5499,5387,62,5449,74
2021-08-26,Ventura,111,848112,90747,89595,3882,93477,1080
2021-08-26,Yolo,113,214977,17255,16727,708,17435,231
2021-08-26,Yuba,115,75493,8190,7834,174,8008,54
2021-08-25,Alameda,001,1643700,108485,105636,2416,108052,1296
2021-08-25,Alpine,003,1148,91,92,0,92,0
2021-08-25,Amador,005,37829,4553,4415,39,4454,53
2021-08-25,Butte,007,227075,15827,15039,2662,17701,214
2021-08-25,Calaveras,009,45235,2993,2851,19,2870,59
2021-08-25,Colusa,011,21464,2280,2227,473,2700,16
2021-08-25,Contra Costa,013,1133247,89242,85322,1740,87062,863
2021-08-25,Del Norte,015,27424,2821,2573,16,2589,8
2021-08-25,El Dorado,017,186661,13555,12787,1212,13999,118
2021-08-25,Fresno,019,978130,116826,113384,10170,123554,1761
2021-08-25,Glenn,021,27897,2838,2728,761,3489,20
2021-08-25,Humboldt,023,135768,6989,6653,213,6866,52
2021-08-25,Imperial,025,180216,30407,30085,2813,32898,748
2021-08-25,Inyo,027,18085,1538,1518,13,1531,39
2021-08-25,Kern,029,883053,108323,105687,14627,120314,1379
2021-08-25,Kings,031,150075,26539,25676,1390,27066,258
2021-08-25,Lake,033,64148,5372,5163,56,5219,74
2021-08-25,Lassen,035,31185,5744,5583,151,5734,21
2021-08-25,Los Angeles,037,10098052,1349924,1331400,48720,1380120,25170
2021-08-25,Madera,039,155013,18949,18311,1321,19632,247
2021-08-25,Marin,041,260295,16263,15938,340,16278,240
2021-08-25,Mariposa,043,17540,730,676,19,695,5
2021-08-25,Mendocino,045,87422,5799,5486,197,5683,53
2021-08-25,Merced,047,269075,35332,34600,1297,35897,492
2021-08-25,Modoc,049,8938,443,433,154,587,5
2021-08-25,Mono,051,14174,1401,1382,18,1400,3
2021-08-25,Monterey,053,433212,45830,45196,2272,47468,539
2021-08-25,Napa,055,140530,11552,11348,68,11416,87
2021-08-25,Nevada,057,99092,7423,7000,243,7243,77
2021-08-25,Orange,059,3164182,286617,282061,13134,295195,5193
2021-08-25,Placer,061,380077,30701,28740,2637,31377,319
2021-08-25,Plumas,063,18699,1016,962,16,978,5
2021-08-25,Riverside,065,2383286,330538,323548,15192,338740,4610
2021-08-25,Sacramento,067,1510023,135920,130046,2902,132948,1827
2021-08-25,San Benito,069,59416,6671,6587,129,6716,64
2021-08-25,San Bernardino,071,2135413,325946,321228,9965,331193,5337
2021-08-25,San Diego,073,3302833,333280,327166,19504,346670,3859
2021-08-25,San Francisco,075,870044,47510,46107,1932,48039,578
2021-08-25,San Joaquin,077,732212,87060,84002,4488,88490,1510
2021-08-25,San Luis Obispo,079,281455,25484,24607,961,25568,276
2021-08-25,San Mateo,081,765935,49496,48153,703,48856,553
2021-08-25,Santa Barbara,083,443738,39459,38450,1336,39786,479
2021-08-25,Santa Clara,085,1922200,134644,130995,983,131978,1783
2021-08-25,Santa Cruz,087,273765,18444,17987,914,18901,210
2021-08-25,Shasta,089,179085,15400,14752,2198,16950,217
2021-08-25,Sierra,091,2930,106,90,13,103,0
2021-08-25,Siskiyou,093,43540,2467,2322,679,3001,33
2021-08-25,Solano,095,438530,41266,38848,1003,39851,286
2021-08-25,Sonoma,097,501317,37298,35986,443,36429,336
2021-08-25,Stanislaus,099,539301,66319,64441,7337,71778,1061
2021-08-25,Sutter,101,95872,11766,11451,141,11592,134
2021-08-25,Tehama,103,63373,6109,5861,819,6680,68
2021-08-25,Trinity,105,12862,614,450,151,601,3
2021-08-25,Tulare,107,460477,55952,53877,11019,64896,866
2021-08-25,Tuolumne,109,53932,5473,5354,62,5416,74
2021-08-25,Ventura,111,848112,90563,89379,3868,93247,1068
2021-08-25,Yolo,113,214977,17190,16667,698,17365,231
2021-08-25,Yuba,115,75493,8124,7771,173,7944,54
2021-08-24,Alameda,001,1643700,108177,105319,2404,107723,1296
2021-08-24,Alpine,003,1148,91,92,0,92,0
2021-08-24,Amador,005,37829,4534,4380,39,4419,50
2021-08-24,Butte,007,227075,15673,14964,2629,17593,214
2021-08-24,Calaveras,009,45235,2954,2811,19,2830,59
2021-08-24,Colusa,011,21464,2272,2221,468,2689,16
2021-08-24,Contra Costa,013,1133247,88878,84963,1735,86698,857
2021-08-24,Del Norte,015,27424,2794,2543,16,2559,8
2021-08-24,El Dorado,017,186661,13478,12732,1197,13929,118
2021-08-24,Fresno,019,978130,116218,113024,10107,123131,1761
2021-08-24,Glenn,021,27897,2823,2717,754,3471,20
2021-08-24,Humboldt,023,135768,6926,6585,200,6785,52
2021-08-24,Imperial,025,180216,30346,30045,2808,32853,748
2021-08-24,Inyo,027,18085,1533,1512,13,1525,39
2021-08-24,Kern,029,883053,107859,105399,14463,119862,1375
2021-08-24,Kings,031,150075,26418,25629,1375,27004,258
2021-08-24,Lake,033,64148,5337,5135,56,5191,72
2021-08-24,Lassen,035,31185,5728,5576,149,5725,21
2021-08-24,Los Angeles,037,10098052,1347059,1328777,48614,1377391,25135
2021-08-24,Madera,039,155013,18873,18251,1304,19555,247
2021-08-24,Marin,041,260295,16227,15900,336,16236,240
2021-08-24,Mariposa,043,17540,723,670,19,689,5
2021-08-24,Mendocino,045,87422,5756,5416,190,5606,52
2021-08-24,Merced,047,269075,35164,34490,1286,35776,491
2021-08-24,Modoc,049,8938,443,432,154,586,5
2021-08-24,Mono,051,14174,1399,1382,18,1400,3
2021-08-24,Monterey,053,433212,45764,45126,2255,47381,539
2021-08-24,Napa,055,140530,11520,11299,67,11366,85
2021-08-24,Nevada,057,99092,7353,6981,241,7222,77
2021-08-24,Orange,059,3164182,286017,281461,13110,294571,5187
2021-08-24,Placer,061,380077,30496,28618,2598,31216,318
2021-08-24,Plumas,063,18699,1006,953,16,969,5
2021-08-24,Riverside,065,2383286,329665,322620,15163,337783,4605
2021-08-24,Sacramento,067,1510023,135237,129542,2856,132398,1812
2021-08-24,San Benito,069,59416,6658,6576,129,6705,64
2021-08-24,San Bernardino,071,2135413,325191,320300,9936,330236,5328
2021-08-24,San Diego,073,3302833,331837,325823,19395,345218,3851
2021-08-24,San Francisco,075,870044,47335,46010,1922,47932,574
2021-08-24,San Joaquin,077,732212,86620,83684,4451,88135,1508
2021-08-24,San Luis Obispo,079,281455,25307,24443,950,25393,274
2021-08-24,San Mateo,081,765935,49347,48050,701,48751,553
2021-08-24,Santa Barbara,083,443738,39328,38307,1335,39642,478
2021-08-24,Santa Clara,085,1922200,134220,130763,978,131741,1779
2021-08-24,Santa Cruz,087,273765,18369,17928,908,18836,209
2021-08-24,Shasta,089,179085,15292,14664,2167,16831,217
2021-08-24,Sierra,091,2930,103,90,13,103,0
2021-08-24,Siskiyou,093,43540,2445,2294,664,2958,33
2021-08-24,Solano,095,438530,41057,38724,991,39715,283
2021-08-24,Sonoma,097,501317,37170,35849,441,36290,336
2021-08-24,Stanislaus,099,539301,65990,64195,7283,71478,1058
2021-08-24,Sutter,101,95872,11699,11384,138,11522,134
2021-08-24,Tehama,103,63373,6063,5826,805,6631,67
2021-08-24,Trinity,105,12862,603,446,143,589,3
2021-08-24,Tulare,107,460477,55600,53702,10929,64631,856
2021-08-24,Tuolumne,109,53932,5442,5287,62,5349,74
2021-08-24,Ventura,111,848112,90379,89167,3857,93024,1068
2021-08-24,Yolo,113,214977,17112,16492,685,17177,231
2021-08-24,Yuba,115,75493,8041,7723,171,7894,54
2021-08-23,Alameda,001,1643700,107769,104922,2391,107313,1294
2021-08-23,Alpine,003,1148,91,91,0,91,0
2021-08-23,Amador,005,37829,4520,4369,39,4408,50
2021-08-23,Butte,007,227075,15528,14847,2591,17438,211
2021-08-23,Calaveras,009,45235,2927,2803,19,2822,59
2021-08-23,Colusa,011,21464,2268,2206,465,2671,16
2021-08-23,Contra Costa,013,1133247,88500,84651,1728,86379,857
2021-08-23,Del Norte,015,27424,2748,2499,16,2515,8
2021-08-23,El Dorado,017,186661,13375,12684,1175,13859,118
2021-08-23,Fresno,019,978130,115657,112445,10057,122502,1759
2021-08-23,Glenn,021,27897,2807,2696,744,3440,20
2021-08-23,Humboldt,023,135768,6853,6498,186,6684,52
2021-08-23,Imperial,025,180216,30295,30011,2805,32816,748
2021-08-23,Inyo,027,18085,1526,1509,13,1522,39
2021-08-23,Kern,029,883053,107404,104995,14309,119304,1375
2021-08-23,Kings,031,150075,26287,25465,1369,26834,257
2021-08-23,Lake,033,64148,5297,5099,54,5153,69
2021-08-23,Lassen,035,31185,5716,5562,149,5711,21
2021-08-23,Los Angeles,037,10098052,1344088,1326412,48484,1374896,25096
2021-08-23,Madera,039,155013,18787,18155,1289,19444,246
2021-08-23,Marin,041,260295,16179,15856,332,16188,240
2021-08-23,Mariposa,043,17540,712,645,19,664,5
2021-08-23,Mendocino,045,87422,5689,5374,183,5557,51
2021-08-23,Merced,047,269075,34982,34322,1281,35603,488
2021-08-23,Modoc,049,8938,440,431,153,584,6
2021-08-23,Mono,051,14174,1395,1384,18,1402,3
2021-08-23,Monterey,053,433212,45664,45047,2245,47292,538
2021-08-23,Napa,055,140530,11482,11257,67,11324,85
2021-08-23,Nevada,057,99092,7272,6930,239,7169,77
2021-08-23,Orange,059,3164182,285383,280891,13076,293967,5181
2021-08-23,Placer,061,380077,30295,28540,2560,31100,314
2021-08-23,Plumas,063,18699,998,934,16,950,5
2021-08-23,Riverside,065,2383286,328747,321650,15137,336787,4598
2021-08-23,Sacramento,067,1510023,134449,128969,2789,131758,1807
2021-08-23,San Benito,069,59416,6640,6562,127,6689,64
2021-08-23,San Bernardino,071,2135413,324386,319577,9897,329474,5324
2021-08-23,San Diego,073,3302833,330404,324536,19272,343808,3848
2021-08-23,San Francisco,075,870044,47179,45945,1913,47858,573
2021-08-23,San Joaquin,077,732212,86187,83466,4418,87884,1499
2021-08-23,San Luis Obispo,079,281455,25124,24317,948,25265,274
2021-08-23,San Mateo,081,765935,49209,47935,698,48633,553
2021-08-23,Santa Barbara,083,443738,39149,38181,1333,39514,478
2021-08-23,Santa Clara,085,1922200,133820,130489,974,131463,1778
2021-08-23,Santa Cruz,087,273765,18312,17871,907,18778,209
2021-08-23,Shasta,089,179085,15165,14537,2129,16666,216
2021-08-23,Sierra,091,2930,103,90,13,103,0
2021-08-23,Siskiyou,093,43540,2424,2274,643,2917,33
2021-08-23,Solano,095,438530,40903,38612,982,39594,283
2021-08-23,Sonoma,097,501317,37049,35769,440,36209,336
2021-08-23,Stanislaus,099,539301,65656,63922,7244,71166,1058
2021-08-23,Sutter,101,95872,11611,11314,130,11444,133
2021-08-23,Tehama,103,63373,6009,5805,789,6594,67
2021-08-23,Trinity,105,12862,600,435,140,575,3
2021-08-23,Tulare,107,460477,55293,53370,10857,64227,856
2021-08-23,Tuolumne,109,53932,5400,5240,62,5302,73
2021-08-23,Ventura,111,848112,90161,88960,3845,92805,1063
2021-08-23,Yolo,113,214977,17023,16445,671,17116,226
2021-08-23,Yuba,115,75493,7970,7653,169,7822,54
2021-08-22,Alameda,001,1643700,107325,104539,2364,106903,1294
2021-08-22,Alpine,003,1148,91,91,0,91,0
2021-08-22,Amador,005,37829,4490,4349,39,4388,50
2021-08-22,Butte,007,227075,15389,14791,2556,17347,211
2021-08-22,Calaveras,009,45235,2889,2771,19,2790,59
2021-08-22,Colusa,011,21464,2261,2201,459,2660,16
2021-08-22,Contra Costa,013,1133247,87957,84371,1715,86086,857
2021-08-22,Del Norte,015,27424,2688,2455,16,2471,8
2021-08-22,El Dorado,017,186661,13271,12629,1155,13784,118
2021-08-22,Fresno,019,978130,115058,112057,9989,122046,1759
2021-08-22,Glenn,021,27897,2780,2678,731,3409,20
2021-08-22,Humboldt,023,135768,6775,6483,168,6651,52
2021-08-22,Imperial,025,180216,30237,29993,2800,32793,748
2021-08-22,Inyo,027,18085,1520,1505,13,1518,39
2021-08-22,Kern,029,883053,106878,104691,14157,118848,1375
2021-08-22,Kings,031,150075,26129,25391,1352,26743,257
2021-08-22,Lake,033,64148,5252,5069,51,5120,69
2021-08-22,Lassen,035,31185,5684,5556,145,5701,21
2021-08-22,Los Angeles,037,10098052,1340765,1324151,48354,1372505,25089
2021-08-22,Madera,039,155013,18668,18120,1275,19395,246
2021-08-22,Marin,041,260295,16127,15822,324,16146,240
2021-08-22,Mariposa,043,17540,702,638,17,655,5
2021-08-22,Mendocino,045,87422,5630,5336,183,5519,51
2021-08-22,Merced,047,269075,34779,34234,1268,35502,488
2021-08-22,Modoc,049,8938,438,431,153,584,6
2021-08-22,Mono,051,14174,1393,1378,18,1396,3
2021-08-22,Monterey,053,433212,45564,45017,2231,47248,538
2021-08-22,Napa,055,140530,11437,11231,67,11298,85
2021-08-22,Nevada,057,99092,7198,6864,237,7101,77
2021-08-22,Orange,059,3164182,284689,280390,13032,293422,5181
2021-08-22,Placer,061,380077,30089,28395,2524,30919,314
2021-08-22,Plumas,063,18699,980,923,15,938,5
2021-08-22,Riverside,065,2383286,327726,320836,15090,335926,4594
2021-08-22,Sacramento,067,1510023,133673,128231,2749,130980,1802
2021-08-22,San Benito,069,59416,6624,6550,127,6677,64
2021-08-22,San Bernardino,071,2135413,323419,318839,9862,328701,5324
2021-08-22,San Diego,073,3302833,329082,323591,19166,342757,3848
2021-08-22,San Francisco,075,870044,47013,45831,1904,47735,573
2021-08-22,San Joaquin,077,732212,85730,83121,4383,87504,1498
2021-08-22,San Luis Obispo,079,281455,24918,24250,941,25191,274
2021-08-22,San Mateo,081,765935,49033,47821,693,48514,553
2021-08-22,Santa Barbara,083,443738,38968,38099,1325,39424,478
2021-08-22,Santa Clara,085,1922200,133403,130189,967,131156,1778
2021-08-22,Santa Cruz,087,273765,18254,17823,902,18725,209
2021-08-22,Shasta,089,179085,15028,14478,2093,16571,216
2021-08-22,Sierra,091,2930,103,87,13,100,0
2021-08-22,Siskiyou,093,43540,2395,2261,625,2886,33
2021-08-22,Solano,095,438530,40705,38489,969,39458,283
2021-08-22,Sonoma,097,501317,36892,35676,438,36114,336
2021-08-22,Stanislaus,099,539301,65303,63683,7154,70837,1058
2021-08-22,Sutter,101,95872,11529,11251,126,11377,133
2021-08-22,Tehama,103,63373,5963,5791,770,6561,67
2021-08-22,Trinity,105,12862,593,433,138,571,3
2021-08-22,Tulare,107,460477,54975,53220,10774,63994,856
2021-08-22,Tuolumne,109,53932,5357,5214,62,5276,73
2021-08-22,Ventura,111,848112,89952,88791,3828,92619,1063
2021-08-22,Yolo,113,214977,16920,16374,664,17038,226
2021-08-22,Yuba,115,75493,7897,7626,168,7794,54
2021-08-21,Alameda,001,1643700,107124,104281,2358,106639,1294
2021-08-21,Alpine,003,1148,91,91,0,91,0
2021-08-21,Amador,005,37829,4480,4338,38,4376,50
2021-08-21,Butte,007,227075,15321,14714,2537,17251,211
2021-08-21,Calaveras,009,45235,2873,2744,19,2763,59
2021-08-21,Colusa,011,21464,2255,2192,455,2647,16
2021-08-21,Contra Costa,013,1133247,87698,84136,1707,85843,857
2021-08-21,Del Norte,015,27424,2665,2409,16,2425,8
2021-08-21,El Dorado,017,186661,13227,12590,1151,13741,118
2021-08-21,Fresno,019,978130,114859,111765,9977,121742,1759
2021-08-21,Glenn,021,27897,2767,2654,723,3377,20
2021-08-21,Humboldt,023,135768,6737,6446,163,6609,52
2021-08-21,Imperial,025,180216,30194,29976,2797,32773,748
2021-08-21,Inyo,027,18085,1517,1500,13,1513,39
2021-08-21,Kern,029,883053,106623,104443,14034,118477,1375
2021-08-21,Kings,031,150075,26058,25313,1347,26660,257
2021-08-21,Lake,033,64148,5231,5055,49,5104,69
2021-08-21,Lassen,035,31185,5670,5553,145,5698,21
2021-08-21,Los Angeles,037,10098052,1339467,1321308,48262,1369570,25080
2021-08-21,Madera,039,155013,18630,18067,1269,19336,246
2021-08-21,Marin,041,260295,16093,15775,322,16097,240
2021-08-21,Mariposa,043,17540,692,634,17,651,5
2021-08-21,Mendocino,045,87422,5584,5307,182,5489,51
2021-08-21,Merced,047,269075,34674,34148,1263,35411,488
2021-08-21,Modoc,049,8938,438,430,153,583,6
2021-08-21,Mono,051,14174,1393,1378,18,1396,3
2021-08-21,Monterey,053,433212,45517,44969,2224,47193,538
2021-08-21,Napa,055,140530,11402,11211,67,11278,85
2021-08-21,Nevada,057,99092,7154,6810,236,7046,77
2021-08-21,Orange,059,3164182,284237,279855,12998,292853,5181
2021-08-21,Placer,061,380077,29951,28289,2500,30789,314
2021-08-21,Plumas,063,18699,976,916,14,930,5
2021-08-21,Riverside,065,2383286,327146,320086,15077,335163,4594
2021-08-21,Sacramento,067,1510023,133177,127751,2738,130489,1809
2021-08-21,San Benito,069,59416,6614,6542,126,6668,64
2021-08-21,San Bernardino,071,2135413,322970,318293,9841,328134,5324
2021-08-21,San Diego,073,3302833,328426,322620,19117,341737,3848
2021-08-21,San Francisco,075,870044,46911,45637,1897,47534,573
2021-08-21,San Joaquin,077,732212,85513,82825,4367,87192,1498
2021-08-21,San Luis Obispo,079,281455,24860,24169,941,25110,273
2021-08-21,San Mateo,081,765935,48938,47685,693,48378,553
2021-08-21,Santa Barbara,083,443738,38886,37951,1321,39272,478
2021-08-21,Santa Clara,085,1922200,133138,129911,963,130874,1778
2021-08-21,Santa Cruz,087,273765,18217,17763,897,18660,209
2021-08-21,Shasta,089,179085,14954,14417,2079,16496,217
2021-08-21,Sierra,091,2930,98,85,13,98,0
2021-08-21,Siskiyou,093,43540,2381,2246,614,2860,33
2021-08-21,Solano,095,438530,40594,38423,959,39382,281
2021-08-21,Sonoma,097,501317,36805,35582,437,36019,336
2021-08-21,Stanislaus,099,539301,65121,63512,7137,70649,1058
2021-08-21,Sutter,101,95872,11484,11204,124,11328,133
2021-08-21,Tehama,103,63373,5938,5757,763,6520,67
2021-08-21,Trinity,105,12862,588,431,136,567,3
2021-08-21,Tulare,107,460477,54830,53045,10731,63776,857
2021-08-21,Tuolumne,109,53932,5326,5193,62,5255,73
2021-08-21,Ventura,111,848112,89807,88558,3813,92371,1063
2021-08-21,Yolo,113,214977,16873,16322,658,16980,226
2021-08-21,Yuba,115,75493,7851,7580,167,7747,54
2021-08-20,Alameda,001,1643700,106888,103812,2350,106162,1294
2021-08-20,Alpine,003,1148,91,91,0,91,0
2021-08-20,Amador,005,37829,4454,4323,38,4361,50
2021-08-20,Butte,007,227075,15248,14617,2514,17131,211
2021-08-20,Calaveras,009,45235,2853,2717,19,2736,59
2021-08-20,Colusa,011,21464,2250,2178,453,2631,16
2021-08-20,Contra Costa,013,1133247,87423,83721,1700,85421,857
2021-08-20,Del Norte,015,27424,2633,2316,16,2332,8
2021-08-20,El Dorado,017,186661,13189,12495,1143,13638,118
2021-08-20,Fresno,019,978130,114502,111315,9943,121258,1759
2021-08-20,Glenn,021,27897,2760,2642,713,3355,20
2021-08-20,Humboldt,023,135768,6685,6349,158,6507,52
2021-08-20,Imperial,025,180216,30171,29934,2797,32731,747
2021-08-20,Inyo,027,18085,1511,1495,13,1508,39
2021-08-20,Kern,029,883053,106340,104048,13906,117954,1373
2021-08-20,Kings,031,150075,25992,25241,1345,26586,256
2021-08-20,Lake,033,64148,5216,5024,46,5070,69
2021-08-20,Lassen,035,31185,5650,5539,145,5684,21
2021-08-20,Los Angeles,037,10098052,1337588,1317541,48161,1365702,25049
2021-08-20,Madera,039,155013,18581,18018,1254,19272,246
2021-08-20,Marin,041,260295,16075,15727,318,16045,240
2021-08-20,Mariposa,043,17540,687,630,17,647,5
2021-08-20,Mendocino,045,87422,5538,5241,181,5422,51
2021-08-20,Merced,047,269075,34610,34035,1253,35288,486
2021-08-20,Modoc,049,8938,438,429,153,582,6
2021-08-20,Mono,051,14174,1392,1368,18,1386,3
2021-08-20,Monterey,053,433212,45479,44890,2218,47108,538
2021-08-20,Napa,055,140530,11370,11152,67,11219,83
2021-08-20,Nevada,057,99092,7112,6753,230,6983,77
2021-08-20,Orange,059,3164182,283792,279193,12977,292170,5179
2021-08-20,Placer,061,380077,29855,28156,2471,30627,313
2021-08-20,Plumas,063,18699,966,908,14,922,5
2021-08-20,Riverside,065,2383286,326450,319072,15046,334118,4594
2021-08-20,Sacramento,067,1510023,132701,127226,2721,129947,1797
2021-08-20,San Benito,069,59416,6600,6508,126,6634,64
2021-08-20,San Bernardino,071,2135413,322359,317372,9812,327184,5322
2021-08-20,San Diego,073,3302833,327517,321102,19047,340149,3846
2021-08-20,San Francisco,075,870044,46815,45432,1882,47314,573
2021-08-20,San Joaquin,077,732212,85282,82419,4348,86767,1496
2021-08-20,San Luis Obispo,079,281455,24782,23986,937,24923,273
2021-08-20,San Mateo,081,765935,48825,47561,690,48251,551
2021-08-20,Santa Barbara,083,443738,38800,37794,1316,39110,477
2021-08-20,Santa Clara,085,1922200,132856,129510,958,130468,1774
2021-08-20,Santa Cruz,087,273765,18177,17701,894,18595,209
2021-08-20,Shasta,089,179085,14873,14277,2061,16338,215
2021-08-20,Sierra,091,2930,97,83,13,96,0
2021-08-20,Siskiyou,093,43540,2365,2226,609,2835,33
2021-08-20,Solano,095,438530,40453,38214,948,39162,277
2021-08-20,Sonoma,097,501317,36737,35416,436,35852,336
2021-08-20,Stanislaus,099,539301,64932,63219,7113,70332,1047
2021-08-20,Sutter,101,95872,11428,11136,123,11259,133
2021-08-20,Tehama,103,63373,5922,5730,751,6481,66
2021-08-20,Trinity,105,12862,588,422,135,557,3
2021-08-20,Tulare,107,460477,54700,52855,10688,63543,856
2021-08-20,Tuolumne,109,53932,5302,5153,61,5214,73
2021-08-20,Ventura,111,848112,89639,88285,3810,92095,1061
2021-08-20,Yolo,113,214977,16818,16236,652,16888,225
2021-08-20,Yuba,115,75493,7810,7523,167,7690,54
2021-08-19,Alameda,001,1643700,106443,103276,2328,105604,1294
2021-08-19,Alpine,003,1148,91,91,0,91,0
2021-08-19,Amador,005,37829,4447,4317,38,4355,50
2021-08-19,Butte,007,227075,15114,14518,2486,17004,211
2021-08-19,Calaveras,009,45235,2831,2673,19,2692,59
2021-08-19,Colusa,011,21464,2241,2167,448,2615,16
2021-08-19,Contra Costa,013,1133247,86983,83296,1687,84983,852
2021-08-19,Del Norte,015,27424,2583,2257,16,2273,8
2021-08-19,El Dorado,017,186661,13103,12410,1124,13534,118
2021-08-19,Fresno,019,978130,114060,110947,9889,120836,1759
2021-08-19,Glenn,021,27897,2742,2629,706,3335,20
2021-08-19,Humboldt,023,135768,6624,6246,152,6398,52
2021-08-19,Imperial,025,180216,30125,29865,2792,32657,747
2021-08-19,Inyo,027,18085,1504,1494,13,1507,39
2021-08-19,Kern,029,883053,105944,103731,13765,117496,1371
2021-08-19,Kings,031,150075,25861,25128,1333,26461,256
2021-08-19,Lake,033,64148,5184,4991,42,5033,69
2021-08-19,Lassen,035,31185,5632,5520,144,5664,21
2021-08-19,Los Angeles,037,10098052,1334604,1314453,48022,1362475,25020
2021-08-19,Madera,039,155013,18519,17947,1239,19186,246
2021-08-19,Marin,041,260295,16042,15672,315,15987,240
2021-08-19,Mariposa,043,17540,672,618,17,635,5
2021-08-19,Mendocino,045,87422,5505,5167,178,5345,51
2021-08-19,Merced,047,269075,34475,33851,1239,35090,486
2021-08-19,Modoc,049,8938,438,427,153,580,6
2021-08-19,Mono,051,14174,1388,1349,18,1367,3
2021-08-19,Monterey,053,433212,45406,44821,2208,47029,538
2021-08-19,Napa,055,140530,11318,11104,67,11171,83
2021-08-19,Nevada,057,99092,7048,6695,227,6922,77
2021-08-19,Orange,059,3164182,283155,278562,12926,291488,5172
2021-08-19,Placer,061,380077,29675,27953,2454,30407,313
2021-08-19,Plumas,063,18699,953,896,14,910,5
2021-08-19,Riverside,065,2383286,325418,318056,15017,333073,4589
2021-08-19,Sacramento,067,1510023,131998,126720,2686,129406,1801
2021-08-19,San Benito,069,59416,6583,6493,125,6618,64
2021-08-19,San Bernardino,071,2135413,321535,316398,9789,326187,5318
2021-08-19,San Diego,073,3302833,326266,319582,18949,338531,3839
2021-08-19,San Francisco,075,870044,46652,45220,1869,47089,571
2021-08-19,San Joaquin,077,732212,84833,82047,4299,86346,1491
2021-08-19,San Luis Obispo,079,281455,24644,23878,930,24808,271
2021-08-19,San Mateo,081,765935,48693,47431,689,48120,551
2021-08-19,Santa Barbara,083,443738,38655,37693,1313,39006,477
2021-08-19,Santa Clara,085,1922200,132466,129133,951,130084,1774
2021-08-19,Santa Cruz,087,273765,18114,17644,887,18531,209
2021-08-19,Shasta,089,179085,14749,14200,2038,16238,214
2021-08-19,Sierra,091,2930,93,83,13,96,0
2021-08-19,Siskiyou,093,43540,2350,2218,597,2815,33
2021-08-19,Solano,095,438530,40295,38025,937,38962,273
2021-08-19,Sonoma,097,501317,36649,35233,435,35668,336
2021-08-19,Stanislaus,099,539301,64588,62928,7069,69997,1047
2021-08-19,Sutter,101,95872,11343,11057,122,11179,133
2021-08-19,Tehama,103,63373,5886,5683,725,6408,66
2021-08-19,Trinity,105,12862,584,414,133,547,3
2021-08-19,Tulare,107,460477,54468,52685,10625,63310,856
2021-08-19,Tuolumne,109,53932,5266,5112,60,5172,64
2021-08-19,Ventura,111,848112,89436,88073,3796,91869,1060
2021-08-19,Yolo,113,214977,16733,16153,644,16797,225
2021-08-19,Yuba,115,75493,7758,7458,166,7624,51
2021-08-18,Alameda,001,1643700,106037,102696,2307,105003,1294
2021-08-18,Alpine,003,1148,90,91,0,91,0
2021-08-18,Amador,005,37829,4431,4279,37,4316,50
2021-08-18,Butte,007,227075,15004,14426,2456,16882,208
2021-08-18,Calaveras,009,45235,2794,2643,18,2661,59
2021-08-18,Colusa,011,21464,2233,2160,444,2604,16
2021-08-18,Contra Costa,013,1133247,86483,82767,1681,84448,851
2021-08-18,Del Norte,015,27424,2526,2219,16,2235,8
2021-08-18,El Dorado,017,186661,13013,12306,1110,13416,118
2021-08-18,Fresno,019,978130,113605,110523,9828,120351,1759
2021-08-18,Glenn,021,27897,2709,2623,698,3321,20
2021-08-18,Humboldt,023,135768,6553,6195,147,6342,52
2021-08-18,Imperial,025,180216,30092,29821,2790,32611,746
2021-08-18,Inyo,027,18085,1501,1494,13,1507,39
2021-08-18,Kern,029,883053,105597,103440,13671,117111,1370
2021-08-18,Kings,031,150075,25752,24984,1325,26309,256
2021-08-18,Lake,033,64148,5143,4957,41,4998,69
2021-08-18,Lassen,035,31185,5613,5506,143,5649,21
2021-08-18,Los Angeles,037,10098052,1331451,1311477,47891,1359368,24984
2021-08-18,Madera,039,155013,18460,17871,1226,19097,246
2021-08-18,Marin,041,260295,16004,15610,312,15922,240
2021-08-18,Mariposa,043,17540,659,615,16,631,5
2021-08-18,Mendocino,045,87422,5454,5129,176,5305,51
2021-08-18,Merced,047,269075,34311,33708,1228,34936,484
2021-08-18,Modoc,049,8938,438,427,152,579,6
2021-08-18,Mono,051,14174,1385,1344,18,1362,3
2021-08-18,Monterey,053,433212,45322,44735,2191,46926,532
2021-08-18,Napa,055,140530,11279,11060,66,11126,83
2021-08-18,Nevada,057,99092,6982,6633,227,6860,76
2021-08-18,Orange,059,3164182,282517,277795,12874,290669,5168
2021-08-18,Placer,061,380077,29447,27741,2426,30167,312
2021-08-18,Plumas,063,18699,944,874,14,888,5
2021-08-18,Riverside,065,2383286,324419,317107,14984,332091,4585
2021-08-18,Sacramento,067,1510023,131237,125599,2654,128253,1781
2021-08-18,San Benito,069,59416,6572,6481,124,6605,64
2021-08-18,San Bernardino,071,2135413,320736,315477,9770,325247,5304
2021-08-18,San Diego,073,3302833,324926,318152,18883,337035,3834
2021-08-18,San Francisco,075,870044,46450,44957,1860,46817,568
2021-08-18,San Joaquin,077,732212,84380,81601,4268,85869,1491
2021-08-18,San Luis Obispo,079,281455,24494,23726,917,24643,270
2021-08-18,San Mateo,081,765935,48529,47255,688,47943,551
2021-08-18,Santa Barbara,083,443738,38525,37599,1307,38906,475
2021-08-18,Santa Clara,085,1922200,132102,128563,948,129511,1773
2021-08-18,Santa Cruz,087,273765,18059,17566,883,18449,209
2021-08-18,Shasta,089,179085,14650,14087,2019,16106,213
2021-08-18,Sierra,091,2930,92,83,13,96,0
2021-08-18,Siskiyou,093,43540,2321,2204,585,2789,33
2021-08-18,Solano,095,438530,40089,37812,922,38734,271
2021-08-18,Sonoma,097,501317,36505,35063,434,35497,333
2021-08-18,Stanislaus,099,539301,64257,62613,7026,69639,1047
2021-08-18,Sutter,101,95872,11271,11004,117,11121,130
2021-08-18,Tehama,103,63373,5851,5653,715,6368,66
2021-08-18,Trinity,105,12862,577,409,130,539,3
2021-08-18,Tulare,107,460477,54229,52486,10556,63042,856
2021-08-18,Tuolumne,109,53932,5230,5081,58,5139,64
2021-08-18,Ventura,111,848112,89204,87835,3786,91621,1055
2021-08-18,Yolo,113,214977,16650,16047,626,16673,225
2021-08-18,Yuba,115,75493,7693,7391,166,7557,51
2021-08-17,Alameda,001,1643700,105640,102379,2292,104671,1290
2021-08-17,Alpine,003,1148,90,91,0,91,0
2021-08-17,Amador,005,37829,4402,4266,37,4303,50
2021-08-17,Butte,007,227075,14897,14357,2421,16778,206
2021-08-17,Calaveras,009,45235,2760,2624,18,2642,59
2021-08-17,Colusa,011,21464,2224,2156,440,2596,16
2021-08-17,Contra Costa,013,1133247,86035,82482,1671,84153,848
2021-08-17,Del Norte,015,27424,2472,2188,16,2204,8
2021-08-17,El Dorado,017,186661,12926,12242,1096,13338,118
2021-08-17,Fresno,019,978130,113120,110263,9765,120028,1755
2021-08-17,Glenn,021,27897,2695,2608,689,3297,20
2021-08-17,Humboldt,023,135768,6473,6155,145,6300,52
2021-08-17,Imperial,025,180216,30041,29768,2786,32554,746
2021-08-17,Inyo,027,18085,1498,1492,13,1505,39
2021-08-17,Kern,029,883053,105203,103048,13550,116598,1367
2021-08-17,Kings,031,150075,25647,24930,1314,26244,254
2021-08-17,Lake,033,64148,5100,4930,35,4965,68
2021-08-17,Lassen,035,31185,5596,5499,141,5640,21
2021-08-17,Los Angeles,037,10098052,1327882,1307999,47764,1355763,24952
2021-08-17,Madera,039,155013,18386,17838,1208,19046,246
2021-08-17,Marin,041,260295,15948,15570,312,15882,240
2021-08-17,Mariposa,043,17540,651,609,15,624,5
2021-08-17,Mendocino,045,87422,5399,5097,176,5273,51
2021-08-17,Merced,047,269075,34161,33508,1217,34725,482
2021-08-17,Modoc,049,8938,435,424,150,574,6
2021-08-17,Mono,051,14174,1380,1341,18,1359,3
2021-08-17,Monterey,053,433212,45238,44672,2181,46853,528
2021-08-17,Napa,055,140530,11238,11007,65,11072,83
2021-08-17,Nevada,057,99092,6907,6605,225,6830,75
2021-08-17,Orange,059,3164182,281872,277121,12838,289959,5164
2021-08-17,Placer,061,380077,29232,27634,2397,30031,312
2021-08-17,Plumas,063,18699,932,860,14,874,5
2021-08-17,Riverside,065,2383286,323406,316051,14941,330992,4582
2021-08-17,Sacramento,067,1510023,130443,125151,2612,127763,1774
2021-08-17,San Benito,069,59416,6553,6470,124,6594,64
2021-08-17,San Bernardino,071,2135413,319797,314402,9730,324132,5302
2021-08-17,San Diego,073,3302833,323316,317058,18785,335843,3824
2021-08-17,San Francisco,075,870044,46250,44820,1854,46674,567
2021-08-17,San Joaquin,077,732212,83912,81300,4234,85534,1489
2021-08-17,San Luis Obispo,079,281455,24338,23556,914,24470,268
2021-08-17,San Mateo,081,765935,48374,47127,683,47810,551
2021-08-17,Santa Barbara,083,443738,38366,37478,1300,38778,475
2021-08-17,Santa Clara,085,1922200,131699,128354,942,129296,1773
2021-08-17,Santa Cruz,087,273765,17974,17528,882,18410,209
2021-08-17,Shasta,089,179085,14519,14012,2000,16012,214
2021-08-17,Sierra,091,2930,91,82,13,95,0
2021-08-17,Siskiyou,093,43540,2305,2183,572,2755,33
2021-08-17,Solano,095,438530,39860,37662,909,38571,269
2021-08-17,Sonoma,097,501317,36357,34943,430,35373,333
2021-08-17,Stanislaus,099,539301,63916,62385,6967,69352,1047
2021-08-17,Sutter,101,95872,11199,10973,117,11090,130
2021-08-17,Tehama,103,63373,5817,5612,694,6306,66
2021-08-17,Trinity,105,12862,572,406,128,534,3
2021-08-17,Tulare,107,460477,53961,52362,10491,62853,856
2021-08-17,Tuolumne,109,53932,5187,5042,57,5099,64
2021-08-17,Ventura,111,848112,88965,87601,3765,91366,1053
2021-08-17,Yolo,113,214977,16561,15975,612,16587,225
2021-08-17,Yuba,115,75493,7621,7355,166,7521,51
2021-08-16,Alameda,001,1643700,105143,102052,2284,104336,1287
2021-08-16,Alpine,003,1148,90,91,0,91,0
2021-08-16,Amador,005,37829,4392,4235,37,4272,50
2021-08-16,Butte,007,227075,14780,14283,2384,16667,206
2021-08-16,Calaveras,009,45235,2700,2609,17,2626,57
2021-08-16,Colusa,011,21464,2213,2147,436,2583,16
2021-08-16,Contra Costa,013,1133247,85493,82070,1661,83731,848
2021-08-16,Del Norte,015,27424,2395,2125,16,2141,8
2021-08-16,El Dorado,017,186661,12825,12139,1083,13222,118
2021-08-16,Fresno,019,978130,112620,109623,9713,119336,1753
2021-08-16,Glenn,021,27897,2676,2593,683,3276,20
2021-08-16,Humboldt,023,135768,6402,6064,124,6188,52
2021-08-16,Imperial,025,180216,30000,29737,2772,32509,746
2021-08-16,Inyo,027,18085,1495,1490,13,1503,39
2021-08-16,Kern,029,883053,104828,102690,13434,116124,1367
2021-08-16,Kings,031,150075,25544,24817,1305,26122,254
2021-08-16,Lake,033,64148,5073,4898,34,4932,68
2021-08-16,Lassen,035,31185,5580,5481,133,5614,21
2021-08-16,Los Angeles,037,10098052,1324499,1305330,47624,1352954,24923
2021-08-16,Madera,039,155013,18311,17756,1187,18943,246
2021-08-16,Marin,041,260295,15889,15497,311,15808,239
2021-08-16,Mariposa,043,17540,634,597,15,612,5
2021-08-16,Mendocino,045,87422,5343,5037,174,5211,49
2021-08-16,Merced,047,269075,33960,33364,1204,34568,481
2021-08-16,Modoc,049,8938,433,421,149,570,5
2021-08-16,Mono,051,14174,1375,1339,18,1357,3
2021-08-16,Monterey,053,433212,45159,44595,2169,46764,527
2021-08-16,Napa,055,140530,11209,10946,65,11011,83
2021-08-16,Nevada,057,99092,6852,6535,224,6759,74
2021-08-16,Orange,059,3164182,281078,275985,12792,288777,5161
2021-08-16,Placer,061,380077,29050,27384,2365,29749,306
2021-08-16,Plumas,063,18699,921,851,14,865,5
2021-08-16,Riverside,065,2383286,322313,314774,14904,329678,4582
2021-08-16,Sacramento,067,1510023,129633,124554,2569,127123,1762
2021-08-16,San Benito,069,59416,6529,6452,124,6576,64
2021-08-16,San Bernardino,071,2135413,318830,313617,9703,323320,5301
2021-08-16,San Diego,073,3302833,321718,315348,18645,333993,3824
2021-08-16,San Francisco,075,870044,46046,44681,1847,46528,567
2021-08-16,San Joaquin,077,732212,83408,81087,4206,85293,1488
2021-08-16,San Luis Obispo,079,281455,24188,23452,906,24358,265
2021-08-16,San Mateo,081,765935,48192,47024,677,47701,548
2021-08-16,Santa Barbara,083,443738,38196,37358,1295,38653,475
2021-08-16,Santa Clara,085,1922200,131235,127978,938,128916,1773
2021-08-16,Santa Cruz,087,273765,17910,17491,876,18367,209
2021-08-16,Shasta,089,179085,14430,13862,1984,15846,211
2021-08-16,Sierra,091,2930,88,82,13,95,0
2021-08-16,Siskiyou,093,43540,2288,2169,552,2721,33
2021-08-16,Solano,095,438530,39579,37436,897,38333,263
2021-08-16,Sonoma,097,501317,36189,34844,427,35271,333
2021-08-16,Stanislaus,099,539301,63577,62033,6915,68948,1039
2021-08-16,Sutter,101,95872,11130,10902,116,11018,130
2021-08-16,Tehama,103,63373,5754,5565,689,6254,66
2021-08-16,Trinity,105,12862,566,400,127,527,3
2021-08-16,Tulare,107,460477,53717,52162,10423,62585,856
2021-08-16,Tuolumne,109,53932,5148,4984,56,5040,64
2021-08-16,Ventura,111,848112,88720,86954,3747,90701,1052
2021-08-16,Yolo,113,214977,16460,15922,604,16526,225
2021-08-16,Yuba,115,75493,7537,7314,165,7479,51
2021-08-15,Alameda,001,1643700,104661,101660,2267,103927,1287
2021-08-15,Alpine,003,1148,90,91,0,91,0
2021-08-15,Amador,005,37829,4364,4231,37,4268,49
2021-08-15,Butte,007,227075,14657,14263,2360,16623,206
2021-08-15,Calaveras,009,45235,2658,2599,17,2616,57
2021-08-15,Colusa,011,21464,2201,2140,426,2566,16
2021-08-15,Contra Costa,013,1133247,85009,81781,1646,83427,848
2021-08-15,Del Norte,015,27424,2328,2060,16,2076,8
2021-08-15,El Dorado,017,186661,12690,12057,1066,13123,118
2021-08-15,Fresno,019,978130,112142,109382,9647,119029,1753
2021-08-15,Glenn,021,27897,2653,2592,671,3263,20
2021-08-15,Humboldt,023,135768,6328,6024,118,6142,52
2021-08-15,Imperial,025,180216,29934,29711,2768,32479,746
2021-08-15,Inyo,027,18085,1494,1489,13,1502,39
2021-08-15,Kern,029,883053,104384,102524,13322,115846,1367
2021-08-15,Kings,031,150075,25398,24736,1295,26031,254
2021-08-15,Lake,033,64148,5014,4886,33,4919,68
2021-08-15,Lassen,035,31185,5563,5482,132,5614,21
2021-08-15,Los Angeles,037,10098052,1320964,1302882,47455,1350337,24918
2021-08-15,Madera,039,155013,18223,17714,1171,18885,246
2021-08-15,Marin,041,260295,15830,15461,309,15770,239
2021-08-15,Mariposa,043,17540,627,591,14,605,5
2021-08-15,Mendocino,045,87422,5286,5022,168,5190,49
2021-08-15,Merced,047,269075,33716,33305,1193,34498,481
2021-08-15,Modoc,049,8938,431,421,149,570,5
2021-08-15,Mono,051,14174,1371,1334,18,1352,3
2021-08-15,Monterey,053,433212,45037,44567,2148,46715,527
2021-08-15,Napa,055,140530,11154,10919,65,10984,83
2021-08-15,Nevada,057,99092,6767,6486,224,6710,74
2021-08-15,Orange,059,3164182,280308,275447,12752,288199,5161
2021-08-15,Placer,061,380077,28828,27220,2317,29537,306
2021-08-15,Plumas,063,18699,909,850,14,864,5
2021-08-15,Riverside,065,2383286,321175,314133,14877,329010,4582
2021-08-15,Sacramento,067,1510023,128815,123924,2537,126461,1761
2021-08-15,San Benito,069,59416,6511,6446,123,6569,64
2021-08-15,San Bernardino,071,2135413,317758,313120,9672,322792,5301
2021-08-15,San Diego,073,3302833,320246,314247,18518,332765,3824
2021-08-15,San Francisco,075,870044,45821,44531,1832,46363,567
2021-08-15,San Joaquin,077,732212,82920,80832,4167,84999,1488
2021-08-15,San Luis Obispo,079,281455,23992,23404,896,24300,265
2021-08-15,San Mateo,081,765935,48005,46897,671,47568,548
2021-08-15,Santa Barbara,083,443738,38024,37276,1288,38564,475
2021-08-15,Santa Clara,085,1922200,130801,127715,932,128647,1773
2021-08-15,Santa Cruz,087,273765,17840,17440,869,18309,209
2021-08-15,Shasta,089,179085,14327,13835,1959,15794,211
2021-08-15,Sierra,091,2930,87,82,12,94,0
2021-08-15,Siskiyou,093,43540,2267,2169,538,2707,33
2021-08-15,Solano,095,438530,39322,37320,886,38206,263
2021-08-15,Sonoma,097,501317,35993,34706,419,35125,333
2021-08-15,Stanislaus,099,539301,63208,61795,6838,68633,1039
2021-08-15,Sutter,101,95872,11039,10863,116,10979,130
2021-08-15,Tehama,103,63373,5705,5550,683,6233,66
2021-08-15,Trinity,105,12862,562,400,126,526,3
2021-08-15,Tulare,107,460477,53462,52046,10364,62410,856
2021-08-15,Tuolumne,109,53932,5110,4934,54,4988,64
2021-08-15,Ventura,111,848112,88415,86797,3732,90529,1052
2021-08-15,Yolo,113,214977,16365,15873,594,16467,225
2021-08-15,Yuba,115,75493,7460,7265,164,7429,51
2021-08-14,Alameda,001,1643700,104445,101305,2263,103568,1287
2021-08-14,Alpine,003,1148,90,91,0,91,0
2021-08-14,Amador,005,37829,4346,4206,37,4243,49
2021-08-14,Butte,007,227075,14621,14192,2344,16536,206
2021-08-14,Calaveras,009,45235,2651,2579,17,2596,57
2021-08-14,Colusa,011,21464,2190,2134,422,2556,16
2021-08-14,Contra Costa,013,1133247,84761,81458,1638,83096,848
2021-08-14,Del Norte,015,27424,2301,2015,16,2031,8
2021-08-14,El Dorado,017,186661,12654,12019,1058,13077,118
2021-08-14,Fresno,019,978130,111980,109056,9617,118673,1753
2021-08-14,Glenn,021,27897,2642,2583,668,3251,20
2021-08-14,Humboldt,023,135768,6275,5998,115,6113,52
2021-08-14,Imperial,025,180216,29907,29671,2768,32439,746
2021-08-14,Inyo,027,18085,1492,1487,13,1500,39
2021-08-14,Kern,029,883053,104189,102306,13226,115532,1367
2021-08-14,Kings,031,150075,25300,24647,1287,25934,254
2021-08-14,Lake,033,64148,4997,4850,32,4882,68
2021-08-14,Lassen,035,31185,5556,5475,131,5606,21
2021-08-14,Los Angeles,037,10098052,1319191,1299346,47318,1346664,24911
2021-08-14,Madera,039,155013,18176,17691,1166,18857,246
2021-08-14,Marin,041,260295,15796,15441,309,15750,239
2021-08-14,Mariposa,043,17540,623,584,14,598,5
2021-08-14,Mendocino,045,87422,5250,4977,165,5142,49
2021-08-14,Merced,047,269075,33652,33234,1187,34421,481
2021-08-14,Modoc,049,8938,431,421,149,570,5
2021-08-14,Mono,051,14174,1366,1332,18,1350,3
2021-08-14,Monterey,053,433212,44992,44514,2145,46659,527
2021-08-14,Napa,055,140530,11124,10878,64,10942,83
2021-08-14,Nevada,057,99092,6732,6419,223,6642,74
2021-08-14,Orange,059,3164182,279874,274732,12725,287457,5161
2021-08-14,Placer,061,380077,28682,27115,2293,29408,306
2021-08-14,Plumas,063,18699,899,849,14,863,5
2021-08-14,Riverside,065,2383286,320459,313264,14856,328120,4582
2021-08-14,Sacramento,067,1510023,128322,123438,2518,125956,1758
2021-08-14,San Benito,069,59416,6498,6428,123,6551,64
2021-08-14,San Bernardino,071,2135413,317208,312142,9651,321793,5301
2021-08-14,San Diego,073,3302833,319575,313589,18450,332039,3824
2021-08-14,San Francisco,075,870044,45692,44353,1813,46166,567
2021-08-14,San Joaquin,077,732212,82703,80585,4152,84737,1488
2021-08-14,San Luis Obispo,079,281455,23931,23328,893,24221,265
2021-08-14,San Mateo,081,765935,47886,46792,667,47459,548
2021-08-14,Santa Barbara,083,443738,37930,37118,1286,38404,475
2021-08-14,Santa Clara,085,1922200,130522,127432,929,128361,1772
2021-08-14,Santa Cruz,087,273765,17801,17384,868,18252,209
2021-08-14,Shasta,089,179085,14252,13813,1938,15751,211
2021-08-14,Sierra,091,2930,86,81,12,93,0
2021-08-14,Siskiyou,093,43540,2257,2160,528,2688,33
2021-08-14,Solano,095,438530,39235,37237,874,38111,263
2021-08-14,Sonoma,097,501317,35870,34606,417,35023,333
2021-08-14,Stanislaus,099,539301,63032,61564,6794,68358,1039
2021-08-14,Sutter,101,95872,10994,10808,115,10923,130
2021-08-14,Tehama,103,63373,5681,5530,678,6208,66
2021-08-14,Trinity,105,12862,556,399,126,525,3
2021-08-14,Tulare,107,460477,53326,51951,10319,62270,856
2021-08-14,Tuolumne,109,53932,5075,4924,54,4978,64
2021-08-14,Ventura,111,848112,88259,86569,3712,90281,1052
2021-08-14,Yolo,113,214977,16320,15815,585,16400,225
2021-08-14,Yuba,115,75493,7411,7223,164,7387,51
2021-08-13,Alameda,001,1643700,104150,100930,2255,103185,1284
2021-08-13,Alpine,003,1148,90,91,0,91,0
2021-08-13,Amador,005,37829,4318,4169,37,4206,49
2021-08-13,Butte,007,227075,14551,14100,2328,16428,206
2021-08-13,Calaveras,009,45235,2645,2564,17,2581,57
2021-08-13,Colusa,011,21464,2183,2123,417,2540,16
2021-08-13,Contra Costa,013,1133247,84449,81046,1631,82677,848
2021-08-13,Del Norte,015,27424,2261,1973,16,1989,8
2021-08-13,El Dorado,017,186661,12614,11951,1046,12997,118
2021-08-13,Fresno,019,978130,111687,108638,9593,118231,1753
2021-08-13,Glenn,021,27897,2631,2574,665,3239,20
2021-08-13,Humboldt,023,135768,6228,5882,112,5994,52
2021-08-13,Imperial,025,180216,29880,29654,2767,32421,745
2021-08-13,Inyo,027,18085,1491,1484,13,1497,39
2021-08-13,Kern,029,883053,103980,102029,13117,115146,1364
2021-08-13,Kings,031,150075,25215,24531,1280,25811,253
2021-08-13,Lake,033,64148,4974,4811,31,4842,68
2021-08-13,Lassen,035,31185,5548,5455,130,5585,21
2021-08-13,Los Angeles,037,10098052,1316867,1295406,47180,1342586,24891
2021-08-13,Madera,039,155013,18127,17614,1157,18771,246
2021-08-13,Marin,041,260295,15765,15380,309,15689,239
2021-08-13,Mariposa,043,17540,617,577,14,591,5
2021-08-13,Mendocino,045,87422,5197,4924,163,5087,49
2021-08-13,Merced,047,269075,33605,33111,1181,34292,480
2021-08-13,Modoc,049,8938,430,421,148,569,5
2021-08-13,Mono,051,14174,1363,1331,18,1349,3
2021-08-13,Monterey,053,433212,44932,44450,2143,46593,527
2021-08-13,Napa,055,140530,11088,10830,64,10894,83
2021-08-13,Nevada,057,99092,6691,6356,222,6578,74
2021-08-13,Orange,059,3164182,279381,274004,12676,286680,5159
2021-08-13,Placer,061,380077,28581,26987,2266,29253,306
2021-08-13,Plumas,063,18699,885,842,14,856,5
2021-08-13,Riverside,065,2383286,319720,312408,14831,327239,4581
2021-08-13,Sacramento,067,1510023,127852,122868,2493,125361,1758
2021-08-13,San Benito,069,59416,6492,6422,121,6543,64
2021-08-13,San Bernardino,071,2135413,316540,311378,9632,321010,5301
2021-08-13,San Diego,073,3302833,318529,312293,18371,330664,3821
2021-08-13,San Francisco,075,870044,45556,44196,1790,45986,567
2021-08-13,San Joaquin,077,732212,82486,80232,4136,84368,1481
2021-08-13,San Luis Obispo,079,281455,23868,23226,890,24116,265
2021-08-13,San Mateo,081,765935,47767,46660,666,47326,548
2021-08-13,Santa Barbara,083,443738,37845,37023,1282,38305,474
2021-08-13,Santa Clara,085,1922200,130235,126958,923,127881,1769
2021-08-13,Santa Cruz,087,273765,17761,17332,861,18193,209
2021-08-13,Shasta,089,179085,14189,13698,1924,15622,211
2021-08-13,Sierra,091,2930,85,81,12,93,0
2021-08-13,Siskiyou,093,43540,2248,2147,524,2671,33
2021-08-13,Solano,095,438530,39101,37104,866,37970,264
2021-08-13,Sonoma,097,501317,35765,34464,417,34881,333
2021-08-13,Stanislaus,099,539301,62860,61294,6753,68047,1039
2021-08-13,Sutter,101,95872,10950,10751,114,10865,130
2021-08-13,Tehama,103,63373,5657,5496,676,6172,66
2021-08-13,Trinity,105,12862,552,392,126,518,3
2021-08-13,Tulare,107,460477,53222,51770,10246,62016,856
2021-08-13,Tuolumne,109,53932,5042,4899,53,4952,64
2021-08-13,Ventura,111,848112,88101,86368,3699,90067,1052
2021-08-13,Yolo,113,214977,16266,15761,575,16336,225
2021-08-13,Yuba,115,75493,7373,7184,164,7348,51
2021-08-12,Alameda,001,1643700,103663,100472,2242,102714,1284
2021-08-12,Alpine,003,1148,90,91,0,91,0
2021-08-12,Amador,005,37829,4288,4161,36,4197,49
2021-08-12,Butte,007,227075,14481,14006,2310,16316,206
2021-08-12,Calaveras,009,45235,2629,2531,17,2548,57
2021-08-12,Colusa,011,21464,2178,2111,416,2527,17
2021-08-12,Contra Costa,013,1133247,83964,80738,1616,82354,846
2021-08-12,Del Norte,015,27424,2189,1923,16,1939,8
2021-08-12,El Dorado,017,186661,12500,11880,1037,12917,118
2021-08-12,Fresno,019,978130,111264,108193,9525,117718,1753
2021-08-12,Glenn,021,27897,2623,2559,653,3212,20
2021-08-12,Humboldt,023,135768,6159,5845,108,5953,52
2021-08-12,Imperial,025,180216,29824,29585,2761,32346,745
2021-08-12,Inyo,027,18085,1489,1483,13,1496,39
2021-08-12,Kern,029,883053,103690,101698,13038,114736,1364
2021-08-12,Kings,031,150075,25115,24423,1272,25695,252
2021-08-12,Lake,033,64148,4948,4774,31,4805,68
2021-08-12,Lassen,035,31185,5526,5428,129,5557,21
2021-08-12,Los Angeles,037,10098052,1313675,1291875,47046,1338921,24874
2021-08-12,Madera,039,155013,18063,17564,1145,18709,246
2021-08-12,Marin,041,260295,15716,15277,306,15583,239
2021-08-12,Mariposa,043,17540,608,568,13,581,5
2021-08-12,Mendocino,045,87422,5167,4873,157,5030,49
2021-08-12,Merced,047,269075,33481,32960,1174,34134,480
2021-08-12,Modoc,049,8938,429,423,148,571,5
2021-08-12,Mono,051,14174,1358,1325,18,1343,3
2021-08-12,Monterey,053,433212,44856,44383,2128,46511,527
2021-08-12,Napa,055,140530,11039,10780,63,10843,83
2021-08-12,Nevada,057,99092,6630,6283,222,6505,74
2021-08-12,Orange,059,3164182,278702,273167,12618,285785,5158
2021-08-12,Placer,061,380077,28382,26856,2243,29099,306
2021-08-12,Plumas,063,18699,877,829,14,843,5
2021-08-12,Riverside,065,2383286,318711,311304,14799,326103,4575
2021-08-12,Sacramento,067,1510023,127079,122222,2463,124685,1758
2021-08-12,San Benito,069,59416,6475,6398,119,6517,64
2021-08-12,San Bernardino,071,2135413,315666,310420,9602,320022,5297
2021-08-12,San Diego,073,3302833,317159,310596,18282,328878,3821
2021-08-12,San Francisco,075,870044,45349,43774,1777,45551,564
2021-08-12,San Joaquin,077,732212,82091,79945,4112,84057,1479
2021-08-12,San Luis Obispo,079,281455,23768,23101,877,23978,264
2021-08-12,San Mateo,081,765935,47623,46435,663,47098,548
2021-08-12,Santa Barbara,083,443738,37708,36881,1274,38155,473
2021-08-12,Santa Clara,085,1922200,129786,126614,917,127531,1769
2021-08-12,Santa Cruz,087,273765,17697,17261,860,18121,209
2021-08-12,Shasta,089,179085,14104,13621,1897,15518,211
2021-08-12,Sierra,091,2930,85,81,12,93,0
2021-08-12,Siskiyou,093,43540,2241,2134,515,2649,33
2021-08-12,Solano,095,438530,38872,36980,857,37837,262
2021-08-12,Sonoma,097,501317,35617,34299,414,34713,333
2021-08-12,Stanislaus,099,539301,62595,61026,6694,67720,1039
2021-08-12,Sutter,101,95872,10889,10695,112,10807,130
2021-08-12,Tehama,103,63373,5627,5462,667,6129,66
2021-08-12,Trinity,105,12862,548,386,125,511,3
2021-08-12,Tulare,107,460477,53077,51632,10197,61829,856
2021-08-12,Tuolumne,109,53932,4995,4845,51,4896,64
2021-08-12,Ventura,111,848112,87864,86106,3675,89781,1052
2021-08-12,Yolo,113,214977,16194,15686,561,16247,224
2021-08-12,Yuba,115,75493,7325,7128,163,7291,51
2021-08-11,Alameda,001,1643700,103157,100040,2239,102279,1281
2021-08-11,Alpine,003,1148,90,91,0,91,0
2021-08-11,Amador,005,37829,4264,4127,36,4163,49
2021-08-11,Butte,007,227075,14380,13905,2284,16189,206
2021-08-11,Calaveras,009,45235,2607,2505,17,2522,57
2021-08-11,Colusa,011,21464,2168,2101,414,2515,16
2021-08-11,Contra Costa,013,1133247,83463,80275,1598,81873,843
2021-08-11,Del Norte,015,27424,2130,1893,16,1909,8
2021-08-11,El Dorado,017,186661,12389,11799,1025,12824,119
2021-08-11,Fresno,019,978130,110806,107773,9479,117252,1751
2021-08-11,Glenn,021,27897,2614,2547,643,3190,20
2021-08-11,Humboldt,023,135768,6112,5765,107,5872,52
2021-08-11,Imperial,025,180216,29781,29565,2757,32322,745
2021-08-11,Inyo,027,18085,1489,1483,13,1496,39
2021-08-11,Kern,029,883053,103376,101448,12931,114379,1363
2021-08-11,Kings,031,150075,25002,24304,1263,25567,250
2021-08-11,Lake,033,64148,4911,4713,30,4743,68
2021-08-11,Lassen,035,31185,5517,5408,127,5535,21
2021-08-11,Los Angeles,037,10098052,1310346,1288238,46861,1335099,24851
2021-08-11,Madera,039,155013,18013,17511,1134,18645,245
2021-08-11,Marin,041,260295,15667,15235,306,15541,239
2021-08-11,Mariposa,043,17540,598,554,12,566,5
2021-08-11,Mendocino,045,87422,5098,4796,148,4944,49
2021-08-11,Merced,047,269075,33348,32802,1170,33972,479
2021-08-11,Modoc,049,8938,429,421,148,569,5
2021-08-11,Mono,051,14174,1353,1320,18,1338,3
2021-08-11,Monterey,053,433212,44757,44314,2110,46424,527
2021-08-11,Napa,055,140530,10998,10732,63,10795,83
2021-08-11,Nevada,057,99092,6577,6172,219,6391,74
2021-08-11,Orange,059,3164182,277844,272212,12572,284784,5155
2021-08-11,Placer,061,380077,28170,26687,2217,28904,305
2021-08-11,Plumas,063,18699,868,824,14,838,5
2021-08-11,Riverside,065,2383286,317718,310265,14764,325029,4570
2021-08-11,Sacramento,067,1510023,126288,121603,2423,124026,1757
2021-08-11,San Benito,069,59416,6462,6381,119,6500,64
2021-08-11,San Bernardino,071,2135413,314773,309498,9583,319081,5296
2021-08-11,San Diego,073,3302833,315689,309406,18178,327584,3818
2021-08-11,San Francisco,075,870044,45124,43555,1769,45324,564
2021-08-11,San Joaquin,077,732212,81684,79641,4085,83726,1478
2021-08-11,San Luis Obispo,079,281455,23664,22920,870,23790,264
2021-08-11,San Mateo,081,765935,47455,46300,660,46960,548
2021-08-11,Santa Barbara,083,443738,37545,36699,1266,37965,472
2021-08-11,Santa Clara,085,1922200,129304,126301,909,127210,1769
2021-08-11,Santa Cruz,087,273765,17632,17191,857,18048,209
2021-08-11,Shasta,089,179085,14030,13546,1882,15428,211
2021-08-11,Sierra,091,2930,84,81,12,93,0
2021-08-11,Siskiyou,093,43540,2227,2124,508,2632,33
2021-08-11,Solano,095,438530,38637,36862,843,37705,262
2021-08-11,Sonoma,097,501317,35438,34188,409,34597,333
2021-08-11,Stanislaus,099,539301,62264,60767,6664,67431,1037
2021-08-11,Sutter,101,95872,10817,10628,112,10740,130
2021-08-11,Tehama,103,63373,5598,5410,651,6061,66
2021-08-11,Trinity,105,12862,546,385,125,510,3
2021-08-11,Tulare,107,460477,52909,51464,10153,61617,854
2021-08-11,Tuolumne,109,53932,4963,4794,51,4845,64
2021-08-11,Ventura,111,848112,87612,85863,3654,89517,1051
2021-08-11,Yolo,113,214977,16119,15593,545,16138,218
2021-08-11,Yuba,115,75493,7266,7063,162,7225,53
2021-08-10,Alameda,001,1643700,102690,99771,2232,102003,1281
2021-08-10,Alpine,003,1148,90,91,0,91,0
2021-08-10,Amador,005,37829,4248,4093,36,4129,49
2021-08-10,Butte,007,227075,14296,13853,2264,16117,205
2021-08-10,Calaveras,009,45235,2583,2491,15,2506,57
2021-08-10,Colusa,011,21464,2155,2088,405,2493,16
2021-08-10,Contra Costa,013,1133247,82919,80018,1588,81606,840
2021-08-10,Del Norte,015,27424,2086,1870,16,1886,8
2021-08-10,El Dorado,017,186661,12288,11734,1013,12747,117
2021-08-10,Fresno,019,978130,110348,107616,9423,117039,1747
2021-08-10,Glenn,021,27897,2601,2538,633,3171,20
2021-08-10,Humboldt,023,135768,6058,5718,104,5822,52
2021-08-10,Imperial,025,180216,29746,29522,2750,32272,745
2021-08-10,Inyo,027,18085,1489,1482,13,1495,39
2021-08-10,Kern,029,883053,103048,101254,12835,114089,1359
2021-08-10,Kings,031,150075,24876,24252,1247,25499,251
2021-08-10,Lake,033,64148,4870,4700,30,4730,67
2021-08-10,Lassen,035,31185,5499,5401,127,5528,21
2021-08-10,Los Angeles,037,10098052,1306589,1285140,46698,1331838,24821
2021-08-10,Madera,039,155013,17940,17481,1124,18605,245
2021-08-10,Marin,041,260295,15620,15194,306,15500,239
2021-08-10,Mariposa,043,17540,585,550,12,562,5
2021-08-10,Mendocino,045,87422,5053,4775,144,4919,49
2021-08-10,Merced,047,269075,33200,32721,1161,33882,477
2021-08-10,Modoc,049,8938,428,421,148,569,5
2021-08-10,Mono,051,14174,1348,1320,18,1338,3
2021-08-10,Monterey,053,433212,44695,44259,2095,46354,527
2021-08-10,Napa,055,140530,10943,10703,62,10765,83
2021-08-10,Nevada,057,99092,6512,6151,218,6369,73
2021-08-10,Orange,059,3164182,276964,271688,12525,284213,5155
2021-08-10,Placer,061,380077,27951,26561,2175,28736,305
2021-08-10,Plumas,063,18699,859,816,14,830,5
2021-08-10,Riverside,065,2383286,316603,309529,14738,324267,4564
2021-08-10,Sacramento,067,1510023,125435,121159,2392,123551,1755
2021-08-10,San Benito,069,59416,6448,6371,119,6490,64
2021-08-10,San Bernardino,071,2135413,313849,308672,9565,318237,5295
2021-08-10,San Diego,073,3302833,314047,308288,18086,326374,3815
2021-08-10,San Francisco,075,870044,44871,43389,1754,45143,564
2021-08-10,San Joaquin,077,732212,81286,79391,4067,83458,1478
2021-08-10,San Luis Obispo,079,281455,23538,22776,868,23644,264
2021-08-10,San Mateo,081,765935,47283,46184,658,46842,548
2021-08-10,Santa Barbara,083,443738,37380,36574,1259,37833,472
2021-08-10,Santa Clara,085,1922200,128841,126019,902,126921,1770
2021-08-10,Santa Cruz,087,273765,17549,17142,855,17997,209
2021-08-10,Shasta,089,179085,13952,13461,1859,15320,211
2021-08-10,Sierra,091,2930,84,76,12,88,0
2021-08-10,Siskiyou,093,43540,2218,2088,501,2589,33
2021-08-10,Solano,095,438530,38391,36767,832,37599,262
2021-08-10,Sonoma,097,501317,35293,34054,406,34460,333
2021-08-10,Stanislaus,099,539301,61918,60605,6627,67232,1037
2021-08-10,Sutter,101,95872,10752,10569,112,10681,130
2021-08-10,Tehama,103,63373,5569,5392,646,6038,66
2021-08-10,Trinity,105,12862,546,384,125,509,3
2021-08-10,Tulare,107,460477,52745,51390,10101,61491,854
2021-08-10,Tuolumne,109,53932,4934,4780,49,4829,64
2021-08-10,Ventura,111,848112,87323,85714,3633,89347,1051
2021-08-10,Yolo,113,214977,16032,15568,535,16103,218
2021-08-10,Yuba,115,75493,7217,7028,162,7190,50
2021-08-09,Alameda,001,1643700,102139,99496,2228,101724,1276
2021-08-09,Alpine,003,1148,90,91,0,91,0
2021-08-09,Amador,005,37829,4222,4078,36,4114,48
2021-08-09,Butte,007,227075,14197,13813,2235,16048,205
2021-08-09,Calaveras,009,45235,2558,2472,15,2487,57
2021-08-09,Colusa,011,21464,2145,2075,398,2473,16
2021-08-09,Contra Costa,013,1133247,82377,79740,1576,81316,840
2021-08-09,Del Norte,015,27424,2018,1848,16,1864,8
2021-08-09,El Dorado,017,186661,12181,11672,1000,12672,117
2021-08-09,Fresno,019,978130,109854,107310,9384,116694,1747
2021-08-09,Glenn,021,27897,2590,2532,621,3153,20
2021-08-09,Humboldt,023,135768,5967,5632,102,5734,52
2021-08-09,Imperial,025,180216,29701,29512,2746,32258,745
2021-08-09,Inyo,027,18085,1489,1481,13,1494,39
2021-08-09,Kern,029,883053,102736,101069,12749,113818,1359
2021-08-09,Kings,031,150075,24769,24155,1233,25388,250
2021-08-09,Lake,033,64148,4835,4670,28,4698,66
2021-08-09,Lassen,035,31185,5477,5393,126,5519,21
2021-08-09,Los Angeles,037,10098052,1302571,1282891,46499,1329390,24798
2021-08-09,Madera,039,155013,17881,17429,1104,18533,245
2021-08-09,Marin,041,260295,15567,15154,305,15459,239
2021-08-09,Mariposa,043,17540,572,545,12,557,5
2021-08-09,Mendocino,045,87422,5002,4732,136,4868,49
2021-08-09,Merced,047,269075,33054,32666,1154,33820,477
2021-08-09,Modoc,049,8938,428,419,148,567,5
2021-08-09,Mono,051,14174,1345,1337,18,1355,3
2021-08-09,Monterey,053,433212,44623,44190,2080,46270,527
2021-08-09,Napa,055,140530,10896,10679,62,10741,83
2021-08-09,Nevada,057,99092,6440,6088,217,6305,73
2021-08-09,Orange,059,3164182,275925,271036,12470,283506,5153
2021-08-09,Placer,061,380077,27727,26457,2144,28601,305
2021-08-09,Plumas,063,18699,842,803,14,817,5
2021-08-09,Riverside,065,2383286,315526,308678,14720,323398,4562
2021-08-09,Sacramento,067,1510023,124601,120812,2367,123179,1748
2021-08-09,San Benito,069,59416,6428,6359,117,6476,63
2021-08-09,San Bernardino,071,2135413,312864,308038,9542,317580,5295
2021-08-09,San Diego,073,3302833,312389,306855,17987,324842,3811
2021-08-09,San Francisco,075,870044,44625,43261,1738,44999,564
2021-08-09,San Joaquin,077,732212,80903,79198,4049,83247,1469
2021-08-09,San Luis Obispo,079,281455,23399,22695,859,23554,264
2021-08-09,San Mateo,081,765935,47111,46040,655,46695,548
2021-08-09,Santa Barbara,083,443738,37196,36474,1251,37725,470
2021-08-09,Santa Clara,085,1922200,128338,125791,893,126684,2187
2021-08-09,Santa Cruz,087,273765,17487,17082,855,17937,209
2021-08-09,Shasta,089,179085,13835,13397,1848,15245,210
2021-08-09,Sierra,091,2930,83,75,12,87,0
2021-08-09,Siskiyou,093,43540,2206,2047,486,2533,32
2021-08-09,Solano,095,438530,38115,36653,830,37483,262
2021-08-09,Sonoma,097,501317,35112,33933,404,34337,333
2021-08-09,Stanislaus,099,539301,61639,60410,6578,66988,1037
2021-08-09,Sutter,101,95872,10703,10525,109,10634,129
2021-08-09,Tehama,103,63373,5527,5373,645,6018,66
2021-08-09,Trinity,105,12862,544,378,123,501,3
2021-08-09,Tulare,107,460477,52586,51274,10038,61312,854
2021-08-09,Tuolumne,109,53932,4892,4745,49,4794,64
2021-08-09,Ventura,111,848112,87051,85514,3622,89136,1047
2021-08-09,Yolo,113,214977,15954,15521,514,16035,218
2021-08-09,Yuba,115,75493,7158,6994,162,7156,50
2021-08-08,Alameda,001,1643700,101590,99135,2222,101357,1276
2021-08-08,Alpine,003,1148,90,91,0,91,0
2021-08-08,Amador,005,37829,4188,4057,35,4092,48
2021-08-08,Butte,007,227075,14115,13791,2215,16006,205
2021-08-08,Calaveras,009,45235,2525,2462,15,2477,57
2021-08-08,Colusa,011,21464,2128,2070,391,2461,16
2021-08-08,Contra Costa,013,1133247,81852,79454,1568,81022,840
2021-08-08,Del Norte,015,27424,1972,1810,16,1826,8
2021-08-08,El Dorado,017,186661,12060,11631,990,12621,117
2021-08-08,Fresno,019,978130,109411,107078,9347,116425,1747
2021-08-08,Glenn,021,27897,2582,2527,614,3141,20
2021-08-08,Humboldt,023,135768,5878,5571,102,5673,52
2021-08-08,Imperial,025,180216,29677,29485,2736,32221,745
2021-08-08,Inyo,027,18085,1489,1481,13,1494,39
2021-08-08,Kern,029,883053,102416,100909,12637,113546,1359
2021-08-08,Kings,031,150075,24655,24095,1224,25319,250
2021-08-08,Lake,033,64148,4785,4636,27,4663,66
2021-08-08,Lassen,035,31185,5462,5391,125,5516,21
2021-08-08,Los Angeles,037,10098052,1298321,1279982,46316,1326298,24793
2021-08-08,Madera,039,155013,17802,17398,1087,18485,245
2021-08-08,Marin,041,260295,15514,15124,303,15427,239
2021-08-08,Mariposa,043,17540,568,538,12,550,5
2021-08-08,Mendocino,045,87422,4940,4702,123,4825,49
2021-08-08,Merced,047,269075,32907,32634,1145,33779,477
2021-08-08,Modoc,049,8938,427,419,147,566,5
2021-08-08,Mono,051,14174,1341,1336,18,1354,3
2021-08-08,Monterey,053,433212,44553,44171,2069,46240,527
2021-08-08,Napa,055,140530,10860,10668,62,10730,83
2021-08-08,Nevada,057,99092,6356,6009,215,6224,73
2021-08-08,Orange,059,3164182,275011,270532,12428,282960,5153
2021-08-08,Placer,061,380077,27518,26332,2103,28435,305
2021-08-08,Plumas,063,18699,833,803,14,817,5
2021-08-08,Riverside,065,2383286,314403,308042,14697,322739,4562
2021-08-08,Sacramento,067,1510023,123772,120109,2355,122464,1744
2021-08-08,San Benito,069,59416,6411,6350,116,6466,63
2021-08-08,San Bernardino,071,2135413,311722,307378,9513,316891,5295
2021-08-08,San Diego,073,3302833,311048,305983,17889,323872,3811
2021-08-08,San Francisco,075,870044,44363,43098,1716,44814,564
2021-08-08,San Joaquin,077,732212,80455,79002,4033,83035,1469
2021-08-08,San Luis Obispo,079,281455,23225,22668,851,23519,263
2021-08-08,San Mateo,081,765935,46921,45927,652,46579,548
2021-08-08,Santa Barbara,083,443738,37019,36417,1244,37661,470
2021-08-08,Santa Clara,085,1922200,127886,125553,888,126441,2187
2021-08-08,Santa Cruz,087,273765,17416,17035,850,17885,209
2021-08-08,Shasta,089,179085,13750,13381,1837,15218,210
2021-08-08,Sierra,091,2930,83,74,12,86,0
2021-08-08,Siskiyou,093,43540,2190,2041,481,2522,32
2021-08-08,Solano,095,438530,37863,36551,826,37377,262
2021-08-08,Sonoma,097,501317,34868,33805,403,34208,333
2021-08-08,Stanislaus,099,539301,61313,60269,6533,66802,1037
2021-08-08,Sutter,101,95872,10643,10481,108,10589,129
2021-08-08,Tehama,103,63373,5491,5359,642,6001,66
2021-08-08,Trinity,105,12862,539,378,123,501,3
2021-08-08,Tulare,107,460477,52407,51220,9979,61199,854
2021-08-08,Tuolumne,109,53932,4852,4731,49,4780,64
2021-08-08,Ventura,111,848112,86760,85382,3612,88994,1047
2021-08-08,Yolo,113,214977,15861,15477,507,15984,218
2021-08-08,Yuba,115,75493,7119,6967,162,7129,50
2021-08-07,Alameda,001,1643700,101344,98812,2216,101028,1276
2021-08-07,Alpine,003,1148,90,91,0,91,0
2021-08-07,Amador,005,37829,4171,4041,34,4075,48
2021-08-07,Butte,007,227075,14063,13714,2203,15917,205
2021-08-07,Calaveras,009,45235,2515,2446,15,2461,57
2021-08-07,Colusa,011,21464,2123,2067,382,2449,16
2021-08-07,Contra Costa,013,1133247,81556,79168,1565,80733,840
2021-08-07,Del Norte,015,27424,1940,1791,16,1807,8
2021-08-07,El Dorado,017,186661,12012,11575,983,12558,117
2021-08-07,Fresno,019,978130,109207,106861,9321,116182,1747
2021-08-07,Glenn,021,27897,2574,2515,613,3128,20
2021-08-07,Humboldt,023,135768,5828,5510,99,5609,52
2021-08-07,Imperial,025,180216,29658,29470,2736,32206,745
2021-08-07,Inyo,027,18085,1487,1476,13,1489,39
2021-08-07,Kern,029,883053,102258,100693,12581,113274,1359
2021-08-07,Kings,031,150075,24594,24048,1218,25266,250
2021-08-07,Lake,033,64148,4764,4613,27,4640,66
2021-08-07,Lassen,035,31185,5458,5386,125,5511,21
2021-08-07,Los Angeles,037,10098052,1296283,1276853,46171,1323024,24786
2021-08-07,Madera,039,155013,17767,17366,1083,18449,245
2021-08-07,Marin,041,260295,15480,15085,302,15387,239
2021-08-07,Mariposa,043,17540,565,530,12,542,5
2021-08-07,Mendocino,045,87422,4904,4690,121,4811,49
2021-08-07,Merced,047,269075,32843,32569,1142,33711,477
2021-08-07,Modoc,049,8938,427,419,147,566,5
2021-08-07,Mono,051,14174,1338,1329,18,1347,3
2021-08-07,Monterey,053,433212,44501,44124,2064,46188,527
2021-08-07,Napa,055,140530,10839,10658,61,10719,83
2021-08-07,Nevada,057,99092,6306,5967,213,6180,73
2021-08-07,Orange,059,3164182,274419,269900,12398,282298,5153
2021-08-07,Placer,061,380077,27329,26244,2094,28338,305
2021-08-07,Plumas,063,18699,828,801,14,815,5
2021-08-07,Riverside,065,2383286,313730,307326,14690,322016,4562
2021-08-07,Sacramento,067,1510023,123270,119636,2351,121987,1744
2021-08-07,San Benito,069,59416,6401,6332,116,6448,63
2021-08-07,San Bernardino,071,2135413,311133,306663,9496,316159,5295
2021-08-07,San Diego,073,3302833,310292,304974,17854,322828,3811
2021-08-07,San Francisco,075,870044,44191,42926,1698,44624,564
2021-08-07,San Joaquin,077,732212,80291,78769,4018,82787,1469
2021-08-07,San Luis Obispo,079,281455,23156,22579,850,23429,263
2021-08-07,San Mateo,081,765935,46793,45804,650,46454,548
2021-08-07,Santa Barbara,083,443738,36923,36303,1238,37541,470
2021-08-07,Santa Clara,085,1922200,127615,125196,883,126079,2188
2021-08-07,Santa Cruz,087,273765,17373,16994,848,17842,209
2021-08-07,Shasta,089,179085,13694,13361,1830,15191,210
2021-08-07,Sierra,091,2930,83,74,12,86,0
2021-08-07,Siskiyou,093,43540,2178,2039,479,2518,32
2021-08-07,Solano,095,438530,37747,36458,818,37276,262
2021-08-07,Sonoma,097,501317,34746,33716,403,34119,333
2021-08-07,Stanislaus,099,539301,61142,60093,6503,66596,1037
2021-08-07,Sutter,101,95872,10606,10447,108,10555,129
2021-08-07,Tehama,103,63373,5480,5343,637,5980,66
2021-08-07,Trinity,105,12862,535,377,122,499,3
2021-08-07,Tulare,107,460477,52321,51133,9941,61074,854
2021-08-07,Tuolumne,109,53932,4822,4721,49,4770,64
2021-08-07,Ventura,111,848112,86580,85232,3598,88830,1047
2021-08-07,Yolo,113,214977,15818,15423,502,15925,218
2021-08-07,Yuba,115,75493,7094,6937,160,7097,50
2021-08-06,Alameda,001,1643700,101015,98487,2210,100697,1275
2021-08-06,Alpine,003,1148,90,91,0,91,0
2021-08-06,Amador,005,37829,4150,4002,34,4036,48
2021-08-06,Butte,007,227075,14013,13626,2188,15814,205
2021-08-06,Calaveras,009,45235,2504,2419,15,2434,57
2021-08-06,Colusa,011,21464,2116,2045,377,2422,16
2021-08-06,Contra Costa,013,1133247,81261,78796,1560,80356,840
2021-08-06,Del Norte,015,27424,1913,1755,15,1770,8
2021-08-06,El Dorado,017,186661,11962,11498,971,12469,117
2021-08-06,Fresno,019,978130,108943,106542,9294,115836,1747
2021-08-06,Glenn,021,27897,2559,2504,610,3114,20
2021-08-06,Humboldt,023,135768,5777,5421,96,5517,52
2021-08-06,Imperial,025,180216,29647,29404,2732,32136,745
2021-08-06,Inyo,027,18085,1484,1471,13,1484,39
2021-08-06,Kern,029,883053,102081,100427,12496,112923,1359
2021-08-06,Kings,031,150075,24539,23974,1214,25188,250
2021-08-06,Lake,033,64148,4741,4557,27,4584,66
2021-08-06,Lassen,035,31185,5436,5368,125,5493,21
2021-08-06,Los Angeles,037,10098052,1293790,1273081,46022,1319103,24772
2021-08-06,Madera,039,155013,17728,17324,1074,18398,245
2021-08-06,Marin,041,260295,15447,15051,302,15353,239
2021-08-06,Mariposa,043,17540,556,511,12,523,5
2021-08-06,Mendocino,045,87422,4862,4649,120,4769,49
2021-08-06,Merced,047,269075,32783,32456,1139,33595,477
2021-08-06,Modoc,049,8938,427,419,147,566,5
2021-08-06,Mono,051,14174,1337,1328,18,1346,3
2021-08-06,Monterey,053,433212,44433,44058,2051,46109,527
2021-08-06,Napa,055,140530,10812,10620,61,10681,83
2021-08-06,Nevada,057,99092,6250,5874,213,6087,73
2021-08-06,Orange,059,3164182,273853,269077,12381,281458,5151
2021-08-06,Placer,061,380077,27206,26086,2073,28159,305
2021-08-06,Plumas,063,18699,819,795,14,809,5
2021-08-06,Riverside,065,2383286,313020,306304,14679,320983,4562
2021-08-06,Sacramento,067,1510023,122778,119169,2332,121501,1740
2021-08-06,San Benito,069,59416,6384,6315,116,6431,63
2021-08-06,San Bernardino,071,2135413,310432,305806,9486,315292,5286
2021-08-06,San Diego,073,3302833,309253,303691,17805,321496,3810
2021-08-06,San Francisco,075,870044,44035,42659,1680,44339,565
2021-08-06,San Joaquin,077,732212,80141,78405,4006,82411,1469
2021-08-06,San Luis Obispo,079,281455,23088,22472,845,23317,263
2021-08-06,San Mateo,081,765935,46641,45665,645,46310,548
2021-08-06,Santa Barbara,083,443738,36834,36208,1234,37442,470
2021-08-06,Santa Clara,085,1922200,127325,124767,878,125645,2185
2021-08-06,Santa Cruz,087,273765,17329,16924,844,17768,207
2021-08-06,Shasta,089,179085,13628,13284,1824,15108,210
2021-08-06,Sierra,091,2930,83,73,12,85,0
2021-08-06,Siskiyou,093,43540,2168,2030,475,2505,32
2021-08-06,Solano,095,438530,37637,36351,809,37160,262
2021-08-06,Sonoma,097,501317,34660,33594,402,33996,333
2021-08-06,Stanislaus,099,539301,61004,59854,6483,66337,1037
2021-08-06,Sutter,101,95872,10563,10391,108,10499,128
2021-08-06,Tehama,103,63373,5456,5325,635,5960,66
2021-08-06,Trinity,105,12862,534,371,121,492,3
2021-08-06,Tulare,107,460477,52220,51018,9894,60912,854
2021-08-06,Tuolumne,109,53932,4795,4674,49,4723,64
2021-08-06,Ventura,111,848112,86409,85046,3586,88632,1047
2021-08-06,Yolo,113,214977,15765,15299,497,15796,218
2021-08-06,Yuba,115,75493,7071,6904,160,7064,50
2021-08-05,Alameda,001,1643700,100531,98052,2205,100257,1275
2021-08-05,Alpine,003,1148,90,91,0,91,0
2021-08-05,Amador,005,37829,4130,3992,34,4026,48
2021-08-05,Butte,007,227075,13952,13564,2165,15729,206
2021-08-05,Calaveras,009,45235,2485,2397,15,2412,57
2021-08-05,Colusa,011,21464,2104,2036,372,2408,16
2021-08-05,Contra Costa,013,1133247,80834,78514,1553,80067,840
2021-08-05,Del Norte,015,27424,1886,1731,15,1746,8
2021-08-05,El Dorado,017,186661,11877,11408,960,12368,117
2021-08-05,Fresno,019,978130,108572,106219,9257,115476,1747
2021-08-05,Glenn,021,27897,2553,2494,607,3101,20
2021-08-05,Humboldt,023,135768,5703,5328,95,5423,52
2021-08-05,Imperial,025,180216,29616,29383,2728,32111,745
2021-08-05,Inyo,027,18085,1480,1468,13,1481,38
2021-08-05,Kern,029,883053,101859,100091,12411,112502,1358
2021-08-05,Kings,031,150075,24455,23906,1209,25115,249
2021-08-05,Lake,033,64148,4702,4490,25,4515,66
2021-08-05,Lassen,035,31185,5428,5344,125,5469,21
2021-08-05,Los Angeles,037,10098052,1290570,1269445,45890,1315335,24756
2021-08-05,Madera,039,155013,17687,17301,1066,18367,245
2021-08-05,Marin,041,260295,15403,15005,298,15303,239
2021-08-05,Mariposa,043,17540,545,504,11,515,5
2021-08-05,Mendocino,045,87422,4819,4597,111,4708,49
2021-08-05,Merced,047,269075,32716,32381,1128,33509,477
2021-08-05,Modoc,049,8938,426,418,147,565,5
2021-08-05,Mono,051,14174,1329,1309,18,1327,3
2021-08-05,Monterey,053,433212,44376,43992,2033,46025,527
2021-08-05,Napa,055,140530,10776,10591,59,10650,83
2021-08-05,Nevada,057,99092,6168,5778,210,5988,73
2021-08-05,Orange,059,3164182,273072,268329,12354,280683,5149
2021-08-05,Placer,061,380077,27006,25965,2046,28011,305
2021-08-05,Plumas,063,18699,810,787,14,801,5
2021-08-05,Riverside,065,2383286,312102,305415,14653,320068,4562
2021-08-05,Sacramento,067,1510023,122070,118590,2318,120908,1739
2021-08-05,San Benito,069,59416,6366,6305,116,6421,63
2021-08-05,San Bernardino,071,2135413,309597,304956,9465,314421,5284
2021-08-05,San Diego,073,3302833,307981,302220,17723,319943,3806
2021-08-05,San Francisco,075,870044,43823,42301,1671,43972,564
2021-08-05,San Joaquin,077,732212,79779,78151,3988,82139,1468
2021-08-05,San Luis Obispo,079,281455,22973,22362,839,23201,263
2021-08-05,San Mateo,081,765935,46468,45554,643,46197,548
2021-08-05,Santa Barbara,083,443738,36727,36112,1231,37343,470
2021-08-05,Santa Clara,085,1922200,126992,124490,878,125368,2185
2021-08-05,Santa Cruz,087,273765,17285,16867,841,17708,207
2021-08-05,Shasta,089,179085,13570,13217,1816,15033,210
2021-08-05,Sierra,091,2930,78,73,12,85,0
2021-08-05,Siskiyou,093,43540,2147,2024,466,2490,32
2021-08-05,Solano,095,438530,37456,36250,802,37052,262
2021-08-05,Sonoma,097,501317,34525,33455,401,33856,330
2021-08-05,Stanislaus,099,539301,60782,59692,6444,66136,1037
2021-08-05,Sutter,101,95872,10508,10349,108,10457,127
2021-08-05,Tehama,103,63373,5438,5305,632,5937,66
2021-08-05,Trinity,105,12862,528,367,121,488,3
2021-08-05,Tulare,107,460477,52103,50889,9840,60729,854
2021-08-05,Tuolumne,109,53932,4765,4619,49,4668,64
2021-08-05,Ventura,111,848112,86158,84837,3572,88409,1047
2021-08-05,Yolo,113,214977,15698,15250,487,15737,218
2021-08-05,Yuba,115,75493,7028,6872,158,7030,50
2021-08-04,Alameda,001,1643700,100027,97477,2194,99671,1274
2021-08-04,Alpine,003,1148,90,91,0,91,0
2021-08-04,Amador,005,37829,4100,3962,33,3995,48
2021-08-04,Butte,007,227075,13884,13509,2148,15657,205
2021-08-04,Calaveras,009,45235,2460,2374,15,2389,57
2021-08-04,Colusa,011,21464,2092,2025,366,2391,16
2021-08-04,Contra Costa,013,1133247,80317,77966,1548,79514,840
2021-08-04,Del Norte,015,27424,1863,1701,15,1716,8
2021-08-04,El Dorado,017,186661,11797,11319,949,12268,117
2021-08-04,Fresno,019,978130,108202,105899,9218,115117,1747
2021-08-04,Glenn,021,27897,2545,2487,605,3092,20
2021-08-04,Humboldt,023,135768,5627,5271,94,5365,52
2021-08-04,Imperial,025,180216,29567,29375,2726,32101,745
2021-08-04,Inyo,027,18085,1479,1465,13,1478,38
2021-08-04,Kern,029,883053,101609,99868,12328,112196,1358
2021-08-04,Kings,031,150075,24383,23840,1201,25041,250
2021-08-04,Lake,033,64148,4672,4423,20,4443,65
2021-08-04,Lassen,035,31185,5420,5340,125,5465,21
2021-08-04,Los Angeles,037,10098052,1287077,1265788,45731,1311519,24737
2021-08-04,Madera,039,155013,17652,17251,1059,18310,245
2021-08-04,Marin,041,260295,15356,14950,296,15246,239
2021-08-04,Mariposa,043,17540,530,497,11,508,5
2021-08-04,Mendocino,045,87422,4795,4560,107,4667,49
2021-08-04,Merced,047,269075,32578,32274,1123,33397,476
2021-08-04,Modoc,049,8938,426,416,147,563,5
2021-08-04,Mono,051,14174,1325,1307,18,1325,3
2021-08-04,Monterey,053,433212,44311,43926,2022,45948,526
2021-08-04,Napa,055,140530,10739,10544,59,10603,82
2021-08-04,Nevada,057,99092,6104,5702,209,5911,73
2021-08-04,Orange,059,3164182,272197,267199,12317,279516,5146
2021-08-04,Placer,061,380077,26789,25688,2026,27714,305
2021-08-04,Plumas,063,18699,804,784,14,798,5
2021-08-04,Riverside,065,2383286,311177,304272,14628,318900,4562
2021-08-04,Sacramento,067,1510023,121313,117882,2292,120174,1736
2021-08-04,San Benito,069,59416,6351,6300,116,6416,63
2021-08-04,San Bernardino,071,2135413,308740,304164,9446,313610,5285
2021-08-04,San Diego,073,3302833,306468,301100,17656,318756,3805
2021-08-04,San Francisco,075,870044,43567,41913,1659,43572,562
2021-08-04,San Joaquin,077,732212,79422,77846,3976,81822,1466
2021-08-04,San Luis Obispo,079,281455,22863,22245,833,23078,262
2021-08-04,San Mateo,081,765935,46296,45392,642,46034,548
2021-08-04,Santa Barbara,083,443738,36598,36013,1223,37236,470
2021-08-04,Santa Clara,085,1922200,126601,124127,871,124998,2183
2021-08-04,Santa Cruz,087,273765,17223,16820,834,17654,208
2021-08-04,Shasta,089,179085,13519,13134,1805,14939,211
2021-08-04,Sierra,091,2930,78,73,12,85,0
2021-08-04,Siskiyou,093,43540,2127,2010,462,2472,32
2021-08-04,Solano,095,438530,37255,36025,793,36818,262
2021-08-04,Sonoma,097,501317,34353,33311,399,33710,330
2021-08-04,Stanislaus,099,539301,60556,59396,6406,65802,1037
2021-08-04,Sutter,101,95872,10471,10294,108,10402,127
2021-08-04,Tehama,103,63373,5412,5281,626,5907,66
2021-08-04,Trinity,105,12862,526,362,118,480,3
2021-08-04,Tulare,107,460477,51993,50797,9796,60593,855
2021-08-04,Tuolumne,109,53932,4740,4584,49,4633,64
2021-08-04,Ventura,111,848112,85900,84406,3550,87956,1047
2021-08-04,Yolo,113,214977,15618,15189,474,15663,215
2021-08-04,Yuba,115,75493,6988,6827,157,6984,50
2021-08-03,Alameda,001,1643700,99580,97275,2189,99464,1270
2021-08-03,Alpine,003,1148,90,91,0,91,0
2021-08-03,Amador,005,37829,4064,3953,33,3986,48
2021-08-03,Butte,007,227075,13817,13468,2133,15601,205
2021-08-03,Calaveras,009,45235,2438,2356,15,2371,57
2021-08-03,Colusa,011,21464,2079,2023,360,2383,16
2021-08-03,Contra Costa,013,1133247,79835,77739,1541,79280,836
2021-08-03,Del Norte,015,27424,1831,1691,14,1705,8
2021-08-03,El Dorado,017,186661,11704,11255,938,12193,117
2021-08-03,Fresno,019,978130,107840,105732,9187,114919,1746
2021-08-03,Glenn,021,27897,2538,2481,599,3080,20
2021-08-03,Humboldt,023,135768,5562,5199,89,5288,52
2021-08-03,Imperial,025,180216,29545,29333,2719,32052,745
2021-08-03,Inyo,027,18085,1476,1459,13,1472,38
2021-08-03,Kern,029,883053,101347,99708,12249,111957,1358
2021-08-03,Kings,031,150075,24295,23780,1194,24974,249
2021-08-03,Lake,033,64148,4616,4408,16,4424,66
2021-08-03,Lassen,035,31185,5410,5341,125,5466,21
2021-08-03,Los Angeles,037,10098052,1283330,1262678,45558,1308236,24721
2021-08-03,Madera,039,155013,17611,17220,1044,18264,245
2021-08-03,Marin,041,260295,15307,14906,293,15199,243
2021-08-03,Mariposa,043,17540,519,495,11,506,5
2021-08-03,Mendocino,045,87422,4746,4546,106,4652,49
2021-08-03,Merced,047,269075,32495,32197,1121,33318,476
2021-08-03,Modoc,049,8938,426,416,147,563,5
2021-08-03,Mono,051,14174,1320,1303,18,1321,3
2021-08-03,Monterey,053,433212,44248,43872,2009,45881,525
2021-08-03,Napa,055,140530,10696,10527,58,10585,82
2021-08-03,Nevada,057,99092,6023,5685,208,5893,73
2021-08-03,Orange,059,3164182,271458,266649,12287,278936,5146
2021-08-03,Placer,061,380077,26588,25624,2002,27626,305
2021-08-03,Plumas,063,18699,797,779,14,793,5
2021-08-03,Riverside,065,2383286,310252,303499,14602,318101,4562
2021-08-03,Sacramento,067,1510023,120568,117591,2272,119863,1732
2021-08-03,San Benito,069,59416,6336,6284,115,6399,63
2021-08-03,San Bernardino,071,2135413,307818,303386,9428,312814,5265
2021-08-03,San Diego,073,3302833,305029,300189,17546,317735,3803
2021-08-03,San Francisco,075,870044,43283,41758,1639,43397,562
2021-08-03,San Joaquin,077,732212,79071,77615,3955,81570,1461
2021-08-03,San Luis Obispo,079,281455,22723,22166,826,22992,264
2021-08-03,San Mateo,081,765935,46104,45255,637,45892,548
2021-08-03,Santa Barbara,083,443738,36479,35912,1217,37129,469
2021-08-03,Santa Clara,085,1922200,126180,123914,865,124779,2183
2021-08-03,Santa Cruz,087,273765,17157,16778,831,17609,207
2021-08-03,Shasta,089,179085,13444,13091,1794,14885,211
2021-08-03,Sierra,091,2930,78,72,12,84,0
2021-08-03,Siskiyou,093,43540,2116,1998,457,2455,32
2021-08-03,Solano,095,438530,37035,35953,781,36734,261
2021-08-03,Sonoma,097,501317,34172,33243,398,33641,330
2021-08-03,Stanislaus,099,539301,60334,59282,6387,65669,1037
2021-08-03,Sutter,101,95872,10431,10263,107,10370,127
2021-08-03,Tehama,103,63373,5385,5269,621,5890,66
2021-08-03,Trinity,105,12862,523,361,115,476,3
2021-08-03,Tulare,107,460477,51898,50729,9750,60479,854
2021-08-03,Tuolumne,109,53932,4705,4563,49,4612,64
2021-08-03,Ventura,111,848112,85656,84270,3529,87799,1046
2021-08-03,Yolo,113,214977,15526,15149,459,15608,215
2021-08-03,Yuba,115,75493,6951,6781,155,6936,50
2021-08-02,Alameda,001,1643700,99024,96954,2185,99139,1270
2021-08-02,Alpine,003,1148,90,91,0,91,0
2021-08-02,Amador,005,37829,4044,3927,33,3960,48
2021-08-02,Butte,007,227075,13737,13442,2114,15556,205
2021-08-02,Calaveras,009,45235,2413,2347,15,2362,57
2021-08-02,Colusa,011,21464,2067,2019,357,2376,16
2021-08-02,Contra Costa,013,1133247,79325,77516,1527,79043,836
2021-08-02,Del Norte,015,27424,1801,1653,14,1667,8
2021-08-02,El Dorado,017,186661,11601,11226,924,12150,116
2021-08-02,Fresno,019,978130,107495,105471,9150,114621,1744
2021-08-02,Glenn,021,27897,2530,2477,596,3073,20
2021-08-02,Humboldt,023,135768,5479,5161,87,5248,52
2021-08-02,Imperial,025,180216,29512,29302,2716,32018,743
2021-08-02,Inyo,027,18085,1470,1455,13,1468,38
2021-08-02,Kern,029,883053,101092,99556,12158,111714,1357
2021-08-02,Kings,031,150075,24225,23722,1188,24910,249
2021-08-02,Lake,033,64148,4573,4375,16,4391,66
2021-08-02,Lassen,035,31185,5387,5338,123,5461,21
2021-08-02,Los Angeles,037,10098052,1279607,1260807,45353,1306160,24705
2021-08-02,Madera,039,155013,17567,17158,1031,18189,245
2021-08-02,Marin,041,260295,15264,14859,292,15151,239
2021-08-02,Mariposa,043,17540,510,490,11,501,5
2021-08-02,Mendocino,045,87422,4706,4512,103,4615,49
2021-08-02,Merced,047,269075,32397,32163,1114,33277,474
2021-08-02,Modoc,049,8938,426,415,147,562,5
2021-08-02,Mono,051,14174,1313,1296,18,1314,3
2021-08-02,Monterey,053,433212,44188,43842,2001,45843,525
2021-08-02,Napa,055,140530,10653,10490,55,10545,82
2021-08-02,Nevada,057,99092,5952,5611,207,5818,73
2021-08-02,Orange,059,3164182,270543,266050,12242,278292,5146
2021-08-02,Placer,061,380077,26441,25516,1968,27484,306
2021-08-02,Plumas,063,18699,790,762,14,776,5
2021-08-02,Riverside,065,2383286,309314,302756,14587,317343,4562
2021-08-02,Sacramento,067,1510023,119870,117183,2253,119436,1728
2021-08-02,San Benito,069,59416,6317,6276,114,6390,63
2021-08-02,San Bernardino,071,2135413,306943,303000,9395,312395,5253
2021-08-02,San Diego,073,3302833,303549,299021,17466,316487,3798
2021-08-02,San Francisco,075,870044,42996,41553,1616,43169,562
2021-08-02,San Joaquin,077,732212,78728,77447,3930,81377,1461
2021-08-02,San Luis Obispo,079,281455,22629,22093,819,22912,261
2021-08-02,San Mateo,081,765935,45927,45154,625,45779,548
2021-08-02,Santa Barbara,083,443738,36341,35851,1211,37062,469
2021-08-02,Santa Clara,085,1922200,125708,123655,857,124512,2183
2021-08-02,Santa Cruz,087,273765,17099,16746,827,17573,207
2021-08-02,Shasta,089,179085,13382,13049,1780,14829,212
2021-08-02,Sierra,091,2930,78,71,12,83,0
2021-08-02,Siskiyou,093,43540,2105,1992,443,2435,31
2021-08-02,Solano,095,438530,36787,35852,768,36620,260
2021-08-02,Sonoma,097,501317,33946,33132,393,33525,330
2021-08-02,Stanislaus,099,539301,60115,59160,6360,65520,1037
2021-08-02,Sutter,101,95872,10385,10220,107,10327,127
2021-08-02,Tehama,103,63373,5362,5260,617,5877,66
2021-08-02,Trinity,105,12862,518,359,114,473,3
2021-08-02,Tulare,107,460477,51797,50640,9678,60318,854
2021-08-02,Tuolumne,109,53932,4638,4524,49,4573,64
2021-08-02,Ventura,111,848112,85471,84143,3506,87649,1044
2021-08-02,Yolo,113,214977,15428,15072,442,15514,215
2021-08-02,Yuba,115,75493,6909,6743,152,6895,50
2021-08-01,Alameda,001,1643700,98493,96775,2179,98954,1270
2021-08-01,Alpine,003,1148,90,91,0,91,0
2021-08-01,Amador,005,37829,4006,3923,33,3956,48
2021-08-01,Butte,007,227075,13659,13406,2096,15502,205
2021-08-01,Calaveras,009,45235,2389,2341,15,2356,57
2021-08-01,Colusa,011,21464,2056,2014,355,2369,16
2021-08-01,Contra Costa,013,1133247,78889,77360,1520,78880,836
2021-08-01,Del Norte,015,27424,1769,1642,14,1656,8
2021-08-01,El Dorado,017,186661,11501,11189,913,12102,116
2021-08-01,Fresno,019,978130,107168,105339,9105,114444,1744
2021-08-01,Glenn,021,27897,2524,2476,593,3069,20
2021-08-01,Humboldt,023,135768,5402,5118,83,5201,52
2021-08-01,Imperial,025,180216,29477,29297,2712,32009,743
2021-08-01,Inyo,027,18085,1468,1454,13,1467,38
2021-08-01,Kern,029,883053,100814,99396,12083,111479,1357
2021-08-01,Kings,031,150075,24138,23700,1183,24883,249
2021-08-01,Lake,033,64148,4494,4356,16,4372,66
2021-08-01,Lassen,035,31185,5374,5336,121,5457,21
2021-08-01,Los Angeles,037,10098052,1275915,1258461,45131,1303592,24700
2021-08-01,Madera,039,155013,17511,17146,1026,18172,245
2021-08-01,Marin,041,260295,15187,14844,291,15135,239
2021-08-01,Mariposa,043,17540,503,482,11,493,5
2021-08-01,Mendocino,045,87422,4660,4476,99,4575,49
2021-08-01,Merced,047,269075,32306,32144,1108,33252,474
2021-08-01,Modoc,049,8938,424,413,147,560,5
2021-08-01,Mono,051,14174,1310,1294,18,1312,3
2021-08-01,Monterey,053,433212,44141,43808,1988,45796,525
2021-08-01,Napa,055,140530,10604,10473,53,10526,82
2021-08-01,Nevada,057,99092,5865,5561,206,5767,73
2021-08-01,Orange,059,3164182,269729,265467,12199,277666,5146
2021-08-01,Placer,061,380077,26224,25464,1938,27402,306
2021-08-01,Plumas,063,18699,784,761,14,775,5
2021-08-01,Riverside,065,2383286,308381,302256,14569,316825,4562
2021-08-01,Sacramento,067,1510023,119134,116923,2239,119162,1727
2021-08-01,San Benito,069,59416,6300,6271,114,6385,63
2021-08-01,San Bernardino,071,2135413,306009,302542,9384,311926,5248
2021-08-01,San Diego,073,3302833,302363,298002,17401,315403,3798
2021-08-01,San Francisco,075,870044,42659,41432,1603,43035,562
2021-08-01,San Joaquin,077,732212,78361,77338,3905,81243,1461
2021-08-01,San Luis Obispo,079,281455,22527,22083,814,22897,261
2021-08-01,San Mateo,081,765935,45744,45036,618,45654,548
2021-08-01,Santa Barbara,083,443738,36217,35809,1207,37016,469
2021-08-01,Santa Clara,085,1922200,125296,123511,849,124360,2183
2021-08-01,Santa Cruz,087,273765,17020,16709,820,17529,207
2021-08-01,Shasta,089,179085,13311,13036,1771,14807,212
2021-08-01,Sierra,091,2930,76,71,12,83,0
2021-08-01,Siskiyou,093,43540,2099,1989,437,2426,31
2021-08-01,Solano,095,438530,36552,35800,759,36559,260
2021-08-01,Sonoma,097,501317,33754,33076,390,33466,330
2021-08-01,Stanislaus,099,539301,59878,59078,6328,65406,1037
2021-08-01,Sutter,101,95872,10330,10198,104,10302,127
2021-08-01,Tehama,103,63373,5345,5252,613,5865,66
2021-08-01,Trinity,105,12862,515,359,113,472,3
2021-08-01,Tulare,107,460477,51640,50600,9617,60217,854
2021-08-01,Tuolumne,109,53932,4600,4489,49,4538,64
2021-08-01,Ventura,111,848112,85241,84040,3491,87531,1044
2021-08-01,Yolo,113,214977,15358,15042,432,15474,215
2021-08-01,Yuba,115,75493,6872,6721,151,6872,50
2021-07-31,Alameda,001,1643700,98161,95279,2174,97453,1265
2021-07-31,Alpine,003,1148,90,89,0,89,0
2021-07-31,Amador,005,37829,3986,3877,33,3910,48
2021-07-31,Butte,007,227075,13625,13235,2075,15310,205
2021-07-31,Calaveras,009,45235,2380,2294,15,2309,57
2021-07-31,Colusa,011,21464,2050,2006,353,2359,16
2021-07-31,Contra Costa,013,1133247,78610,75866,1518,77384,832
2021-07-31,Del Norte,015,27424,1743,1576,14,1590,8
2021-07-31,El Dorado,017,186661,11448,11017,907,11924,116
2021-07-31,Fresno,019,978130,107009,104639,9092,113731,1744
2021-07-31,Glenn,021,27897,2519,2465,588,3053,20
2021-07-31,Humboldt,023,135768,5347,4978,82,5060,52
2021-07-31,Imperial,025,180216,29460,29164,2709,31873,743
2021-07-31,Inyo,027,18085,1465,1442,13,1455,38
2021-07-31,Kern,029,883053,100649,98903,12024,110927,1357
2021-07-31,Kings,031,150075,24085,23548,1178,24726,248
2021-07-31,Lake,033,64148,4469,4238,16,4254,66
2021-07-31,Lassen,035,31185,5367,5320,121,5441,21
2021-07-31,Los Angeles,037,10098052,1273708,1248545,44991,1293536,24691
2021-07-31,Madera,039,155013,17478,17058,1020,18078,245
2021-07-31,Marin,041,260295,15143,14701,290,14991,239
2021-07-31,Mariposa,043,17540,494,470,11,481,5
2021-07-31,Mendocino,045,87422,4635,4400,96,4496,49
2021-07-31,Merced,047,269075,32258,31959,1103,33062,474
2021-07-31,Modoc,049,8938,424,413,147,560,5
2021-07-31,Mono,051,14174,1308,1287,18,1305,3
2021-07-31,Monterey,053,433212,44101,43720,1978,45698,525
2021-07-31,Napa,055,140530,10585,10401,52,10453,82
2021-07-31,Nevada,057,99092,5826,5373,205,5578,72
2021-07-31,Orange,059,3164182,269155,263446,12181,275627,5144
2021-07-31,Placer,061,380077,26092,25104,1931,27035,306
2021-07-31,Plumas,063,18699,781,743,14,757,5
2021-07-31,Riverside,065,2383286,307764,300315,14559,314874,4554
2021-07-31,Sacramento,067,1510023,118722,115259,2232,117491,1720
2021-07-31,San Benito,069,59416,6289,6251,114,6365,63
2021-07-31,San Bernardino,071,2135413,305435,300726,9381,310107,5240
2021-07-31,San Diego,073,3302833,301690,295054,17355,312409,3798
2021-07-31,San Francisco,075,870044,42431,40412,1583,41995,562
2021-07-31,San Joaquin,077,732212,78196,76575,3892,80467,1443
2021-07-31,San Luis Obispo,079,281455,22474,21922,812,22734,260
2021-07-31,San Mateo,081,765935,45587,44622,613,45235,548
2021-07-31,Santa Barbara,083,443738,36136,35531,1206,36737,467
2021-07-31,Santa Clara,085,1922200,125041,122614,847,123461,2099
2021-07-31,Santa Cruz,087,273765,16981,16576,819,17395,207
2021-07-31,Shasta,089,179085,13274,12918,1763,14681,212
2021-07-31,Sierra,091,2930,76,68,12,80,0
2021-07-31,Siskiyou,093,43540,2090,1976,431,2407,31
2021-07-31,Solano,095,438530,36451,35340,752,36092,263
2021-07-31,Sonoma,097,501317,33628,32601,390,32991,329
2021-07-31,Stanislaus,099,539301,59719,58586,6306,64892,1035
2021-07-31,Sutter,101,95872,10296,10068,103,10171,127
2021-07-31,Tehama,103,63373,5330,5216,610,5826,66
2021-07-31,Trinity,105,12862,514,354,112,466,3
2021-07-31,Tulare,107,460477,51550,50409,9564,59973,854
2021-07-31,Tuolumne,109,53932,4561,4362,49,4411,64
2021-07-31,Ventura,111,848112,85080,83509,3475,86984,1044
2021-07-31,Yolo,113,214977,15310,14863,421,15284,215
2021-07-31,Yuba,115,75493,6849,6615,147,6762,50
2021-07-30,Alameda,001,1643700,97835,95279,2170,97449,1265
2021-07-30,Alpine,003,1148,90,89,0,89,0
2021-07-30,Amador,005,37829,3963,3877,33,3910,48
2021-07-30,Butte,007,227075,13570,13235,2062,15297,205
2021-07-30,Calaveras,009,45235,2370,2294,15,2309,57
2021-07-30,Colusa,011,21464,2046,2006,351,2357,16
2021-07-30,Contra Costa,013,1133247,78364,75866,1514,77380,832
2021-07-30,Del Norte,015,27424,1725,1576,14,1590,8
2021-07-30,El Dorado,017,186661,11415,11017,901,11918,116
2021-07-30,Fresno,019,978130,106814,104639,9080,113719,1744
2021-07-30,Glenn,021,27897,2514,2465,587,3052,20
2021-07-30,Humboldt,023,135768,5284,4978,79,5057,52
2021-07-30,Imperial,025,180216,29446,29164,2706,31870,743
2021-07-30,Inyo,027,18085,1464,1442,13,1455,38
2021-07-30,Kern,029,883053,100525,98903,11977,110880,1357
2021-07-30,Kings,031,150075,24045,23548,1174,24722,248
2021-07-30,Lake,033,64148,4441,4238,16,4254,66
2021-07-30,Lassen,035,31185,5363,5320,121,5441,21
2021-07-30,Los Angeles,037,10098052,1271375,1248545,44844,1293389,24691
2021-07-30,Madera,039,155013,17436,17058,1017,18075,245
2021-07-30,Marin,041,260295,15109,14701,290,14991,239
2021-07-30,Mariposa,043,17540,490,470,11,481,5
2021-07-30,Mendocino,045,87422,4605,4400,95,4495,49
2021-07-30,Merced,047,269075,32217,31959,1099,33058,474
2021-07-30,Modoc,049,8938,422,413,147,560,5
2021-07-30,Mono,051,14174,1303,1287,18,1305,3
2021-07-30,Monterey,053,433212,44067,43720,1969,45689,525
2021-07-30,Napa,055,140530,10563,10401,51,10452,82
2021-07-30,Nevada,057,99092,5769,5373,205,5578,72
2021-07-30,Orange,059,3164182,268530,263446,12155,275601,5144
2021-07-30,Placer,061,380077,26002,25104,1913,27017,306
2021-07-30,Plumas,063,18699,776,743,14,757,5
2021-07-30,Riverside,065,2383286,307127,300315,14549,314864,4554
2021-07-30,Sacramento,067,1510023,118270,115259,2228,117487,1720
2021-07-30,San Benito,069,59416,6282,6251,114,6365,63
2021-07-30,San Bernardino,071,2135413,304921,300726,9374,310100,5240
2021-07-30,San Diego,073,3302833,300916,295054,17297,312351,3798
2021-07-30,San Francisco,075,870044,42218,40412,1569,41981,562
2021-07-30,San Joaquin,077,732212,78042,76575,3887,80462,1443
2021-07-30,San Luis Obispo,079,281455,22436,21922,808,22730,260
2021-07-30,San Mateo,081,765935,45462,44622,600,45222,548
2021-07-30,Santa Barbara,083,443738,36067,35531,1200,36731,467
2021-07-30,Santa Clara,085,1922200,124818,122614,845,123459,2099
2021-07-30,Santa Cruz,087,273765,16955,16576,817,17393,207
2021-07-30,Shasta,089,179085,13229,12918,1763,14681,212
2021-07-30,Sierra,091,2930,75,68,12,80,0
2021-07-30,Siskiyou,093,43540,2081,1976,430,2406,31
2021-07-30,Solano,095,438530,36360,35340,736,36076,263
2021-07-30,Sonoma,097,501317,33533,32601,390,32991,329
2021-07-30,Stanislaus,099,539301,59575,58586,6286,64872,1035
2021-07-30,Sutter,101,95872,10261,10068,103,10171,127
2021-07-30,Tehama,103,63373,5320,5216,610,5826,66
2021-07-30,Trinity,105,12862,514,354,112,466,3
2021-07-30,Tulare,107,460477,51507,50409,9529,59938,854
2021-07-30,Tuolumne,109,53932,4543,4362,49,4411,64
2021-07-30,Ventura,111,848112,84916,83509,3460,86969,1044
2021-07-30,Yolo,113,214977,15250,14863,417,15280,215
2021-07-30,Yuba,115,75493,6813,6615,146,6761,50
2021-07-29,Alameda,001,1643700,97423,95279,2164,97443,1265
2021-07-29,Alpine,003,1148,90,89,0,89,0
2021-07-29,Amador,005,37829,3944,3877,33,3910,48
2021-07-29,Butte,007,227075,13521,13235,2054,15289,205
2021-07-29,Calaveras,009,45235,2355,2294,15,2309,57
2021-07-29,Colusa,011,21464,2039,2006,351,2357,16
2021-07-29,Contra Costa,013,1133247,77924,75866,1512,77378,832
2021-07-29,Del Norte,015,27424,1701,1576,14,1590,8
2021-07-29,El Dorado,017,186661,11351,11017,889,11906,116
2021-07-29,Fresno,019,978130,106550,104639,9054,113693,1744
2021-07-29,Glenn,021,27897,2504,2465,586,3051,20
2021-07-29,Humboldt,023,135768,5224,4978,77,5055,52
2021-07-29,Imperial,025,180216,29401,29164,2704,31868,743
2021-07-29,Inyo,027,18085,1460,1442,13,1455,38
2021-07-29,Kern,029,883053,100318,98903,11900,110803,1357
2021-07-29,Kings,031,150075,23999,23548,1170,24718,248
2021-07-29,Lake,033,64148,4406,4238,16,4254,66
2021-07-29,Lassen,035,31185,5355,5320,118,5438,21
2021-07-29,Los Angeles,037,10098052,1268271,1248545,44667,1293212,24691
2021-07-29,Madera,039,155013,17389,17058,1013,18071,245
2021-07-29,Marin,041,260295,15065,14701,290,14991,239
2021-07-29,Mariposa,043,17540,486,470,11,481,5
2021-07-29,Mendocino,045,87422,4582,4400,93,4493,49
2021-07-29,Merced,047,269075,32162,31959,1099,33058,474
2021-07-29,Modoc,049,8938,422,413,147,560,5
2021-07-29,Mono,051,14174,1301,1287,18,1305,3
2021-07-29,Monterey,053,433212,44018,43720,1959,45679,525
2021-07-29,Napa,055,140530,10531,10401,49,10450,82
2021-07-29,Nevada,057,99092,5717,5373,204,5577,72
2021-07-29,Orange,059,3164182,267818,263446,12123,275569,5144
2021-07-29,Placer,061,380077,25879,25104,1898,27002,306
2021-07-29,Plumas,063,18699,768,743,14,757,5
2021-07-29,Riverside,065,2383286,306422,300315,14525,314840,4554
2021-07-29,Sacramento,067,1510023,117715,115259,2215,117474,1720
2021-07-29,San Benito,069,59416,6271,6251,114,6365,63
2021-07-29,San Bernardino,071,2135413,304284,300726,9365,310091,5240
2021-07-29,San Diego,073,3302833,299859,295054,17229,312283,3798
2021-07-29,San Francisco,075,870044,41967,40412,1548,41960,562
2021-07-29,San Joaquin,077,732212,77787,76575,3879,80454,1443
2021-07-29,San Luis Obispo,079,281455,22381,21922,806,22728,260
2021-07-29,San Mateo,081,765935,45335,44622,590,45212,548
2021-07-29,Santa Barbara,083,443738,35981,35531,1199,36730,467
2021-07-29,Santa Clara,085,1922200,124522,122614,842,123456,2099
2021-07-29,Santa Cruz,087,273765,16902,16576,815,17391,207
2021-07-29,Shasta,089,179085,13175,12918,1754,14672,212
2021-07-29,Sierra,091,2930,75,68,12,80,0
2021-07-29,Siskiyou,093,43540,2076,1976,428,2404,31
2021-07-29,Solano,095,438530,36200,35340,726,36066,263
2021-07-29,Sonoma,097,501317,33359,32601,388,32989,329
2021-07-29,Stanislaus,099,539301,59403,58586,6271,64857,1035
2021-07-29,Sutter,101,95872,10215,10068,102,10170,127
2021-07-29,Tehama,103,63373,5307,5216,604,5820,66
2021-07-29,Trinity,105,12862,512,354,111,465,3
2021-07-29,Tulare,107,460477,51417,50409,9489,59898,854
2021-07-29,Tuolumne,109,53932,4503,4362,48,4410,64
2021-07-29,Ventura,111,848112,84750,83509,3453,86962,1044
2021-07-29,Yolo,113,214977,15183,14863,403,15266,215
2021-07-29,Yuba,115,75493,6764,6615,143,6758,50
2021-07-28,Alameda,001,1643700,96963,94965,2157,97122,1262
2021-07-28,Alpine,003,1148,90,89,0,89,0
2021-07-28,Amador,005,37829,3930,3870,33,3903,48
2021-07-28,Butte,007,227075,13464,13184,2041,15225,205
2021-07-28,Calaveras,009,45235,2334,2289,15,2304,57
2021-07-28,Colusa,011,21464,2036,2001,350,2351,16
2021-07-28,Contra Costa,013,1133247,77435,75487,1504,76991,832
2021-07-28,Del Norte,015,27424,1668,1545,14,1559,8
2021-07-28,El Dorado,017,186661,11301,10967,880,11847,116
2021-07-28,Fresno,019,978130,106298,104458,9034,113492,1744
2021-07-28,Glenn,021,27897,2501,2464,583,3047,20
2021-07-28,Humboldt,023,135768,5173,4946,76,5022,52
2021-07-28,Imperial,025,180216,29354,29096,2704,31800,743
2021-07-28,Inyo,027,18085,1454,1439,12,1451,38
2021-07-28,Kern,029,883053,100162,98781,11854,110635,1352
2021-07-28,Kings,031,150075,23935,23503,1160,24663,248
2021-07-28,Lake,033,64148,4360,4191,15,4206,65
2021-07-28,Lassen,035,31185,5347,5318,118,5436,21
2021-07-28,Los Angeles,037,10098052,1265094,1245485,44484,1289969,24673
2021-07-28,Madera,039,155013,17348,17024,1007,18031,245
2021-07-28,Marin,041,260295,15011,14652,290,14942,239
2021-07-28,Mariposa,043,17540,479,469,11,480,5
2021-07-28,Mendocino,045,87422,4554,4377,93,4470,49
2021-07-28,Merced,047,269075,32106,31886,1095,32981,474
2021-07-28,Modoc,049,8938,420,413,147,560,5
2021-07-28,Mono,051,14174,1300,1286,18,1304,3
2021-07-28,Monterey,053,433212,43971,43668,1950,45618,524
2021-07-28,Napa,055,140530,10491,10376,47,10423,82
2021-07-28,Nevada,057,99092,5663,5320,204,5524,72
2021-07-28,Orange,059,3164182,267026,262735,12094,274829,5143
2021-07-28,Placer,061,380077,25732,24978,1883,26861,306
2021-07-28,Plumas,063,18699,763,754,14,768,5
2021-07-28,Riverside,065,2383286,305655,299611,14506,314117,4554
2021-07-28,Sacramento,067,1510023,117062,114665,2196,116861,1714
2021-07-28,San Benito,069,59416,6260,6236,114,6350,63
2021-07-28,San Bernardino,071,2135413,303662,300121,9353,309474,5236
2021-07-28,San Diego,073,3302833,298585,294176,17156,311332,3798
2021-07-28,San Francisco,075,870044,41663,40144,1522,41666,561
2021-07-28,San Joaquin,077,732212,77536,76312,3849,80161,1443
2021-07-28,San Luis Obispo,079,281455,22322,21865,805,22670,260
2021-07-28,San Mateo,081,765935,45184,44477,581,45058,547
2021-07-28,Santa Barbara,083,443738,35906,35431,1194,36625,467
2021-07-28,Santa Clara,085,1922200,124260,122345,840,123185,2099
2021-07-28,Santa Cruz,087,273765,16864,16551,814,17365,207
2021-07-28,Shasta,089,179085,13130,12882,1744,14626,212
2021-07-28,Sierra,091,2930,71,67,12,79,0
2021-07-28,Siskiyou,093,43540,2067,1971,425,2396,31
2021-07-28,Solano,095,438530,36026,35204,719,35923,262
2021-07-28,Sonoma,097,501317,33215,32434,385,32819,328
2021-07-28,Stanislaus,099,539301,59206,58427,6255,64682,1035
2021-07-28,Sutter,101,95872,10183,10033,101,10134,126
2021-07-28,Tehama,103,63373,5295,5209,601,5810,66
2021-07-28,Trinity,105,12862,511,352,111,463,3
2021-07-28,Tulare,107,460477,51329,50363,9442,59805,854
2021-07-28,Tuolumne,109,53932,4464,4313,48,4361,64
2021-07-28,Ventura,111,848112,84554,83360,3437,86797,1043
2021-07-28,Yolo,113,214977,15111,14801,394,15195,215
2021-07-28,Yuba,115,75493,6731,6591,142,6733,51
2021-07-27,Alameda,001,1643700,96562,94682,2149,96831,1256
2021-07-27,Alpine,003,1148,90,89,0,89,0
2021-07-27,Amador,005,37829,3914,3861,33,3894,48
2021-07-27,Butte,007,227075,13416,13127,2029,15156,205
2021-07-27,Calaveras,009,45235,2323,2280,15,2295,57
2021-07-27,Colusa,011,21464,2027,1999,349,2348,16
2021-07-27,Contra Costa,013,1133247,76950,75227,1500,76727,830
2021-07-27,Del Norte,015,27424,1648,1538,14,1552,8
2021-07-27,El Dorado,017,186661,11241,10941,870,11811,116
2021-07-27,Fresno,019,978130,106006,104288,9011,113299,1746
2021-07-27,Glenn,021,27897,2493,2460,581,3041,20
2021-07-27,Humboldt,023,135768,5119,4925,75,5000,52
2021-07-27,Imperial,025,180216,29309,29048,2703,31751,743
2021-07-27,Inyo,027,18085,1452,1430,12,1442,38
2021-07-27,Kern,029,883053,99992,98724,11798,110522,1352
2021-07-27,Kings,031,150075,23878,23463,1150,24613,248
2021-07-27,Lake,033,64148,4321,4157,15,4172,65
2021-07-27,Lassen,035,31185,5341,5315,118,5433,21
2021-07-27,Los Angeles,037,10098052,1261625,1243336,44280,1287616,24658
2021-07-27,Madera,039,155013,17295,16998,1001,17999,245
2021-07-27,Marin,041,260295,14963,14631,287,14918,239
2021-07-27,Mariposa,043,17540,476,468,11,479,5
2021-07-27,Mendocino,045,87422,4531,4371,93,4464,49
2021-07-27,Merced,047,269075,32039,31825,1092,32917,473
2021-07-27,Modoc,049,8938,419,413,147,560,5
2021-07-27,Mono,051,14174,1296,1288,18,1306,3
2021-07-27,Monterey,053,433212,43931,43646,1939,45585,523
2021-07-27,Napa,055,140530,10461,10354,47,10401,82
2021-07-27,Nevada,057,99092,5586,5305,202,5507,72
2021-07-27,Orange,059,3164182,266286,262193,12068,274261,5143
2021-07-27,Placer,061,380077,25573,24916,1857,26773,306
2021-07-27,Plumas,063,18699,760,752,14,766,5
2021-07-27,Riverside,065,2383286,304926,299160,14487,313647,4554
2021-07-27,Sacramento,067,1510023,116459,114413,2187,116600,1710
2021-07-27,San Benito,069,59416,6251,6229,114,6343,63
2021-07-27,San Bernardino,071,2135413,302979,299593,9331,308924,5236
2021-07-27,San Diego,073,3302833,297496,293408,17077,310485,3798
2021-07-27,San Francisco,075,870044,41307,39939,1504,41443,561
2021-07-27,San Joaquin,077,732212,77274,76166,3830,79996,1442
2021-07-27,San Luis Obispo,079,281455,22267,21803,796,22599,260
2021-07-27,San Mateo,081,765935,45033,44378,578,44956,547
2021-07-27,Santa Barbara,083,443738,35811,35355,1192,36547,467
2021-07-27,Santa Clara,085,1922200,123966,122154,838,122992,2099
2021-07-27,Santa Cruz,087,273765,16818,16523,813,17336,207
2021-07-27,Shasta,089,179085,13080,12846,1731,14577,212
2021-07-27,Sierra,091,2930,71,65,12,77,0
2021-07-27,Siskiyou,093,43540,2062,1964,422,2386,31
2021-07-27,Solano,095,438530,35894,35093,709,35802,261
2021-07-27,Sonoma,097,501317,33071,32367,383,32750,328
2021-07-27,Stanislaus,099,539301,59038,58333,6227,64560,1033
2021-07-27,Sutter,101,95872,10142,9998,101,10099,115
2021-07-27,Tehama,103,63373,5273,5192,599,5791,66
2021-07-27,Trinity,105,12862,510,351,111,462,3
2021-07-27,Tulare,107,460477,51263,50324,9411,59735,854
2021-07-27,Tuolumne,109,53932,4412,4282,48,4330,64
2021-07-27,Ventura,111,848112,84346,83189,3425,86614,1043
2021-07-27,Yolo,113,214977,15038,14759,388,15147,215
2021-07-27,Yuba,115,75493,6709,6564,140,6704,51
2021-07-26,Alameda,001,1643700,96117,94436,2145,96581,1259
2021-07-26,Alpine,003,1148,90,89,0,89,0
2021-07-26,Amador,005,37829,3904,3854,33,3887,48
2021-07-26,Butte,007,227075,13361,13082,2013,15095,203
2021-07-26,Calaveras,009,45235,2317,2276,15,2291,57
2021-07-26,Colusa,011,21464,2020,1996,347,2343,16
2021-07-26,Contra Costa,013,1133247,76453,74854,1493,76347,830
2021-07-26,Del Norte,015,27424,1627,1530,14,1544,8
2021-07-26,El Dorado,017,186661,11177,10899,867,11766,116
2021-07-26,Fresno,019,978130,105802,104143,8988,113131,1742
2021-07-26,Glenn,021,27897,2491,2461,580,3041,20
2021-07-26,Humboldt,023,135768,5080,4906,73,4979,52
2021-07-26,Imperial,025,180216,29269,29034,2703,31737,743
2021-07-26,Inyo,027,18085,1447,1429,12,1441,38
2021-07-26,Kern,029,883053,99826,98633,11733,110366,1351
2021-07-26,Kings,031,150075,23829,23426,1146,24572,247
2021-07-26,Lake,033,64148,4300,4133,15,4148,65
2021-07-26,Lassen,035,31185,5337,5314,118,5432,21
2021-07-26,Los Angeles,037,10098052,1258277,1241527,44109,1285636,24647
2021-07-26,Madera,039,155013,17267,16971,994,17965,245
2021-07-26,Marin,041,260295,14906,14579,286,14865,239
2021-07-26,Mariposa,043,17540,475,467,11,478,5
2021-07-26,Mendocino,045,87422,4510,4354,93,4447,49
2021-07-26,Merced,047,269075,31948,31774,1088,32862,473
2021-07-26,Modoc,049,8938,419,413,147,560,5
2021-07-26,Mono,051,14174,1295,1286,18,1304,3
2021-07-26,Monterey,053,433212,43888,43595,1927,45522,521
2021-07-26,Napa,055,140530,10438,10332,47,10379,82
2021-07-26,Nevada,057,99092,5500,5280,202,5482,72
2021-07-26,Orange,059,3164182,265647,261803,12048,273851,5142
2021-07-26,Placer,061,380077,25436,24842,1836,26678,304
2021-07-26,Plumas,063,18699,756,750,14,764,5
2021-07-26,Riverside,065,2383286,304234,298626,14473,313099,4553
2021-07-26,Sacramento,067,1510023,115859,113986,2171,116157,1705
2021-07-26,San Benito,069,59416,6245,6222,114,6336,63
2021-07-26,San Bernardino,071,2135413,302364,299238,9318,308556,5237
2021-07-26,San Diego,073,3302833,296388,292688,16995,309683,3793
2021-07-26,San Francisco,075,870044,40945,39800,1478,41278,561
2021-07-26,San Joaquin,077,732212,77039,76033,3826,79859,1440
2021-07-26,San Luis Obispo,079,281455,22218,21752,793,22545,260
2021-07-26,San Mateo,081,765935,44885,44297,570,44867,547
2021-07-26,Santa Barbara,083,443738,35738,35311,1180,36491,467
2021-07-26,Santa Clara,085,1922200,123657,121978,829,122807,2099
2021-07-26,Santa Cruz,087,273765,16778,16493,810,17303,207
2021-07-26,Shasta,089,179085,13031,12819,1720,14539,211
2021-07-26,Sierra,091,2930,70,65,12,77,0
2021-07-26,Siskiyou,093,43540,2059,1962,420,2382,31
2021-07-26,Solano,095,438530,35739,34990,702,35692,259
2021-07-26,Sonoma,097,501317,32935,32283,381,32664,328
2021-07-26,Stanislaus,099,539301,58893,58219,6208,64427,1033
2021-07-26,Sutter,101,95872,10102,9963,98,10061,115
2021-07-26,Tehama,103,63373,5263,5183,595,5778,66
2021-07-26,Trinity,105,12862,510,351,110,461,3
2021-07-26,Tulare,107,460477,51197,50265,9382,59647,854
2021-07-26,Tuolumne,109,53932,4382,4271,47,4318,64
2021-07-26,Ventura,111,848112,84173,83072,3410,86482,1041
2021-07-26,Yolo,113,214977,14977,14727,376,15103,215
2021-07-26,Yuba,115,75493,6675,6538,138,6676,51
2021-07-25,Alameda,001,1643700,95629,94146,2140,96286,1259
2021-07-25,Alpine,003,1148,88,89,0,89,0
2021-07-25,Amador,005,37829,3889,3848,33,3881,48
2021-07-25,Butte,007,227075,13322,13074,2001,15075,203
2021-07-25,Calaveras,009,45235,2306,2275,15,2290,57
2021-07-25,Colusa,011,21464,2011,1996,343,2339,16
2021-07-25,Contra Costa,013,1133247,75969,74634,1479,76113,830
2021-07-25,Del Norte,015,27424,1606,1526,14,1540,8
2021-07-25,El Dorado,017,186661,11120,10878,863,11741,116
2021-07-25,Fresno,019,978130,105561,104019,8972,112991,1742
2021-07-25,Glenn,021,27897,2482,2461,578,3039,20
2021-07-25,Humboldt,023,135768,5021,4892,72,4964,52
2021-07-25,Imperial,025,180216,29233,29037,2703,31740,743
2021-07-25,Inyo,027,18085,1442,1427,12,1439,38
2021-07-25,Kern,029,883053,99654,98503,11662,110165,1351
2021-07-25,Kings,031,150075,23775,23396,1142,24538,247
2021-07-25,Lake,033,64148,4247,4109,14,4123,65
2021-07-25,Lassen,035,31185,5332,5314,118,5432,21
2021-07-25,Los Angeles,037,10098052,1254856,1239596,43917,1283513,24643
2021-07-25,Madera,039,155013,17230,16947,987,17934,245
2021-07-25,Marin,041,260295,14857,14558,283,14841,239
2021-07-25,Mariposa,043,17540,472,465,11,476,5
2021-07-25,Mendocino,045,87422,4481,4335,91,4426,49
2021-07-25,Merced,047,269075,31875,31760,1086,32846,473
2021-07-25,Modoc,049,8938,419,413,147,560,5
2021-07-25,Mono,051,14174,1292,1286,18,1304,3
2021-07-25,Monterey,053,433212,43850,43590,1919,45509,521
2021-07-25,Napa,055,140530,10402,10316,46,10362,82
2021-07-25,Nevada,057,99092,5435,5256,199,5455,72
2021-07-25,Orange,059,3164182,264939,261351,12025,273376,5142
2021-07-25,Placer,061,380077,25314,24755,1815,26570,304
2021-07-25,Plumas,063,18699,754,750,14,764,5
2021-07-25,Riverside,065,2383286,303469,298181,14456,312637,4553
2021-07-25,Sacramento,067,1510023,115309,113611,2156,115767,1704
2021-07-25,San Benito,069,59416,6238,6217,114,6331,63
2021-07-25,San Bernardino,071,2135413,301705,298982,9311,308293,5237
2021-07-25,San Diego,073,3302833,295326,290626,16921,307547,3793
2021-07-25,San Francisco,075,870044,40595,39663,1453,41116,561
2021-07-25,San Joaquin,077,732212,76782,75926,3807,79733,1440
2021-07-25,San Luis Obispo,079,281455,22145,21741,790,22531,260
2021-07-25,San Mateo,081,765935,44723,44189,564,44753,547
2021-07-25,Santa Barbara,083,443738,35658,35261,1177,36438,467
2021-07-25,Santa Clara,085,1922200,123327,121800,824,122624,2099
2021-07-25,Santa Cruz,087,273765,16731,16474,809,17283,207
2021-07-25,Shasta,089,179085,12984,12815,1715,14530,211
2021-07-25,Sierra,091,2930,70,65,12,77,0
2021-07-25,Siskiyou,093,43540,2051,1963,417,2380,31
2021-07-25,Solano,095,438530,35547,34863,699,35562,259
2021-07-25,Sonoma,097,501317,32810,32202,378,32580,328
2021-07-25,Stanislaus,099,539301,58727,58154,6203,64357,1033
2021-07-25,Sutter,101,95872,10049,9937,96,10033,115
2021-07-25,Tehama,103,63373,5247,5181,594,5775,66
2021-07-25,Trinity,105,12862,508,351,108,459,3
2021-07-25,Tulare,107,460477,51123,50221,9344,59565,854
2021-07-25,Tuolumne,109,53932,4331,4267,47,4314,64
2021-07-25,Ventura,111,848112,83959,82986,3387,86373,1041
2021-07-25,Yolo,113,214977,14916,14693,362,15055,215
2021-07-25,Yuba,115,75493,6643,6519,138,6657,51
2021-07-24,Alameda,001,1643700,95348,93170,2136,95306,1259
2021-07-24,Alpine,003,1148,88,89,0,89,0
2021-07-24,Amador,005,37829,3880,3816,33,3849,48
2021-07-24,Butte,007,227075,13293,12982,1997,14979,203
2021-07-24,Calaveras,009,45235,2301,2267,15,2282,57
2021-07-24,Colusa,011,21464,2010,1992,341,2333,16
2021-07-24,Contra Costa,013,1133247,75741,73682,1476,75158,830
2021-07-24,Del Norte,015,27424,1595,1497,14,1511,8
2021-07-24,El Dorado,017,186661,11086,10773,860,11633,116
2021-07-24,Fresno,019,978130,105443,103637,8962,112599,1736
2021-07-24,Glenn,021,27897,2480,2457,578,3035,20
2021-07-24,Humboldt,023,135768,4986,4780,71,4851,52
2021-07-24,Imperial,025,180216,29213,28996,2703,31699,742
2021-07-24,Inyo,027,18085,1439,1424,12,1436,38
2021-07-24,Kern,029,883053,99576,98261,11640,109901,1350
2021-07-24,Kings,031,150075,23744,23304,1139,24443,246
2021-07-24,Lake,033,64148,4224,3963,14,3977,64
2021-07-24,Lassen,035,31185,5331,5311,118,5429,21
2021-07-24,Los Angeles,037,10098052,1253079,1232164,43790,1275954,24623
2021-07-24,Madera,039,155013,17206,16885,985,17870,245
2021-07-24,Marin,041,260295,14818,14454,283,14737,238
2021-07-24,Mariposa,043,17540,472,453,11,464,5
2021-07-24,Mendocino,045,87422,4456,4293,91,4384,49
2021-07-24,Merced,047,269075,31853,31661,1085,32746,473
2021-07-24,Modoc,049,8938,419,413,147,560,5
2021-07-24,Mono,051,14174,1290,1284,18,1302,3
2021-07-24,Monterey,053,433212,43825,43525,1912,45437,521
2021-07-24,Napa,055,140530,10386,10230,46,10276,81
2021-07-24,Nevada,057,99092,5403,5183,199,5382,72
2021-07-24,Orange,059,3164182,264473,259973,12013,271986,5141
2021-07-24,Placer,061,380077,25232,24530,1810,26340,303
2021-07-24,Plumas,063,18699,753,737,14,751,4
2021-07-24,Riverside,065,2383286,303001,296912,14446,311358,4552
2021-07-24,Sacramento,067,1510023,114994,112438,2152,114590,1698
2021-07-24,San Benito,069,59416,6234,6200,113,6313,63
2021-07-24,San Bernardino,071,2135413,301314,297899,9302,307201,5236
2021-07-24,San Diego,073,3302833,294860,289368,16893,306261,3788
2021-07-24,San Francisco,075,870044,40422,38954,1437,40391,561
2021-07-24,San Joaquin,077,732212,76654,75461,3796,79257,1436
2021-07-24,San Luis Obispo,079,281455,22114,21616,788,22404,260
2021-07-24,San Mateo,081,765935,44606,43880,558,44438,542
2021-07-24,Santa Barbara,083,443738,35599,35071,1173,36244,465
2021-07-24,Santa Clara,085,1922200,123115,121092,823,121915,2099
2021-07-24,Santa Cruz,087,273765,16708,16416,809,17225,207
2021-07-24,Shasta,089,179085,12956,12759,1712,14471,211
2021-07-24,Sierra,091,2930,69,64,12,76,0
2021-07-24,Siskiyou,093,43540,2051,1951,417,2368,31
2021-07-24,Solano,095,438530,35455,34499,690,35189,259
2021-07-24,Sonoma,097,501317,32685,31928,376,32304,327
2021-07-24,Stanislaus,099,539301,58635,57879,6193,64072,1030
2021-07-24,Sutter,101,95872,10022,9890,96,9986,115
2021-07-24,Tehama,103,63373,5240,5166,592,5758,65
2021-07-24,Trinity,105,12862,508,345,108,453,3
2021-07-24,Tulare,107,460477,51080,50104,9327,59431,854
2021-07-24,Tuolumne,109,53932,4305,4216,47,4263,64
2021-07-24,Ventura,111,848112,83832,82687,3371,86058,1041
2021-07-24,Yolo,113,214977,14878,14557,358,14915,214
2021-07-24,Yuba,115,75493,6624,6449,138,6587,51
2021-07-23,Alameda,001,1643700,95095,93170,2132,95302,1259
2021-07-23,Alpine,003,1148,88,89,0,89,0
2021-07-23,Amador,005,37829,3873,3816,33,3849,48
2021-07-23,Butte,007,227075,13264,12982,1988,14970,203
2021-07-23,Calaveras,009,45235,2291,2267,15,2282,57
2021-07-23,Colusa,011,21464,2009,1992,341,2333,16
2021-07-23,Contra Costa,013,1133247,75481,73682,1467,75149,830
2021-07-23,Del Norte,015,27424,1587,1497,14,1511,8
2021-07-23,El Dorado,017,186661,11057,10773,856,11629,116
2021-07-23,Fresno,019,978130,105311,103637,8952,112589,1736
2021-07-23,Glenn,021,27897,2478,2457,575,3032,20
2021-07-23,Humboldt,023,135768,4964,4780,68,4848,52
2021-07-23,Imperial,025,180216,29201,28996,2703,31699,742
2021-07-23,Inyo,027,18085,1436,1424,12,1436,38
2021-07-23,Kern,029,883053,99494,98261,11615,109876,1350
2021-07-23,Kings,031,150075,23713,23304,1136,24440,246
2021-07-23,Lake,033,64148,4195,3963,14,3977,64
2021-07-23,Lassen,035,31185,5329,5311,118,5429,21
2021-07-23,Los Angeles,037,10098052,1251136,1232164,43683,1275847,24623
2021-07-23,Madera,039,155013,17176,16885,980,17865,245
2021-07-23,Marin,041,260295,14781,14454,281,14735,238
2021-07-23,Mariposa,043,17540,469,453,11,464,5
2021-07-23,Mendocino,045,87422,4443,4293,91,4384,49
2021-07-23,Merced,047,269075,31828,31661,1085,32746,473
2021-07-23,Modoc,049,8938,419,413,147,560,5
2021-07-23,Mono,051,14174,1289,1284,18,1302,3
2021-07-23,Monterey,053,433212,43799,43525,1912,45437,521
2021-07-23,Napa,055,140530,10365,10230,46,10276,81
2021-07-23,Nevada,057,99092,5359,5183,199,5382,72
2021-07-23,Orange,059,3164182,264024,259973,11990,271963,5141
2021-07-23,Placer,061,380077,25152,24530,1794,26324,303
2021-07-23,Plumas,063,18699,751,737,14,751,4
2021-07-23,Riverside,065,2383286,302535,296912,14434,311346,4552
2021-07-23,Sacramento,067,1510023,114639,112438,2150,114588,1698
2021-07-23,San Benito,069,59416,6228,6200,113,6313,63
2021-07-23,San Bernardino,071,2135413,300932,297899,9293,307192,5236
2021-07-23,San Diego,073,3302833,294252,289368,16845,306213,3788
2021-07-23,San Francisco,075,870044,40236,38954,1425,40379,561
2021-07-23,San Joaquin,077,732212,76550,75461,3781,79242,1436
2021-07-23,San Luis Obispo,079,281455,22075,21616,788,22404,260
2021-07-23,San Mateo,081,765935,44502,43880,554,44434,542
2021-07-23,Santa Barbara,083,443738,35534,35071,1172,36243,465
2021-07-23,Santa Clara,085,1922200,122896,121092,820,121912,2099
2021-07-23,Santa Cruz,087,273765,16683,16416,809,17225,207
2021-07-23,Shasta,089,179085,12929,12759,1709,14468,211
2021-07-23,Sierra,091,2930,69,64,12,76,0
2021-07-23,Siskiyou,093,43540,2049,1951,417,2368,31
2021-07-23,Solano,095,438530,35363,34499,686,35185,259
2021-07-23,Sonoma,097,501317,32590,31928,375,32303,327
2021-07-23,Stanislaus,099,539301,58559,57879,6184,64063,1030
2021-07-23,Sutter,101,95872,9993,9890,96,9986,115
2021-07-23,Tehama,103,63373,5231,5166,592,5758,65
2021-07-23,Trinity,105,12862,507,345,107,452,3
2021-07-23,Tulare,107,460477,51034,50104,9306,59410,854
2021-07-23,Tuolumne,109,53932,4283,4216,47,4263,64
2021-07-23,Ventura,111,848112,83670,82687,3353,86040,1041
2021-07-23,Yolo,113,214977,14842,14557,351,14908,214
2021-07-23,Yuba,115,75493,6598,6449,137,6586,51
2021-07-22,Alameda,001,1643700,94743,93170,2127,95297,1259
2021-07-22,Alpine,003,1148,88,89,0,89,0
2021-07-22,Amador,005,37829,3864,3816,33,3849,48
2021-07-22,Butte,007,227075,13230,12982,1979,14961,203
2021-07-22,Calaveras,009,45235,2281,2267,15,2282,57
2021-07-22,Colusa,011,21464,2007,1992,338,2330,16
2021-07-22,Contra Costa,013,1133247,75142,73682,1462,75144,830
2021-07-22,Del Norte,015,27424,1570,1497,14,1511,8
2021-07-22,El Dorado,017,186661,11021,10773,848,11621,116
2021-07-22,Fresno,019,978130,105182,103637,8942,112579,1736
2021-07-22,Glenn,021,27897,2474,2457,575,3032,20
2021-07-22,Humboldt,023,135768,4933,4780,66,4846,52
2021-07-22,Imperial,025,180216,29171,28996,2703,31699,742
2021-07-22,Inyo,027,18085,1434,1424,12,1436,38
2021-07-22,Kern,029,883053,99379,98261,11574,109835,1350
2021-07-22,Kings,031,150075,23674,23304,1134,24438,246
2021-07-22,Lake,033,64148,4144,3963,14,3977,64
2021-07-22,Lassen,035,31185,5326,5311,118,5429,21
2021-07-22,Los Angeles,037,10098052,1248697,1232164,43507,1275671,24623
2021-07-22,Madera,039,155013,17141,16885,978,17863,245
2021-07-22,Marin,041,260295,14740,14454,280,14734,238
2021-07-22,Mariposa,043,17540,462,453,11,464,5
2021-07-22,Mendocino,045,87422,4430,4293,90,4383,49
2021-07-22,Merced,047,269075,31786,31661,1084,32745,473
2021-07-22,Modoc,049,8938,419,413,147,560,5
2021-07-22,Mono,051,14174,1288,1284,18,1302,3
2021-07-22,Monterey,053,433212,43771,43525,1906,45431,521
2021-07-22,Napa,055,140530,10347,10230,46,10276,81
2021-07-22,Nevada,057,99092,5333,5183,198,5381,72
2021-07-22,Orange,059,3164182,263471,259973,11981,271954,5141
2021-07-22,Placer,061,380077,25058,24530,1783,26313,303
2021-07-22,Plumas,063,18699,750,737,14,751,4
2021-07-22,Riverside,065,2383286,302027,296912,14413,311325,4552
2021-07-22,Sacramento,067,1510023,114202,112438,2141,114579,1698
2021-07-22,San Benito,069,59416,6221,6200,113,6313,63
2021-07-22,San Bernardino,071,2135413,300529,297899,9278,307177,5236
2021-07-22,San Diego,073,3302833,293523,289368,16785,306153,3788
2021-07-22,San Francisco,075,870044,40023,38954,1413,40367,561
2021-07-22,San Joaquin,077,732212,76407,75461,3769,79230,1436
2021-07-22,San Luis Obispo,079,281455,22037,21616,784,22400,260
2021-07-22,San Mateo,081,765935,44390,43880,549,44429,542
2021-07-22,Santa Barbara,083,443738,35468,35071,1170,36241,465
2021-07-22,Santa Clara,085,1922200,122655,121092,817,121909,2099
2021-07-22,Santa Cruz,087,273765,16646,16416,808,17224,207
2021-07-22,Shasta,089,179085,12905,12759,1705,14464,211
2021-07-22,Sierra,091,2930,67,64,12,76,0
2021-07-22,Siskiyou,093,43540,2046,1951,417,2368,31
2021-07-22,Solano,095,438530,35217,34499,679,35178,259
2021-07-22,Sonoma,097,501317,32480,31928,373,32301,327
2021-07-22,Stanislaus,099,539301,58431,57879,6172,64051,1030
2021-07-22,Sutter,101,95872,9972,9890,96,9986,115
2021-07-22,Tehama,103,63373,5225,5166,592,5758,65
2021-07-22,Trinity,105,12862,507,345,107,452,3
2021-07-22,Tulare,107,460477,50991,50104,9278,59382,854
2021-07-22,Tuolumne,109,53932,4271,4216,47,4263,64
2021-07-22,Ventura,111,848112,83536,82687,3340,86027,1041
2021-07-22,Yolo,113,214977,14804,14557,351,14908,214
2021-07-22,Yuba,115,75493,6567,6449,134,6583,51
2021-07-21,Alameda,001,1643700,94423,92840,2124,94964,1256
2021-07-21,Alpine,003,1148,88,89,0,89,0
2021-07-21,Amador,005,37829,3851,3813,33,3846,48
2021-07-21,Butte,007,227075,13189,12939,1974,14913,203
2021-07-21,Calaveras,009,45235,2277,2257,15,2272,57
2021-07-21,Colusa,011,21464,2003,1988,337,2325,16
2021-07-21,Contra Costa,013,1133247,74878,73320,1453,74773,827
2021-07-21,Del Norte,015,27424,1560,1492,14,1506,8
2021-07-21,El Dorado,017,186661,10984,10742,844,11586,116
2021-07-21,Fresno,019,978130,105033,103504,8933,112437,1736
2021-07-21,Glenn,021,27897,2472,2455,574,3029,20
2021-07-21,Humboldt,023,135768,4901,4763,64,4827,52
2021-07-21,Imperial,025,180216,29159,28964,2700,31664,742
2021-07-21,Inyo,027,18085,1434,1423,12,1435,38
2021-07-21,Kern,029,883053,99261,98152,11533,109685,1350
2021-07-21,Kings,031,150075,23646,23270,1130,24400,246
2021-07-21,Lake,033,64148,4078,3896,14,3910,64
2021-07-21,Lassen,035,31185,5323,5310,118,5428,21
2021-07-21,Los Angeles,037,10098052,1246185,1229598,43369,1272967,24609
2021-07-21,Madera,039,155013,17117,16858,976,17834,245
2021-07-21,Marin,041,260295,14690,14427,280,14707,238
2021-07-21,Mariposa,043,17540,458,449,11,460,5
2021-07-21,Mendocino,045,87422,4412,4274,90,4364,49
2021-07-21,Merced,047,269075,31747,31607,1080,32687,473
2021-07-21,Modoc,049,8938,419,413,147,560,5
2021-07-21,Mono,051,14174,1285,1282,18,1300,3
2021-07-21,Monterey,053,433212,43741,43502,1903,45405,515
2021-07-21,Napa,055,140530,10321,10209,46,10255,81
2021-07-21,Nevada,057,99092,5298,5152,198,5350,72
2021-07-21,Orange,059,3164182,262916,259615,11951,271566,5139
2021-07-21,Placer,061,380077,24949,24441,1772,26213,303
2021-07-21,Plumas,063,18699,750,736,14,750,4
2021-07-21,Riverside,065,2383286,301514,296419,14396,310815,4552
2021-07-21,Sacramento,067,1510023,113779,112043,2130,114173,1696
2021-07-21,San Benito,069,59416,6211,6196,113,6309,63
2021-07-21,San Bernardino,071,2135413,300073,297519,9270,306789,5230
2021-07-21,San Diego,073,3302833,292673,288682,16722,305404,3787
2021-07-21,San Francisco,075,870044,39798,38699,1408,40107,559
2021-07-21,San Joaquin,077,732212,76218,75288,3757,79045,1434
2021-07-21,San Luis Obispo,079,281455,22000,21579,781,22360,260
2021-07-21,San Mateo,081,765935,44298,43755,545,44300,542
2021-07-21,Santa Barbara,083,443738,35409,34998,1154,36152,465
2021-07-21,Santa Clara,085,1922200,122446,120838,815,121653,2099
2021-07-21,Santa Cruz,087,273765,16612,16407,808,17215,207
2021-07-21,Shasta,089,179085,12872,12751,1702,14453,211
2021-07-21,Sierra,091,2930,67,64,12,76,0
2021-07-21,Siskiyou,093,43540,2044,1943,415,2358,31
2021-07-21,Solano,095,438530,35059,34374,674,35048,258
2021-07-21,Sonoma,097,501317,32364,31789,373,32162,327
2021-07-21,Stanislaus,099,539301,58329,57774,6162,63936,1028
2021-07-21,Sutter,101,95872,9948,9862,96,9958,113
2021-07-21,Tehama,103,63373,5221,5161,592,5753,65
2021-07-21,Trinity,105,12862,505,345,106,451,3
2021-07-21,Tulare,107,460477,50932,50066,9253,59319,854
2021-07-21,Tuolumne,109,53932,4234,4156,47,4203,64
2021-07-21,Ventura,111,848112,83414,82573,3328,85901,1041
2021-07-21,Yolo,113,214977,14763,14525,350,14875,213
2021-07-21,Yuba,115,75493,6539,6425,134,6559,52
2021-07-20,Alameda,001,1643700,94053,92625,2110,94735,1256
2021-07-20,Alpine,003,1148,88,89,0,89,0
2021-07-20,Amador,005,37829,3840,3807,33,3840,48
2021-07-20,Butte,007,227075,13152,12916,1968,14884,203
2021-07-20,Calaveras,009,45235,2274,2249,15,2264,57
2021-07-20,Colusa,011,21464,2003,1985,337,2322,16
2021-07-20,Contra Costa,013,1133247,74593,73143,1435,74578,825
2021-07-20,Del Norte,015,27424,1550,1490,14,1504,8
2021-07-20,El Dorado,017,186661,10944,10727,840,11567,116
2021-07-20,Fresno,019,978130,104898,103438,8914,112352,1736
2021-07-20,Glenn,021,27897,2472,2453,574,3027,20
2021-07-20,Humboldt,023,135768,4856,4735,62,4797,52
2021-07-20,Imperial,025,180216,29139,28933,2700,31633,742
2021-07-20,Inyo,027,18085,1430,1420,12,1432,36
2021-07-20,Kern,029,883053,99147,98082,11505,109587,1350
2021-07-20,Kings,031,150075,23605,23254,1125,24379,246
2021-07-20,Lake,033,64148,4053,3871,14,3885,64
2021-07-20,Lassen,035,31185,5323,5306,118,5424,21
2021-07-20,Los Angeles,037,10098052,1243389,1227404,43204,1270608,24603
2021-07-20,Madera,039,155013,17096,16856,972,17828,245
2021-07-20,Marin,041,260295,14654,14396,277,14673,234
2021-07-20,Mariposa,043,17540,456,448,11,459,5
2021-07-20,Mendocino,045,87422,4395,4259,90,4349,49
2021-07-20,Merced,047,269075,31708,31578,1073,32651,473
2021-07-20,Modoc,049,8938,419,413,147,560,5
2021-07-20,Mono,051,14174,1281,1281,18,1299,3
2021-07-20,Monterey,053,433212,43710,43481,1900,45381,515
2021-07-20,Napa,055,140530,10298,10191,46,10237,81
2021-07-20,Nevada,057,99092,5279,5148,197,5345,72
2021-07-20,Orange,059,3164182,262359,259303,11921,271224,5139
2021-07-20,Placer,061,380077,24858,24408,1750,26158,303
2021-07-20,Plumas,063,18699,748,736,14,750,4
2021-07-20,Riverside,065,2383286,300979,296118,14382,310500,4543
2021-07-20,Sacramento,067,1510023,113338,111796,2100,113896,1695
2021-07-20,San Benito,069,59416,6204,6196,113,6309,63
2021-07-20,San Bernardino,071,2135413,299664,297222,9245,306467,5231
2021-07-20,San Diego,073,3302833,291747,288209,16626,304835,3786
2021-07-20,San Francisco,075,870044,39539,38536,1398,39934,558
2021-07-20,San Joaquin,077,732212,76046,75198,3744,78942,1433
2021-07-20,San Luis Obispo,079,281455,21954,21556,780,22336,259
2021-07-20,San Mateo,081,765935,44179,43670,543,44213,542
2021-07-20,Santa Barbara,083,443738,35339,34935,1148,36083,462
2021-07-20,Santa Clara,085,1922200,122189,120704,813,121517,2098
2021-07-20,Santa Cruz,087,273765,16583,16399,808,17207,207
2021-07-20,Shasta,089,179085,12846,12734,1698,14432,211
2021-07-20,Sierra,091,2930,67,64,12,76,0
2021-07-20,Siskiyou,093,43540,2040,1931,414,2345,31
2021-07-20,Solano,095,438530,34924,34337,667,35004,258
2021-07-20,Sonoma,097,501317,32245,31763,372,32135,326
2021-07-20,Stanislaus,099,539301,58214,57706,6157,63863,1028
2021-07-20,Sutter,101,95872,9921,9854,93,9947,114
2021-07-20,Tehama,103,63373,5219,5153,592,5745,65
2021-07-20,Trinity,105,12862,503,344,105,449,3
2021-07-20,Tulare,107,460477,50890,50047,9236,59283,854
2021-07-20,Tuolumne,109,53932,4215,4156,47,4203,64
2021-07-20,Ventura,111,848112,83261,82504,3313,85817,1041
2021-07-20,Yolo,113,214977,14698,14495,347,14842,213
2021-07-20,Yuba,115,75493,6514,6393,131,6524,52
2021-07-19,Alameda,001,1643700,93675,92357,2095,94452,1256
2021-07-19,Alpine,003,1148,88,89,0,89,0
2021-07-19,Amador,005,37829,3836,3802,33,3835,48
2021-07-19,Butte,007,227075,13108,12901,1963,14864,202
2021-07-19,Calaveras,009,45235,2270,2245,15,2260,57
2021-07-19,Colusa,011,21464,2001,1981,337,2318,16
2021-07-19,Contra Costa,013,1133247,74281,72935,1415,74350,825
2021-07-19,Del Norte,015,27424,1537,1484,14,1498,8
2021-07-19,El Dorado,017,186661,10914,10703,832,11535,114
2021-07-19,Fresno,019,978130,104767,103350,8901,112251,1731
2021-07-19,Glenn,021,27897,2472,2452,573,3025,20
2021-07-19,Humboldt,023,135768,4826,4719,60,4779,52
2021-07-19,Imperial,025,180216,29112,28888,2699,31587,742
2021-07-19,Inyo,027,18085,1429,1417,12,1429,36
2021-07-19,Kern,029,883053,99033,97999,11472,109471,1349
2021-07-19,Kings,031,150075,23575,23221,1119,24340,246
2021-07-19,Lake,033,64148,4017,3848,14,3862,64
2021-07-19,Lassen,035,31185,5322,5305,118,5423,21
2021-07-19,Los Angeles,037,10098052,1240783,1225946,43018,1268964,24600
2021-07-19,Madera,039,155013,17073,16846,969,17815,244
2021-07-19,Marin,041,260295,14619,14369,274,14643,234
2021-07-19,Mariposa,043,17540,450,447,11,458,5
2021-07-19,Mendocino,045,87422,4377,4251,90,4341,49
2021-07-19,Merced,047,269075,31644,31565,1066,32631,472
2021-07-19,Modoc,049,8938,418,413,147,560,5
2021-07-19,Mono,051,14174,1279,1280,18,1298,3
2021-07-19,Monterey,053,433212,43686,43436,1899,45335,515
2021-07-19,Napa,055,140530,10273,10180,44,10224,81
2021-07-19,Nevada,057,99092,5251,5133,196,5329,72
2021-07-19,Orange,059,3164182,261836,258927,11889,270816,5138
2021-07-19,Placer,061,380077,24759,24359,1728,26087,303
2021-07-19,Plumas,063,18699,748,730,14,744,4
2021-07-19,Riverside,065,2383286,300489,295736,14344,310080,4543
2021-07-19,Sacramento,067,1510023,112974,111470,2074,113544,1696
2021-07-19,San Benito,069,59416,6201,6193,113,6306,63
2021-07-19,San Bernardino,071,2135413,299291,296929,9226,306155,5235
2021-07-19,San Diego,073,3302833,290847,287695,16521,304216,3786
2021-07-19,San Francisco,075,870044,39266,38463,1385,39848,560
2021-07-19,San Joaquin,077,732212,75881,75086,3739,78825,1431
2021-07-19,San Luis Obispo,079,281455,21909,21531,776,22307,259
2021-07-19,San Mateo,081,765935,44037,43563,534,44097,542
2021-07-19,Santa Barbara,083,443738,35267,34904,1146,36050,461
2021-07-19,Santa Clara,085,1922200,121931,120554,812,121366,2098
2021-07-19,Santa Cruz,087,273765,16567,16387,808,17195,207
2021-07-19,Shasta,089,179085,12828,12723,1696,14419,209
2021-07-19,Sierra,091,2930,66,64,12,76,0
2021-07-19,Siskiyou,093,43540,2035,1927,412,2339,31
2021-07-19,Solano,095,438530,34749,34262,656,34918,261
2021-07-19,Sonoma,097,501317,32124,31713,371,32084,325
2021-07-19,Stanislaus,099,539301,58113,57644,6147,63791,1027
2021-07-19,Sutter,101,95872,9905,9834,93,9927,114
2021-07-19,Tehama,103,63373,5213,5152,590,5742,65
2021-07-19,Trinity,105,12862,503,344,104,448,3
2021-07-19,Tulare,107,460477,50843,49994,9220,59214,855
2021-07-19,Tuolumne,109,53932,4205,4151,47,4198,64
2021-07-19,Ventura,111,848112,83165,82409,3291,85700,1041
2021-07-19,Yolo,113,214977,14666,14439,345,14784,213
2021-07-19,Yuba,115,75493,6490,6370,131,6501,52
2021-07-18,Alameda,001,1643700,93314,92162,2083,94245,1256
2021-07-18,Alpine,003,1148,88,89,0,89,0
2021-07-18,Amador,005,37829,3825,3799,33,3832,48
2021-07-18,Butte,007,227075,13066,12888,1956,14844,202
2021-07-18,Calaveras,009,45235,2267,2243,15,2258,57
2021-07-18,Colusa,011,21464,2001,1981,336,2317,16
2021-07-18,Contra Costa,013,1133247,73965,72849,1397,74246,825
2021-07-18,Del Norte,015,27424,1528,1482,14,1496,8
2021-07-18,El Dorado,017,186661,10877,10687,824,11511,114
2021-07-18,Fresno,019,978130,104613,103298,8883,112181,1731
2021-07-18,Glenn,021,27897,2471,2452,572,3024,20
2021-07-18,Humboldt,023,135768,4790,4714,60,4774,52
2021-07-18,Imperial,025,180216,29075,28877,2698,31575,742
2021-07-18,Inyo,027,18085,1425,1417,12,1429,36
2021-07-18,Kern,029,883053,98907,97963,11430,109393,1349
2021-07-18,Kings,031,150075,23554,23203,1115,24318,246
2021-07-18,Lake,033,64148,3981,3825,14,3839,64
2021-07-18,Lassen,035,31185,5322,5305,118,5423,21
2021-07-18,Los Angeles,037,10098052,1238095,1224691,42829,1267520,24598
2021-07-18,Madera,039,155013,17048,16838,965,17803,244
2021-07-18,Marin,041,260295,14583,14358,272,14630,234
2021-07-18,Mariposa,043,17540,449,447,11,458,5
2021-07-18,Mendocino,045,87422,4356,4246,90,4336,49
2021-07-18,Merced,047,269075,31613,31537,1064,32601,471
2021-07-18,Modoc,049,8938,418,413,147,560,5
2021-07-18,Mono,051,14174,1278,1280,18,1298,3
2021-07-18,Monterey,053,433212,43668,43422,1889,45311,515
2021-07-18,Napa,055,140530,10256,10174,41,10215,81
2021-07-18,Nevada,057,99092,5225,5124,196,5320,72
2021-07-18,Orange,059,3164182,261352,258724,11861,270585,5138
2021-07-18,Placer,061,380077,24691,24313,1701,26014,303
2021-07-18,Plumas,063,18699,748,730,14,744,4
2021-07-18,Riverside,065,2383286,299997,295522,14302,309824,4543
2021-07-18,Sacramento,067,1510023,112544,111255,2041,113296,1696
2021-07-18,San Benito,069,59416,6193,6191,113,6304,63
2021-07-18,San Bernardino,071,2135413,298816,296739,9211,305950,5233
2021-07-18,San Diego,073,3302833,290031,286287,16437,302724,3786
2021-07-18,San Francisco,075,870044,39030,38367,1374,39741,560
2021-07-18,San Joaquin,077,732212,75704,74997,3726,78723,1431
2021-07-18,San Luis Obispo,079,281455,21874,21527,773,22300,259
2021-07-18,San Mateo,081,765935,43924,43506,528,44034,542
2021-07-18,Santa Barbara,083,443738,35202,34880,1144,36024,461
2021-07-18,Santa Clara,085,1922200,121717,120438,805,121243,2098
2021-07-18,Santa Cruz,087,273765,16535,16372,807,17179,207
2021-07-18,Shasta,089,179085,12803,12714,1692,14406,209
2021-07-18,Sierra,091,2930,66,64,12,76,0
2021-07-18,Siskiyou,093,43540,2029,1927,407,2334,31
2021-07-18,Solano,095,438530,34621,34215,652,34867,261
2021-07-18,Sonoma,097,501317,32019,31675,370,32045,325
2021-07-18,Stanislaus,099,539301,58002,57600,6122,63722,1028
2021-07-18,Sutter,101,95872,9873,9826,93,9919,114
2021-07-18,Tehama,103,63373,5210,5150,589,5739,65
2021-07-18,Trinity,105,12862,503,344,104,448,3
2021-07-18,Tulare,107,460477,50790,49985,9197,59182,855
2021-07-18,Tuolumne,109,53932,4187,4149,47,4196,64
2021-07-18,Ventura,111,848112,83051,82361,3267,85628,1041
2021-07-18,Yolo,113,214977,14607,14425,339,14764,213
2021-07-18,Yuba,115,75493,6449,6357,131,6488,52
2021-07-17,Alameda,001,1643700,93096,91346,2072,93418,1255
2021-07-17,Alpine,003,1148,88,89,0,89,0
2021-07-17,Amador,005,37829,3816,3785,33,3818,48
2021-07-17,Butte,007,227075,13051,12824,1952,14776,202
2021-07-17,Calaveras,009,45235,2262,2237,15,2252,57
2021-07-17,Colusa,011,21464,1998,1976,336,2312,16
2021-07-17,Contra Costa,013,1133247,73783,72254,1384,73638,824
2021-07-17,Del Norte,015,27424,1520,1475,14,1489,8
2021-07-17,El Dorado,017,186661,10850,10622,820,11442,114
2021-07-17,Fresno,019,978130,104540,103055,8869,111924,1730
2021-07-17,Glenn,021,27897,2470,2451,572,3023,20
2021-07-17,Humboldt,023,135768,4777,4654,59,4713,52
2021-07-17,Imperial,025,180216,29059,28840,2698,31538,742
2021-07-17,Inyo,027,18085,1425,1416,12,1428,36
2021-07-17,Kern,029,883053,98850,97796,11394,109190,1348
2021-07-17,Kings,031,150075,23534,23163,1114,24277,246
2021-07-17,Lake,033,64148,3956,3760,14,3774,64
2021-07-17,Lassen,035,31185,5322,5302,118,5420,21
2021-07-17,Los Angeles,037,10098052,1236558,1219733,42688,1262421,24582
2021-07-17,Madera,039,155013,17040,16804,965,17769,240
2021-07-17,Marin,041,260295,14565,14297,270,14567,234
2021-07-17,Mariposa,043,17540,449,445,11,456,5
2021-07-17,Mendocino,045,87422,4344,4209,90,4299,49
2021-07-17,Merced,047,269075,31592,31451,1060,32511,471
2021-07-17,Modoc,049,8938,418,412,147,559,5
2021-07-17,Mono,051,14174,1276,1277,18,1295,3
2021-07-17,Monterey,053,433212,43645,43367,1884,45251,515
2021-07-17,Napa,055,140530,10240,10129,41,10170,81
2021-07-17,Nevada,057,99092,5210,5066,196,5262,72
2021-07-17,Orange,059,3164182,261045,257805,11822,269627,5136
2021-07-17,Placer,061,380077,24624,24169,1687,25856,303
2021-07-17,Plumas,063,18699,743,721,14,735,4
2021-07-17,Riverside,065,2383286,299691,294751,14270,309021,4542
2021-07-17,Sacramento,067,1510023,112308,110432,2021,112453,1694
2021-07-17,San Benito,069,59416,6187,6181,113,6294,63
2021-07-17,San Bernardino,071,2135413,298579,296048,9192,305240,5218
2021-07-17,San Diego,073,3302833,289624,285698,16369,302067,3786
2021-07-17,San Francisco,075,870044,38909,37978,1371,39349,560
2021-07-17,San Joaquin,077,732212,75617,74695,3720,78415,1430
2021-07-17,San Luis Obispo,079,281455,21847,21462,773,22235,258
2021-07-17,San Mateo,081,765935,43853,43324,527,43851,542
2021-07-17,Santa Barbara,083,443738,35161,34769,1141,35910,461
2021-07-17,Santa Clara,085,1922200,121545,119980,802,120782,2097
2021-07-17,Santa Cruz,087,273765,16528,16337,807,17144,207
2021-07-17,Shasta,089,179085,12788,12683,1687,14370,210
2021-07-17,Sierra,091,2930,66,62,12,74,0
2021-07-17,Siskiyou,093,43540,2024,1922,404,2326,29
2021-07-17,Solano,095,438530,34556,34015,644,34659,263
2021-07-17,Sonoma,097,501317,31951,31536,369,31905,322
2021-07-17,Stanislaus,099,539301,57925,57400,6108,63508,1028
2021-07-17,Sutter,101,95872,9863,9778,93,9871,114
2021-07-17,Tehama,103,63373,5207,5145,589,5734,64
2021-07-17,Trinity,105,12862,502,341,104,445,3
2021-07-17,Tulare,107,460477,50768,49937,9185,59122,854
2021-07-17,Tuolumne,109,53932,4177,4131,47,4178,64
2021-07-17,Ventura,111,848112,82982,82125,3256,85381,1041
2021-07-17,Yolo,113,214977,14575,14356,332,14688,213
2021-07-17,Yuba,115,75493,6438,6309,131,6440,52
2021-07-16,Alameda,001,1643700,92857,91346,2061,93407,1255
2021-07-16,Alpine,003,1148,88,89,0,89,0
2021-07-16,Amador,005,37829,3813,3785,33,3818,48
2021-07-16,Butte,007,227075,13026,12824,1948,14772,202
2021-07-16,Calaveras,009,45235,2261,2237,15,2252,57
2021-07-16,Colusa,011,21464,1996,1976,335,2311,16
2021-07-16,Contra Costa,013,1133247,73594,72254,1380,73634,824
2021-07-16,Del Norte,015,27424,1518,1475,14,1489,8
2021-07-16,El Dorado,017,186661,10831,10622,819,11441,114
2021-07-16,Fresno,019,978130,104488,103055,8849,111904,1730
2021-07-16,Glenn,021,27897,2470,2451,572,3023,20
2021-07-16,Humboldt,023,135768,4755,4654,59,4713,52
2021-07-16,Imperial,025,180216,29047,28840,2698,31538,742
2021-07-16,Inyo,027,18085,1423,1416,12,1428,36
2021-07-16,Kern,029,883053,98788,97796,11354,109150,1348
2021-07-16,Kings,031,150075,23509,23163,1113,24276,246
2021-07-16,Lake,033,64148,3929,3760,14,3774,64
2021-07-16,Lassen,035,31185,5321,5302,118,5420,21
2021-07-16,Los Angeles,037,10098052,1235056,1219733,42543,1262276,24582
2021-07-16,Madera,039,155013,17022,16804,965,17769,240
2021-07-16,Marin,041,260295,14541,14297,267,14564,234
2021-07-16,Mariposa,043,17540,449,445,11,456,5
2021-07-16,Mendocino,045,87422,4335,4209,89,4298,49
2021-07-16,Merced,047,269075,31571,31451,1058,32509,471
2021-07-16,Modoc,049,8938,418,412,147,559,5
2021-07-16,Mono,051,14174,1275,1277,18,1295,3
2021-07-16,Monterey,053,433212,43623,43367,1883,45250,515
2021-07-16,Napa,055,140530,10216,10129,40,10169,81
2021-07-16,Nevada,057,99092,5200,5066,196,5262,72
2021-07-16,Orange,059,3164182,260772,257805,11781,269586,5136
2021-07-16,Placer,061,380077,24571,24169,1682,25851,303
2021-07-16,Plumas,063,18699,742,721,14,735,4
2021-07-16,Riverside,065,2383286,299415,294751,14244,308995,4542
2021-07-16,Sacramento,067,1510023,112091,110432,2008,112440,1694
2021-07-16,San Benito,069,59416,6185,6181,113,6294,63
2021-07-16,San Bernardino,071,2135413,298303,296048,9175,305223,5218
2021-07-16,San Diego,073,3302833,289182,285698,16322,302020,3786
2021-07-16,San Francisco,075,870044,38791,37978,1366,39344,560
2021-07-16,San Joaquin,077,732212,75523,74695,3717,78412,1430
2021-07-16,San Luis Obispo,079,281455,21830,21462,773,22235,258
2021-07-16,San Mateo,081,765935,43800,43324,526,43850,542
2021-07-16,Santa Barbara,083,443738,35123,34769,1141,35910,461
2021-07-16,Santa Clara,085,1922200,121398,119980,795,120775,2097
2021-07-16,Santa Cruz,087,273765,16515,16337,807,17144,207
2021-07-16,Shasta,089,179085,12778,12683,1686,14369,210
2021-07-16,Sierra,091,2930,66,62,12,74,0
2021-07-16,Siskiyou,093,43540,2022,1922,402,2324,29
2021-07-16,Solano,095,438530,34489,34015,636,34651,263
2021-07-16,Sonoma,097,501317,31899,31536,366,31902,322
2021-07-16,Stanislaus,099,539301,57875,57400,6098,63498,1028
2021-07-16,Sutter,101,95872,9851,9778,93,9871,114
2021-07-16,Tehama,103,63373,5205,5145,589,5734,64
2021-07-16,Trinity,105,12862,502,341,103,444,3
2021-07-16,Tulare,107,460477,50743,49937,9175,59112,854
2021-07-16,Tuolumne,109,53932,4171,4131,47,4178,64
2021-07-16,Ventura,111,848112,82917,82125,3249,85374,1041
2021-07-16,Yolo,113,214977,14549,14356,329,14685,213
2021-07-16,Yuba,115,75493,6416,6309,130,6439,52
2021-07-15,Alameda,001,1643700,92561,91346,2051,93397,1255
2021-07-15,Alpine,003,1148,88,89,0,89,0
2021-07-15,Amador,005,37829,3810,3785,33,3818,48
2021-07-15,Butte,007,227075,13000,12824,1946,14770,202
2021-07-15,Calaveras,009,45235,2258,2237,15,2252,57
2021-07-15,Colusa,011,21464,1995,1976,334,2310,16
2021-07-15,Contra Costa,013,1133247,73380,72254,1373,73627,824
2021-07-15,Del Norte,015,27424,1515,1475,14,1489,8
2021-07-15,El Dorado,017,186661,10804,10622,817,11439,114
2021-07-15,Fresno,019,978130,104391,103055,8829,111884,1730
2021-07-15,Glenn,021,27897,2470,2451,572,3023,20
2021-07-15,Humboldt,023,135768,4737,4654,58,4712,52
2021-07-15,Imperial,025,180216,29024,28840,2698,31538,742
2021-07-15,Inyo,027,18085,1423,1416,12,1428,36
2021-07-15,Kern,029,883053,98718,97796,11326,109122,1348
2021-07-15,Kings,031,150075,23471,23163,1110,24273,246
2021-07-15,Lake,033,64148,3890,3760,14,3774,64
2021-07-15,Lassen,035,31185,5320,5302,118,5420,21
2021-07-15,Los Angeles,037,10098052,1233069,1219733,42386,1262119,24582
2021-07-15,Madera,039,155013,17000,16804,961,17765,240
2021-07-15,Marin,041,260295,14516,14297,267,14564,234
2021-07-15,Mariposa,043,17540,449,445,11,456,5
2021-07-15,Mendocino,045,87422,4327,4209,88,4297,49
2021-07-15,Merced,047,269075,31541,31451,1058,32509,471
2021-07-15,Modoc,049,8938,418,412,147,559,5
2021-07-15,Mono,051,14174,1275,1277,18,1295,3
2021-07-15,Monterey,053,433212,43594,43367,1880,45247,515
2021-07-15,Napa,055,140530,10191,10129,39,10168,81
2021-07-15,Nevada,057,99092,5183,5066,195,5261,72
2021-07-15,Orange,059,3164182,260421,257805,11750,269555,5136
2021-07-15,Placer,061,380077,24511,24169,1665,25834,303
2021-07-15,Plumas,063,18699,741,721,14,735,4
2021-07-15,Riverside,065,2383286,299094,294751,14229,308980,4542
2021-07-15,Sacramento,067,1510023,111786,110432,1991,112423,1694
2021-07-15,San Benito,069,59416,6183,6181,113,6294,63
2021-07-15,San Bernardino,071,2135413,297996,296048,9161,305209,5218
2021-07-15,San Diego,073,3302833,288544,285698,16244,301942,3786
2021-07-15,San Francisco,075,870044,38640,37978,1358,39336,560
2021-07-15,San Joaquin,077,732212,75406,74695,3712,78407,1430
2021-07-15,San Luis Obispo,079,281455,21798,21462,773,22235,258
2021-07-15,San Mateo,081,765935,43695,43324,521,43845,542
2021-07-15,Santa Barbara,083,443738,35067,34769,1140,35909,461
2021-07-15,Santa Clara,085,1922200,121276,119980,792,120772,2097
2021-07-15,Santa Cruz,087,273765,16502,16337,807,17144,207
2021-07-15,Shasta,089,179085,12770,12683,1682,14365,210
2021-07-15,Sierra,091,2930,66,62,12,74,0
2021-07-15,Siskiyou,093,43540,2021,1922,402,2324,29
2021-07-15,Solano,095,438530,34413,34015,630,34645,263
2021-07-15,Sonoma,097,501317,31838,31536,366,31902,322
2021-07-15,Stanislaus,099,539301,57806,57400,6085,63485,1028
2021-07-15,Sutter,101,95872,9831,9778,92,9870,114
2021-07-15,Tehama,103,63373,5199,5145,588,5733,64
2021-07-15,Trinity,105,12862,502,341,103,444,3
2021-07-15,Tulare,107,460477,50723,49937,9158,59095,854
2021-07-15,Tuolumne,109,53932,4159,4131,47,4178,64
2021-07-15,Ventura,111,848112,82841,82125,3244,85369,1041
2021-07-15,Yolo,113,214977,14521,14356,328,14684,213
2021-07-15,Yuba,115,75493,6401,6309,129,6438,52
2021-07-14,Alameda,001,1643700,92301,91092,2035,93127,1255
2021-07-14,Alpine,003,1148,88,89,0,89,0
2021-07-14,Amador,005,37829,3802,3784,33,3817,48
2021-07-14,Butte,007,227075,12973,12813,1939,14752,202
2021-07-14,Calaveras,009,45235,2251,2234,15,2249,57
2021-07-14,Colusa,011,21464,1992,1974,334,2308,16
2021-07-14,Contra Costa,013,1133247,73151,72091,1361,73452,823
2021-07-14,Del Norte,015,27424,1514,1472,14,1486,8
2021-07-14,El Dorado,017,186661,10778,10598,814,11412,114
2021-07-14,Fresno,019,978130,104311,102966,8818,111784,1728
2021-07-14,Glenn,021,27897,2470,2449,572,3021,20
2021-07-14,Humboldt,023,135768,4713,4644,56,4700,52
2021-07-14,Imperial,025,180216,28995,28822,2698,31520,742
2021-07-14,Inyo,027,18085,1422,1415,12,1427,36
2021-07-14,Kern,029,883053,98654,97736,11301,109037,1346
2021-07-14,Kings,031,150075,23458,23142,1110,24252,246
2021-07-14,Lake,033,64148,3857,3739,14,3753,63
2021-07-14,Lassen,035,31185,5319,5298,118,5416,21
2021-07-14,Los Angeles,037,10098052,1231053,1218265,42245,1260510,24578
2021-07-14,Madera,039,155013,16988,16786,959,17745,240
2021-07-14,Marin,041,260295,14482,14269,265,14534,233
2021-07-14,Mariposa,043,17540,447,445,11,456,5
2021-07-14,Mendocino,045,87422,4313,4193,88,4281,49
2021-07-14,Merced,047,269075,31504,31412,1055,32467,471
2021-07-14,Modoc,049,8938,418,412,147,559,4
2021-07-14,Mono,051,14174,1275,1278,18,1296,3
2021-07-14,Monterey,053,433212,43570,43347,1878,45225,504
2021-07-14,Napa,055,140530,10169,10121,39,10160,81
2021-07-14,Nevada,057,99092,5163,5058,195,5253,72
2021-07-14,Orange,059,3164182,260104,257558,11720,269278,5137
2021-07-14,Placer,061,380077,24458,24125,1653,25778,303
2021-07-14,Plumas,063,18699,734,719,14,733,4
2021-07-14,Riverside,065,2383286,298770,294511,14213,308724,4542
2021-07-14,Sacramento,067,1510023,111458,110193,1967,112160,1688
2021-07-14,San Benito,069,59416,6180,6177,113,6290,63
2021-07-14,San Bernardino,071,2135413,297696,295820,9146,304966,5193
2021-07-14,San Diego,073,3302833,287972,285269,16164,301433,3786
2021-07-14,San Francisco,075,870044,38501,37836,1353,39189,559
2021-07-14,San Joaquin,077,732212,75314,74599,3703,78302,1416
2021-07-14,San Luis Obispo,079,281455,21776,21444,771,22215,258
2021-07-14,San Mateo,081,765935,43596,43249,517,43766,542
2021-07-14,Santa Barbara,083,443738,35025,34719,1138,35857,461
2021-07-14,Santa Clara,085,1922200,121126,119844,789,120633,2098
2021-07-14,Santa Cruz,087,273765,16490,16326,807,17133,207
2021-07-14,Shasta,089,179085,12750,12669,1679,14348,209
2021-07-14,Sierra,091,2930,66,62,12,74,0
2021-07-14,Siskiyou,093,43540,2014,1922,399,2321,29
2021-07-14,Solano,095,438530,34340,33948,630,34578,268
2021-07-14,Sonoma,097,501317,31786,31470,366,31836,322
2021-07-14,Stanislaus,099,539301,57731,57340,6073,63413,1028
2021-07-14,Sutter,101,95872,9809,9766,92,9858,114
2021-07-14,Tehama,103,63373,5197,5142,588,5730,64
2021-07-14,Trinity,105,12862,502,341,103,444,3
2021-07-14,Tulare,107,460477,50706,49908,9144,59052,853
2021-07-14,Tuolumne,109,53932,4156,4128,46,4174,64
2021-07-14,Ventura,111,848112,82747,82041,3233,85274,1040
2021-07-14,Yolo,113,214977,14488,14332,325,14657,213
2021-07-14,Yuba,115,75493,6383,6294,129,6423,52
2021-07-13,Alameda,001,1643700,92037,90874,2025,92899,1255
2021-07-13,Alpine,003,1148,88,89,0,89,0
2021-07-13,Amador,005,37829,3795,3783,33,3816,48
2021-07-13,Butte,007,227075,12959,12802,1938,14740,202
2021-07-13,Calaveras,009,45235,2247,2230,15,2245,57
2021-07-13,Colusa,011,21464,1990,1972,331,2303,16
2021-07-13,Contra Costa,013,1133247,72926,71963,1352,73315,823
2021-07-13,Del Norte,015,27424,1510,1471,14,1485,8
2021-07-13,El Dorado,017,186661,10761,10581,812,11393,114
2021-07-13,Fresno,019,978130,104236,102909,8808,111717,1727
2021-07-13,Glenn,021,27897,2468,2448,572,3020,20
2021-07-13,Humboldt,023,135768,4698,4634,56,4690,51
2021-07-13,Imperial,025,180216,28984,28792,2698,31490,741
2021-07-13,Inyo,027,18085,1421,1415,12,1427,36
2021-07-13,Kern,029,883053,98565,97698,11262,108960,1346
2021-07-13,Kings,031,150075,23440,23132,1110,24242,246
2021-07-13,Lake,033,64148,3830,3719,13,3732,63
2021-07-13,Lassen,035,31185,5317,5292,118,5410,21
2021-07-13,Los Angeles,037,10098052,1229202,1217184,42075,1259259,24569
2021-07-13,Madera,039,155013,16978,16773,955,17728,240
2021-07-13,Marin,041,260295,14453,14254,264,14518,233
2021-07-13,Mariposa,043,17540,446,443,11,454,5
2021-07-13,Mendocino,045,87422,4306,4185,88,4273,49
2021-07-13,Merced,047,269075,31483,31379,1052,32431,471
2021-07-13,Modoc,049,8938,418,411,147,558,4
2021-07-13,Mono,051,14174,1274,1277,18,1295,3
2021-07-13,Monterey,053,433212,43552,43333,1874,45207,504
2021-07-13,Napa,055,140530,10148,10118,39,10157,81
2021-07-13,Nevada,057,99092,5138,5053,195,5248,72
2021-07-13,Orange,059,3164182,259774,257339,11692,269031,5136
2021-07-13,Placer,061,380077,24412,24091,1640,25731,303
2021-07-13,Plumas,063,18699,733,716,14,730,4
2021-07-13,Riverside,065,2383286,298448,294302,14186,308488,4541
2021-07-13,Sacramento,067,1510023,111148,109990,1944,111934,1687
2021-07-13,San Benito,069,59416,6178,6173,113,6286,63
2021-07-13,San Bernardino,071,2135413,297419,295596,9124,304720,5183
2021-07-13,San Diego,073,3302833,287424,284997,16085,301082,3785
2021-07-13,San Francisco,075,870044,38357,37725,1347,39072,559
2021-07-13,San Joaquin,077,732212,75198,74500,3700,78200,1417
2021-07-13,San Luis Obispo,079,281455,21750,21423,768,22191,258
2021-07-13,San Mateo,081,765935,43527,43180,516,43696,542
2021-07-13,Santa Barbara,083,443738,34976,34679,1135,35814,461
2021-07-13,Santa Clara,085,1922200,120973,119727,785,120512,2098
2021-07-13,Santa Cruz,087,273765,16481,16315,805,17120,207
2021-07-13,Shasta,089,179085,12737,12659,1672,14331,209
2021-07-13,Sierra,091,2930,66,62,12,74,0
2021-07-13,Siskiyou,093,43540,2013,1916,397,2313,29
2021-07-13,Solano,095,438530,34275,33918,624,34542,268
2021-07-13,Sonoma,097,501317,31727,31431,366,31797,322
2021-07-13,Stanislaus,099,539301,57660,57282,6058,63340,1028
2021-07-13,Sutter,101,95872,9791,9752,91,9843,114
2021-07-13,Tehama,103,63373,5190,5144,588,5732,64
2021-07-13,Trinity,105,12862,502,341,102,443,3
2021-07-13,Tulare,107,460477,50681,49891,9128,59019,853
2021-07-13,Tuolumne,109,53932,4148,4122,45,4167,64
2021-07-13,Ventura,111,848112,82662,81982,3208,85190,1040
2021-07-13,Yolo,113,214977,14460,14320,319,14639,213
2021-07-13,Yuba,115,75493,6366,6279,129,6408,52
2021-07-12,Alameda,001,1643700,91779,90720,2018,92738,1254
2021-07-12,Alpine,003,1148,88,89,0,89,0
2021-07-12,Amador,005,37829,3788,3781,33,3814,47
2021-07-12,Butte,007,227075,12939,12796,1936,14732,202
2021-07-12,Calaveras,009,45235,2245,2228,15,2243,57
2021-07-12,Colusa,011,21464,1986,1971,330,2301,16
2021-07-12,Contra Costa,013,1133247,72722,71833,1347,73180,823
2021-07-12,Del Norte,015,27424,1507,1469,14,1483,8
2021-07-12,El Dorado,017,186661,10732,10569,810,11379,114
2021-07-12,Fresno,019,978130,104142,102853,8796,111649,1728
2021-07-12,Glenn,021,27897,2468,2446,572,3018,20
2021-07-12,Humboldt,023,135768,4682,4621,56,4677,51
2021-07-12,Imperial,025,180216,28954,28789,2698,31487,741
2021-07-12,Inyo,027,18085,1421,1415,12,1427,36
2021-07-12,Kern,029,883053,98496,97660,11237,108897,1346
2021-07-12,Kings,031,150075,23420,23124,1108,24232,246
2021-07-12,Lake,033,64148,3809,3706,13,3719,63
2021-07-12,Lassen,035,31185,5316,5292,118,5410,21
2021-07-12,Los Angeles,037,10098052,1227405,1216230,41943,1258173,24559
2021-07-12,Madera,039,155013,16967,16772,955,17727,240
2021-07-12,Marin,041,260295,14428,14238,263,14501,233
2021-07-12,Mariposa,043,17540,446,442,11,453,5
2021-07-12,Mendocino,045,87422,4295,4175,88,4263,49
2021-07-12,Merced,047,269075,31452,31374,1051,32425,471
2021-07-12,Modoc,049,8938,417,411,147,558,4
2021-07-12,Mono,051,14174,1272,1275,18,1293,3
2021-07-12,Monterey,053,433212,43531,43315,1870,45185,504
2021-07-12,Napa,055,140530,10130,10104,38,10142,81
2021-07-12,Nevada,057,99092,5115,5046,195,5241,72
2021-07-12,Orange,059,3164182,259420,257171,11669,268840,5136
2021-07-12,Placer,061,380077,24361,24052,1634,25686,302
2021-07-12,Plumas,063,18699,733,716,14,730,4
2021-07-12,Riverside,065,2383286,298140,294108,14157,308265,4541
2021-07-12,Sacramento,067,1510023,110932,109849,1918,111767,1685
2021-07-12,San Benito,069,59416,6175,6166,113,6279,63
2021-07-12,San Bernardino,071,2135413,297147,295447,9109,304556,5171
2021-07-12,San Diego,073,3302833,286955,284648,16009,300657,3785
2021-07-12,San Francisco,075,870044,38211,37656,1344,39000,559
2021-07-12,San Joaquin,077,732212,75104,74424,3690,78114,1415
2021-07-12,San Luis Obispo,079,281455,21731,21408,767,22175,258
2021-07-12,San Mateo,081,765935,43433,43138,509,43647,542
2021-07-12,Santa Barbara,083,443738,34933,34664,1133,35797,461
2021-07-12,Santa Clara,085,1922200,120808,119634,782,120416,2098
2021-07-12,Santa Cruz,087,273765,16456,16310,804,17114,207
2021-07-12,Shasta,089,179085,12730,12648,1669,14317,208
2021-07-12,Sierra,091,2930,66,62,12,74,0
2021-07-12,Siskiyou,093,43540,2008,1916,392,2308,29
2021-07-12,Solano,095,438530,34185,33859,615,34474,268
2021-07-12,Sonoma,097,501317,31679,31377,365,31742,322
2021-07-12,Stanislaus,099,539301,57590,57243,6051,63294,1028
2021-07-12,Sutter,101,95872,9774,9736,90,9826,114
2021-07-12,Tehama,103,63373,5185,5138,587,5725,63
2021-07-12,Trinity,105,12862,498,340,100,440,3
2021-07-12,Tulare,107,460477,50653,49882,9115,58997,853
2021-07-12,Tuolumne,109,53932,4144,4116,45,4161,64
2021-07-12,Ventura,111,848112,82561,81919,3187,85106,1040
2021-07-12,Yolo,113,214977,14432,14303,315,14618,213
2021-07-12,Yuba,115,75493,6351,6266,129,6395,52
2021-07-11,Alameda,001,1643700,91450,90597,2006,92603,1254
2021-07-11,Alpine,003,1148,88,89,0,89,0
2021-07-11,Amador,005,37829,3786,3779,33,3812,47
2021-07-11,Butte,007,227075,12917,12794,1930,14724,202
2021-07-11,Calaveras,009,45235,2243,2226,14,2240,57
2021-07-11,Colusa,011,21464,1985,1971,329,2300,16
2021-07-11,Contra Costa,013,1133247,72512,71744,1340,73084,823
2021-07-11,Del Norte,015,27424,1503,1467,13,1480,8
2021-07-11,El Dorado,017,186661,10703,10554,808,11362,114
2021-07-11,Fresno,019,978130,104047,102813,8776,111589,1728
2021-07-11,Glenn,021,27897,2467,2446,572,3018,20
2021-07-11,Humboldt,023,135768,4669,4611,55,4666,51
2021-07-11,Imperial,025,180216,28936,28787,2697,31484,741
2021-07-11,Inyo,027,18085,1419,1415,12,1427,36
2021-07-11,Kern,029,883053,98423,97637,11221,108858,1346
2021-07-11,Kings,031,150075,23389,23116,1105,24221,246
2021-07-11,Lake,033,64148,3778,3699,13,3712,63
2021-07-11,Lassen,035,31185,5313,5291,118,5409,21
2021-07-11,Los Angeles,037,10098052,1225647,1215182,41787,1256969,24558
2021-07-11,Madera,039,155013,16948,16766,954,17720,240
2021-07-11,Marin,041,260295,14402,14231,263,14494,233
2021-07-11,Mariposa,043,17540,445,442,11,453,5
2021-07-11,Mendocino,045,87422,4275,4167,88,4255,49
2021-07-11,Merced,047,269075,31428,31366,1046,32412,471
2021-07-11,Modoc,049,8938,416,411,147,558,4
2021-07-11,Mono,051,14174,1272,1275,18,1293,3
2021-07-11,Monterey,053,433212,43512,43307,1866,45173,504
2021-07-11,Napa,055,140530,10126,10100,38,10138,81
2021-07-11,Nevada,057,99092,5104,5035,194,5229,72
2021-07-11,Orange,059,3164182,259108,257009,11641,268650,5136
2021-07-11,Placer,061,380077,24304,24017,1622,25639,302
2021-07-11,Plumas,063,18699,733,716,14,730,4
2021-07-11,Riverside,065,2383286,297876,293969,14139,308108,4541
2021-07-11,Sacramento,067,1510023,110654,109696,1907,111603,1685
2021-07-11,San Benito,069,59416,6170,6163,113,6276,63
2021-07-11,San Bernardino,071,2135413,296841,295342,9084,304426,5167
2021-07-11,San Diego,073,3302833,286541,283819,15923,299742,3784
2021-07-11,San Francisco,075,870044,38082,37596,1338,38934,559
2021-07-11,San Joaquin,077,732212,74987,74376,3673,78049,1415
2021-07-11,San Luis Obispo,079,281455,21698,21403,766,22169,258
2021-07-11,San Mateo,081,765935,43354,43107,503,43610,542
2021-07-11,Santa Barbara,083,443738,34886,34646,1133,35779,461
2021-07-11,Santa Clara,085,1922200,120654,119549,781,120330,2098
2021-07-11,Santa Cruz,087,273765,16440,16303,804,17107,207
2021-07-11,Shasta,089,179085,12713,12647,1667,14314,208
2021-07-11,Sierra,091,2930,66,62,12,74,0
2021-07-11,Siskiyou,093,43540,2004,1915,390,2305,29
2021-07-11,Solano,095,438530,34103,33837,611,34448,268
2021-07-11,Sonoma,097,501317,31597,31352,365,31717,322
2021-07-11,Stanislaus,099,539301,57524,57230,6040,63270,1028
2021-07-11,Sutter,101,95872,9760,9728,90,9818,114
2021-07-11,Tehama,103,63373,5182,5138,587,5725,63
2021-07-11,Trinity,105,12862,497,340,100,440,3
2021-07-11,Tulare,107,460477,50628,49877,9097,58974,853
2021-07-11,Tuolumne,109,53932,4138,4116,45,4161,64
2021-07-11,Ventura,111,848112,82488,81875,3167,85042,1040
2021-07-11,Yolo,113,214977,14407,14285,309,14594,213
2021-07-11,Yuba,115,75493,6340,6260,129,6389,52
2021-07-10,Alameda,001,1643700,91300,90090,2002,92092,1252
2021-07-10,Alpine,003,1148,88,89,0,89,0
2021-07-10,Amador,005,37829,3780,3773,33,3806,47
2021-07-10,Butte,007,227075,12907,12764,1927,14691,202
2021-07-10,Calaveras,009,45235,2242,2214,14,2228,57
2021-07-10,Colusa,011,21464,1983,1969,329,2298,16
2021-07-10,Contra Costa,013,1133247,72412,71376,1339,72715,821
2021-07-10,Del Norte,015,27424,1501,1451,13,1464,8
2021-07-10,El Dorado,017,186661,10686,10508,805,11313,114
2021-07-10,Fresno,019,978130,104013,102675,8769,111444,1730
2021-07-10,Glenn,021,27897,2464,2440,571,3011,20
2021-07-10,Humboldt,023,135768,4660,4574,55,4629,51
2021-07-10,Imperial,025,180216,28923,28729,2697,31426,741
2021-07-10,Inyo,027,18085,1418,1415,12,1427,36
2021-07-10,Kern,029,883053,98383,97538,11204,108742,1346
2021-07-10,Kings,031,150075,23382,23090,1104,24194,246
2021-07-10,Lake,033,64148,3761,3667,13,3680,63
2021-07-10,Lassen,035,31185,5313,5290,118,5408,21
2021-07-10,Los Angeles,037,10098052,1224619,1212043,41684,1253727,24542
2021-07-10,Madera,039,155013,16942,16744,951,17695,241
2021-07-10,Marin,041,260295,14388,14194,263,14457,233
2021-07-10,Mariposa,043,17540,445,442,11,453,5
2021-07-10,Mendocino,045,87422,4268,4153,87,4240,49
2021-07-10,Merced,047,269075,31415,31328,1046,32374,470
2021-07-10,Modoc,049,8938,416,410,147,557,4
2021-07-10,Mono,051,14174,1272,1275,18,1293,3
2021-07-10,Monterey,053,433212,43498,43251,1864,45115,499
2021-07-10,Napa,055,140530,10114,10077,38,10115,81
2021-07-10,Nevada,057,99092,5095,5000,194,5194,72
2021-07-10,Orange,059,3164182,258930,256438,11625,268063,5135
2021-07-10,Placer,061,380077,24275,23916,1612,25528,302
2021-07-10,Plumas,063,18699,732,717,14,731,4
2021-07-10,Riverside,065,2383286,297686,293474,14126,307600,4541
2021-07-10,Sacramento,067,1510023,110505,109091,1901,110992,1682
2021-07-10,San Benito,069,59416,6165,6141,113,6254,63
2021-07-10,San Bernardino,071,2135413,296653,294932,9071,304003,5117
2021-07-10,San Diego,073,3302833,286251,283577,15870,299447,3783
2021-07-10,San Francisco,075,870044,37999,37338,1335,38673,559
2021-07-10,San Joaquin,077,732212,74930,74150,3667,77817,1412
2021-07-10,San Luis Obispo,079,281455,21687,21375,765,22140,258
2021-07-10,San Mateo,081,765935,43302,42948,501,43449,542
2021-07-10,Santa Barbara,083,443738,34859,34595,1133,35728,460
2021-07-10,Santa Clara,085,1922200,120551,119330,778,120108,2094
2021-07-10,Santa Cruz,087,273765,16433,16286,804,17090,207
2021-07-10,Shasta,089,179085,12700,12623,1662,14285,206
2021-07-10,Sierra,091,2930,66,61,12,73,0
2021-07-10,Siskiyou,093,43540,2002,1909,387,2296,29
2021-07-10,Solano,095,438530,34061,33678,605,34283,268
2021-07-10,Sonoma,097,501317,31546,31231,365,31596,317
2021-07-10,Stanislaus,099,539301,57488,57104,6030,63134,1026
2021-07-10,Sutter,101,95872,9748,9692,90,9782,114
2021-07-10,Tehama,103,63373,5179,5131,587,5718,63
2021-07-10,Trinity,105,12862,497,341,100,441,3
2021-07-10,Tulare,107,460477,50618,49850,9091,58941,853
2021-07-10,Tuolumne,109,53932,4136,4114,45,4159,64
2021-07-10,Ventura,111,848112,82443,81713,3149,84862,1039
2021-07-10,Yolo,113,214977,14386,14250,306,14556,213
2021-07-10,Yuba,115,75493,6330,6238,129,6367,52
2021-07-09,Alameda,001,1643700,91141,90090,1997,92087,1252
2021-07-09,Alpine,003,1148,88,89,0,89,0
2021-07-09,Amador,005,37829,3779,3773,33,3806,47
2021-07-09,Butte,007,227075,12895,12764,1925,14689,202
2021-07-09,Calaveras,009,45235,2240,2214,14,2228,57
2021-07-09,Colusa,011,21464,1982,1969,329,2298,16
2021-07-09,Contra Costa,013,1133247,72286,71376,1337,72713,821
2021-07-09,Del Norte,015,27424,1496,1451,13,1464,8
2021-07-09,El Dorado,017,186661,10671,10508,804,11312,114
2021-07-09,Fresno,019,978130,103958,102675,8762,111437,1730
2021-07-09,Glenn,021,27897,2463,2440,569,3009,20
2021-07-09,Humboldt,023,135768,4641,4574,55,4629,51
2021-07-09,Imperial,025,180216,28915,28729,2696,31425,741
2021-07-09,Inyo,027,18085,1417,1415,12,1427,36
2021-07-09,Kern,029,883053,98345,97538,11192,108730,1346
2021-07-09,Kings,031,150075,23371,23090,1103,24193,246
2021-07-09,Lake,033,64148,3747,3667,13,3680,63
2021-07-09,Lassen,035,31185,5311,5290,117,5407,21
2021-07-09,Los Angeles,037,10098052,1223614,1212043,41614,1253657,24542
2021-07-09,Madera,039,155013,16932,16744,950,17694,241
2021-07-09,Marin,041,260295,14367,14194,262,14456,233
2021-07-09,Mariposa,043,17540,445,442,11,453,5
2021-07-09,Mendocino,045,87422,4261,4153,87,4240,49
2021-07-09,Merced,047,269075,31400,31328,1046,32374,470
2021-07-09,Modoc,049,8938,416,410,147,557,4
2021-07-09,Mono,051,14174,1272,1275,18,1293,3
2021-07-09,Monterey,053,433212,43489,43251,1864,45115,499
2021-07-09,Napa,055,140530,10107,10077,38,10115,81
2021-07-09,Nevada,057,99092,5086,5000,194,5194,72
2021-07-09,Orange,059,3164182,258724,256438,11611,268049,5135
2021-07-09,Placer,061,380077,24253,23916,1606,25522,302
2021-07-09,Plumas,063,18699,730,717,14,731,4
2021-07-09,Riverside,065,2383286,297500,293474,14113,307587,4541
2021-07-09,Sacramento,067,1510023,110351,109091,1892,110983,1682
2021-07-09,San Benito,069,59416,6163,6141,113,6254,63
2021-07-09,San Bernardino,071,2135413,296501,294932,9064,303996,5117
2021-07-09,San Diego,073,3302833,285962,283577,15822,299399,3783
2021-07-09,San Francisco,075,870044,37919,37338,1328,38666,559
2021-07-09,San Joaquin,077,732212,74856,74150,3660,77810,1412
2021-07-09,San Luis Obispo,079,281455,21675,21375,765,22140,258
2021-07-09,San Mateo,081,765935,43258,42948,497,43445,542
2021-07-09,Santa Barbara,083,443738,34838,34595,1132,35727,460
2021-07-09,Santa Clara,085,1922200,120440,119330,778,120108,2094
2021-07-09,Santa Cruz,087,273765,16430,16286,804,17090,207
2021-07-09,Shasta,089,179085,12694,12623,1657,14280,206
2021-07-09,Sierra,091,2930,66,61,12,73,0
2021-07-09,Siskiyou,093,43540,2000,1909,386,2295,29
2021-07-09,Solano,095,438530,34025,33678,601,34279,268
2021-07-09,Sonoma,097,501317,31510,31231,365,31596,317
2021-07-09,Stanislaus,099,539301,57459,57104,6028,63132,1026
2021-07-09,Sutter,101,95872,9739,9692,90,9782,114
2021-07-09,Tehama,103,63373,5177,5131,587,5718,63
2021-07-09,Trinity,105,12862,496,341,97,438,3
2021-07-09,Tulare,107,460477,50605,49850,9085,58935,853
2021-07-09,Tuolumne,109,53932,4132,4114,45,4159,64
2021-07-09,Ventura,111,848112,82388,81713,3140,84853,1039
2021-07-09,Yolo,113,214977,14371,14250,302,14552,213
2021-07-09,Yuba,115,75493,6317,6238,129,6367,52
2021-07-08,Alameda,001,1643700,90935,90090,1994,92084,1252
2021-07-08,Alpine,003,1148,88,89,0,89,0
2021-07-08,Amador,005,37829,3777,3773,33,3806,47
2021-07-08,Butte,007,227075,12882,12764,1922,14686,202
2021-07-08,Calaveras,009,45235,2237,2214,13,2227,57
2021-07-08,Colusa,011,21464,1982,1969,329,2298,16
2021-07-08,Contra Costa,013,1133247,72158,71376,1332,72708,821
2021-07-08,Del Norte,015,27424,1494,1451,13,1464,8
2021-07-08,El Dorado,017,186661,10654,10508,797,11305,114
2021-07-08,Fresno,019,978130,103895,102675,8751,111426,1730
2021-07-08,Glenn,021,27897,2463,2440,569,3009,20
2021-07-08,Humboldt,023,135768,4625,4574,54,4628,51
2021-07-08,Imperial,025,180216,28903,28729,2695,31424,741
2021-07-08,Inyo,027,18085,1417,1415,12,1427,36
2021-07-08,Kern,029,883053,98297,97538,11177,108715,1346
2021-07-08,Kings,031,150075,23362,23090,1103,24193,246
2021-07-08,Lake,033,64148,3733,3667,13,3680,63
2021-07-08,Lassen,035,31185,5308,5290,117,5407,21
2021-07-08,Los Angeles,037,10098052,1222401,1212043,41520,1253563,24542
2021-07-08,Madera,039,155013,16916,16744,950,17694,241
2021-07-08,Marin,041,260295,14353,14194,262,14456,233
2021-07-08,Mariposa,043,17540,444,442,11,453,5
2021-07-08,Mendocino,045,87422,4258,4153,87,4240,49
2021-07-08,Merced,047,269075,31386,31328,1044,32372,470
2021-07-08,Modoc,049,8938,416,410,147,557,4
2021-07-08,Mono,051,14174,1272,1275,18,1293,3
2021-07-08,Monterey,053,433212,43469,43251,1858,45109,499
2021-07-08,Napa,055,140530,10103,10077,38,10115,81
2021-07-08,Nevada,057,99092,5080,5000,194,5194,72
2021-07-08,Orange,059,3164182,258529,256438,11589,268027,5135
2021-07-08,Placer,061,380077,24214,23916,1598,25514,302
2021-07-08,Plumas,063,18699,729,717,14,731,4
2021-07-08,Riverside,065,2383286,297299,293474,14097,307571,4541
2021-07-08,Sacramento,067,1510023,110129,109091,1887,110978,1682
2021-07-08,San Benito,069,59416,6160,6141,113,6254,63
2021-07-08,San Bernardino,071,2135413,296326,294932,9055,303987,5117
2021-07-08,San Diego,073,3302833,285635,283577,15774,299351,3783
2021-07-08,San Francisco,075,870044,37839,37338,1324,38662,559
2021-07-08,San Joaquin,077,732212,74768,74150,3647,77797,1412
2021-07-08,San Luis Obispo,079,281455,21663,21375,762,22137,258
2021-07-08,San Mateo,081,765935,43207,42948,496,43444,542
2021-07-08,Santa Barbara,083,443738,34811,34595,1130,35725,460
2021-07-08,Santa Clara,085,1922200,120347,119330,777,120107,2094
2021-07-08,Santa Cruz,087,273765,16424,16286,804,17090,207
2021-07-08,Shasta,089,179085,12688,12623,1653,14276,206
2021-07-08,Sierra,091,2930,66,61,12,73,0
2021-07-08,Siskiyou,093,43540,1995,1909,383,2292,29
2021-07-08,Solano,095,438530,33970,33678,595,34273,268
2021-07-08,Sonoma,097,501317,31479,31231,364,31595,317
2021-07-08,Stanislaus,099,539301,57432,57104,6024,63128,1026
2021-07-08,Sutter,101,95872,9725,9692,88,9780,114
2021-07-08,Tehama,103,63373,5174,5131,586,5717,63
2021-07-08,Trinity,105,12862,496,341,97,438,3
2021-07-08,Tulare,107,460477,50587,49850,9078,58928,853
2021-07-08,Tuolumne,109,53932,4130,4114,45,4159,64
2021-07-08,Ventura,111,848112,82324,81713,3124,84837,1039
2021-07-08,Yolo,113,214977,14351,14250,300,14550,213
2021-07-08,Yuba,115,75493,6309,6238,129,6367,52
2021-07-07,Alameda,001,1643700,90752,89995,1988,91983,1253
2021-07-07,Alpine,003,1148,88,89,0,89,0
2021-07-07,Amador,005,37829,3772,3770,33,3803,47
2021-07-07,Butte,007,227075,12869,12750,1917,14667,202
2021-07-07,Calaveras,009,45235,2230,2212,13,2225,57
2021-07-07,Colusa,011,21464,1978,1969,329,2298,16
2021-07-07,Contra Costa,013,1133247,72011,71308,1330,72638,821
2021-07-07,Del Norte,015,27424,1489,1446,13,1459,8
2021-07-07,El Dorado,017,186661,10634,10494,795,11289,114
2021-07-07,Fresno,019,978130,103845,102639,8744,111383,1729
2021-07-07,Glenn,021,27897,2463,2441,569,3010,20
2021-07-07,Humboldt,023,135768,4611,4566,54,4620,51
2021-07-07,Imperial,025,180216,28896,28701,2695,31396,740
2021-07-07,Inyo,027,18085,1416,1415,12,1427,36
2021-07-07,Kern,029,883053,98253,97507,11162,108669,1348
2021-07-07,Kings,031,150075,23349,23085,1100,24185,245
2021-07-07,Lake,033,64148,3714,3660,13,3673,63
2021-07-07,Lassen,035,31185,5308,5286,117,5403,21
2021-07-07,Los Angeles,037,10098052,1221219,1211316,41418,1252734,24531
2021-07-07,Madera,039,155013,16905,16733,948,17681,241
2021-07-07,Marin,041,260295,14334,14183,261,14444,233
2021-07-07,Mariposa,043,17540,442,442,11,453,5
2021-07-07,Mendocino,045,87422,4249,4145,87,4232,49
2021-07-07,Merced,047,269075,31371,31317,1044,32361,470
2021-07-07,Modoc,049,8938,416,410,147,557,4
2021-07-07,Mono,051,14174,1271,1274,18,1292,3
2021-07-07,Monterey,053,433212,43445,43233,1856,45089,494
2021-07-07,Napa,055,140530,10092,10078,38,10116,81
2021-07-07,Nevada,057,99092,5073,4996,194,5190,72
2021-07-07,Orange,059,3164182,258303,256301,11568,267869,5132
2021-07-07,Placer,061,380077,24178,23901,1588,25489,302
2021-07-07,Plumas,063,18699,729,710,14,724,4
2021-07-07,Riverside,065,2383286,297085,293331,14087,307418,4538
2021-07-07,Sacramento,067,1510023,109939,108954,1879,110833,1682
2021-07-07,San Benito,069,59416,6155,6137,113,6250,63
2021-07-07,San Bernardino,071,2135413,296157,294787,9048,303835,5087
2021-07-07,San Diego,073,3302833,285315,283377,15734,299111,3782
2021-07-07,San Francisco,075,870044,37747,37284,1321,38605,558
2021-07-07,San Joaquin,077,732212,74692,74095,3632,77727,1410
2021-07-07,San Luis Obispo,079,281455,21654,21360,760,22120,258
2021-07-07,San Mateo,081,765935,43153,42908,493,43401,542
2021-07-07,Santa Barbara,083,443738,34785,34582,1130,35712,460
2021-07-07,Santa Clara,085,1922200,120249,119250,776,120026,2094
2021-07-07,Santa Cruz,087,273765,16415,16279,803,17082,207
2021-07-07,Shasta,089,179085,12680,12613,1650,14263,206
2021-07-07,Sierra,091,2930,66,60,12,72,0
2021-07-07,Siskiyou,093,43540,1989,1908,379,2287,29
2021-07-07,Solano,095,438530,33921,33659,588,34247,268
2021-07-07,Sonoma,097,501317,31433,31172,364,31536,316
2021-07-07,Stanislaus,099,539301,57400,57102,6019,63121,1028
2021-07-07,Sutter,101,95872,9715,9683,88,9771,114
2021-07-07,Tehama,103,63373,5173,5129,586,5715,63
2021-07-07,Trinity,105,12862,496,341,97,438,3
2021-07-07,Tulare,107,460477,50583,49835,9069,58904,853
2021-07-07,Tuolumne,109,53932,4126,4115,44,4159,64
2021-07-07,Ventura,111,848112,82280,81608,3110,84718,1036
2021-07-07,Yolo,113,214977,14340,14236,297,14533,213
2021-07-07,Yuba,115,75493,6293,6233,129,6362,51
2021-07-06,Alameda,001,1643700,90557,89918,1980,91898,1253
2021-07-06,Alpine,003,1148,88,89,0,89,0
2021-07-06,Amador,005,37829,3771,3768,32,3800,47
2021-07-06,Butte,007,227075,12856,12744,1914,14658,201
2021-07-06,Calaveras,009,45235,2230,2211,13,2224,55
2021-07-06,Colusa,011,21464,1977,1967,326,2293,16
2021-07-06,Contra Costa,013,1133247,71882,71262,1327,72589,820
2021-07-06,Del Norte,015,27424,1485,1445,13,1458,8
2021-07-06,El Dorado,017,186661,10616,10484,793,11277,113
2021-07-06,Fresno,019,978130,103793,102616,8732,111348,1727
2021-07-06,Glenn,021,27897,2462,2438,569,3007,20
2021-07-06,Humboldt,023,135768,4597,4565,53,4618,49
2021-07-06,Imperial,025,180216,28881,28693,2693,31386,739
2021-07-06,Inyo,027,18085,1416,1412,12,1424,36
2021-07-06,Kern,029,883053,98211,97491,11151,108642,1346
2021-07-06,Kings,031,150075,23341,23077,1099,24176,245
2021-07-06,Lake,033,64148,3704,3659,13,3672,63
2021-07-06,Lassen,035,31185,5307,5288,116,5404,21
2021-07-06,Los Angeles,037,10098052,1220000,1210965,41322,1252287,24525
2021-07-06,Madera,039,155013,16893,16730,948,17678,241
2021-07-06,Marin,041,260295,14320,14181,261,14442,233
2021-07-06,Mariposa,043,17540,442,442,11,453,5
2021-07-06,Mendocino,045,87422,4242,4143,87,4230,49
2021-07-06,Merced,047,269075,31354,31317,1043,32360,470
2021-07-06,Modoc,049,8938,416,411,147,558,4
2021-07-06,Mono,051,14174,1270,1274,18,1292,3
2021-07-06,Monterey,053,433212,43423,43224,1854,45078,494
2021-07-06,Napa,055,140530,10081,10081,38,10119,81
2021-07-06,Nevada,057,99092,5064,4988,194,5182,72
2021-07-06,Orange,059,3164182,258059,256227,11551,267778,5129
2021-07-06,Placer,061,380077,24137,23876,1582,25458,302
2021-07-06,Plumas,063,18699,728,708,14,722,4
2021-07-06,Riverside,065,2383286,296882,293227,14069,307296,4539
2021-07-06,Sacramento,067,1510023,109728,108850,1871,110721,1679
2021-07-06,San Benito,069,59416,6151,6137,113,6250,63
2021-07-06,San Bernardino,071,2135413,295978,294712,9035,303747,5056
2021-07-06,San Diego,073,3302833,284957,283278,15675,298953,3782
2021-07-06,San Francisco,075,870044,37630,37251,1320,38571,558
2021-07-06,San Joaquin,077,732212,74622,74019,3620,77639,1410
2021-07-06,San Luis Obispo,079,281455,21637,21354,758,22112,257
2021-07-06,San Mateo,081,765935,43078,42895,493,43388,541
2021-07-06,Santa Barbara,083,443738,34766,34572,1129,35701,460
2021-07-06,Santa Clara,085,1922200,120131,119194,773,119967,2095
2021-07-06,Santa Cruz,087,273765,16410,16274,802,17076,207
2021-07-06,Shasta,089,179085,12670,12606,1648,14254,205
2021-07-06,Sierra,091,2930,65,60,12,72,0
2021-07-06,Siskiyou,093,43540,1986,1905,375,2280,29
2021-07-06,Solano,095,438530,33870,33619,585,34204,268
2021-07-06,Sonoma,097,501317,31370,31130,363,31493,316
2021-07-06,Stanislaus,099,539301,57351,57120,6008,63128,1029
2021-07-06,Sutter,101,95872,9706,9674,87,9761,114
2021-07-06,Tehama,103,63373,5170,5126,585,5711,63
2021-07-06,Trinity,105,12862,496,341,97,438,3
2021-07-06,Tulare,107,460477,50568,49826,9059,58885,853
2021-07-06,Tuolumne,109,53932,4124,4113,44,4157,64
2021-07-06,Ventura,111,848112,82240,81534,3085,84619,1033
2021-07-06,Yolo,113,214977,14318,14227,294,14521,213
2021-07-06,Yuba,115,75493,6282,6231,129,6360,51
2021-07-05,Alameda,001,1643700,90381,89892,1975,91867,1253
2021-07-05,Alpine,003,1148,88,89,0,89,0
2021-07-05,Amador,005,37829,3769,3768,32,3800,47
2021-07-05,Butte,007,227075,12848,12740,1905,14645,201
2021-07-05,Calaveras,009,45235,2228,2211,13,2224,55
2021-07-05,Colusa,011,21464,1975,1966,325,2291,16
2021-07-05,Contra Costa,013,1133247,71754,71235,1327,72562,820
2021-07-05,Del Norte,015,27424,1481,1446,13,1459,8
2021-07-05,El Dorado,017,186661,10591,10481,793,11274,113
2021-07-05,Fresno,019,978130,103734,102592,8717,111309,1727
2021-07-05,Glenn,021,27897,2459,2438,568,3006,20
2021-07-05,Humboldt,023,135768,4583,4563,53,4616,49
2021-07-05,Imperial,025,180216,28862,28689,2693,31382,739
2021-07-05,Inyo,027,18085,1416,1412,12,1424,36
2021-07-05,Kern,029,883053,98163,97479,11131,108610,1346
2021-07-05,Kings,031,150075,23333,23065,1096,24161,245
2021-07-05,Lake,033,64148,3686,3645,13,3658,63
2021-07-05,Lassen,035,31185,5304,5288,115,5403,21
2021-07-05,Los Angeles,037,10098052,1218805,1210653,41220,1251873,24522
2021-07-05,Madera,039,155013,16882,16722,947,17669,241
2021-07-05,Marin,041,260295,14299,14178,261,14439,233
2021-07-05,Mariposa,043,17540,442,441,11,452,5
2021-07-05,Mendocino,045,87422,4237,4139,87,4226,49
2021-07-05,Merced,047,269075,31334,31312,1043,32355,470
2021-07-05,Modoc,049,8938,416,410,147,557,4
2021-07-05,Mono,051,14174,1270,1273,18,1291,3
2021-07-05,Monterey,053,433212,43403,43218,1849,45067,494
2021-07-05,Napa,055,140530,10075,10074,38,10112,81
2021-07-05,Nevada,057,99092,5046,4980,193,5173,72
2021-07-05,Orange,059,3164182,257858,256173,11533,267706,5129
2021-07-05,Placer,061,380077,24090,23867,1574,25441,302
2021-07-05,Plumas,063,18699,727,708,14,722,4
2021-07-05,Riverside,065,2383286,296691,293193,14057,307250,4539
2021-07-05,Sacramento,067,1510023,109546,108758,1861,110619,1679
2021-07-05,San Benito,069,59416,6144,6137,113,6250,63
2021-07-05,San Bernardino,071,2135413,295816,294647,9028,303675,5037
2021-07-05,San Diego,073,3302833,284594,282834,15631,298465,3782
2021-07-05,San Francisco,075,870044,37542,37237,1315,38552,558
2021-07-05,San Joaquin,077,732212,74552,73999,3615,77614,1410
2021-07-05,San Luis Obispo,079,281455,21623,21351,757,22108,257
2021-07-05,San Mateo,081,765935,43026,42876,490,43366,541
2021-07-05,Santa Barbara,083,443738,34746,34569,1129,35698,460
2021-07-05,Santa Clara,085,1922200,120025,119184,771,119955,2095
2021-07-05,Santa Cruz,087,273765,16401,16273,801,17074,208
2021-07-05,Shasta,089,179085,12661,12603,1646,14249,205
2021-07-05,Sierra,091,2930,65,60,12,72,0
2021-07-05,Siskiyou,093,43540,1984,1904,374,2278,29
2021-07-05,Solano,095,438530,33800,33612,579,34191,268
2021-07-05,Sonoma,097,501317,31317,31116,363,31479,316
2021-07-05,Stanislaus,099,539301,57321,57109,5997,63106,1029
2021-07-05,Sutter,101,95872,9694,9667,87,9754,114
2021-07-05,Tehama,103,63373,5169,5125,585,5710,63
2021-07-05,Trinity,105,12862,495,341,96,437,3
2021-07-05,Tulare,107,460477,50549,49818,9056,58874,853
2021-07-05,Tuolumne,109,53932,4120,4112,44,4156,64
2021-07-05,Ventura,111,848112,82189,81519,3066,84585,1033
2021-07-05,Yolo,113,214977,14298,14225,286,14511,213
2021-07-05,Yuba,115,75493,6274,6223,129,6352,51
2021-07-04,Alameda,001,1643700,90217,89683,1972,91655,1253
2021-07-04,Alpine,003,1148,88,89,0,89,0
2021-07-04,Amador,005,37829,3768,3758,32,3790,46
2021-07-04,Butte,007,227075,12838,12684,1905,14589,201
2021-07-04,Calaveras,009,45235,2224,2200,13,2213,55
2021-07-04,Colusa,011,21464,1975,1969,325,2294,15
2021-07-04,Contra Costa,013,1133247,71648,70941,1322,72263,818
2021-07-04,Del Norte,015,27424,1478,1439,13,1452,8
2021-07-04,El Dorado,017,186661,10582,10433,792,11225,113
2021-07-04,Fresno,019,978130,103688,102512,8702,111214,1727
2021-07-04,Glenn,021,27897,2457,2442,567,3009,20
2021-07-04,Humboldt,023,135768,4575,4530,53,4583,49
2021-07-04,Imperial,025,180216,28856,28661,2693,31354,739
2021-07-04,Inyo,027,18085,1416,1412,12,1424,35
2021-07-04,Kern,029,883053,98144,97421,11122,108543,1347
2021-07-04,Kings,031,150075,23325,23051,1096,24147,245
2021-07-04,Lake,033,64148,3676,3623,13,3636,62
2021-07-04,Lassen,035,31185,5303,5277,115,5392,20
2021-07-04,Los Angeles,037,10098052,1217941,1208705,41137,1249842,24506
2021-07-04,Madera,039,155013,16870,16696,946,17642,240
2021-07-04,Marin,041,260295,14284,14143,261,14404,233
2021-07-04,Mariposa,043,17540,442,441,11,452,5
2021-07-04,Mendocino,045,87422,4227,4122,87,4209,49
2021-07-04,Merced,047,269075,31323,31297,1043,32340,469
2021-07-04,Modoc,049,8938,416,410,147,557,4
2021-07-04,Mono,051,14174,1270,1275,18,1293,3
2021-07-04,Monterey,053,433212,43387,43212,1848,45060,492
2021-07-04,Napa,055,140530,10067,10045,37,10082,81
2021-07-04,Nevada,057,99092,5036,4966,193,5159,72
2021-07-04,Orange,059,3164182,257683,255823,11513,267336,5126
2021-07-04,Placer,061,380077,24053,23764,1568,25332,299
2021-07-04,Plumas,063,18699,727,707,14,721,4
2021-07-04,Riverside,065,2383286,296531,293260,14051,307311,4536
2021-07-04,Sacramento,067,1510023,109376,108257,1855,110112,1676
2021-07-04,San Benito,069,59416,6137,6108,113,6221,63
2021-07-04,San Bernardino,071,2135413,295648,294294,9021,303315,5003
2021-07-04,San Diego,073,3302833,284369,282692,15594,298286,3780
2021-07-04,San Francisco,075,870044,37483,37107,1309,38416,558
2021-07-04,San Joaquin,077,732212,74486,73841,3607,77448,1409
2021-07-04,San Luis Obispo,079,281455,21617,21330,756,22086,256
2021-07-04,San Mateo,081,765935,42992,42691,490,43181,541
2021-07-04,Santa Barbara,083,443738,34723,34526,1128,35654,456
2021-07-04,Santa Clara,085,1922200,119935,118966,770,119736,2090
2021-07-04,Santa Cruz,087,273765,16390,16254,801,17055,208
2021-07-04,Shasta,089,179085,12657,12582,1645,14227,204
2021-07-04,Sierra,091,2930,64,60,12,72,0
2021-07-04,Siskiyou,093,43540,1980,1899,373,2272,29
2021-07-04,Solano,095,438530,33759,33486,577,34063,268
2021-07-04,Sonoma,097,501317,31287,31000,363,31363,316
2021-07-04,Stanislaus,099,539301,57306,57018,5991,63009,1018
2021-07-04,Sutter,101,95872,9683,9644,87,9731,114
2021-07-04,Tehama,103,63373,5165,5124,585,5709,63
2021-07-04,Trinity,105,12862,494,341,96,437,3
2021-07-04,Tulare,107,460477,50539,49789,9053,58842,853
2021-07-04,Tuolumne,109,53932,4112,4113,44,4157,64
2021-07-04,Ventura,111,848112,82131,81425,3055,84480,1033
2021-07-04,Yolo,113,214977,14277,14188,283,14471,213
2021-07-04,Yuba,115,75493,6266,6197,129,6326,51
2021-07-03,Alameda,001,1643700,90130,89683,1964,91647,1253
2021-07-03,Alpine,003,1148,88,89,0,89,0
2021-07-03,Amador,005,37829,3768,3758,32,3790,46
2021-07-03,Butte,007,227075,12834,12684,1904,14588,201
2021-07-03,Calaveras,009,45235,2222,2200,13,2213,55
2021-07-03,Colusa,011,21464,1974,1969,325,2294,15
2021-07-03,Contra Costa,013,1133247,71588,70941,1319,72260,818
2021-07-03,Del Norte,015,27424,1475,1439,13,1452,8
2021-07-03,El Dorado,017,186661,10576,10433,790,11223,113
2021-07-03,Fresno,019,978130,103664,102512,8693,111205,1727
2021-07-03,Glenn,021,27897,2457,2442,567,3009,20
2021-07-03,Humboldt,023,135768,4570,4530,53,4583,49
2021-07-03,Imperial,025,180216,28846,28661,2693,31354,739
2021-07-03,Inyo,027,18085,1416,1412,12,1424,35
2021-07-03,Kern,029,883053,98124,97421,11114,108535,1347
2021-07-03,Kings,031,150075,23325,23051,1095,24146,245
2021-07-03,Lake,033,64148,3666,3623,13,3636,62
2021-07-03,Lassen,035,31185,5302,5277,115,5392,20
2021-07-03,Los Angeles,037,10098052,1217512,1208705,41106,1249811,24506
2021-07-03,Madera,039,155013,16861,16696,943,17639,240
2021-07-03,Marin,041,260295,14280,14143,261,14404,233
2021-07-03,Mariposa,043,17540,442,441,11,452,5
2021-07-03,Mendocino,045,87422,4226,4122,87,4209,49
2021-07-03,Merced,047,269075,31310,31297,1042,32339,469
2021-07-03,Modoc,049,8938,415,410,147,557,4
2021-07-03,Mono,051,14174,1269,1275,18,1293,3
2021-07-03,Monterey,053,433212,43375,43212,1846,45058,492
2021-07-03,Napa,055,140530,10062,10045,37,10082,81
2021-07-03,Nevada,057,99092,5022,4966,193,5159,72
2021-07-03,Orange,059,3164182,257599,255823,11506,267329,5126
2021-07-03,Placer,061,380077,24034,23764,1565,25329,299
2021-07-03,Plumas,063,18699,727,707,14,721,4
2021-07-03,Riverside,065,2383286,296439,293260,14047,307307,4536
2021-07-03,Sacramento,067,1510023,109302,108257,1852,110109,1676
2021-07-03,San Benito,069,59416,6130,6108,113,6221,63
2021-07-03,San Bernardino,071,2135413,295558,294294,9018,303312,5003
2021-07-03,San Diego,073,3302833,284238,282692,15575,298267,3780
2021-07-03,San Francisco,075,870044,37442,37107,1306,38413,558
2021-07-03,San Joaquin,077,732212,74450,73841,3602,77443,1409
2021-07-03,San Luis Obispo,079,281455,21605,21330,756,22086,256
2021-07-03,San Mateo,081,765935,42967,42691,489,43180,541
2021-07-03,Santa Barbara,083,443738,34714,34526,1127,35653,456
2021-07-03,Santa Clara,085,1922200,119888,118966,770,119736,2090
2021-07-03,Santa Cruz,087,273765,16383,16254,801,17055,208
2021-07-03,Shasta,089,179085,12653,12582,1643,14225,204
2021-07-03,Sierra,091,2930,64,60,12,72,0
2021-07-03,Siskiyou,093,43540,1979,1899,372,2271,29
2021-07-03,Solano,095,438530,33715,33486,577,34063,268
2021-07-03,Sonoma,097,501317,31253,31000,363,31363,316
2021-07-03,Stanislaus,099,539301,57295,57018,5984,63002,1018
2021-07-03,Sutter,101,95872,9673,9644,87,9731,114
2021-07-03,Tehama,103,63373,5163,5124,585,5709,63
2021-07-03,Trinity,105,12862,494,341,96,437,3
2021-07-03,Tulare,107,460477,50533,49789,9047,58836,853
2021-07-03,Tuolumne,109,53932,4111,4113,44,4157,64
2021-07-03,Ventura,111,848112,82101,81425,3047,84472,1033
2021-07-03,Yolo,113,214977,14267,14188,280,14468,213
2021-07-03,Yuba,115,75493,6260,6197,129,6326,51
2021-07-02,Alameda,001,1643700,90046,89683,1962,91645,1253
2021-07-02,Alpine,003,1148,88,89,0,89,0
2021-07-02,Amador,005,37829,3766,3758,32,3790,46
2021-07-02,Butte,007,227075,12827,12684,1904,14588,201
2021-07-02,Calaveras,009,45235,2220,2200,13,2213,55
2021-07-02,Colusa,011,21464,1973,1969,324,2293,15
2021-07-02,Contra Costa,013,1133247,71518,70941,1315,72256,818
2021-07-02,Del Norte,015,27424,1475,1439,13,1452,8
2021-07-02,El Dorado,017,186661,10568,10433,790,11223,113
2021-07-02,Fresno,019,978130,103636,102512,8687,111199,1727
2021-07-02,Glenn,021,27897,2456,2442,566,3008,20
2021-07-02,Humboldt,023,135768,4567,4530,52,4582,49
2021-07-02,Imperial,025,180216,28840,28661,2692,31353,739
2021-07-02,Inyo,027,18085,1416,1412,12,1424,35
2021-07-02,Kern,029,883053,98106,97421,11106,108527,1347
2021-07-02,Kings,031,150075,23315,23051,1095,24146,245
2021-07-02,Lake,033,64148,3660,3623,13,3636,62
2021-07-02,Lassen,035,31185,5302,5277,115,5392,20
2021-07-02,Los Angeles,037,10098052,1217038,1208705,41068,1249773,24506
2021-07-02,Madera,039,155013,16852,16696,942,17638,240
2021-07-02,Marin,041,260295,14276,14143,261,14404,233
2021-07-02,Mariposa,043,17540,442,441,11,452,5
2021-07-02,Mendocino,045,87422,4222,4122,86,4208,49
2021-07-02,Merced,047,269075,31301,31297,1042,32339,469
2021-07-02,Modoc,049,8938,415,410,147,557,4
2021-07-02,Mono,051,14174,1268,1275,18,1293,3
2021-07-02,Monterey,053,433212,43367,43212,1845,45057,492
2021-07-02,Napa,055,140530,10057,10045,37,10082,81
2021-07-02,Nevada,057,99092,5013,4966,193,5159,72
2021-07-02,Orange,059,3164182,257487,255823,11499,267322,5126
2021-07-02,Placer,061,380077,24017,23764,1558,25322,299
2021-07-02,Plumas,063,18699,727,707,14,721,4
2021-07-02,Riverside,065,2383286,296341,293260,14042,307302,4536
2021-07-02,Sacramento,067,1510023,109224,108257,1851,110108,1676
2021-07-02,San Benito,069,59416,6127,6108,113,6221,63
2021-07-02,San Bernardino,071,2135413,295471,294294,9016,303310,5003
2021-07-02,San Diego,073,3302833,284093,282692,15549,298241,3780
2021-07-02,San Francisco,075,870044,37394,37107,1304,38411,558
2021-07-02,San Joaquin,077,732212,74418,73841,3596,77437,1409
2021-07-02,San Luis Obispo,079,281455,21599,21330,755,22085,256
2021-07-02,San Mateo,081,765935,42932,42691,489,43180,541
2021-07-02,Santa Barbara,083,443738,34704,34526,1127,35653,456
2021-07-02,Santa Clara,085,1922200,119810,118966,770,119736,2090
2021-07-02,Santa Cruz,087,273765,16379,16254,801,17055,208
2021-07-02,Shasta,089,179085,12649,12582,1643,14225,204
2021-07-02,Sierra,091,2930,63,60,12,72,0
2021-07-02,Siskiyou,093,43540,1976,1899,371,2270,29
2021-07-02,Solano,095,438530,33690,33486,577,34063,268
2021-07-02,Sonoma,097,501317,31230,31000,363,31363,316
2021-07-02,Stanislaus,099,539301,57278,57018,5983,63001,1018
2021-07-02,Sutter,101,95872,9669,9644,87,9731,114
2021-07-02,Tehama,103,63373,5161,5124,583,5707,63
2021-07-02,Trinity,105,12862,494,341,96,437,3
2021-07-02,Tulare,107,460477,50523,49789,9039,58828,853
2021-07-02,Tuolumne,109,53932,4108,4113,44,4157,64
2021-07-02,Ventura,111,848112,82058,81425,3039,84464,1033
2021-07-02,Yolo,113,214977,14251,14188,278,14466,213
2021-07-02,Yuba,115,75493,6252,6197,129,6326,51
2021-07-01,Alameda,001,1643700,89945,89683,1960,91643,1253
2021-07-01,Alpine,003,1148,88,89,0,89,0
2021-07-01,Amador,005,37829,3765,3758,32,3790,46
2021-07-01,Butte,007,227075,12815,12684,1902,14586,201
2021-07-01,Calaveras,009,45235,2218,2200,13,2213,55
2021-07-01,Colusa,011,21464,1973,1969,322,2291,15
2021-07-01,Contra Costa,013,1133247,71446,70941,1315,72256,818
2021-07-01,Del Norte,015,27424,1474,1439,13,1452,8
2021-07-01,El Dorado,017,186661,10556,10433,790,11223,113
2021-07-01,Fresno,019,978130,103597,102512,8682,111194,1727
2021-07-01,Glenn,021,27897,2456,2442,566,3008,20
2021-07-01,Humboldt,023,135768,4565,4530,52,4582,49
2021-07-01,Imperial,025,180216,28823,28661,2692,31353,739
2021-07-01,Inyo,027,18085,1416,1412,12,1424,35
2021-07-01,Kern,029,883053,98080,97421,11096,108517,1347
2021-07-01,Kings,031,150075,23301,23051,1095,24146,245
2021-07-01,Lake,033,64148,3657,3623,13,3636,62
2021-07-01,Lassen,035,31185,5300,5277,115,5392,20
2021-07-01,Los Angeles,037,10098052,1216434,1208705,41013,1249718,24506
2021-07-01,Madera,039,155013,16843,16696,941,17637,240
2021-07-01,Marin,041,260295,14272,14143,261,14404,233
2021-07-01,Mariposa,043,17540,442,441,11,452,5
2021-07-01,Mendocino,045,87422,4218,4122,85,4207,49
2021-07-01,Merced,047,269075,31295,31297,1042,32339,469
2021-07-01,Modoc,049,8938,415,410,147,557,4
2021-07-01,Mono,051,14174,1267,1275,18,1293,3
2021-07-01,Monterey,053,433212,43359,43212,1842,45054,492
2021-07-01,Napa,055,140530,10050,10045,37,10082,81
2021-07-01,Nevada,057,99092,5008,4966,193,5159,72
2021-07-01,Orange,059,3164182,257367,255823,11480,267303,5126
2021-07-01,Placer,061,380077,23999,23764,1555,25319,299
2021-07-01,Plumas,063,18699,724,707,12,719,4
2021-07-01,Riverside,065,2383286,296232,293260,14034,307294,4536
2021-07-01,Sacramento,067,1510023,109099,108257,1844,110101,1676
2021-07-01,San Benito,069,59416,6123,6108,113,6221,63
2021-07-01,San Bernardino,071,2135413,295350,294294,9011,303305,5003
2021-07-01,San Diego,073,3302833,283915,282692,15512,298204,3780
2021-07-01,San Francisco,075,870044,37357,37107,1302,38409,558
2021-07-01,San Joaquin,077,732212,74367,73841,3592,77433,1409
2021-07-01,San Luis Obispo,079,281455,21584,21330,754,22084,256
2021-07-01,San Mateo,081,765935,42904,42691,488,43179,541
2021-07-01,Santa Barbara,083,443738,34691,34526,1127,35653,456
2021-07-01,Santa Clara,085,1922200,119761,118966,770,119736,2090
2021-07-01,Santa Cruz,087,273765,16374,16254,801,17055,208
2021-07-01,Shasta,089,179085,12641,12582,1642,14224,204
2021-07-01,Sierra,091,2930,63,60,12,72,0
2021-07-01,Siskiyou,093,43540,1976,1899,371,2270,29
2021-07-01,Solano,095,438530,33649,33486,576,34062,268
2021-07-01,Sonoma,097,501317,31186,31000,363,31363,316
2021-07-01,Stanislaus,099,539301,57261,57018,5979,62997,1018
2021-07-01,Sutter,101,95872,9660,9644,87,9731,114
2021-07-01,Tehama,103,63373,5161,5124,582,5706,63
2021-07-01,Trinity,105,12862,494,341,96,437,3
2021-07-01,Tulare,107,460477,50514,49789,9032,58821,853
2021-07-01,Tuolumne,109,53932,4101,4113,44,4157,64
2021-07-01,Ventura,111,848112,82027,81425,3029,84454,1033
2021-07-01,Yolo,113,214977,14235,14188,276,14464,213
2021-07-01,Yuba,115,75493,6245,6197,129,6326,51
2021-06-30,Alameda,001,1643700,89864,89597,1956,91553,1256
2021-06-30,Alpine,003,1148,88,89,0,89,0
2021-06-30,Amador,005,37829,3763,3756,32,3788,46
2021-06-30,Butte,007,227075,12808,12676,1893,14569,201
2021-06-30,Calaveras,009,45235,2212,2198,13,2211,55
2021-06-30,Colusa,011,21464,1971,1967,319,2286,15
2021-06-30,Contra Costa,013,1133247,71381,70869,1312,72181,818
2021-06-30,Del Norte,015,27424,1469,1435,13,1448,8
2021-06-30,El Dorado,017,186661,10536,10420,790,11210,113
2021-06-30,Fresno,019,978130,103560,102490,8679,111169,1727
2021-06-30,Glenn,021,27897,2454,2440,566,3006,20
2021-06-30,Humboldt,023,135768,4549,4522,50,4572,49
2021-06-30,Imperial,025,180216,28815,28651,2692,31343,739
2021-06-30,Inyo,027,18085,1416,1409,12,1421,35
2021-06-30,Kern,029,883053,98039,97267,11084,108351,1348
2021-06-30,Kings,031,150075,23296,23038,1094,24132,245
2021-06-30,Lake,033,64148,3644,3601,13,3614,56
2021-06-30,Lassen,035,31185,5295,5269,115,5384,20
2021-06-30,Los Angeles,037,10098052,1215760,1208246,40968,1249214,24499
2021-06-30,Madera,039,155013,16835,16688,939,17627,240
2021-06-30,Marin,041,260295,14263,14133,260,14393,232
2021-06-30,Mariposa,043,17540,441,441,11,452,5
2021-06-30,Mendocino,045,87422,4208,4115,85,4200,49
2021-06-30,Merced,047,269075,31285,31286,1042,32328,469
2021-06-30,Modoc,049,8938,415,410,147,557,4
2021-06-30,Mono,051,14174,1267,1275,18,1293,3
2021-06-30,Monterey,053,433212,43354,43209,1840,45049,492
2021-06-30,Napa,055,140530,10042,10039,37,10076,81
2021-06-30,Nevada,057,99092,4997,4958,193,5151,72
2021-06-30,Orange,059,3164182,257242,255764,11470,267234,5125
2021-06-30,Placer,061,380077,23975,23721,1552,25273,299
2021-06-30,Plumas,063,18699,724,705,12,717,4
2021-06-30,Riverside,065,2383286,296118,293280,14026,307306,4535
2021-06-30,Sacramento,067,1510023,108960,108137,1840,109977,1676
2021-06-30,San Benito,069,59416,6119,6105,113,6218,63
2021-06-30,San Bernardino,071,2135413,295190,294211,9006,303217,4975
2021-06-30,San Diego,073,3302833,283779,282583,15484,298067,3780
2021-06-30,San Francisco,075,870044,37308,37065,1297,38362,558
2021-06-30,San Joaquin,077,732212,74305,73777,3591,77368,1409
2021-06-30,San Luis Obispo,079,281455,21571,21326,753,22079,256
2021-06-30,San Mateo,081,765935,42867,42599,487,43086,537
2021-06-30,Santa Barbara,083,443738,34675,34521,1127,35648,456
2021-06-30,Santa Clara,085,1922200,119714,118930,767,119697,2090
2021-06-30,Santa Cruz,087,273765,16368,16250,801,17051,208
2021-06-30,Shasta,089,179085,12635,12564,1642,14206,204
2021-06-30,Sierra,091,2930,63,60,12,72,0
2021-06-30,Siskiyou,093,43540,1974,1900,368,2268,29
2021-06-30,Solano,095,438530,33610,33453,574,34027,268
2021-06-30,Sonoma,097,501317,31156,30947,363,31310,316
2021-06-30,Stanislaus,099,539301,57244,56997,5978,62975,1018
2021-06-30,Sutter,101,95872,9650,9638,87,9725,114
2021-06-30,Tehama,103,63373,5159,5124,582,5706,63
2021-06-30,Trinity,105,12862,494,341,96,437,3
2021-06-30,Tulare,107,460477,50503,49764,9021,58785,853
2021-06-30,Tuolumne,109,53932,4098,4112,44,4156,64
2021-06-30,Ventura,111,848112,81984,81392,3024,84416,1032
2021-06-30,Yolo,113,214977,14229,14178,273,14451,213
2021-06-30,Yuba,115,75493,6238,6191,129,6320,51
2021-06-29,Alameda,001,1643700,89758,89519,1954,91473,1257
2021-06-29,Alpine,003,1148,88,89,0,89,0
2021-06-29,Amador,005,37829,3759,3754,32,3786,46
2021-06-29,Butte,007,227075,12800,12669,1893,14562,201
2021-06-29,Calaveras,009,45235,2206,2198,13,2211,55
2021-06-29,Colusa,011,21464,1969,1967,319,2286,15
2021-06-29,Contra Costa,013,1133247,71307,70775,1311,72086,817
2021-06-29,Del Norte,015,27424,1468,1435,13,1448,8
2021-06-29,El Dorado,017,186661,10523,10403,786,11189,113
2021-06-29,Fresno,019,978130,103527,102464,8676,111140,1725
2021-06-29,Glenn,021,27897,2453,2439,566,3005,20
2021-06-29,Humboldt,023,135768,4545,4514,49,4563,49
2021-06-29,Imperial,025,180216,28806,28645,2691,31336,737
2021-06-29,Inyo,027,18085,1416,1408,12,1420,35
2021-06-29,Kern,029,883053,98018,97173,11078,108251,1347
2021-06-29,Kings,031,150075,23287,23035,1093,24128,245
2021-06-29,Lake,033,64148,3638,3594,13,3607,56
2021-06-29,Lassen,035,31185,5288,5268,115,5383,20
2021-06-29,Los Angeles,037,10098052,1215145,1207895,40940,1248835,24498
2021-06-29,Madera,039,155013,16831,16680,938,17618,240
2021-06-29,Marin,041,260295,14251,14127,260,14387,232
2021-06-29,Mariposa,043,17540,441,441,11,452,5
2021-06-29,Mendocino,045,87422,4204,4107,84,4191,49
2021-06-29,Merced,047,269075,31273,31277,1042,32319,469
2021-06-29,Modoc,049,8938,414,408,147,555,3
2021-06-29,Mono,051,14174,1267,1275,18,1293,3
2021-06-29,Monterey,053,433212,43344,43196,1838,45034,471
2021-06-29,Napa,055,140530,10036,10033,37,10070,81
2021-06-29,Nevada,057,99092,4990,4952,193,5145,72
2021-06-29,Orange,059,3164182,257142,255686,11455,267141,5124
2021-06-29,Placer,061,380077,23951,23693,1550,25243,299
2021-06-29,Plumas,063,18699,724,704,12,716,4
2021-06-29,Riverside,065,2383286,296019,292962,14019,306981,4524
2021-06-29,Sacramento,067,1510023,108807,108067,1836,109903,1677
2021-06-29,San Benito,069,59416,6108,6099,113,6212,63
2021-06-29,San Bernardino,071,2135413,295078,294118,9005,303123,4940
2021-06-29,San Diego,073,3302833,283623,282499,15457,297956,3780
2021-06-29,San Francisco,075,870044,37269,37041,1294,38335,558
2021-06-29,San Joaquin,077,732212,74257,73724,3588,77312,1409
2021-06-29,San Luis Obispo,079,281455,21561,21324,752,22076,256
2021-06-29,San Mateo,081,765935,42833,42540,487,43027,540
2021-06-29,Santa Barbara,083,443738,34665,34507,1126,35633,455
2021-06-29,Santa Clara,085,1922200,119660,118893,766,119659,2090
2021-06-29,Santa Cruz,087,273765,16362,16249,801,17050,208
2021-06-29,Shasta,089,179085,12623,12564,1641,14205,204
2021-06-29,Sierra,091,2930,63,59,12,71,0
2021-06-29,Siskiyou,093,43540,1971,1897,364,2261,29
2021-06-29,Solano,095,438530,33577,33440,572,34012,268
2021-06-29,Sonoma,097,501317,31114,30950,361,31311,316
2021-06-29,Stanislaus,099,539301,57223,56980,5971,62951,1018
2021-06-29,Sutter,101,95872,9639,9634,87,9721,114
2021-06-29,Tehama,103,63373,5159,5124,582,5706,63
2021-06-29,Trinity,105,12862,494,341,96,437,3
2021-06-29,Tulare,107,460477,50490,49751,9016,58767,852
2021-06-29,Tuolumne,109,53932,4096,4111,44,4155,64
2021-06-29,Ventura,111,848112,81946,81363,3018,84381,1032
2021-06-29,Yolo,113,214977,14217,14171,272,14443,213
2021-06-29,Yuba,115,75493,6228,6188,129,6317,51
2021-06-28,Alameda,001,1643700,89663,89638,1951,91589,1259
2021-06-28,Alpine,003,1148,88,89,0,89,0
2021-06-28,Amador,005,37829,3758,3753,32,3785,46
2021-06-28,Butte,007,227075,12791,12697,1891,14588,198
2021-06-28,Calaveras,009,45235,2203,2203,13,2216,55
2021-06-28,Colusa,011,21464,1967,1974,319,2293,15
2021-06-28,Contra Costa,013,1133247,71232,70807,1309,72116,816
2021-06-28,Del Norte,015,27424,1468,1436,13,1449,8
2021-06-28,El Dorado,017,186661,10513,10422,782,11204,115
2021-06-28,Fresno,019,978130,103496,103121,8674,111795,1727
2021-06-28,Glenn,021,27897,2453,2439,566,3005,20
2021-06-28,Humboldt,023,135768,4538,4520,48,4568,49
2021-06-28,Imperial,025,180216,28798,28981,2690,31671,741
2021-06-28,Inyo,027,18085,1413,1407,12,1419,35
2021-06-28,Kern,029,883053,97999,97252,11073,108325,1348
2021-06-28,Kings,031,150075,23281,23134,1093,24227,246
2021-06-28,Lake,033,64148,3631,3591,13,3604,56
2021-06-28,Lassen,035,31185,5286,5268,115,5383,20
2021-06-28,Los Angeles,037,10098052,1214625,1207714,40906,1248620,24496
2021-06-28,Madera,039,155013,16820,16683,937,17620,240
2021-06-28,Marin,041,260295,14236,14186,260,14446,232
2021-06-28,Mariposa,043,17540,441,440,11,451,5
2021-06-28,Mendocino,045,87422,4195,4102,83,4185,49
2021-06-28,Merced,047,269075,31261,31277,1042,32319,469
2021-06-28,Modoc,049,8938,414,411,146,557,3
2021-06-28,Mono,051,14174,1267,1276,18,1294,3
2021-06-28,Monterey,053,433212,43340,43202,1837,45039,462
2021-06-28,Napa,055,140530,10027,10050,36,10086,81
2021-06-28,Nevada,057,99092,4986,4951,193,5144,72
2021-06-28,Orange,059,3164182,257052,255755,11441,267196,5123
2021-06-28,Placer,061,380077,23935,23756,1546,25302,299
2021-06-28,Plumas,063,18699,722,704,12,716,4
2021-06-28,Riverside,065,2383286,295893,292647,14007,306654,4507
2021-06-28,Sacramento,067,1510023,108675,108342,1831,110173,1675
2021-06-28,San Benito,069,59416,6106,6101,113,6214,63
2021-06-28,San Bernardino,071,2135413,294978,294151,9000,303151,4928
2021-06-28,San Diego,073,3302833,283459,282417,15428,297845,3780
2021-06-28,San Francisco,075,870044,37234,37372,1292,38664,559
2021-06-28,San Joaquin,077,732212,74210,73973,3585,77558,1411
2021-06-28,San Luis Obispo,079,281455,21557,21340,751,22091,256
2021-06-28,San Mateo,081,765935,42799,42927,486,43413,540
2021-06-28,Santa Barbara,083,443738,34658,34534,1124,35658,455
2021-06-28,Santa Clara,085,1922200,119596,120377,765,121142,2103
2021-06-28,Santa Cruz,087,273765,16357,16245,801,17046,208
2021-06-28,Shasta,089,179085,12619,12642,1639,14281,203
2021-06-28,Sierra,091,2930,63,58,12,70,0
2021-06-28,Siskiyou,093,43540,1970,1896,364,2260,29
2021-06-28,Solano,095,438530,33541,33524,570,34094,267
2021-06-28,Sonoma,097,501317,31077,31137,360,31497,315
2021-06-28,Stanislaus,099,539301,57205,57047,5967,63014,1018
2021-06-28,Sutter,101,95872,9635,9682,87,9769,114
2021-06-28,Tehama,103,63373,5157,5122,582,5704,63
2021-06-28,Trinity,105,12862,494,341,96,437,3
2021-06-28,Tulare,107,460477,50480,49751,9012,58763,850
2021-06-28,Tuolumne,109,53932,4088,4121,44,4165,64
2021-06-28,Ventura,111,848112,81889,81393,3013,84406,1032
2021-06-28,Yolo,113,214977,14208,14199,269,14468,213
2021-06-28,Yuba,115,75493,6223,6207,129,6336,51
2021-06-27,Alameda,001,1643700,89576,89611,1947,91558,1259
2021-06-27,Alpine,003,1148,88,89,0,89,0
2021-06-27,Amador,005,37829,3757,3752,32,3784,46
2021-06-27,Butte,007,227075,12782,12696,1890,14586,198
2021-06-27,Calaveras,009,45235,2202,2203,13,2216,55
2021-06-27,Colusa,011,21464,1967,1974,319,2293,15
2021-06-27,Contra Costa,013,1133247,71146,70762,1305,72067,816
2021-06-27,Del Norte,015,27424,1465,1436,13,1449,8
2021-06-27,El Dorado,017,186661,10501,10418,779,11197,115
2021-06-27,Fresno,019,978130,103467,103110,8671,111781,1727
2021-06-27,Glenn,021,27897,2452,2439,565,3004,20
2021-06-27,Humboldt,023,135768,4526,4513,45,4558,49
2021-06-27,Imperial,025,180216,28784,28987,2690,31677,741
2021-06-27,Inyo,027,18085,1413,1407,12,1419,35
2021-06-27,Kern,029,883053,97973,97249,11066,108315,1348
2021-06-27,Kings,031,150075,23271,23132,1093,24225,246
2021-06-27,Lake,033,64148,3624,3581,13,3594,56
2021-06-27,Lassen,035,31185,5285,5265,115,5380,20
2021-06-27,Los Angeles,037,10098052,1214073,1207461,40866,1248327,24493
2021-06-27,Madera,039,155013,16812,16680,937,17617,240
2021-06-27,Marin,041,260295,14227,14182,260,14442,232
2021-06-27,Mariposa,043,17540,441,440,11,451,5
2021-06-27,Mendocino,045,87422,4188,4100,83,4183,49
2021-06-27,Merced,047,269075,31249,31266,1042,32308,469
2021-06-27,Modoc,049,8938,414,411,146,557,3
2021-06-27,Mono,051,14174,1267,1279,18,1297,3
2021-06-27,Monterey,053,433212,43327,43199,1837,45036,462
2021-06-27,Napa,055,140530,10021,10046,36,10082,81
2021-06-27,Nevada,057,99092,4980,4946,193,5139,72
2021-06-27,Orange,059,3164182,256938,255710,11430,267140,5123
2021-06-27,Placer,061,380077,23902,23731,1543,25274,299
2021-06-27,Plumas,063,18699,722,704,12,716,4
2021-06-27,Riverside,065,2383286,295791,292641,14001,306642,4507
2021-06-27,Sacramento,067,1510023,108540,108279,1827,110106,1675
2021-06-27,San Benito,069,59416,6100,6101,113,6214,63
2021-06-27,San Bernardino,071,2135413,294865,294115,8998,303113,4927
2021-06-27,San Diego,073,3302833,283319,282359,15402,297761,3780
2021-06-27,San Francisco,075,870044,37197,37360,1291,38651,559
2021-06-27,San Joaquin,077,732212,74174,73960,3583,77543,1411
2021-06-27,San Luis Obispo,079,281455,21550,21340,750,22090,256
2021-06-27,San Mateo,081,765935,42770,42925,483,43408,539
2021-06-27,Santa Barbara,083,443738,34644,34533,1122,35655,455
2021-06-27,Santa Clara,085,1922200,119545,120352,764,121116,2103
2021-06-27,Santa Cruz,087,273765,16348,16241,801,17042,208
2021-06-27,Shasta,089,179085,12613,12640,1638,14278,203
2021-06-27,Sierra,091,2930,63,58,12,70,0
2021-06-27,Siskiyou,093,43540,1968,1896,363,2259,29
2021-06-27,Solano,095,438530,33513,33516,570,34086,267
2021-06-27,Sonoma,097,501317,31039,31129,360,31489,315
2021-06-27,Stanislaus,099,539301,57165,57021,5964,62985,1018
2021-06-27,Sutter,101,95872,9629,9678,87,9765,114
2021-06-27,Tehama,103,63373,5153,5122,582,5704,63
2021-06-27,Trinity,105,12862,494,341,95,436,3
2021-06-27,Tulare,107,460477,50467,49749,9005,58754,850
2021-06-27,Tuolumne,109,53932,4086,4121,44,4165,64
2021-06-27,Ventura,111,848112,81855,81361,3004,84365,1032
2021-06-27,Yolo,113,214977,14193,14194,265,14459,213
2021-06-27,Yuba,115,75493,6217,6205,129,6334,51
2021-06-26,Alameda,001,1643700,89519,89560,1945,91505,1259
2021-06-26,Alpine,003,1148,88,89,0,89,0
2021-06-26,Amador,005,37829,3757,3748,32,3780,46
2021-06-26,Butte,007,227075,12778,12693,1887,14580,198
2021-06-26,Calaveras,009,45235,2200,2202,13,2215,55
2021-06-26,Colusa,011,21464,1967,1973,319,2292,15
2021-06-26,Contra Costa,013,1133247,71103,70712,1304,72016,816
2021-06-26,Del Norte,015,27424,1464,1432,13,1445,8
2021-06-26,El Dorado,017,186661,10493,10414,777,11191,115
2021-06-26,Fresno,019,978130,103447,103091,8669,111760,1727
2021-06-26,Glenn,021,27897,2450,2441,565,3006,20
2021-06-26,Humboldt,023,135768,4523,4509,45,4554,49
2021-06-26,Imperial,025,180216,28780,28970,2690,31660,741
2021-06-26,Inyo,027,18085,1413,1407,12,1419,35
2021-06-26,Kern,029,883053,97947,97239,11057,108296,1348
2021-06-26,Kings,031,150075,23267,23128,1092,24220,246
2021-06-26,Lake,033,64148,3613,3576,13,3589,56
2021-06-26,Lassen,035,31185,5282,5263,115,5378,20
2021-06-26,Los Angeles,037,10098052,1213769,1207198,40835,1248033,24490
2021-06-26,Madera,039,155013,16805,16679,936,17615,240
2021-06-26,Marin,041,260295,14218,14180,260,14440,232
2021-06-26,Mariposa,043,17540,441,440,11,451,5
2021-06-26,Mendocino,045,87422,4186,4096,83,4179,49
2021-06-26,Merced,047,269075,31243,31259,1041,32300,469
2021-06-26,Modoc,049,8938,414,411,146,557,3
2021-06-26,Mono,051,14174,1267,1279,18,1297,3
2021-06-26,Monterey,053,433212,43324,43192,1837,45029,462
2021-06-26,Napa,055,140530,10014,10043,36,10079,81
2021-06-26,Nevada,057,99092,4975,4939,193,5132,72
2021-06-26,Orange,059,3164182,256858,255640,11423,267063,5123
2021-06-26,Placer,061,380077,23888,23702,1541,25243,299
2021-06-26,Plumas,063,18699,722,704,12,716,4
2021-06-26,Riverside,065,2383286,295733,292480,13995,306475,4505
2021-06-26,Sacramento,067,1510023,108469,108179,1824,110003,1675
2021-06-26,San Benito,069,59416,6096,6100,113,6213,63
2021-06-26,San Bernardino,071,2135413,294771,294034,8994,303028,4928
2021-06-26,San Diego,073,3302833,283234,282263,15384,297647,3780
2021-06-26,San Francisco,075,870044,37165,37348,1290,38638,559
2021-06-26,San Joaquin,077,732212,74145,73928,3582,77510,1411
2021-06-26,San Luis Obispo,079,281455,21549,21330,749,22079,256
2021-06-26,San Mateo,081,765935,42750,42898,483,43381,539
2021-06-26,Santa Barbara,083,443738,34635,34525,1122,35647,455
2021-06-26,Santa Clara,085,1922200,119512,120321,764,121085,2103
2021-06-26,Santa Cruz,087,273765,16345,16239,801,17040,208
2021-06-26,Shasta,089,179085,12609,12635,1634,14269,203
2021-06-26,Sierra,091,2930,63,58,12,70,0
2021-06-26,Siskiyou,093,43540,1967,1896,362,2258,29
2021-06-26,Solano,095,438530,33495,33489,568,34057,267
2021-06-26,Sonoma,097,501317,31013,31088,360,31448,315
2021-06-26,Stanislaus,099,539301,57149,57006,5961,62967,1018
2021-06-26,Sutter,101,95872,9628,9669,87,9756,114
2021-06-26,Tehama,103,63373,5153,5119,582,5701,63
2021-06-26,Trinity,105,12862,494,341,95,436,3
2021-06-26,Tulare,107,460477,50461,49745,9005,58750,850
2021-06-26,Tuolumne,109,53932,4086,4121,44,4165,64
2021-06-26,Ventura,111,848112,81831,81352,3003,84355,1032
2021-06-26,Yolo,113,214977,14185,14184,265,14449,213
2021-06-26,Yuba,115,75493,6214,6200,129,6329,51
2021-06-25,Alameda,001,1643700,89451,89453,1943,91396,1271
2021-06-25,Alpine,003,1148,88,89,0,89,0
2021-06-25,Amador,005,37829,3756,3746,32,3778,46
2021-06-25,Butte,007,227075,12773,12682,1884,14566,198
2021-06-25,Calaveras,009,45235,2199,2201,13,2214,55
2021-06-25,Colusa,011,21464,1967,1972,319,2291,15
2021-06-25,Contra Costa,013,1133247,71067,70659,1304,71963,815
2021-06-25,Del Norte,015,27424,1464,1426,13,1439,8
2021-06-25,El Dorado,017,186661,10485,10406,774,11180,115
2021-06-25,Fresno,019,978130,103429,103073,8665,111738,1727
2021-06-25,Glenn,021,27897,2450,2441,565,3006,20
2021-06-25,Humboldt,023,135768,4517,4503,43,4546,49
2021-06-25,Imperial,025,180216,28777,28968,2690,31658,740
2021-06-25,Inyo,027,18085,1412,1406,12,1418,35
2021-06-25,Kern,029,883053,97928,97182,11053,108235,1347
2021-06-25,Kings,031,150075,23261,23118,1092,24210,246
2021-06-25,Lake,033,64148,3607,3571,13,3584,56
2021-06-25,Lassen,035,31185,5281,5259,115,5374,20
2021-06-25,Los Angeles,037,10098052,1213486,1206909,40818,1247727,24483
2021-06-25,Madera,039,155013,16802,16670,936,17606,240
2021-06-25,Marin,041,260295,14215,14179,260,14439,232
2021-06-25,Mariposa,043,17540,441,440,11,451,5
2021-06-25,Mendocino,045,87422,4183,4089,83,4172,49
2021-06-25,Merced,047,269075,31235,31256,1041,32297,467
2021-06-25,Modoc,049,8938,414,411,146,557,3
2021-06-25,Mono,051,14174,1267,1279,18,1297,3
2021-06-25,Monterey,053,433212,43319,43184,1836,45020,462
2021-06-25,Napa,055,140530,10009,10037,36,10073,81
2021-06-25,Nevada,057,99092,4972,4932,193,5125,72
2021-06-25,Orange,059,3164182,256787,255574,11421,266995,5119
2021-06-25,Placer,061,380077,23869,23672,1540,25212,299
2021-06-25,Plumas,063,18699,722,702,11,713,4
2021-06-25,Riverside,065,2383286,295665,291663,13988,305651,4490
2021-06-25,Sacramento,067,1510023,108397,108034,1821,109855,1673
2021-06-25,San Benito,069,59416,6092,6098,113,6211,63
2021-06-25,San Bernardino,071,2135413,294716,293941,8992,302933,4911
2021-06-25,San Diego,073,3302833,283174,282157,15371,297528,3779
2021-06-25,San Francisco,075,870044,37142,37338,1289,38627,559
2021-06-25,San Joaquin,077,732212,74112,73860,3580,77440,1410
2021-06-25,San Luis Obispo,079,281455,21546,21325,748,22073,256
2021-06-25,San Mateo,081,765935,42732,42849,483,43332,537
2021-06-25,Santa Barbara,083,443738,34626,34518,1121,35639,454
2021-06-25,Santa Clara,085,1922200,119492,120272,764,121036,2103
2021-06-25,Santa Cruz,087,273765,16342,16230,799,17029,208
2021-06-25,Shasta,089,179085,12599,12633,1633,14266,202
2021-06-25,Sierra,091,2930,63,58,12,70,0
2021-06-25,Siskiyou,093,43540,1966,1894,362,2256,29
2021-06-25,Solano,095,438530,33475,33449,568,34017,267
2021-06-25,Sonoma,097,501317,30990,31043,360,31403,314
2021-06-25,Stanislaus,099,539301,57133,56973,5954,62927,1018
2021-06-25,Sutter,101,95872,9621,9664,87,9751,114
2021-06-25,Tehama,103,63373,5152,5119,582,5701,63
2021-06-25,Trinity,105,12862,494,338,95,433,3
2021-06-25,Tulare,107,460477,50454,49731,9002,58733,850
2021-06-25,Tuolumne,109,53932,4085,4121,44,4165,64
2021-06-25,Ventura,111,848112,81802,81342,2997,84339,1032
2021-06-25,Yolo,113,214977,14179,14172,265,14437,213
2021-06-25,Yuba,115,75493,6210,6195,129,6324,51
2021-06-24,Alameda,001,1643700,89379,89358,1940,91298,1268
2021-06-24,Alpine,003,1148,88,89,0,89,0
2021-06-24,Amador,005,37829,3752,3745,32,3777,46
2021-06-24,Butte,007,227075,12767,12673,1882,14555,198
2021-06-24,Calaveras,009,45235,2196,2202,13,2215,55
2021-06-24,Colusa,011,21464,1966,1972,319,2291,15
2021-06-24,Contra Costa,013,1133247,71008,70590,1304,71894,813
2021-06-24,Del Norte,015,27424,1463,1421,13,1434,8
2021-06-24,El Dorado,017,186661,10478,10402,774,11176,115
2021-06-24,Fresno,019,978130,103409,103061,8663,111724,1727
2021-06-24,Glenn,021,27897,2449,2439,565,3004,20
2021-06-24,Humboldt,023,135768,4512,4493,43,4536,49
2021-06-24,Imperial,025,180216,28774,28981,2690,31671,740
2021-06-24,Inyo,027,18085,1411,1406,12,1418,35
2021-06-24,Kern,029,883053,97909,97129,11040,108169,1346
2021-06-24,Kings,031,150075,23257,23114,1091,24205,246
2021-06-24,Lake,033,64148,3601,3571,13,3584,56
2021-06-24,Lassen,035,31185,5280,5258,115,5373,20
2021-06-24,Los Angeles,037,10098052,1213161,1206590,40795,1247385,24480
2021-06-24,Madera,039,155013,16791,16662,935,17597,240
2021-06-24,Marin,041,260295,14211,14180,260,14440,232
2021-06-24,Mariposa,043,17540,441,440,11,451,5
2021-06-24,Mendocino,045,87422,4175,4085,83,4168,49
2021-06-24,Merced,047,269075,31225,31248,1040,32288,466
2021-06-24,Modoc,049,8938,414,411,146,557,3
2021-06-24,Mono,051,14174,1267,1276,18,1294,3
2021-06-24,Monterey,053,433212,43312,43180,1836,45016,451
2021-06-24,Napa,055,140530,10007,10036,36,10072,80
2021-06-24,Nevada,057,99092,4970,4927,193,5120,72
2021-06-24,Orange,059,3164182,256723,255520,11413,266933,5117
2021-06-24,Placer,061,380077,23844,23659,1538,25197,299
2021-06-24,Plumas,063,18699,721,702,11,713,4
2021-06-24,Riverside,065,2383286,295584,291067,13977,305044,4473
2021-06-24,Sacramento,067,1510023,108309,107965,1819,109784,1672
2021-06-24,San Benito,069,59416,6089,6098,113,6211,63
2021-06-24,San Bernardino,071,2135413,294645,293895,8986,302881,4898
2021-06-24,San Diego,073,3302833,283070,282053,15358,297411,3778
2021-06-24,San Francisco,075,870044,37120,37320,1287,38607,559
2021-06-24,San Joaquin,077,732212,74064,73814,3580,77394,1408
2021-06-24,San Luis Obispo,079,281455,21540,21326,748,22074,256
2021-06-24,San Mateo,081,765935,42706,42814,482,43296,542
2021-06-24,Santa Barbara,083,443738,34620,34512,1120,35632,454
2021-06-24,Santa Clara,085,1922200,119461,120274,763,121037,2103
2021-06-24,Santa Cruz,087,273765,16341,16227,799,17026,208
2021-06-24,Shasta,089,179085,12594,12629,1629,14258,202
2021-06-24,Sierra,091,2930,63,58,12,70,0
2021-06-24,Siskiyou,093,43540,1966,1892,362,2254,28
2021-06-24,Solano,095,438530,33452,33432,566,33998,267
2021-06-24,Sonoma,097,501317,30961,31020,360,31380,314
2021-06-24,Stanislaus,099,539301,57107,56946,5954,62900,1018
2021-06-24,Sutter,101,95872,9614,9660,87,9747,113
2021-06-24,Tehama,103,63373,5149,5115,582,5697,63
2021-06-24,Trinity,105,12862,493,338,95,433,3
2021-06-24,Tulare,107,460477,50443,49730,9000,58730,850
2021-06-24,Tuolumne,109,53932,4083,4120,44,4164,64
2021-06-24,Ventura,111,848112,81774,81332,2996,84328,1032
2021-06-24,Yolo,113,214977,14170,14169,262,14431,213
2021-06-24,Yuba,115,75493,6205,6195,129,6324,51
2021-06-23,Alameda,001,1643700,89307,89338,1939,91277,1266
2021-06-23,Alpine,003,1148,88,88,0,88,0
2021-06-23,Amador,005,37829,3750,3743,32,3775,46
2021-06-23,Butte,007,227075,12760,12666,1882,14548,198
2021-06-23,Calaveras,009,45235,2195,2199,13,2212,55
2021-06-23,Colusa,011,21464,1965,1972,319,2291,15
2021-06-23,Contra Costa,013,1133247,70943,70526,1303,71829,813
2021-06-23,Del Norte,015,27424,1459,1418,13,1431,8
2021-06-23,El Dorado,017,186661,10468,10395,771,11166,115
2021-06-23,Fresno,019,978130,103380,103020,8661,111681,1724
2021-06-23,Glenn,021,27897,2449,2437,564,3001,20
2021-06-23,Humboldt,023,135768,4503,4490,43,4533,48
2021-06-23,Imperial,025,180216,28767,28908,2690,31598,740
2021-06-23,Inyo,027,18085,1411,1406,12,1418,35
2021-06-23,Kern,029,883053,97881,97078,11027,108105,1345
2021-06-23,Kings,031,150075,23250,23105,1089,24194,245
2021-06-23,Lake,033,64148,3592,3566,13,3579,53
2021-06-23,Lassen,035,31185,5277,5257,115,5372,20
2021-06-23,Los Angeles,037,10098052,1212824,1206358,40785,1247143,24472
2021-06-23,Madera,039,155013,16784,16660,935,17595,240
2021-06-23,Marin,041,260295,14205,14177,260,14437,230
2021-06-23,Mariposa,043,17540,441,439,11,450,5
2021-06-23,Mendocino,045,87422,4171,4078,83,4161,49
2021-06-23,Merced,047,269075,31216,31260,1040,32300,465
2021-06-23,Modoc,049,8938,412,407,146,553,3
2021-06-23,Mono,051,14174,1267,1279,18,1297,3
2021-06-23,Monterey,053,433212,43303,43166,1836,45002,439
2021-06-23,Napa,055,140530,9998,10032,36,10068,80
2021-06-23,Nevada,057,99092,4967,4924,193,5117,72
2021-06-23,Orange,059,3164182,256657,255479,11405,266884,5116
2021-06-23,Placer,061,380077,23815,23630,1533,25163,299
2021-06-23,Plumas,063,18699,720,701,11,712,4
2021-06-23,Riverside,065,2383286,295501,290343,13975,304318,4462
2021-06-23,Sacramento,067,1510023,108216,107868,1814,109682,1671
2021-06-23,San Benito,069,59416,6085,6097,113,6210,63
2021-06-23,San Bernardino,071,2135413,294566,293816,8981,302797,4886
2021-06-23,San Diego,073,3302833,282970,281937,15337,297274,3777
2021-06-23,San Francisco,075,870044,37095,37304,1285,38589,559
2021-06-23,San Joaquin,077,732212,74025,73764,3578,77342,1405
2021-06-23,San Luis Obispo,079,281455,21536,21323,747,22070,257
2021-06-23,San Mateo,081,765935,42690,42756,482,43238,542
2021-06-23,Santa Barbara,083,443738,34610,34505,1120,35625,454
2021-06-23,Santa Clara,085,1922200,119432,120233,763,120996,2098
2021-06-23,Santa Cruz,087,273765,16337,16215,799,17014,209
2021-06-23,Shasta,089,179085,12587,12604,1627,14231,202
2021-06-23,Sierra,091,2930,63,57,12,69,0
2021-06-23,Siskiyou,093,43540,1964,1892,362,2254,28
2021-06-23,Solano,095,438530,33408,33408,566,33974,267
2021-06-23,Sonoma,097,501317,30921,30959,358,31317,314
2021-06-23,Stanislaus,099,539301,57077,56926,5953,62879,1017
2021-06-23,Sutter,101,95872,9608,9653,87,9740,113
2021-06-23,Tehama,103,63373,5149,5119,581,5700,63
2021-06-23,Trinity,105,12862,493,338,95,433,3
2021-06-23,Tulare,107,460477,50436,49711,8997,58708,850
2021-06-23,Tuolumne,109,53932,4080,4120,44,4164,64
2021-06-23,Ventura,111,848112,81751,81312,2993,84305,1032
2021-06-23,Yolo,113,214977,14160,14161,262,14423,212
2021-06-23,Yuba,115,75493,6202,6190,129,6319,51
2021-06-22,Alameda,001,1643700,89240,89308,1939,91247,1263
2021-06-22,Alpine,003,1148,88,88,0,88,0
2021-06-22,Amador,005,37829,3747,3743,32,3775,46
2021-06-22,Butte,007,227075,12756,12662,1879,14541,198
2021-06-22,Calaveras,009,45235,2194,2198,13,2211,55
2021-06-22,Colusa,011,21464,1964,1971,319,2290,15
2021-06-22,Contra Costa,013,1133247,70887,70480,1302,71782,813
2021-06-22,Del Norte,015,27424,1456,1417,13,1430,8
2021-06-22,El Dorado,017,186661,10463,10380,770,11150,113
2021-06-22,Fresno,019,978130,103360,102996,8657,111653,1724
2021-06-22,Glenn,021,27897,2448,2435,562,2997,19
2021-06-22,Humboldt,023,135768,4493,4483,43,4526,42
2021-06-22,Imperial,025,180216,28762,28880,2690,31570,740
2021-06-22,Inyo,027,18085,1411,1405,12,1417,35
2021-06-22,Kern,029,883053,97868,97013,11023,108036,1342
2021-06-22,Kings,031,150075,23242,23098,1088,24186,245
2021-06-22,Lake,033,64148,3590,3564,13,3577,45
2021-06-22,Lassen,035,31185,5272,5254,115,5369,20
2021-06-22,Los Angeles,037,10098052,1212508,1206146,40773,1246919,24461
2021-06-22,Madera,039,155013,16779,16652,935,17587,240
2021-06-22,Marin,041,260295,14203,14174,260,14434,230
2021-06-22,Mariposa,043,17540,441,439,11,450,5
2021-06-22,Mendocino,045,87422,4165,4072,83,4155,49
2021-06-22,Merced,047,269075,31205,31267,1040,32307,464
2021-06-22,Modoc,049,8938,410,405,145,550,3
2021-06-22,Mono,051,14174,1267,1277,18,1295,3
2021-06-22,Monterey,053,433212,43300,43162,1835,44997,427
2021-06-22,Napa,055,140530,9994,10029,36,10065,80
2021-06-22,Nevada,057,99092,4961,4923,193,5116,72
2021-06-22,Orange,059,3164182,256588,255452,11394,266846,5114
2021-06-22,Placer,061,380077,23793,23603,1533,25136,299
2021-06-22,Plumas,063,18699,720,697,11,708,4
2021-06-22,Riverside,065,2383286,295440,289839,13971,303810,4456
2021-06-22,Sacramento,067,1510023,108115,107801,1809,109610,1670
2021-06-22,San Benito,069,59416,6084,6098,113,6211,63
2021-06-22,San Bernardino,071,2135413,294490,293770,8975,302745,4873
2021-06-22,San Diego,073,3302833,282866,281867,15314,297181,3771
2021-06-22,San Francisco,075,870044,37081,37287,1285,38572,556
2021-06-22,San Joaquin,077,732212,73995,73723,3576,77299,1405
2021-06-22,San Luis Obispo,079,281455,21533,21321,746,22067,257
2021-06-22,San Mateo,081,765935,42676,42725,477,43202,542
2021-06-22,Santa Barbara,083,443738,34599,34500,1119,35619,454
2021-06-22,Santa Clara,085,1922200,119400,120194,763,120957,2095
2021-06-22,Santa Cruz,087,273765,16332,16218,799,17017,209
2021-06-22,Shasta,089,179085,12576,12616,1624,14240,202
2021-06-22,Sierra,091,2930,62,57,12,69,0
2021-06-22,Siskiyou,093,43540,1964,1892,362,2254,28
2021-06-22,Solano,095,438530,33390,33397,565,33962,267
2021-06-22,Sonoma,097,501317,30881,30933,358,31291,314
2021-06-22,Stanislaus,099,539301,57061,56915,5951,62866,1017
2021-06-22,Sutter,101,95872,9601,9649,87,9736,113
2021-06-22,Tehama,103,63373,5147,5118,580,5698,63
2021-06-22,Trinity,105,12862,491,337,95,432,3
2021-06-22,Tulare,107,460477,50428,49706,8992,58698,850
2021-06-22,Tuolumne,109,53932,4078,4119,44,4163,64
2021-06-22,Ventura,111,848112,81737,81300,2992,84292,1032
2021-06-22,Yolo,113,214977,14155,14157,260,14417,212
2021-06-22,Yuba,115,75493,6198,6181,129,6310,51
2021-06-21,Alameda,001,1643700,89184,89281,1938,91219,1262
2021-06-21,Alpine,003,1148,88,88,0,88,0
2021-06-21,Amador,005,37829,3741,3742,32,3774,46
2021-06-21,Butte,007,227075,12750,12668,1877,14545,195
2021-06-21,Calaveras,009,45235,2192,2194,13,2207,55
2021-06-21,Colusa,011,21464,1963,1970,318,2288,15
2021-06-21,Contra Costa,013,1133247,70817,70439,1301,71740,813
2021-06-21,Del Norte,015,27424,1452,1416,13,1429,8
2021-06-21,El Dorado,017,186661,10457,10375,769,11144,113
2021-06-21,Fresno,019,978130,103340,102971,8654,111625,1724
2021-06-21,Glenn,021,27897,2447,2433,562,2995,19
2021-06-21,Humboldt,023,135768,4484,4478,42,4520,42
2021-06-21,Imperial,025,180216,28758,28855,2690,31545,740
2021-06-21,Inyo,027,18085,1410,1405,12,1417,35
2021-06-21,Kern,029,883053,97839,96995,11015,108010,1342
2021-06-21,Kings,031,150075,23235,23091,1085,24176,245
2021-06-21,Lake,033,64148,3584,3563,13,3576,45
2021-06-21,Lassen,035,31185,5270,5233,115,5348,19
2021-06-21,Los Angeles,037,10098052,1212214,1205994,40751,1246745,24459
2021-06-21,Madera,039,155013,16770,16647,935,17582,240
2021-06-21,Marin,041,260295,14199,14173,260,14433,230
2021-06-21,Mariposa,043,17540,441,439,11,450,5
2021-06-21,Mendocino,045,87422,4162,4085,83,4168,49
2021-06-21,Merced,047,269075,31195,31264,1039,32303,465
2021-06-21,Modoc,049,8938,410,405,145,550,3
2021-06-21,Mono,051,14174,1267,1277,18,1295,3
2021-06-21,Monterey,053,433212,43297,43157,1835,44992,427
2021-06-21,Napa,055,140530,9989,10028,36,10064,80
2021-06-21,Nevada,057,99092,4957,4921,193,5114,72
2021-06-21,Orange,059,3164182,256515,255400,11387,266787,5113
2021-06-21,Placer,061,380077,23769,23577,1533,25110,298
2021-06-21,Plumas,063,18699,718,697,11,708,4
2021-06-21,Riverside,065,2383286,295364,289797,13966,303763,4456
2021-06-21,Sacramento,067,1510023,108004,107757,1808,109565,1669
2021-06-21,San Benito,069,59416,6080,6098,113,6211,63
2021-06-21,San Bernardino,071,2135413,294403,293736,8971,302707,4850
2021-06-21,San Diego,073,3302833,282761,281811,15294,297105,3771
2021-06-21,San Francisco,075,870044,37065,37275,1284,38559,556
2021-06-21,San Joaquin,077,732212,73954,73687,3575,77262,1405
2021-06-21,San Luis Obispo,079,281455,21524,21316,746,22062,257
2021-06-21,San Mateo,081,765935,42660,42685,476,43161,542
2021-06-21,Santa Barbara,083,443738,34594,34492,1119,35611,455
2021-06-21,Santa Clara,085,1922200,119367,120192,762,120954,2093
2021-06-21,Santa Cruz,087,273765,16330,16212,799,17011,208
2021-06-21,Shasta,089,179085,12563,12617,1621,14238,201
2021-06-21,Sierra,091,2930,62,57,12,69,0
2021-06-21,Siskiyou,093,43540,1964,1892,362,2254,27
2021-06-21,Solano,095,438530,33367,33383,564,33947,266
2021-06-21,Sonoma,097,501317,30858,30912,358,31270,314
2021-06-21,Stanislaus,099,539301,57031,56891,5946,62837,1017
2021-06-21,Sutter,101,95872,9598,9649,87,9736,113
2021-06-21,Tehama,103,63373,5147,5115,579,5694,63
2021-06-21,Trinity,105,12862,491,337,95,432,3
2021-06-21,Tulare,107,460477,50417,49689,8988,58677,849
2021-06-21,Tuolumne,109,53932,4074,4119,44,4163,63
2021-06-21,Ventura,111,848112,81709,81291,2988,84279,1031
2021-06-21,Yolo,113,214977,14149,14165,260,14425,212
2021-06-21,Yuba,115,75493,6197,6172,129,6301,51
2021-06-20,Alameda,001,1643700,89119,89255,1937,91192,1263
2021-06-20,Alpine,003,1148,88,88,0,88,0
2021-06-20,Amador,005,37829,3738,3740,32,3772,46
2021-06-20,Butte,007,227075,12743,12668,1876,14544,194
2021-06-20,Calaveras,009,45235,2191,2193,13,2206,55
2021-06-20,Colusa,011,21464,1963,1970,318,2288,15
2021-06-20,Contra Costa,013,1133247,70760,70401,1299,71700,813
2021-06-20,Del Norte,015,27424,1448,1416,13,1429,8
2021-06-20,El Dorado,017,186661,10443,10372,766,11138,113
2021-06-20,Fresno,019,978130,103299,102947,8651,111598,1724
2021-06-20,Glenn,021,27897,2447,2434,562,2996,19
2021-06-20,Humboldt,023,135768,4478,4472,42,4514,42
2021-06-20,Imperial,025,180216,28749,28855,2690,31545,740
2021-06-20,Inyo,027,18085,1409,1405,12,1417,35
2021-06-20,Kern,029,883053,97818,96985,11004,107989,1342
2021-06-20,Kings,031,150075,23230,23088,1083,24171,245
2021-06-20,Lake,033,64148,3582,3563,13,3576,45
2021-06-20,Lassen,035,31185,5267,5230,115,5345,19
2021-06-20,Los Angeles,037,10098052,1211909,1205874,40743,1246617,24456
2021-06-20,Madera,039,155013,16762,16638,933,17571,240
2021-06-20,Marin,041,260295,14196,14166,260,14426,230
2021-06-20,Mariposa,043,17540,439,439,11,450,5
2021-06-20,Mendocino,045,87422,4155,4080,83,4163,49
2021-06-20,Merced,047,269075,31183,31265,1039,32304,465
2021-06-20,Modoc,049,8938,410,405,145,550,3
2021-06-20,Mono,051,14174,1267,1275,18,1293,3
2021-06-20,Monterey,053,433212,43288,43156,1834,44990,427
2021-06-20,Napa,055,140530,9982,10026,35,10061,80
2021-06-20,Nevada,057,99092,4950,4919,193,5112,72
2021-06-20,Orange,059,3164182,256451,255377,11376,266753,5113
2021-06-20,Placer,061,380077,23735,23562,1529,25091,298
2021-06-20,Plumas,063,18699,717,697,11,708,4
2021-06-20,Riverside,065,2383286,295285,289770,13955,303725,4456
2021-06-20,Sacramento,067,1510023,107892,107700,1805,109505,1669
2021-06-20,San Benito,069,59416,6080,6098,113,6211,63
2021-06-20,San Bernardino,071,2135413,294302,293713,8967,302680,4845
2021-06-20,San Diego,073,3302833,282655,281750,15272,297022,3771
2021-06-20,San Francisco,075,870044,37042,37269,1284,38553,556
2021-06-20,San Joaquin,077,732212,73909,73676,3566,77242,1405
2021-06-20,San Luis Obispo,079,281455,21522,21313,746,22059,257
2021-06-20,San Mateo,081,765935,42631,42681,476,43157,542
2021-06-20,Santa Barbara,083,443738,34585,34487,1119,35606,455
2021-06-20,Santa Clara,085,1922200,119332,120163,762,120925,2093
2021-06-20,Santa Cruz,087,273765,16325,16210,799,17009,208
2021-06-20,Shasta,089,179085,12558,12617,1619,14236,201
2021-06-20,Sierra,091,2930,62,57,12,69,0
2021-06-20,Siskiyou,093,43540,1963,1891,362,2253,27
2021-06-20,Solano,095,438530,33345,33361,562,33923,266
2021-06-20,Sonoma,097,501317,30811,30884,355,31239,314
2021-06-20,Stanislaus,099,539301,56998,56868,5945,62813,1017
2021-06-20,Sutter,101,95872,9595,9645,87,9732,113
2021-06-20,Tehama,103,63373,5143,5115,579,5694,63
2021-06-20,Trinity,105,12862,491,337,95,432,3
2021-06-20,Tulare,107,460477,50408,49685,8986,58671,849
2021-06-20,Tuolumne,109,53932,4071,4117,44,4161,63
2021-06-20,Ventura,111,848112,81693,81282,2986,84268,1031
2021-06-20,Yolo,113,214977,14142,14160,260,14420,212
2021-06-20,Yuba,115,75493,6190,6167,129,6296,51
2021-06-19,Alameda,001,1643700,89084,89202,1937,91139,1263
2021-06-19,Alpine,003,1148,88,88,0,88,0
2021-06-19,Amador,005,37829,3736,3739,32,3771,46
2021-06-19,Butte,007,227075,12739,12659,1876,14535,194
2021-06-19,Calaveras,009,45235,2191,2192,13,2205,55
2021-06-19,Colusa,011,21464,1963,1969,318,2287,15
2021-06-19,Contra Costa,013,1133247,70729,70334,1298,71632,813
2021-06-19,Del Norte,015,27424,1447,1416,13,1429,8
2021-06-19,El Dorado,017,186661,10442,10363,765,11128,113
2021-06-19,Fresno,019,978130,103286,102922,8650,111572,1724
2021-06-19,Glenn,021,27897,2446,2434,561,2995,19
2021-06-19,Humboldt,023,135768,4467,4463,42,4505,42
2021-06-19,Imperial,025,180216,28748,28813,2690,31503,740
2021-06-19,Inyo,027,18085,1409,1405,12,1417,35
2021-06-19,Kern,029,883053,97802,96966,11000,107966,1342
2021-06-19,Kings,031,150075,23227,23086,1083,24169,245
2021-06-19,Lake,033,64148,3578,3563,13,3576,45
2021-06-19,Lassen,035,31185,5266,5225,115,5340,19
2021-06-19,Los Angeles,037,10098052,1211706,1205602,40727,1246329,24454
2021-06-19,Madera,039,155013,16760,16632,933,17565,240
2021-06-19,Marin,041,260295,14188,14152,260,14412,230
2021-06-19,Mariposa,043,17540,439,439,11,450,5
2021-06-19,Mendocino,045,87422,4150,4077,83,4160,49
2021-06-19,Merced,047,269075,31181,31256,1039,32295,465
2021-06-19,Modoc,049,8938,409,402,145,547,3
2021-06-19,Mono,051,14174,1267,1275,18,1293,3
2021-06-19,Monterey,053,433212,43282,43153,1834,44987,427
2021-06-19,Napa,055,140530,9978,10025,35,10060,80
2021-06-19,Nevada,057,99092,4945,4910,193,5103,72
2021-06-19,Orange,059,3164182,256405,255329,11373,266702,5112
2021-06-19,Placer,061,380077,23719,23537,1526,25063,298
2021-06-19,Plumas,063,18699,716,697,11,708,4
2021-06-19,Riverside,065,2383286,295239,289720,13955,303675,4456
2021-06-19,Sacramento,067,1510023,107845,107631,1802,109433,1669
2021-06-19,San Benito,069,59416,6079,6098,113,6211,63
2021-06-19,San Bernardino,071,2135413,294259,293673,8965,302638,4844
2021-06-19,San Diego,073,3302833,282595,281682,15258,296940,3771
2021-06-19,San Francisco,075,870044,37029,37256,1284,38540,556
2021-06-19,San Joaquin,077,732212,73893,73652,3562,77214,1405
2021-06-19,San Luis Obispo,079,281455,21520,21308,744,22052,257
2021-06-19,San Mateo,081,765935,42613,42646,474,43120,542
2021-06-19,Santa Barbara,083,443738,34583,34472,1119,35591,455
2021-06-19,Santa Clara,085,1922200,119309,120110,761,120871,2093
2021-06-19,Santa Cruz,087,273765,16320,16206,799,17005,208
2021-06-19,Shasta,089,179085,12556,12615,1618,14233,201
2021-06-19,Sierra,091,2930,62,57,12,69,0
2021-06-19,Siskiyou,093,43540,1963,1891,362,2253,27
2021-06-19,Solano,095,438530,33335,33341,561,33902,266
2021-06-19,Sonoma,097,501317,30770,30841,355,31196,314
2021-06-19,Stanislaus,099,539301,56979,56847,5942,62789,1017
2021-06-19,Sutter,101,95872,9592,9645,87,9732,113
2021-06-19,Tehama,103,63373,5142,5115,579,5694,63
2021-06-19,Trinity,105,12862,491,337,95,432,3
2021-06-19,Tulare,107,460477,50401,49681,8981,58662,849
2021-06-19,Tuolumne,109,53932,4071,4117,44,4161,63
2021-06-19,Ventura,111,848112,81680,81270,2985,84255,1031
2021-06-19,Yolo,113,214977,14138,14156,259,14415,212
2021-06-19,Yuba,115,75493,6189,6157,129,6286,51
2021-06-18,Alameda,001,1643700,89047,89123,1937,91060,1263
2021-06-18,Alpine,003,1148,88,88,0,88,0
2021-06-18,Amador,005,37829,3736,3739,32,3771,46
2021-06-18,Butte,007,227075,12736,12653,1873,14526,194
2021-06-18,Calaveras,009,45235,2191,2191,13,2204,55
2021-06-18,Colusa,011,21464,1962,1969,318,2287,15
2021-06-18,Contra Costa,013,1133247,70687,70271,1296,71567,813
2021-06-18,Del Norte,015,27424,1447,1415,13,1428,8
2021-06-18,El Dorado,017,186661,10439,10348,763,11111,113
2021-06-18,Fresno,019,978130,103270,102894,8648,111542,1722
2021-06-18,Glenn,021,27897,2445,2430,561,2991,19
2021-06-18,Humboldt,023,135768,4459,4450,42,4492,42
2021-06-18,Imperial,025,180216,28746,28809,2690,31499,740
2021-06-18,Inyo,027,18085,1409,1405,12,1417,35
2021-06-18,Kern,029,883053,97791,96948,10994,107942,1341
2021-06-18,Kings,031,150075,23222,23082,1083,24165,245
2021-06-18,Lake,033,64148,3574,3563,13,3576,45
2021-06-18,Lassen,035,31185,5265,5224,115,5339,19
2021-06-18,Los Angeles,037,10098052,1211539,1205472,40711,1246183,24451
2021-06-18,Madera,039,155013,16754,16625,933,17558,241
2021-06-18,Marin,041,260295,14185,14147,260,14407,230
2021-06-18,Mariposa,043,17540,439,439,11,450,5
2021-06-18,Mendocino,045,87422,4145,4068,83,4151,49
2021-06-18,Merced,047,269075,31179,31262,1039,32301,464
2021-06-18,Modoc,049,8938,409,402,145,547,3
2021-06-18,Mono,051,14174,1266,1275,17,1292,3
2021-06-18,Monterey,053,433212,43279,43148,1834,44982,427
2021-06-18,Napa,055,140530,9974,10021,35,10056,80
2021-06-18,Nevada,057,99092,4937,4903,193,5096,72
2021-06-18,Orange,059,3164182,256368,255274,11370,266644,5108
2021-06-18,Placer,061,380077,23711,23500,1523,25023,298
2021-06-18,Plumas,063,18699,716,697,11,708,4
2021-06-18,Riverside,065,2383286,295190,289676,13954,303630,4457
2021-06-18,Sacramento,067,1510023,107797,107570,1802,109372,1669
2021-06-18,San Benito,069,59416,6078,6097,113,6210,63
2021-06-18,San Bernardino,071,2135413,294215,293629,8961,302590,4826
2021-06-18,San Diego,073,3302833,282519,281608,15247,296855,3771
2021-06-18,San Francisco,075,870044,37020,37246,1284,38530,556
2021-06-18,San Joaquin,077,732212,73875,73623,3560,77183,1403
2021-06-18,San Luis Obispo,079,281455,21516,21301,742,22043,257
2021-06-18,San Mateo,081,765935,42602,42630,473,43103,542
2021-06-18,Santa Barbara,083,443738,34573,34469,1119,35588,455
2021-06-18,Santa Clara,085,1922200,119288,120081,759,120840,2093
2021-06-18,Santa Cruz,087,273765,16316,16202,799,17001,208
2021-06-18,Shasta,089,179085,12552,12607,1616,14223,201
2021-06-18,Sierra,091,2930,61,57,12,69,0
2021-06-18,Siskiyou,093,43540,1963,1890,362,2252,27
2021-06-18,Solano,095,438530,33321,33323,561,33884,266
2021-06-18,Sonoma,097,501317,30752,30816,354,31170,313
2021-06-18,Stanislaus,099,539301,56964,56803,5940,62743,1012
2021-06-18,Sutter,101,95872,9589,9643,87,9730,113
2021-06-18,Tehama,103,63373,5140,5114,579,5693,63
2021-06-18,Trinity,105,12862,491,337,94,431,3
2021-06-18,Tulare,107,460477,50399,49664,8974,58638,849
2021-06-18,Tuolumne,109,53932,4068,4116,44,4160,63
2021-06-18,Ventura,111,848112,81670,81256,2980,84236,1031
2021-06-18,Yolo,113,214977,14135,14148,257,14405,212
2021-06-18,Yuba,115,75493,6183,6150,129,6279,51
2021-06-17,Alameda,001,1643700,89001,89087,1937,91024,1262
2021-06-17,Alpine,003,1148,88,88,0,88,0
2021-06-17,Amador,005,37829,3734,3731,32,3763,46
2021-06-17,Butte,007,227075,12726,12644,1872,14516,194
2021-06-17,Calaveras,009,45235,2190,2189,13,2202,55
2021-06-17,Colusa,011,21464,1961,1969,318,2287,15
2021-06-17,Contra Costa,013,1133247,70648,70190,1292,71482,810
2021-06-17,Del Norte,015,27424,1445,1413,13,1426,8
2021-06-17,El Dorado,017,186661,10429,10341,763,11104,113
2021-06-17,Fresno,019,978130,103244,102867,8644,111511,1722
2021-06-17,Glenn,021,27897,2445,2430,561,2991,19
2021-06-17,Humboldt,023,135768,4450,4438,42,4480,42
2021-06-17,Imperial,025,180216,28738,28801,2690,31491,741
2021-06-17,Inyo,027,18085,1409,1405,12,1417,35
2021-06-17,Kern,029,883053,97776,96840,10988,107828,1340
2021-06-17,Kings,031,150075,23218,23078,1082,24160,245
2021-06-17,Lake,033,64148,3571,3563,9,3572,45
2021-06-17,Lassen,035,31185,5261,5223,115,5338,19
2021-06-17,Los Angeles,037,10098052,1211324,1205301,40684,1245985,24444
2021-06-17,Madera,039,155013,16749,16618,933,17551,241
2021-06-17,Marin,041,260295,14185,14141,260,14401,229
2021-06-17,Mariposa,043,17540,439,439,11,450,5
2021-06-17,Mendocino,045,87422,4138,4054,83,4137,49
2021-06-17,Merced,047,269075,31174,31262,1039,32301,464
2021-06-17,Modoc,049,8938,408,401,145,546,3
2021-06-17,Mono,051,14174,1265,1275,17,1292,3
2021-06-17,Monterey,053,433212,43271,43140,1834,44974,416
2021-06-17,Napa,055,140530,9974,10014,35,10049,80
2021-06-17,Nevada,057,99092,4933,4898,193,5091,72
2021-06-17,Orange,059,3164182,256323,255240,11360,266600,5109
2021-06-17,Placer,061,380077,23695,23461,1521,24982,298
2021-06-17,Plumas,063,18699,715,697,11,708,4
2021-06-17,Riverside,065,2383286,295136,289627,13952,303579,4458
2021-06-17,Sacramento,067,1510023,107733,107492,1800,109292,1666
2021-06-17,San Benito,069,59416,6078,6097,113,6210,63
2021-06-17,San Bernardino,071,2135413,294174,293560,8961,302521,4811
2021-06-17,San Diego,073,3302833,282443,281531,15233,296764,3771
2021-06-17,San Francisco,075,870044,37008,37243,1283,38526,556
2021-06-17,San Joaquin,077,732212,73852,73560,3555,77115,1403
2021-06-17,San Luis Obispo,079,281455,21514,21297,742,22039,257
2021-06-17,San Mateo,081,765935,42596,42615,473,43088,542
2021-06-17,Santa Barbara,083,443738,34567,34466,1119,35585,453
2021-06-17,Santa Clara,085,1922200,119263,120032,758,120790,2093
2021-06-17,Santa Cruz,087,273765,16312,16197,799,16996,208
2021-06-17,Shasta,089,179085,12544,12597,1616,14213,201
2021-06-17,Sierra,091,2930,61,56,12,68,0
2021-06-17,Siskiyou,093,43540,1962,1889,362,2251,27
2021-06-17,Solano,095,438530,33300,33296,560,33856,266
2021-06-17,Sonoma,097,501317,30722,30793,354,31147,323
2021-06-17,Stanislaus,099,539301,56933,56752,5935,62687,1012
2021-06-17,Sutter,101,95872,9586,9629,87,9716,113
2021-06-17,Tehama,103,63373,5139,5112,577,5689,63
2021-06-17,Trinity,105,12862,490,337,94,431,3
2021-06-17,Tulare,107,460477,50394,49649,8966,58615,849
2021-06-17,Tuolumne,109,53932,4067,4116,44,4160,63
2021-06-17,Ventura,111,848112,81661,81248,2977,84225,1030
2021-06-17,Yolo,113,214977,14127,14141,257,14398,212
2021-06-17,Yuba,115,75493,6174,6140,129,6269,51
2021-06-16,Alameda,001,1643700,88952,89045,1936,90981,1265
2021-06-16,Alpine,003,1148,88,88,0,88,0
2021-06-16,Amador,005,37829,3733,3730,32,3762,46
2021-06-16,Butte,007,227075,12724,12635,1870,14505,194
2021-06-16,Calaveras,009,45235,2188,2188,13,2201,55
2021-06-16,Colusa,011,21464,1961,1967,318,2285,15
2021-06-16,Contra Costa,013,1133247,70596,70136,1291,71427,810
2021-06-16,Del Norte,015,27424,1442,1413,13,1426,8
2021-06-16,El Dorado,017,186661,10423,10334,762,11096,113
2021-06-16,Fresno,019,978130,103213,102842,8640,111482,1722
2021-06-16,Glenn,021,27897,2445,2430,561,2991,19
2021-06-16,Humboldt,023,135768,4441,4427,41,4468,42
2021-06-16,Imperial,025,180216,28735,28796,2690,31486,741
2021-06-16,Inyo,027,18085,1408,1405,12,1417,35
2021-06-16,Kern,029,883053,97754,96789,10981,107770,1339
2021-06-16,Kings,031,150075,23217,23072,1081,24153,245
2021-06-16,Lake,033,64148,3571,3562,9,3571,45
2021-06-16,Lassen,035,31185,5258,5216,115,5331,19
2021-06-16,Los Angeles,037,10098052,1211100,1205102,40674,1245776,24439
2021-06-16,Madera,039,155013,16745,16603,933,17536,240
2021-06-16,Marin,041,260295,14183,14137,260,14397,229
2021-06-16,Mariposa,043,17540,439,437,11,448,5
2021-06-16,Mendocino,045,87422,4130,4041,83,4124,49
2021-06-16,Merced,047,269075,31166,31250,1039,32289,463
2021-06-16,Modoc,049,8938,407,383,144,527,3
2021-06-16,Mono,051,14174,1265,1275,17,1292,3
2021-06-16,Monterey,053,433212,43268,43122,1834,44956,416
2021-06-16,Napa,055,140530,9970,10011,35,10046,80
2021-06-16,Nevada,057,99092,4928,4894,193,5087,72
2021-06-16,Orange,059,3164182,256269,255188,11352,266540,5109
2021-06-16,Placer,061,380077,23685,23425,1517,24942,298
2021-06-16,Plumas,063,18699,715,697,11,708,4
2021-06-16,Riverside,065,2383286,295075,289539,13950,303489,4457
2021-06-16,Sacramento,067,1510023,107663,107422,1796,109218,1665
2021-06-16,San Benito,069,59416,6078,6090,113,6203,63
2021-06-16,San Bernardino,071,2135413,294125,293499,8959,302458,4797
2021-06-16,San Diego,073,3302833,282364,281423,15220,296643,3770
2021-06-16,San Francisco,075,870044,36995,37222,1281,38503,555
2021-06-16,San Joaquin,077,732212,73814,73530,3551,77081,1399
2021-06-16,San Luis Obispo,079,281455,21509,21294,742,22036,257
2021-06-16,San Mateo,081,765935,42580,42601,473,43074,542
2021-06-16,Santa Barbara,083,443738,34561,34459,1119,35578,460
2021-06-16,Santa Clara,085,1922200,119231,119982,758,120740,2087
2021-06-16,Santa Cruz,087,273765,16309,16187,799,16986,208
2021-06-16,Shasta,089,179085,12539,12592,1615,14207,200
2021-06-16,Sierra,091,2930,61,56,12,68,0
2021-06-16,Siskiyou,093,43540,1961,1886,362,2248,26
2021-06-16,Solano,095,438530,33272,33276,560,33836,266
2021-06-16,Sonoma,097,501317,30686,30741,354,31095,323
2021-06-16,Stanislaus,099,539301,56902,56738,5933,62671,984
2021-06-16,Sutter,101,95872,9582,9620,87,9707,113
2021-06-16,Tehama,103,63373,5137,5106,577,5683,63
2021-06-16,Trinity,105,12862,489,332,94,426,3
2021-06-16,Tulare,107,460477,50389,49578,8962,58540,849
2021-06-16,Tuolumne,109,53932,4067,4110,44,4154,63
2021-06-16,Ventura,111,848112,81647,81229,2975,84204,1029
2021-06-16,Yolo,113,214977,14118,14135,256,14391,212
2021-06-16,Yuba,115,75493,6164,6134,129,6263,51
2021-06-15,Alameda,001,1643700,88911,89008,1936,90944,1262
2021-06-15,Alpine,003,1148,88,88,0,88,0
2021-06-15,Amador,005,37829,3730,3723,32,3755,46
2021-06-15,Butte,007,227075,12716,12620,1869,14489,194
2021-06-15,Calaveras,009,45235,2187,2188,13,2201,55
2021-06-15,Colusa,011,21464,1961,1967,316,2283,15
2021-06-15,Contra Costa,013,1133247,70534,70101,1291,71392,810
2021-06-15,Del Norte,015,27424,1441,1411,13,1424,8
2021-06-15,El Dorado,017,186661,10414,10330,762,11092,113
2021-06-15,Fresno,019,978130,103180,102828,8639,111467,1722
2021-06-15,Glenn,021,27897,2444,2426,561,2987,19
2021-06-15,Humboldt,023,135768,4432,4414,40,4454,42
2021-06-15,Imperial,025,180216,28729,28789,2690,31479,741
2021-06-15,Inyo,027,18085,1408,1405,12,1417,35
2021-06-15,Kern,029,883053,97726,96782,10973,107755,1338
2021-06-15,Kings,031,150075,23211,23070,1079,24149,245
2021-06-15,Lake,033,64148,3570,3559,9,3568,45
2021-06-15,Lassen,035,31185,5257,5211,115,5326,19
2021-06-15,Los Angeles,037,10098052,1210875,1204926,40666,1245592,24435
2021-06-15,Madera,039,155013,16738,16600,932,17532,240
2021-06-15,Marin,041,260295,14175,14135,260,14395,229
2021-06-15,Mariposa,043,17540,439,437,11,448,5
2021-06-15,Mendocino,045,87422,4123,4034,83,4117,49
2021-06-15,Merced,047,269075,31160,31244,1039,32283,461
2021-06-15,Modoc,049,8938,406,383,144,527,3
2021-06-15,Mono,051,14174,1265,1275,17,1292,3
2021-06-15,Monterey,053,433212,43262,43118,1834,44952,416
2021-06-15,Napa,055,140530,9968,10010,35,10045,80
2021-06-15,Nevada,057,99092,4925,4888,193,5081,72
2021-06-15,Orange,059,3164182,256228,255127,11343,266470,5105
2021-06-15,Placer,061,380077,23663,23396,1516,24912,298
2021-06-15,Plumas,063,18699,714,697,11,708,4
2021-06-15,Riverside,065,2383286,295015,289508,13946,303454,4455
2021-06-15,Sacramento,067,1510023,107588,107370,1790,109160,1662
2021-06-15,San Benito,069,59416,6077,6089,113,6202,63
2021-06-15,San Bernardino,071,2135413,294075,293463,8953,302416,4790
2021-06-15,San Diego,073,3302833,282280,281375,15205,296580,3770
2021-06-15,San Francisco,075,870044,36986,37210,1280,38490,555
2021-06-15,San Joaquin,077,732212,73774,73494,3546,77040,1399
2021-06-15,San Luis Obispo,079,281455,21504,21293,741,22034,257
2021-06-15,San Mateo,081,765935,42567,42593,473,43066,543
2021-06-15,Santa Barbara,083,443738,34556,34451,1119,35570,460
2021-06-15,Santa Clara,085,1922200,119193,119963,758,120721,2086
2021-06-15,Santa Cruz,087,273765,16303,16180,798,16978,208
2021-06-15,Shasta,089,179085,12533,12583,1615,14198,201
2021-06-15,Sierra,091,2930,60,55,12,67,0
2021-06-15,Siskiyou,093,43540,1960,1887,362,2249,26
2021-06-15,Solano,095,438530,33253,33264,560,33824,266
2021-06-15,Sonoma,097,501317,30647,30707,353,31060,323
2021-06-15,Stanislaus,099,539301,56874,56724,5930,62654,979
2021-06-15,Sutter,101,95872,9573,9616,87,9703,113
2021-06-15,Tehama,103,63373,5135,5102,577,5679,63
2021-06-15,Trinity,105,12862,488,332,93,425,3
2021-06-15,Tulare,107,460477,50383,49561,8959,58520,848
2021-06-15,Tuolumne,109,53932,4067,4111,44,4155,63
2021-06-15,Ventura,111,848112,81636,81215,2972,84187,1029
2021-06-15,Yolo,113,214977,14114,14127,254,14381,212
2021-06-15,Yuba,115,75493,6153,6130,129,6259,51
2021-06-14,Alameda,001,1643700,88863,88966,1936,90902,1264
2021-06-14,Alpine,003,1148,88,88,0,88,0
2021-06-14,Amador,005,37829,3729,3722,32,3754,46
2021-06-14,Butte,007,227075,12705,12613,1865,14478,194
2021-06-14,Calaveras,009,45235,2186,2190,13,2203,55
2021-06-14,Colusa,011,21464,1960,1966,316,2282,15
2021-06-14,Contra Costa,013,1133247,70481,70069,1289,71358,810
2021-06-14,Del Norte,015,27424,1441,1411,13,1424,8
2021-06-14,El Dorado,017,186661,10405,10327,760,11087,113
2021-06-14,Fresno,019,978130,103158,102812,8637,111449,1719
2021-06-14,Glenn,021,27897,2444,2426,561,2987,19
2021-06-14,Humboldt,023,135768,4424,4407,39,4446,42
2021-06-14,Imperial,025,180216,28717,28836,2690,31526,741
2021-06-14,Inyo,027,18085,1407,1405,12,1417,35
2021-06-14,Kern,029,883053,97706,96760,10963,107723,1337
2021-06-14,Kings,031,150075,23208,23071,1078,24149,245
2021-06-14,Lake,033,64148,3569,3557,9,3566,45
2021-06-14,Lassen,035,31185,5254,5209,114,5323,19
2021-06-14,Los Angeles,037,10098052,1210633,1204748,40656,1245404,24434
2021-06-14,Madera,039,155013,16732,16597,931,17528,240
2021-06-14,Marin,041,260295,14173,14133,260,14393,229
2021-06-14,Mariposa,043,17540,438,437,11,448,5
2021-06-14,Mendocino,045,87422,4117,4028,83,4111,49
2021-06-14,Merced,047,269075,31151,31241,1038,32279,461
2021-06-14,Modoc,049,8938,397,382,142,524,3
2021-06-14,Mono,051,14174,1265,1275,17,1292,3
2021-06-14,Monterey,053,433212,43259,43110,1834,44944,415
2021-06-14,Napa,055,140530,9964,10000,35,10035,80
2021-06-14,Nevada,057,99092,4918,4885,193,5078,72
2021-06-14,Orange,059,3164182,256190,255069,11339,266408,5103
2021-06-14,Placer,061,380077,23638,23379,1515,24894,298
2021-06-14,Plumas,063,18699,714,696,11,707,4
2021-06-14,Riverside,065,2383286,294961,289476,13946,303422,4453
2021-06-14,Sacramento,067,1510023,107533,107334,1784,109118,1661
2021-06-14,San Benito,069,59416,6077,6087,113,6200,63
2021-06-14,San Bernardino,071,2135413,294019,293446,8949,302395,4790
2021-06-14,San Diego,073,3302833,282174,281314,15185,296499,3770
2021-06-14,San Francisco,075,870044,36972,37206,1280,38486,555
2021-06-14,San Joaquin,077,732212,73745,73453,3546,76999,1398
2021-06-14,San Luis Obispo,079,281455,21502,21302,741,22043,256
2021-06-14,San Mateo,081,765935,42554,42619,472,43091,543
2021-06-14,Santa Barbara,083,443738,34553,34449,1119,35568,460
2021-06-14,Santa Clara,085,1922200,119162,119957,757,120714,2085
2021-06-14,Santa Cruz,087,273765,16300,16175,798,16973,208
2021-06-14,Shasta,089,179085,12522,12561,1612,14173,201
2021-06-14,Sierra,091,2930,59,55,12,67,0
2021-06-14,Siskiyou,093,43540,1960,1886,362,2248,26
2021-06-14,Solano,095,438530,33236,33243,559,33802,266
2021-06-14,Sonoma,097,501317,30615,30679,352,31031,323
2021-06-14,Stanislaus,099,539301,56837,56689,5927,62616,975
2021-06-14,Sutter,101,95872,9570,9607,87,9694,112
2021-06-14,Tehama,103,63373,5133,5102,577,5679,63
2021-06-14,Trinity,105,12862,488,332,93,425,3
2021-06-14,Tulare,107,460477,50378,49538,8956,58494,848
2021-06-14,Tuolumne,109,53932,4064,4108,44,4152,63
2021-06-14,Ventura,111,848112,81626,81209,2972,84181,1028
2021-06-14,Yolo,113,214977,14106,14123,254,14377,212
2021-06-14,Yuba,115,75493,6146,6127,129,6256,50
2021-06-13,Alameda,001,1643700,88805,88947,1935,90882,1264
2021-06-13,Alpine,003,1148,87,88,0,88,0
2021-06-13,Amador,005,37829,3725,3721,32,3753,46
2021-06-13,Butte,007,227075,12694,12586,1862,14448,194
2021-06-13,Calaveras,009,45235,2186,2189,13,2202,55
2021-06-13,Colusa,011,21464,1960,1965,315,2280,15
2021-06-13,Contra Costa,013,1133247,70428,70040,1287,71327,810
2021-06-13,Del Norte,015,27424,1439,1412,13,1425,8
2021-06-13,El Dorado,017,186661,10396,10324,760,11084,113
2021-06-13,Fresno,019,978130,103128,102795,8632,111427,1719
2021-06-13,Glenn,021,27897,2443,2425,559,2984,19
2021-06-13,Humboldt,023,135768,4411,4401,39,4440,42
2021-06-13,Imperial,025,180216,28708,28800,2690,31490,741
2021-06-13,Inyo,027,18085,1407,1405,12,1417,35
2021-06-13,Kern,029,883053,97682,96743,10951,107694,1337
2021-06-13,Kings,031,150075,23203,23069,1077,24146,245
2021-06-13,Lake,033,64148,3569,3556,9,3565,45
2021-06-13,Lassen,035,31185,5249,5209,114,5323,19
2021-06-13,Los Angeles,037,10098052,1210365,1204614,40645,1245259,24433
2021-06-13,Madera,039,155013,16718,16590,931,17521,240
2021-06-13,Marin,041,260295,14167,14126,260,14386,229
2021-06-13,Mariposa,043,17540,438,434,11,445,5
2021-06-13,Mendocino,045,87422,4110,4026,83,4109,49
2021-06-13,Merced,047,269075,31145,31240,1037,32277,461
2021-06-13,Modoc,049,8938,395,382,140,522,3
2021-06-13,Mono,051,14174,1265,1275,17,1292,3
2021-06-13,Monterey,053,433212,43251,43108,1834,44942,415
2021-06-13,Napa,055,140530,9958,9995,35,10030,80
2021-06-13,Nevada,057,99092,4913,4883,193,5076,72
2021-06-13,Orange,059,3164182,256135,255043,11336,266379,5103
2021-06-13,Placer,061,380077,23612,23365,1513,24878,295
2021-06-13,Plumas,063,18699,713,696,11,707,4
2021-06-13,Riverside,065,2383286,294894,289447,13943,303390,4453
2021-06-13,Sacramento,067,1510023,107457,107289,1781,109070,1658
2021-06-13,San Benito,069,59416,6077,6086,113,6199,63
2021-06-13,San Bernardino,071,2135413,293967,293416,8944,302360,4788
2021-06-13,San Diego,073,3302833,282095,281268,15169,296437,3770
2021-06-13,San Francisco,075,870044,36960,37197,1280,38477,555
2021-06-13,San Joaquin,077,732212,73710,73438,3544,76982,1398
2021-06-13,San Luis Obispo,079,281455,21496,21298,740,22038,256
2021-06-13,San Mateo,081,765935,42541,42611,472,43083,542
2021-06-13,Santa Barbara,083,443738,34542,34449,1118,35567,460
2021-06-13,Santa Clara,085,1922200,119138,119946,757,120703,2085
2021-06-13,Santa Cruz,087,273765,16293,16172,798,16970,208
2021-06-13,Shasta,089,179085,12513,12560,1611,14171,201
2021-06-13,Sierra,091,2930,59,55,12,67,0
2021-06-13,Siskiyou,093,43540,1959,1885,362,2247,26
2021-06-13,Solano,095,438530,33215,33234,559,33793,266
2021-06-13,Sonoma,097,501317,30580,30663,350,31013,323
2021-06-13,Stanislaus,099,539301,56811,56671,5924,62595,975
2021-06-13,Sutter,101,95872,9563,9603,87,9690,112
2021-06-13,Tehama,103,63373,5131,5100,577,5677,63
2021-06-13,Trinity,105,12862,487,332,93,425,3
2021-06-13,Tulare,107,460477,50369,49537,8951,58488,848
2021-06-13,Tuolumne,109,53932,4062,4107,43,4150,63
2021-06-13,Ventura,111,848112,81612,81201,2972,84173,1028
2021-06-13,Yolo,113,214977,14097,14120,252,14372,212
2021-06-13,Yuba,115,75493,6139,6125,129,6254,50
2021-06-12,Alameda,001,1643700,88778,88901,1935,90836,1271
2021-06-12,Alpine,003,1148,87,88,0,88,0
2021-06-12,Amador,005,37829,3724,3721,32,3753,46
2021-06-12,Butte,007,227075,12690,12576,1861,14437,194
2021-06-12,Calaveras,009,45235,2186,2189,13,2202,55
2021-06-12,Colusa,011,21464,1960,1965,315,2280,15
2021-06-12,Contra Costa,013,1133247,70397,69989,1285,71274,810
2021-06-12,Del Norte,015,27424,1439,1412,13,1425,8
2021-06-12,El Dorado,017,186661,10391,10320,759,11079,113
2021-06-12,Fresno,019,978130,103118,102783,8631,111414,1720
2021-06-12,Glenn,021,27897,2441,2425,559,2984,19
2021-06-12,Humboldt,023,135768,4403,4396,39,4435,42
2021-06-12,Imperial,025,180216,28705,28799,2690,31489,741
2021-06-12,Inyo,027,18085,1407,1405,12,1417,35
2021-06-12,Kern,029,883053,97667,96731,10947,107678,1337
2021-06-12,Kings,031,150075,23201,23067,1077,24144,245
2021-06-12,Lake,033,64148,3568,3552,9,3561,45
2021-06-12,Lassen,035,31185,5249,5208,114,5322,19
2021-06-12,Los Angeles,037,10098052,1210228,1204439,40639,1245078,24434
2021-06-12,Madera,039,155013,16714,16586,931,17517,240
2021-06-12,Marin,041,260295,14164,14121,260,14381,229
2021-06-12,Mariposa,043,17540,438,434,11,445,5
2021-06-12,Mendocino,045,87422,4107,4024,83,4107,49
2021-06-12,Merced,047,269075,31142,31236,1037,32273,461
2021-06-12,Modoc,049,8938,394,382,140,522,3
2021-06-12,Mono,051,14174,1265,1275,17,1292,3
2021-06-12,Monterey,053,433212,43246,43103,1834,44937,415
2021-06-12,Napa,055,140530,9954,9986,35,10021,80
2021-06-12,Nevada,057,99092,4907,4878,193,5071,72
2021-06-12,Orange,059,3164182,256103,255004,11334,266338,5103
2021-06-12,Placer,061,380077,23593,23345,1513,24858,295
2021-06-12,Plumas,063,18699,713,696,11,707,4
2021-06-12,Riverside,065,2383286,294852,289413,13940,303353,4453
2021-06-12,Sacramento,067,1510023,107398,107199,1778,108977,1658
2021-06-12,San Benito,069,59416,6075,6083,113,6196,63
2021-06-12,San Bernardino,071,2135413,293932,293375,8942,302317,4788
2021-06-12,San Diego,073,3302833,282038,281203,15160,296363,3770
2021-06-12,San Francisco,075,870044,36950,37189,1280,38469,555
2021-06-12,San Joaquin,077,732212,73691,73413,3543,76956,1398
2021-06-12,San Luis Obispo,079,281455,21493,21293,740,22033,256
2021-06-12,San Mateo,081,765935,42535,42604,472,43076,542
2021-06-12,Santa Barbara,083,443738,34537,34450,1118,35568,460
2021-06-12,Santa Clara,085,1922200,119098,119894,757,120651,2085
2021-06-12,Santa Cruz,087,273765,16285,16170,798,16968,208
2021-06-12,Shasta,089,179085,12510,12556,1610,14166,201
2021-06-12,Sierra,091,2930,59,55,12,67,0
2021-06-12,Siskiyou,093,43540,1958,1884,362,2246,25
2021-06-12,Solano,095,438530,33206,33219,559,33778,266
2021-06-12,Sonoma,097,501317,30551,30647,350,30997,323
2021-06-12,Stanislaus,099,539301,56794,56649,5923,62572,974
2021-06-12,Sutter,101,95872,9559,9603,87,9690,112
2021-06-12,Tehama,103,63373,5131,5099,576,5675,63
2021-06-12,Trinity,105,12862,487,332,93,425,3
2021-06-12,Tulare,107,460477,50364,49533,8944,58477,848
2021-06-12,Tuolumne,109,53932,4061,4105,43,4148,63
2021-06-12,Ventura,111,848112,81600,81197,2972,84169,1028
2021-06-12,Yolo,113,214977,14094,14118,251,14369,212
2021-06-12,Yuba,115,75493,6134,6120,129,6249,50
2021-06-11,Alameda,001,1643700,88750,88844,1935,90779,1278
2021-06-11,Alpine,003,1148,87,88,0,88,0
2021-06-11,Amador,005,37829,3723,3710,32,3742,46
2021-06-11,Butte,007,227075,12686,12576,1859,14435,194
2021-06-11,Calaveras,009,45235,2186,2188,13,2201,55
2021-06-11,Colusa,011,21464,1959,1964,315,2279,15
2021-06-11,Contra Costa,013,1133247,70364,69940,1283,71223,808
2021-06-11,Del Norte,015,27424,1439,1409,13,1422,8
2021-06-11,El Dorado,017,186661,10388,10316,759,11075,113
2021-06-11,Fresno,019,978130,103099,102770,8630,111400,1720
2021-06-11,Glenn,021,27897,2441,2425,559,2984,19
2021-06-11,Humboldt,023,135768,4399,4389,39,4428,42
2021-06-11,Imperial,025,180216,28700,28793,2690,31483,741
2021-06-11,Inyo,027,18085,1407,1405,12,1417,35
2021-06-11,Kern,029,883053,97655,96718,10944,107662,1340
2021-06-11,Kings,031,150075,23197,23069,1076,24145,245
2021-06-11,Lake,033,64148,3567,3550,9,3559,45
2021-06-11,Lassen,035,31185,5248,5204,114,5318,18
2021-06-11,Los Angeles,037,10098052,1210078,1204259,40624,1244883,24434
2021-06-11,Madera,039,155013,16711,16582,931,17513,240
2021-06-11,Marin,041,260295,14161,14116,260,14376,229
2021-06-11,Mariposa,043,17540,438,434,11,445,5
2021-06-11,Mendocino,045,87422,4104,4022,83,4105,49
2021-06-11,Merced,047,269075,31137,31231,1037,32268,461
2021-06-11,Modoc,049,8938,394,382,139,521,3
2021-06-11,Mono,051,14174,1265,1274,17,1291,3
2021-06-11,Monterey,053,433212,43242,43097,1834,44931,415
2021-06-11,Napa,055,140530,9951,9977,35,10012,80
2021-06-11,Nevada,057,99092,4905,4873,193,5066,72
2021-06-11,Orange,059,3164182,256069,254975,11331,266306,5101
2021-06-11,Placer,061,380077,23588,23330,1513,24843,294
2021-06-11,Plumas,063,18699,713,696,11,707,4
2021-06-11,Riverside,065,2383286,294814,289376,13935,303311,4451
2021-06-11,Sacramento,067,1510023,107339,107119,1777,108896,1659
2021-06-11,San Benito,069,59416,6074,6082,113,6195,63
2021-06-11,San Bernardino,071,2135413,293896,293335,8938,302273,4788
2021-06-11,San Diego,073,3302833,281998,281144,15153,296297,3768
2021-06-11,San Francisco,075,870044,36945,37177,1280,38457,555
2021-06-11,San Joaquin,077,732212,73674,73347,3540,76887,1397
2021-06-11,San Luis Obispo,079,281455,21492,21288,740,22028,256
2021-06-11,San Mateo,081,765935,42521,42585,472,43057,542
2021-06-11,Santa Barbara,083,443738,34534,34438,1118,35556,460
2021-06-11,Santa Clara,085,1922200,119078,119860,757,120617,2083
2021-06-11,Santa Cruz,087,273765,16277,16164,798,16962,208
2021-06-11,Shasta,089,179085,12502,12550,1608,14158,201
2021-06-11,Sierra,091,2930,59,55,12,67,0
2021-06-11,Siskiyou,093,43540,1957,1882,362,2244,25
2021-06-11,Solano,095,438530,33186,33179,558,33737,266
2021-06-11,Sonoma,097,501317,30533,30624,350,30974,323
2021-06-11,Stanislaus,099,539301,56768,56617,5919,62536,974
2021-06-11,Sutter,101,95872,9556,9600,86,9686,112
2021-06-11,Tehama,103,63373,5130,5099,576,5675,63
2021-06-11,Trinity,105,12862,487,331,93,424,3
2021-06-11,Tulare,107,460477,50358,49516,8943,58459,848
2021-06-11,Tuolumne,109,53932,4058,4104,43,4147,63
2021-06-11,Ventura,111,848112,81590,81189,2972,84161,1026
2021-06-11,Yolo,113,214977,14087,14111,247,14358,212
2021-06-11,Yuba,115,75493,6130,6113,129,6242,50
2021-06-10,Alameda,001,1643700,88706,88806,1934,90740,1275
2021-06-10,Alpine,003,1148,87,88,0,88,0
2021-06-10,Amador,005,37829,3719,3709,32,3741,46
2021-06-10,Butte,007,227075,12669,12565,1859,14424,194
2021-06-10,Calaveras,009,45235,2185,2188,13,2201,55
2021-06-10,Colusa,011,21464,1957,1964,315,2279,15
2021-06-10,Contra Costa,013,1133247,70310,69876,1283,71159,807
2021-06-10,Del Norte,015,27424,1439,1405,13,1418,8
2021-06-10,El Dorado,017,186661,10381,10314,755,11069,113
2021-06-10,Fresno,019,978130,103073,102724,8629,111353,1717
2021-06-10,Glenn,021,27897,2441,2425,559,2984,19
2021-06-10,Humboldt,023,135768,4391,4384,39,4423,42
2021-06-10,Imperial,025,180216,28694,28779,2690,31469,739
2021-06-10,Inyo,027,18085,1407,1405,12,1417,35
2021-06-10,Kern,029,883053,97641,96706,10939,107645,1336
2021-06-10,Kings,031,150075,23196,23067,1076,24143,245
2021-06-10,Lake,033,64148,3562,3550,9,3559,45
2021-06-10,Lassen,035,31185,5246,5201,114,5315,18
2021-06-10,Los Angeles,037,10098052,1209912,1204110,40609,1244719,24440
2021-06-10,Madera,039,155013,16704,16581,930,17511,240
2021-06-10,Marin,041,260295,14158,14118,260,14378,229
2021-06-10,Mariposa,043,17540,436,434,11,445,5
2021-06-10,Mendocino,045,87422,4099,4016,83,4099,48
2021-06-10,Merced,047,269075,31129,31231,1034,32265,461
2021-06-10,Modoc,049,8938,393,381,139,520,3
2021-06-10,Mono,051,14174,1264,1274,17,1291,3
2021-06-10,Monterey,053,433212,43236,43090,1834,44924,415
2021-06-10,Napa,055,140530,9950,9974,35,10009,80
2021-06-10,Nevada,057,99092,4900,4866,193,5059,72
2021-06-10,Orange,059,3164182,256040,254950,11324,266274,5097
2021-06-10,Placer,061,380077,23575,23296,1513,24809,293
2021-06-10,Plumas,063,18699,713,696,11,707,4
2021-06-10,Riverside,065,2383286,294772,289335,13930,303265,4450
2021-06-10,Sacramento,067,1510023,107277,107049,1777,108826,1658
2021-06-10,San Benito,069,59416,6074,6079,113,6192,63
2021-06-10,San Bernardino,071,2135413,293855,293281,8935,302216,4782
2021-06-10,San Diego,073,3302833,281940,281052,15136,296188,3766
2021-06-10,San Francisco,075,870044,36935,37159,1278,38437,552
2021-06-10,San Joaquin,077,732212,73640,73276,3539,76815,1393
2021-06-10,San Luis Obispo,079,281455,21489,21280,740,22020,256
2021-06-10,San Mateo,081,765935,42514,42562,472,43034,666
2021-06-10,Santa Barbara,083,443738,34530,34434,1118,35552,460
2021-06-10,Santa Clara,085,1922200,119043,119832,756,120588,2075
2021-06-10,Santa Cruz,087,273765,16276,16159,798,16957,208
2021-06-10,Shasta,089,179085,12492,12536,1608,14144,201
2021-06-10,Sierra,091,2930,58,55,12,67,0
2021-06-10,Siskiyou,093,43540,1957,1881,362,2243,25
2021-06-10,Solano,095,438530,33169,33150,557,33707,265
2021-06-10,Sonoma,097,501317,30497,30571,348,30919,323
2021-06-10,Stanislaus,099,539301,56747,56588,5915,62503,974
2021-06-10,Sutter,101,95872,9549,9594,86,9680,112
2021-06-10,Tehama,103,63373,5130,5096,576,5672,63
2021-06-10,Trinity,105,12862,487,331,93,424,3
2021-06-10,Tulare,107,460477,50350,49503,8943,58446,848
2021-06-10,Tuolumne,109,53932,4058,4100,43,4143,63
2021-06-10,Ventura,111,848112,81579,81172,2971,84143,1026
2021-06-10,Yolo,113,214977,14084,14107,247,14354,212
2021-06-10,Yuba,115,75493,6126,6112,129,6241,50
2021-06-09,Alameda,001,1643700,88662,88762,1933,90695,1271
2021-06-09,Alpine,003,1148,87,88,0,88,0
2021-06-09,Amador,005,37829,3715,3706,32,3738,46
2021-06-09,Butte,007,227075,12663,12555,1857,14412,194
2021-06-09,Calaveras,009,45235,2183,2184,13,2197,55
2021-06-09,Colusa,011,21464,1957,1962,314,2276,15
2021-06-09,Contra Costa,013,1133247,70273,69829,1282,71111,803
2021-06-09,Del Norte,015,27424,1435,1403,13,1416,8
2021-06-09,El Dorado,017,186661,10378,10312,754,11066,113
2021-06-09,Fresno,019,978130,103053,102690,8625,111315,1717
2021-06-09,Glenn,021,27897,2440,2424,559,2983,19
2021-06-09,Humboldt,023,135768,4386,4379,38,4417,42
2021-06-09,Imperial,025,180216,28691,28754,2690,31444,739
2021-06-09,Inyo,027,18085,1407,1405,12,1417,35
2021-06-09,Kern,029,883053,97627,96697,10930,107627,1328
2021-06-09,Kings,031,150075,23194,23061,1076,24137,245
2021-06-09,Lake,033,64148,3559,3541,9,3550,45
2021-06-09,Lassen,035,31185,5245,5200,114,5314,18
2021-06-09,Los Angeles,037,10098052,1209724,1203955,40596,1244551,24432
2021-06-09,Madera,039,155013,16699,16580,930,17510,240
2021-06-09,Marin,041,260295,14153,14114,260,14374,229
2021-06-09,Mariposa,043,17540,436,434,11,445,5
2021-06-09,Mendocino,045,87422,4093,4008,83,4091,47
2021-06-09,Merced,047,269075,31125,31225,1034,32259,461
2021-06-09,Modoc,049,8938,391,377,138,515,3
2021-06-09,Mono,051,14174,1264,1274,17,1291,3
2021-06-09,Monterey,053,433212,43229,43082,1834,44916,415
2021-06-09,Napa,055,140530,9944,9971,35,10006,80
2021-06-09,Nevada,057,99092,4890,4863,192,5055,72
2021-06-09,Orange,059,3164182,255996,254893,11319,266212,5080
2021-06-09,Placer,061,380077,23556,23237,1513,24750,293
2021-06-09,Plumas,063,18699,712,697,11,708,4
2021-06-09,Riverside,065,2383286,294726,289299,13928,303227,4450
2021-06-09,Sacramento,067,1510023,107214,106971,1774,108745,1657
2021-06-09,San Benito,069,59416,6071,6078,113,6191,63
2021-06-09,San Bernardino,071,2135413,293813,293222,8935,302157,4782
2021-06-09,San Diego,073,3302833,281876,280941,15124,296065,3765
2021-06-09,San Francisco,075,870044,36921,37143,1277,38420,552
2021-06-09,San Joaquin,077,732212,73614,73232,3539,76771,1392
2021-06-09,San Luis Obispo,079,281455,21488,21259,740,21999,256
2021-06-09,San Mateo,081,765935,42498,42502,471,42973,666
2021-06-09,Santa Barbara,083,443738,34519,34422,1118,35540,460
2021-06-09,Santa Clara,085,1922200,119006,119793,755,120548,2068
2021-06-09,Santa Cruz,087,273765,16273,16155,798,16953,208
2021-06-09,Shasta,089,179085,12482,12521,1606,14127,201
2021-06-09,Sierra,091,2930,57,55,12,67,0
2021-06-09,Siskiyou,093,43540,1956,1871,362,2233,25
2021-06-09,Solano,095,438530,33153,33137,556,33693,264
2021-06-09,Sonoma,097,501317,30475,30540,348,30888,323
2021-06-09,Stanislaus,099,539301,56727,56560,5912,62472,974
2021-06-09,Sutter,101,95872,9540,9586,85,9671,111
2021-06-09,Tehama,103,63373,5129,5093,576,5669,63
2021-06-09,Trinity,105,12862,486,331,93,424,3
2021-06-09,Tulare,107,460477,50346,49496,8941,58437,847
2021-06-09,Tuolumne,109,53932,4055,4100,43,4143,63
2021-06-09,Ventura,111,848112,81569,81154,2970,84124,1026
2021-06-09,Yolo,113,214977,14082,14102,246,14348,212
2021-06-09,Yuba,115,75493,6122,6109,129,6238,50
2021-06-08,Alameda,001,1643700,88614,88731,1933,90664,1267
2021-06-08,Alpine,003,1148,87,88,0,88,0
2021-06-08,Amador,005,37829,3714,3704,32,3736,46
2021-06-08,Butte,007,227075,12657,12540,1855,14395,194
2021-06-08,Calaveras,009,45235,2182,2181,13,2194,55
2021-06-08,Colusa,011,21464,1957,1961,314,2275,15
2021-06-08,Contra Costa,013,1133247,70225,69762,1281,71043,803
2021-06-08,Del Norte,015,27424,1433,1402,13,1415,8
2021-06-08,El Dorado,017,186661,10373,10306,752,11058,113
2021-06-08,Fresno,019,978130,103028,102680,8623,111303,1717
2021-06-08,Glenn,021,27897,2439,2423,559,2982,19
2021-06-08,Humboldt,023,135768,4381,4363,38,4401,42
2021-06-08,Imperial,025,180216,28682,28752,2690,31442,738
2021-06-08,Inyo,027,18085,1407,1405,12,1417,35
2021-06-08,Kern,029,883053,97608,96671,10923,107594,1325
2021-06-08,Kings,031,150075,23193,23036,1076,24112,245
2021-06-08,Lake,033,64148,3558,3540,9,3549,45
2021-06-08,Lassen,035,31185,5245,5200,114,5314,18
2021-06-08,Los Angeles,037,10098052,1209526,1203794,40584,1244378,24426
2021-06-08,Madera,039,155013,16693,16579,929,17508,240
2021-06-08,Marin,041,260295,14151,14111,259,14370,229
2021-06-08,Mariposa,043,17540,436,434,11,445,5
2021-06-08,Mendocino,045,87422,4086,4002,83,4085,47
2021-06-08,Merced,047,269075,31117,31225,1034,32259,461
2021-06-08,Modoc,049,8938,385,377,137,514,3
2021-06-08,Mono,051,14174,1264,1274,17,1291,3
2021-06-08,Monterey,053,433212,43223,43078,1833,44911,415
2021-06-08,Napa,055,140530,9940,9962,35,9997,80
2021-06-08,Nevada,057,99092,4885,4861,192,5053,72
2021-06-08,Orange,059,3164182,255954,254852,11312,266164,5078
2021-06-08,Placer,061,380077,23538,23209,1509,24718,293
2021-06-08,Plumas,063,18699,712,692,11,703,4
2021-06-08,Riverside,065,2383286,294690,289268,13920,303188,4452
2021-06-08,Sacramento,067,1510023,107152,106901,1771,108672,1654
2021-06-08,San Benito,069,59416,6069,6076,113,6189,63
2021-06-08,San Bernardino,071,2135413,293764,293186,8931,302117,4778
2021-06-08,San Diego,073,3302833,281813,280879,15115,295994,3764
2021-06-08,San Francisco,075,870044,36906,37134,1276,38410,552
2021-06-08,San Joaquin,077,732212,73570,73186,3534,76720,1390
2021-06-08,San Luis Obispo,079,281455,21482,21251,739,21990,255
2021-06-08,San Mateo,081,765935,42485,42488,471,42959,663
2021-06-08,Santa Barbara,083,443738,34515,34418,1118,35536,459
2021-06-08,Santa Clara,085,1922200,118985,119770,754,120524,2068
2021-06-08,Santa Cruz,087,273765,16270,16160,798,16958,208
2021-06-08,Shasta,089,179085,12467,12498,1606,14104,201
2021-06-08,Sierra,091,2930,57,55,12,67,0
2021-06-08,Siskiyou,093,43540,1954,1870,360,2230,21
2021-06-08,Solano,095,438530,33132,33130,556,33686,259
2021-06-08,Sonoma,097,501317,30449,30523,346,30869,323
2021-06-08,Stanislaus,099,539301,56700,56548,5910,62458,973
2021-06-08,Sutter,101,95872,9537,9581,85,9666,111
2021-06-08,Tehama,103,63373,5126,5093,576,5669,63
2021-06-08,Trinity,105,12862,486,330,92,422,3
2021-06-08,Tulare,107,460477,50335,49485,8937,58422,847
2021-06-08,Tuolumne,109,53932,4051,4099,43,4142,63
2021-06-08,Ventura,111,848112,81553,81142,2969,84111,1026
2021-06-08,Yolo,113,214977,14077,14099,245,14344,212
2021-06-08,Yuba,115,75493,6120,6103,129,6232,50
2021-06-07,Alameda,001,1643700,88557,88688,1933,90621,1267
2021-06-07,Alpine,003,1148,87,88,0,88,0
2021-06-07,Amador,005,37829,3704,3697,32,3729,46
2021-06-07,Butte,007,227075,12650,12533,1854,14387,194
2021-06-07,Calaveras,009,45235,2181,2181,13,2194,55
2021-06-07,Colusa,011,21464,1956,1960,314,2274,15
2021-06-07,Contra Costa,013,1133247,70168,69718,1280,70998,817
2021-06-07,Del Norte,015,27424,1433,1401,13,1414,8
2021-06-07,El Dorado,017,186661,10368,10305,752,11057,113
2021-06-07,Fresno,019,978130,102997,102659,8615,111274,1717
2021-06-07,Glenn,021,27897,2439,2423,559,2982,19
2021-06-07,Humboldt,023,135768,4373,4354,38,4392,42
2021-06-07,Imperial,025,180216,28680,28754,2690,31444,738
2021-06-07,Inyo,027,18085,1407,1404,12,1416,35
2021-06-07,Kern,029,883053,97592,96645,10916,107561,1324
2021-06-07,Kings,031,150075,23189,23023,1076,24099,244
2021-06-07,Lake,033,64148,3556,3540,9,3549,45
2021-06-07,Lassen,035,31185,5240,5198,114,5312,18
2021-06-07,Los Angeles,037,10098052,1209302,1203664,40570,1244234,24413
2021-06-07,Madera,039,155013,16686,16572,929,17501,240
2021-06-07,Marin,041,260295,14147,14108,258,14366,229
2021-06-07,Mariposa,043,17540,436,434,11,445,5
2021-06-07,Mendocino,045,87422,4080,3998,83,4081,47
2021-06-07,Merced,047,269075,31105,31212,1033,32245,459
2021-06-07,Modoc,049,8938,384,375,134,509,3
2021-06-07,Mono,051,14174,1264,1275,17,1292,3
2021-06-07,Monterey,053,433212,43216,43077,1833,44910,415
2021-06-07,Napa,055,140530,9932,9962,35,9997,80
2021-06-07,Nevada,057,99092,4883,4860,192,5052,72
2021-06-07,Orange,059,3164182,255914,254808,11304,266112,5073
2021-06-07,Placer,061,380077,23519,23176,1507,24683,293
2021-06-07,Plumas,063,18699,712,692,11,703,4
2021-06-07,Riverside,065,2383286,294647,289232,13916,303148,4451
2021-06-07,Sacramento,067,1510023,107076,106841,1768,108609,1655
2021-06-07,San Benito,069,59416,6068,6074,113,6187,63
2021-06-07,San Bernardino,071,2135413,293726,293129,8930,302059,4775
2021-06-07,San Diego,073,3302833,281731,280808,15102,295910,3764
2021-06-07,San Francisco,075,870044,36888,37122,1276,38398,552
2021-06-07,San Joaquin,077,732212,73525,73130,3527,76657,1388
2021-06-07,San Luis Obispo,079,281455,21469,21252,739,21991,255
2021-06-07,San Mateo,081,765935,42469,42479,471,42950,664
2021-06-07,Santa Barbara,083,443738,34509,34407,1118,35525,459
2021-06-07,Santa Clara,085,1922200,118953,119743,754,120497,2066
2021-06-07,Santa Cruz,087,273765,16269,16159,798,16957,208
2021-06-07,Shasta,089,179085,12453,12483,1601,14084,200
2021-06-07,Sierra,091,2930,57,55,12,67,0
2021-06-07,Siskiyou,093,43540,1954,1869,360,2229,21
2021-06-07,Solano,095,438530,33110,33124,555,33679,258
2021-06-07,Sonoma,097,501317,30413,30504,345,30849,323
2021-06-07,Stanislaus,099,539301,56667,56521,5908,62429,972
2021-06-07,Sutter,101,95872,9533,9571,85,9656,111
2021-06-07,Tehama,103,63373,5122,5092,574,5666,63
2021-06-07,Trinity,105,12862,486,329,92,421,3
2021-06-07,Tulare,107,460477,50329,49471,8937,58408,847
2021-06-07,Tuolumne,109,53932,4050,4098,43,4141,63
2021-06-07,Ventura,111,848112,81536,81137,2967,84104,1025
2021-06-07,Yolo,113,214977,14072,14097,244,14341,211
2021-06-07,Yuba,115,75493,6118,6099,126,6225,49
2021-06-06,Alameda,001,1643700,88519,88636,1932,90568,1267
2021-06-06,Alpine,003,1148,87,88,0,88,0
2021-06-06,Amador,005,37829,3701,3696,32,3728,46
2021-06-06,Butte,007,227075,12639,12527,1853,14380,194
2021-06-06,Calaveras,009,45235,2180,2181,13,2194,55
2021-06-06,Colusa,011,21464,1954,1959,314,2273,15
2021-06-06,Contra Costa,013,1133247,70103,69659,1278,70937,817
2021-06-06,Del Norte,015,27424,1428,1401,13,1414,8
2021-06-06,El Dorado,017,186661,10361,10294,752,11046,113
2021-06-06,Fresno,019,978130,102964,102642,8612,111254,1717
2021-06-06,Glenn,021,27897,2438,2423,559,2982,19
2021-06-06,Humboldt,023,135768,4362,4353,38,4391,42
2021-06-06,Imperial,025,180216,28674,28762,2690,31452,738
2021-06-06,Inyo,027,18085,1406,1404,12,1416,35
2021-06-06,Kern,029,883053,97574,96623,10909,107532,1324
2021-06-06,Kings,031,150075,23183,23021,1076,24097,244
2021-06-06,Lake,033,64148,3556,3535,9,3544,45
2021-06-06,Lassen,035,31185,5238,5191,114,5305,18
2021-06-06,Los Angeles,037,10098052,1209103,1203539,40556,1244095,24410
2021-06-06,Madera,039,155013,16679,16567,929,17496,240
2021-06-06,Marin,041,260295,14141,14106,257,14363,229
2021-06-06,Mariposa,043,17540,435,435,11,446,5
2021-06-06,Mendocino,045,87422,4076,3993,83,4076,47
2021-06-06,Merced,047,269075,31099,31215,1032,32247,459
2021-06-06,Modoc,049,8938,384,375,133,508,3
2021-06-06,Mono,051,14174,1264,1275,17,1292,3
2021-06-06,Monterey,053,433212,43211,43078,1833,44911,415
2021-06-06,Napa,055,140530,9926,9963,35,9998,80
2021-06-06,Nevada,057,99092,4876,4854,191,5045,72
2021-06-06,Orange,059,3164182,255878,254782,11299,266081,5073
2021-06-06,Placer,061,380077,23494,23156,1504,24660,293
2021-06-06,Plumas,063,18699,712,692,11,703,4
2021-06-06,Riverside,065,2383286,294608,289201,13910,303111,4451
2021-06-06,Sacramento,067,1510023,106990,106749,1767,108516,1655
2021-06-06,San Benito,069,59416,6062,6074,113,6187,63
2021-06-06,San Bernardino,071,2135413,293669,293117,8921,302038,4773
2021-06-06,San Diego,073,3302833,281651,280743,15085,295828,3764
2021-06-06,San Francisco,075,870044,36873,37118,1274,38392,552
2021-06-06,San Joaquin,077,732212,73493,73105,3523,76628,1388
2021-06-06,San Luis Obispo,079,281455,21466,21246,739,21985,255
2021-06-06,San Mateo,081,765935,42452,42457,471,42928,664
2021-06-06,Santa Barbara,083,443738,34505,34403,1117,35520,459
2021-06-06,Santa Clara,085,1922200,118931,119711,754,120465,2066
2021-06-06,Santa Cruz,087,273765,16268,16158,798,16956,208
2021-06-06,Shasta,089,179085,12438,12478,1598,14076,200
2021-06-06,Sierra,091,2930,57,55,12,67,0
2021-06-06,Siskiyou,093,43540,1951,1869,360,2229,21
2021-06-06,Solano,095,438530,33083,33093,555,33648,258
2021-06-06,Sonoma,097,501317,30381,30478,344,30822,323
2021-06-06,Stanislaus,099,539301,56631,56486,5905,62391,972
2021-06-06,Sutter,101,95872,9526,9567,85,9652,111
2021-06-06,Tehama,103,63373,5112,5092,572,5664,63
2021-06-06,Trinity,105,12862,486,328,92,420,3
2021-06-06,Tulare,107,460477,50320,49466,8932,58398,847
2021-06-06,Tuolumne,109,53932,4047,4097,43,4140,63
2021-06-06,Ventura,111,848112,81525,81130,2964,84094,1025
2021-06-06,Yolo,113,214977,14064,14089,243,14332,210
2021-06-06,Yuba,115,75493,6110,6096,126,6222,49
2021-06-05,Alameda,001,1643700,88486,88612,1932,90544,1268
2021-06-05,Alpine,003,1148,87,88,0,88,0
2021-06-05,Amador,005,37829,3701,3694,32,3726,46
2021-06-05,Butte,007,227075,12633,12514,1852,14366,194
2021-06-05,Calaveras,009,45235,2180,2181,13,2194,55
2021-06-05,Colusa,011,21464,1954,1959,314,2273,15
2021-06-05,Contra Costa,013,1133247,70074,69601,1278,70879,817
2021-06-05,Del Norte,015,27424,1428,1400,13,1413,8
2021-06-05,El Dorado,017,186661,10359,10288,751,11039,113
2021-06-05,Fresno,019,978130,102955,102626,8612,111238,1717
2021-06-05,Glenn,021,27897,2437,2423,559,2982,19
2021-06-05,Humboldt,023,135768,4357,4346,38,4384,42
2021-06-05,Imperial,025,180216,28671,28764,2690,31454,738
2021-06-05,Inyo,027,18085,1406,1405,12,1417,35
2021-06-05,Kern,029,883053,97561,96597,10905,107502,1324
2021-06-05,Kings,031,150075,23180,23017,1076,24093,244
2021-06-05,Lake,033,64148,3553,3534,9,3543,45
2021-06-05,Lassen,035,31185,5237,5191,114,5305,18
2021-06-05,Los Angeles,037,10098052,1208974,1203338,40545,1243883,24411
2021-06-05,Madera,039,155013,16675,16563,929,17492,240
2021-06-05,Marin,041,260295,14139,14101,257,14358,229
2021-06-05,Mariposa,043,17540,435,435,11,446,5
2021-06-05,Mendocino,045,87422,4073,3989,83,4072,47
2021-06-05,Merced,047,269075,31097,31212,1031,32243,459
2021-06-05,Modoc,049,8938,384,375,132,507,3
2021-06-05,Mono,051,14174,1264,1274,17,1291,3
2021-06-05,Monterey,053,433212,43207,43071,1832,44903,415
2021-06-05,Napa,055,140530,9921,9960,35,9995,80
2021-06-05,Nevada,057,99092,4874,4849,191,5040,72
2021-06-05,Orange,059,3164182,255854,254752,11296,266048,5069
2021-06-05,Placer,061,380077,23478,23133,1504,24637,293
2021-06-05,Plumas,063,18699,712,692,11,703,4
2021-06-05,Riverside,065,2383286,294573,289157,13906,303063,4451
2021-06-05,Sacramento,067,1510023,106938,106688,1765,108453,1655
2021-06-05,San Benito,069,59416,6060,6074,113,6187,63
2021-06-05,San Bernardino,071,2135413,293636,293081,8920,302001,4772
2021-06-05,San Diego,073,3302833,281610,280676,15072,295748,3764
2021-06-05,San Francisco,075,870044,36864,37111,1274,38385,552
2021-06-05,San Joaquin,077,732212,73477,73078,3517,76595,1388
2021-06-05,San Luis Obispo,079,281455,21463,21236,739,21975,255
2021-06-05,San Mateo,081,765935,42442,42433,471,42904,664
2021-06-05,Santa Barbara,083,443738,34502,34399,1116,35515,459
2021-06-05,Santa Clara,085,1922200,118909,119676,752,120428,2066
2021-06-05,Santa Cruz,087,273765,16268,16154,798,16952,208
2021-06-05,Shasta,089,179085,12428,12472,1597,14069,200
2021-06-05,Sierra,091,2930,57,55,12,67,0
2021-06-05,Siskiyou,093,43540,1951,1867,360,2227,21
2021-06-05,Solano,095,438530,33068,33074,555,33629,257
2021-06-05,Sonoma,097,501317,30354,30450,342,30792,323
2021-06-05,Stanislaus,099,539301,56622,56463,5903,62366,973
2021-06-05,Sutter,101,95872,9523,9559,85,9644,111
2021-06-05,Tehama,103,63373,5111,5092,571,5663,63
2021-06-05,Trinity,105,12862,486,328,92,420,3
2021-06-05,Tulare,107,460477,50314,49463,8932,58395,847
2021-06-05,Tuolumne,109,53932,4045,4098,43,4141,63
2021-06-05,Ventura,111,848112,81516,81119,2962,84081,1025
2021-06-05,Yolo,113,214977,14062,14088,243,14331,210
2021-06-05,Yuba,115,75493,6109,6087,126,6213,49
2021-06-04,Alameda,001,1643700,88459,88585,1929,90514,1263
2021-06-04,Alpine,003,1148,87,88,0,88,0
2021-06-04,Amador,005,37829,3701,3690,32,3722,46
2021-06-04,Butte,007,227075,12622,12494,1849,14343,193
2021-06-04,Calaveras,009,45235,2180,2179,13,2192,55
2021-06-04,Colusa,011,21464,1954,1959,314,2273,15
2021-06-04,Contra Costa,013,1133247,70039,69540,1275,70815,816
2021-06-04,Del Norte,015,27424,1428,1398,13,1411,8
2021-06-04,El Dorado,017,186661,10355,10284,749,11033,112
2021-06-04,Fresno,019,978130,102939,102601,8612,111213,1712
2021-06-04,Glenn,021,27897,2437,2423,558,2981,19
2021-06-04,Humboldt,023,135768,4352,4327,38,4365,42
2021-06-04,Imperial,025,180216,28667,28753,2690,31443,738
2021-06-04,Inyo,027,18085,1406,1404,12,1416,35
2021-06-04,Kern,029,883053,97543,96573,10903,107476,1327
2021-06-04,Kings,031,150075,23179,23002,1076,24078,244
2021-06-04,Lake,033,64148,3551,3528,9,3537,45
2021-06-04,Lassen,035,31185,5237,5180,114,5294,18
2021-06-04,Los Angeles,037,10098052,1208853,1203106,40536,1243642,24400
2021-06-04,Madera,039,155013,16673,16557,929,17486,240
2021-06-04,Marin,041,260295,14138,14099,256,14355,229
2021-06-04,Mariposa,043,17540,435,435,11,446,5
2021-06-04,Mendocino,045,87422,4064,3983,83,4066,47
2021-06-04,Merced,047,269075,31092,31204,1030,32234,459
2021-06-04,Modoc,049,8938,382,375,132,507,3
2021-06-04,Mono,051,14174,1264,1275,17,1292,3
2021-06-04,Monterey,053,433212,43203,43068,1832,44900,415
2021-06-04,Napa,055,140530,9917,9958,35,9993,80
2021-06-04,Nevada,057,99092,4870,4844,191,5035,72
2021-06-04,Orange,059,3164182,255817,254730,11292,266022,5059
2021-06-04,Placer,061,380077,23462,23110,1503,24613,293
2021-06-04,Plumas,063,18699,712,691,11,702,4
2021-06-04,Riverside,065,2383286,294547,289098,13902,303000,4452
2021-06-04,Sacramento,067,1510023,106884,106616,1764,108380,1654
2021-06-04,San Benito,069,59416,6058,6073,113,6186,63
2021-06-04,San Bernardino,071,2135413,293612,293056,8918,301974,4768
2021-06-04,San Diego,073,3302833,281567,280556,15065,295621,3763
2021-06-04,San Francisco,075,870044,36857,37079,1273,38352,551
2021-06-04,San Joaquin,077,732212,73458,73039,3515,76554,1388
2021-06-04,San Luis Obispo,079,281455,21460,21234,738,21972,255
2021-06-04,San Mateo,081,765935,42430,42413,471,42884,478
2021-06-04,Santa Barbara,083,443738,34496,34402,1115,35517,459
2021-06-04,Santa Clara,085,1922200,118879,119619,752,120371,2065
2021-06-04,Santa Cruz,087,273765,16265,16150,798,16948,207
2021-06-04,Shasta,089,179085,12422,12458,1592,14050,200
2021-06-04,Sierra,091,2930,57,55,12,67,0
2021-06-04,Siskiyou,093,43540,1950,1865,360,2225,21
2021-06-04,Solano,095,438530,33057,33058,555,33613,256
2021-06-04,Sonoma,097,501317,30333,30411,342,30753,323
2021-06-04,Stanislaus,099,539301,56607,56442,5901,62343,973
2021-06-04,Sutter,101,95872,9518,9554,85,9639,111
2021-06-04,Tehama,103,63373,5106,5090,571,5661,63
2021-06-04,Trinity,105,12862,486,328,92,420,3
2021-06-04,Tulare,107,460477,50305,49452,8930,58382,847
2021-06-04,Tuolumne,109,53932,4044,4095,43,4138,63
2021-06-04,Ventura,111,848112,81509,81104,2960,84064,1023
2021-06-04,Yolo,113,214977,14060,14083,243,14326,210
2021-06-04,Yuba,115,75493,6106,6084,126,6210,49
2021-06-03,Alameda,001,1643700,88421,88555,1926,90481,1257
2021-06-03,Alpine,003,1148,87,88,0,88,0
2021-06-03,Amador,005,37829,3693,3688,32,3720,46
2021-06-03,Butte,007,227075,12618,12478,1848,14326,193
2021-06-03,Calaveras,009,45235,2180,2179,13,2192,55
2021-06-03,Colusa,011,21464,1954,1957,314,2271,15
2021-06-03,Contra Costa,013,1133247,69985,69500,1270,70770,816
2021-06-03,Del Norte,015,27424,1426,1397,13,1410,8
2021-06-03,El Dorado,017,186661,10349,10284,746,11030,112
2021-06-03,Fresno,019,978130,102922,102566,8612,111178,1709
2021-06-03,Glenn,021,27897,2437,2421,558,2979,19
2021-06-03,Humboldt,023,135768,4344,4314,38,4352,42
2021-06-03,Imperial,025,180216,28656,28737,2690,31427,738
2021-06-03,Inyo,027,18085,1406,1404,12,1416,35
2021-06-03,Kern,029,883053,97516,96507,10889,107396,1326
2021-06-03,Kings,031,150075,23175,22982,1076,24058,244
2021-06-03,Lake,033,64148,3549,3526,9,3535,45
2021-06-03,Lassen,035,31185,5228,5177,114,5291,12
2021-06-03,Los Angeles,037,10098052,1208681,1202923,40528,1243451,24386
2021-06-03,Madera,039,155013,16666,16554,929,17483,240
2021-06-03,Marin,041,260295,14133,14095,256,14351,230
2021-06-03,Mariposa,043,17540,435,435,11,446,5
2021-06-03,Mendocino,045,87422,4057,3978,83,4061,47
2021-06-03,Merced,047,269075,31089,31199,1030,32229,459
2021-06-03,Modoc,049,8938,381,376,131,507,3
2021-06-03,Mono,051,14174,1264,1275,17,1292,3
2021-06-03,Monterey,053,433212,43200,43063,1832,44895,415
2021-06-03,Napa,055,140530,9910,9957,35,9992,81
2021-06-03,Nevada,057,99092,4866,4837,191,5028,72
2021-06-03,Orange,059,3164182,255789,254676,11282,265958,5056
2021-06-03,Placer,061,380077,23453,23100,1502,24602,293
2021-06-03,Plumas,063,18699,712,691,11,702,4
2021-06-03,Riverside,065,2383286,294492,289035,13898,302933,4447
2021-06-03,Sacramento,067,1510023,106805,106526,1762,108288,1654
2021-06-03,San Benito,069,59416,6058,6073,113,6186,63
2021-06-03,San Bernardino,071,2135413,293581,293021,8918,301939,4762
2021-06-03,San Diego,073,3302833,281503,280430,15055,295485,3761
2021-06-03,San Francisco,075,870044,36850,37072,1273,38345,551
2021-06-03,San Joaquin,077,732212,73430,72989,3511,76500,1388
2021-06-03,San Luis Obispo,079,281455,21455,21224,738,21962,255
2021-06-03,San Mateo,081,765935,42417,42396,471,42867,467
2021-06-03,Santa Barbara,083,443738,34493,34391,1115,35506,459
2021-06-03,Santa Clara,085,1922200,118857,119592,750,120342,2058
2021-06-03,Santa Cruz,087,273765,16263,16144,798,16942,207
2021-06-03,Shasta,089,179085,12407,12441,1589,14030,199
2021-06-03,Sierra,091,2930,57,55,12,67,0
2021-06-03,Siskiyou,093,43540,1950,1862,359,2221,21
2021-06-03,Solano,095,438530,33043,33019,555,33574,256
2021-06-03,Sonoma,097,501317,30311,30383,341,30724,322
2021-06-03,Stanislaus,099,539301,56588,56401,5895,62296,973
2021-06-03,Sutter,101,95872,9509,9539,85,9624,111
2021-06-03,Tehama,103,63373,5106,5087,571,5658,63
2021-06-03,Trinity,105,12862,486,328,92,420,3
2021-06-03,Tulare,107,460477,50302,49442,8926,58368,848
2021-06-03,Tuolumne,109,53932,4042,4095,43,4138,63
2021-06-03,Ventura,111,848112,81497,81078,2958,84036,1023
2021-06-03,Yolo,113,214977,14056,14078,241,14319,210
2021-06-03,Yuba,115,75493,6099,6077,126,6203,49
2021-06-02,Alameda,001,1643700,88376,88525,1924,90449,1254
2021-06-02,Alpine,003,1148,87,88,0,88,0
2021-06-02,Amador,005,37829,3691,3687,32,3719,46
2021-06-02,Butte,007,227075,12598,12432,1846,14278,193
2021-06-02,Calaveras,009,45235,2177,2174,13,2187,55
2021-06-02,Colusa,011,21464,1953,1957,314,2271,15
2021-06-02,Contra Costa,013,1133247,69934,69455,1268,70723,814
2021-06-02,Del Norte,015,27424,1424,1395,13,1408,8
2021-06-02,El Dorado,017,186661,10345,10275,746,11021,110
2021-06-02,Fresno,019,978130,102898,102547,8609,111156,1707
2021-06-02,Glenn,021,27897,2437,2421,558,2979,19
2021-06-02,Humboldt,023,135768,4329,4302,38,4340,42
2021-06-02,Imperial,025,180216,28650,28737,2689,31426,738
2021-06-02,Inyo,027,18085,1405,1403,12,1415,35
2021-06-02,Kern,029,883053,97489,96481,10882,107363,1326
2021-06-02,Kings,031,150075,23173,22981,1075,24056,244
2021-06-02,Lake,033,64148,3544,3522,9,3531,45
2021-06-02,Lassen,035,31185,5227,5177,114,5291,6
2021-06-02,Los Angeles,037,10098052,1208477,1202760,40519,1243279,24375
2021-06-02,Madera,039,155013,16658,16550,929,17479,240
2021-06-02,Marin,041,260295,14131,14091,255,14346,229
2021-06-02,Mariposa,043,17540,435,434,11,445,5
2021-06-02,Mendocino,045,87422,4051,3970,83,4053,47
2021-06-02,Merced,047,269075,31076,31195,1029,32224,458
2021-06-02,Modoc,049,8938,380,375,130,505,3
2021-06-02,Mono,051,14174,1264,1275,17,1292,3
2021-06-02,Monterey,053,433212,43198,43056,1832,44888,380
2021-06-02,Napa,055,140530,9909,9953,35,9988,82
2021-06-02,Nevada,057,99092,4863,4833,191,5024,72
2021-06-02,Orange,059,3164182,255740,254637,11275,265912,5055
2021-06-02,Placer,061,380077,23432,23058,1500,24558,293
2021-06-02,Plumas,063,18699,712,690,11,701,4
2021-06-02,Riverside,065,2383286,294434,289012,13888,302900,4445
2021-06-02,Sacramento,067,1510023,106740,106435,1756,108191,1649
2021-06-02,San Benito,069,59416,6057,6073,113,6186,63
2021-06-02,San Bernardino,071,2135413,293533,293004,8913,301917,4760
2021-06-02,San Diego,073,3302833,281423,280347,15034,295381,3760
2021-06-02,San Francisco,075,870044,36830,37050,1272,38322,550
2021-06-02,San Joaquin,077,732212,73399,72893,3508,76401,1387
2021-06-02,San Luis Obispo,079,281455,21448,21214,737,21951,255
2021-06-02,San Mateo,081,765935,42407,42383,470,42853,464
2021-06-02,Santa Barbara,083,443738,34486,34381,1115,35496,456
2021-06-02,Santa Clara,085,1922200,118829,119553,749,120302,2058
2021-06-02,Santa Cruz,087,273765,16260,16144,798,16942,207
2021-06-02,Shasta,089,179085,12389,12426,1584,14010,199
2021-06-02,Sierra,091,2930,57,55,12,67,0
2021-06-02,Siskiyou,093,43540,1950,1861,357,2218,21
2021-06-02,Solano,095,438530,33031,33007,554,33561,256
2021-06-02,Sonoma,097,501317,30292,30359,336,30695,322
2021-06-02,Stanislaus,099,539301,56569,56377,5890,62267,973
2021-06-02,Sutter,101,95872,9506,9533,85,9618,111
2021-06-02,Tehama,103,63373,5103,5081,571,5652,63
2021-06-02,Trinity,105,12862,484,328,92,420,3
2021-06-02,Tulare,107,460477,50294,49434,8922,58356,846
2021-06-02,Tuolumne,109,53932,4041,4095,43,4138,63
2021-06-02,Ventura,111,848112,81472,81033,2958,83991,1020
2021-06-02,Yolo,113,214977,14053,14074,240,14314,210
2021-06-02,Yuba,115,75493,6093,6072,126,6198,48
2021-06-01,Alameda,001,1643700,88341,88472,1922,90394,1253
2021-06-01,Alpine,003,1148,87,88,0,88,0
2021-06-01,Amador,005,37829,3689,3687,32,3719,46
2021-06-01,Butte,007,227075,12584,12427,1845,14272,193
2021-06-01,Calaveras,009,45235,2175,2173,13,2186,55
2021-06-01,Colusa,011,21464,1952,1955,313,2268,15
2021-06-01,Contra Costa,013,1133247,69876,69404,1268,70672,813
2021-06-01,Del Norte,015,27424,1423,1394,13,1407,8
2021-06-01,El Dorado,017,186661,10339,10271,746,11017,110
2021-06-01,Fresno,019,978130,102874,102534,8606,111140,1706
2021-06-01,Glenn,021,27897,2437,2422,558,2980,18
2021-06-01,Humboldt,023,135768,4319,4299,38,4337,42
2021-06-01,Imperial,025,180216,28646,28722,2687,31409,736
2021-06-01,Inyo,027,18085,1405,1403,12,1415,35
2021-06-01,Kern,029,883053,97462,96477,10874,107351,1319
2021-06-01,Kings,031,150075,23169,22977,1075,24052,244
2021-06-01,Lake,033,64148,3543,3523,9,3532,45
2021-06-01,Lassen,035,31185,5220,5172,114,5286,6
2021-06-01,Los Angeles,037,10098052,1208240,1202673,40505,1243178,24367
2021-06-01,Madera,039,155013,16649,16549,928,17477,240
2021-06-01,Marin,041,260295,14129,14081,255,14336,229
2021-06-01,Mariposa,043,17540,435,431,11,442,5
2021-06-01,Mendocino,045,87422,4044,3966,83,4049,47
2021-06-01,Merced,047,269075,31066,31195,1029,32224,456
2021-06-01,Modoc,049,8938,378,375,130,505,3
2021-06-01,Mono,051,14174,1264,1275,17,1292,3
2021-06-01,Monterey,053,433212,43192,43051,1832,44883,379
2021-06-01,Napa,055,140530,9907,9949,35,9984,82
2021-06-01,Nevada,057,99092,4858,4825,191,5016,72
2021-06-01,Orange,059,3164182,255704,254603,11267,265870,5051
2021-06-01,Placer,061,380077,23402,23021,1498,24519,293
2021-06-01,Plumas,063,18699,711,690,11,701,4
2021-06-01,Riverside,065,2383286,294381,288996,13882,302878,4442
2021-06-01,Sacramento,067,1510023,106668,106330,1754,108084,1644
2021-06-01,San Benito,069,59416,6056,6073,112,6185,63
2021-06-01,San Bernardino,071,2135413,293508,292990,8912,301902,4758
2021-06-01,San Diego,073,3302833,281319,280305,15017,295322,3756
2021-06-01,San Francisco,075,870044,36814,37031,1272,38303,550
2021-06-01,San Joaquin,077,732212,73367,72858,3507,76365,1383
2021-06-01,San Luis Obispo,079,281455,21443,21217,737,21954,256
2021-06-01,San Mateo,081,765935,42391,42383,469,42852,462
2021-06-01,Santa Barbara,083,443738,34482,34374,1115,35489,456
2021-06-01,Santa Clara,085,1922200,118801,119528,749,120277,2057
2021-06-01,Santa Cruz,087,273765,16256,16143,797,16940,207
2021-06-01,Shasta,089,179085,12380,12409,1579,13988,199
2021-06-01,Sierra,091,2930,57,55,12,67,0
2021-06-01,Siskiyou,093,43540,1943,1860,356,2216,21
2021-06-01,Solano,095,438530,33006,32974,553,33527,256
2021-06-01,Sonoma,097,501317,30253,30324,335,30659,322
2021-06-01,Stanislaus,099,539301,56552,56348,5888,62236,973
2021-06-01,Sutter,101,95872,9499,9528,85,9613,111
2021-06-01,Tehama,103,63373,5101,5079,571,5650,63
2021-06-01,Trinity,105,12862,483,328,91,419,3
2021-06-01,Tulare,107,460477,50286,49419,8918,58337,845
2021-06-01,Tuolumne,109,53932,4041,4094,43,4137,63
2021-06-01,Ventura,111,848112,81456,81018,2957,83975,1021
2021-06-01,Yolo,113,214977,14047,14067,240,14307,210
2021-06-01,Yuba,115,75493,6089,6067,126,6193,48
2021-05-31,Alameda,001,1643700,88305,88458,1918,90376,1253
2021-05-31,Alpine,003,1148,87,88,0,88,0
2021-05-31,Amador,005,37829,3683,3687,32,3719,46
2021-05-31,Butte,007,227075,12571,12429,1845,14274,193
2021-05-31,Calaveras,009,45235,2174,2171,13,2184,55
2021-05-31,Colusa,011,21464,1952,1956,312,2268,15
2021-05-31,Contra Costa,013,1133247,69839,69390,1267,70657,813
2021-05-31,Del Norte,015,27424,1420,1394,13,1407,8
2021-05-31,El Dorado,017,186661,10333,10271,744,11015,110
2021-05-31,Fresno,019,978130,102837,102507,8606,111113,1706
2021-05-31,Glenn,021,27897,2436,2422,557,2979,18
2021-05-31,Humboldt,023,135768,4307,4295,38,4333,42
2021-05-31,Imperial,025,180216,28640,28732,2684,31416,736
2021-05-31,Inyo,027,18085,1404,1403,12,1415,35
2021-05-31,Kern,029,883053,97426,96457,10865,107322,1319
2021-05-31,Kings,031,150075,23165,22977,1075,24052,244
2021-05-31,Lake,033,64148,3538,3523,9,3532,45
2021-05-31,Lassen,035,31185,5218,5172,113,5285,6
2021-05-31,Los Angeles,037,10098052,1207997,1202567,40496,1243063,24364
2021-05-31,Madera,039,155013,16648,16543,927,17470,240
2021-05-31,Marin,041,260295,14127,14080,255,14335,229
2021-05-31,Mariposa,043,17540,435,430,11,441,5
2021-05-31,Mendocino,045,87422,4034,3961,83,4044,47
2021-05-31,Merced,047,269075,31061,31194,1029,32223,456
2021-05-31,Modoc,049,8938,377,374,130,504,3
2021-05-31,Mono,051,14174,1264,1275,17,1292,3
2021-05-31,Monterey,053,433212,43188,43051,1832,44883,379
2021-05-31,Napa,055,140530,9900,9948,35,9983,82
2021-05-31,Nevada,057,99092,4848,4823,190,5013,72
2021-05-31,Orange,059,3164182,255676,254572,11259,265831,5051
2021-05-31,Placer,061,380077,23375,23019,1494,24513,293
2021-05-31,Plumas,063,18699,710,690,11,701,4
2021-05-31,Riverside,065,2383286,294324,288970,13870,302840,4442
2021-05-31,Sacramento,067,1510023,106571,106278,1749,108027,1644
2021-05-31,San Benito,069,59416,6056,6072,112,6184,63
2021-05-31,San Bernardino,071,2135413,293460,292973,8911,301884,4758
2021-05-31,San Diego,073,3302833,281215,280254,15005,295259,3756
2021-05-31,San Francisco,075,870044,36799,37022,1271,38293,550
2021-05-31,San Joaquin,077,732212,73318,72856,3501,76357,1383
2021-05-31,San Luis Obispo,079,281455,21435,21215,737,21952,256
2021-05-31,San Mateo,081,765935,42375,42389,469,42858,442
2021-05-31,Santa Barbara,083,443738,34469,34369,1113,35482,456
2021-05-31,Santa Clara,085,1922200,118757,119515,749,120264,2057
2021-05-31,Santa Cruz,087,273765,16253,16139,797,16936,207
2021-05-31,Shasta,089,179085,12364,12408,1576,13984,199
2021-05-31,Sierra,091,2930,57,55,12,67,0
2021-05-31,Siskiyou,093,43540,1942,1856,355,2211,21
2021-05-31,Solano,095,438530,32956,32973,553,33526,256
2021-05-31,Sonoma,097,501317,30210,30314,335,30649,322
2021-05-31,Stanislaus,099,539301,56511,56335,5885,62220,973
2021-05-31,Sutter,101,95872,9480,9523,85,9608,111
2021-05-31,Tehama,103,63373,5098,5076,570,5646,63
2021-05-31,Trinity,105,12862,483,328,91,419,3
2021-05-31,Tulare,107,460477,50275,49404,8913,58317,845
2021-05-31,Tuolumne,109,53932,4039,4095,43,4138,63
2021-05-31,Ventura,111,848112,81441,81017,2954,83971,1021
2021-05-31,Yolo,113,214977,14043,14064,240,14304,210
2021-05-31,Yuba,115,75493,6083,6063,123,6186,48
2021-05-30,Alameda,001,1643700,88282,88429,1918,90347,1253
2021-05-30,Alpine,003,1148,87,88,0,88,0
2021-05-30,Amador,005,37829,3679,3685,32,3717,46
2021-05-30,Butte,007,227075,12562,12427,1843,14270,190
2021-05-30,Calaveras,009,45235,2170,2166,13,2179,55
2021-05-30,Colusa,011,21464,1952,1954,312,2266,15
2021-05-30,Contra Costa,013,1133247,69805,69381,1265,70646,813
2021-05-30,Del Norte,015,27424,1419,1393,13,1406,8
2021-05-30,El Dorado,017,186661,10330,10271,744,11015,110
2021-05-30,Fresno,019,978130,102820,102499,8602,111101,1706
2021-05-30,Glenn,021,27897,2436,2422,556,2978,18
2021-05-30,Humboldt,023,135768,4299,4291,38,4329,42
2021-05-30,Imperial,025,180216,28636,28732,2683,31415,736
2021-05-30,Inyo,027,18085,1404,1403,12,1415,35
2021-05-30,Kern,029,883053,97410,96443,10862,107305,1319
2021-05-30,Kings,031,150075,23164,22974,1075,24049,244
2021-05-30,Lake,033,64148,3538,3517,9,3526,45
2021-05-30,Lassen,035,31185,5216,5171,113,5284,6
2021-05-30,Los Angeles,037,10098052,1207882,1202425,40489,1242914,24360
2021-05-30,Madera,039,155013,16644,16538,927,17465,240
2021-05-30,Marin,041,260295,14123,14083,254,14337,229
2021-05-30,Mariposa,043,17540,435,430,11,441,5
2021-05-30,Mendocino,045,87422,4027,3955,83,4038,47
2021-05-30,Merced,047,269075,31057,31189,1028,32217,456
2021-05-30,Modoc,049,8938,377,374,130,504,3
2021-05-30,Mono,051,14174,1264,1275,17,1292,3
2021-05-30,Monterey,053,433212,43185,43049,1832,44881,379
2021-05-30,Napa,055,140530,9899,9948,35,9983,82
2021-05-30,Nevada,057,99092,4842,4818,190,5008,72
2021-05-30,Orange,059,3164182,255653,254559,11258,265817,5051
2021-05-30,Placer,061,380077,23369,23016,1494,24510,293
2021-05-30,Plumas,063,18699,708,690,11,701,4
2021-05-30,Riverside,065,2383286,294303,288961,13868,302829,4442
2021-05-30,Sacramento,067,1510023,106526,106252,1747,107999,1644
2021-05-30,San Benito,069,59416,6056,6072,112,6184,63
2021-05-30,San Bernardino,071,2135413,293434,292981,8910,301891,4758
2021-05-30,San Diego,073,3302833,281159,280209,15000,295209,3756
2021-05-30,San Francisco,075,870044,36780,37016,1271,38287,550
2021-05-30,San Joaquin,077,732212,73301,72853,3500,76353,1383
2021-05-30,San Luis Obispo,079,281455,21426,21211,736,21947,256
2021-05-30,San Mateo,081,765935,42367,42386,469,42855,439
2021-05-30,Santa Barbara,083,443738,34465,34369,1113,35482,456
2021-05-30,Santa Clara,085,1922200,118735,119510,745,120255,2057
2021-05-30,Santa Cruz,087,273765,16251,16140,797,16937,207
2021-05-30,Shasta,089,179085,12362,12408,1573,13981,199
2021-05-30,Sierra,091,2930,57,55,12,67,0
2021-05-30,Siskiyou,093,43540,1942,1856,355,2211,21
2021-05-30,Solano,095,438530,32945,32952,552,33504,256
2021-05-30,Sonoma,097,501317,30193,30310,334,30644,322
2021-05-30,Stanislaus,099,539301,56500,56323,5884,62207,973
2021-05-30,Sutter,101,95872,9479,9519,84,9603,111
2021-05-30,Tehama,103,63373,5098,5073,570,5643,63
2021-05-30,Trinity,105,12862,483,328,91,419,3
2021-05-30,Tulare,107,460477,50268,49397,8905,58302,845
2021-05-30,Tuolumne,109,53932,4039,4094,43,4137,63
2021-05-30,Ventura,111,848112,81437,81012,2953,83965,1021
2021-05-30,Yolo,113,214977,14038,14059,239,14298,210
2021-05-30,Yuba,115,75493,6076,6063,122,6185,48
2021-05-29,Alameda,001,1643700,88259,88433,1916,90349,1253
2021-05-29,Alpine,003,1148,87,88,0,88,0
2021-05-29,Amador,005,37829,3678,3683,32,3715,46
2021-05-29,Butte,007,227075,12556,12425,1843,14268,190
2021-05-29,Calaveras,009,45235,2169,2166,13,2179,55
2021-05-29,Colusa,011,21464,1949,1954,312,2266,15
2021-05-29,Contra Costa,013,1133247,69772,69351,1265,70616,813
2021-05-29,Del Norte,015,27424,1419,1391,13,1404,8
2021-05-29,El Dorado,017,186661,10329,10269,742,11011,110
2021-05-29,Fresno,019,978130,102808,102470,8599,111069,1706
2021-05-29,Glenn,021,27897,2436,2422,555,2977,18
2021-05-29,Humboldt,023,135768,4293,4283,38,4321,42
2021-05-29,Imperial,025,180216,28633,28729,2682,31411,736
2021-05-29,Inyo,027,18085,1404,1404,12,1416,35
2021-05-29,Kern,029,883053,97399,96424,10849,107273,1319
2021-05-29,Kings,031,150075,23163,22970,1074,24044,244
2021-05-29,Lake,033,64148,3538,3515,9,3524,45
2021-05-29,Lassen,035,31185,5216,5171,113,5284,6
2021-05-29,Los Angeles,037,10098052,1207760,1202264,40486,1242750,24359
2021-05-29,Madera,039,155013,16642,16535,927,17462,240
2021-05-29,Marin,041,260295,14119,14071,253,14324,229
2021-05-29,Mariposa,043,17540,434,428,11,439,5
2021-05-29,Mendocino,045,87422,4021,3952,83,4035,47
2021-05-29,Merced,047,269075,31045,31187,1028,32215,456
2021-05-29,Modoc,049,8938,377,374,130,504,3
2021-05-29,Mono,051,14174,1264,1275,17,1292,3
2021-05-29,Monterey,053,433212,43183,43042,1832,44874,379
2021-05-29,Napa,055,140530,9896,9948,35,9983,82
2021-05-29,Nevada,057,99092,4841,4816,190,5006,72
2021-05-29,Orange,059,3164182,255631,254537,11248,265785,5049
2021-05-29,Placer,061,380077,23354,23009,1493,24502,293
2021-05-29,Plumas,063,18699,708,689,11,700,4
2021-05-29,Riverside,065,2383286,294283,288908,13867,302775,4442
2021-05-29,Sacramento,067,1510023,106496,106218,1746,107964,1643
2021-05-29,San Benito,069,59416,6055,6072,112,6184,63
2021-05-29,San Bernardino,071,2135413,293401,292961,8909,301870,4757
2021-05-29,San Diego,073,3302833,281100,280151,14995,295146,3756
2021-05-29,San Francisco,075,870044,36771,37008,1271,38279,550
2021-05-29,San Joaquin,077,732212,73285,72827,3498,76325,1383
2021-05-29,San Luis Obispo,079,281455,21424,21201,736,21937,256
2021-05-29,San Mateo,081,765935,42359,42375,468,42843,439
2021-05-29,Santa Barbara,083,443738,34461,34367,1113,35480,456
2021-05-29,Santa Clara,085,1922200,118711,119498,744,120242,2056
2021-05-29,Santa Cruz,087,273765,16250,16137,797,16934,207
2021-05-29,Shasta,089,179085,12354,12401,1572,13973,199
2021-05-29,Sierra,091,2930,57,55,12,67,0
2021-05-29,Siskiyou,093,43540,1937,1856,355,2211,21
2021-05-29,Solano,095,438530,32936,32917,552,33469,256
2021-05-29,Sonoma,097,501317,30170,30298,333,30631,322
2021-05-29,Stanislaus,099,539301,56482,56305,5882,62187,974
2021-05-29,Sutter,101,95872,9475,9516,84,9600,111
2021-05-29,Tehama,103,63373,5097,5070,570,5640,63
2021-05-29,Trinity,105,12862,483,328,91,419,3
2021-05-29,Tulare,107,460477,50258,49392,8901,58293,845
2021-05-29,Tuolumne,109,53932,4039,4093,43,4136,63
2021-05-29,Ventura,111,848112,81429,81008,2953,83961,1021
2021-05-29,Yolo,113,214977,14037,14055,239,14294,210
2021-05-29,Yuba,115,75493,6076,6059,122,6181,48
2021-05-28,Alameda,001,1643700,88235,88391,1912,90303,1261
2021-05-28,Alpine,003,1148,87,88,0,88,0
2021-05-28,Amador,005,37829,3678,3680,32,3712,46
2021-05-28,Butte,007,227075,12553,12407,1842,14249,190
2021-05-28,Calaveras,009,45235,2168,2165,13,2178,55
2021-05-28,Colusa,011,21464,1949,1954,310,2264,15
2021-05-28,Contra Costa,013,1133247,69736,69290,1264,70554,813
2021-05-28,Del Norte,015,27424,1418,1390,13,1403,8
2021-05-28,El Dorado,017,186661,10326,10265,742,11007,110
2021-05-28,Fresno,019,978130,102793,102437,8599,111036,1705
2021-05-28,Glenn,021,27897,2436,2419,555,2974,18
2021-05-28,Humboldt,023,135768,4286,4265,38,4303,42
2021-05-28,Imperial,025,180216,28630,28722,2682,31404,736
2021-05-28,Inyo,027,18085,1404,1404,12,1416,35
2021-05-28,Kern,029,883053,97382,96396,10841,107237,1320
2021-05-28,Kings,031,150075,23161,22962,1074,24036,244
2021-05-28,Lake,033,64148,3536,3515,9,3524,45
2021-05-28,Lassen,035,31185,5216,5169,113,5282,6
2021-05-28,Los Angeles,037,10098052,1207649,1202103,40476,1242579,24357
2021-05-28,Madera,039,155013,16640,16530,927,17457,240
2021-05-28,Marin,041,260295,14118,14063,252,14315,229
2021-05-28,Mariposa,043,17540,434,428,11,439,5
2021-05-28,Mendocino,045,87422,4016,3947,83,4030,47
2021-05-28,Merced,047,269075,31042,31176,1028,32204,455
2021-05-28,Modoc,049,8938,377,374,130,504,3
2021-05-28,Mono,051,14174,1264,1274,17,1291,3
2021-05-28,Monterey,053,433212,43182,43036,1832,44868,379
2021-05-28,Napa,055,140530,9896,9941,35,9976,82
2021-05-28,Nevada,057,99092,4839,4813,190,5003,71
2021-05-28,Orange,059,3164182,255611,254494,11246,265740,5047
2021-05-28,Placer,061,380077,23344,22987,1491,24478,293
2021-05-28,Plumas,063,18699,706,688,11,699,4
2021-05-28,Riverside,065,2383286,294261,288872,13865,302737,4442
2021-05-28,Sacramento,067,1510023,106440,106131,1744,107875,1642
2021-05-28,San Benito,069,59416,6055,6074,112,6186,63
2021-05-28,San Bernardino,071,2135413,293378,292905,8909,301814,4757
2021-05-28,San Diego,073,3302833,281037,280043,14984,295027,3756
2021-05-28,San Francisco,075,870044,36765,36987,1271,38258,546
2021-05-28,San Joaquin,077,732212,73255,72793,3496,76289,1383
2021-05-28,San Luis Obispo,079,281455,21419,21190,734,21924,256
2021-05-28,San Mateo,081,765935,42353,42364,468,42832,439
2021-05-28,Santa Barbara,083,443738,34460,34371,1113,35484,455
2021-05-28,Santa Clara,085,1922200,118687,119462,744,120206,2056
2021-05-28,Santa Cruz,087,273765,16249,16129,797,16926,207
2021-05-28,Shasta,089,179085,12345,12383,1570,13953,198
2021-05-28,Sierra,091,2930,57,54,12,66,0
2021-05-28,Siskiyou,093,43540,1935,1850,355,2205,19
2021-05-28,Solano,095,438530,32921,32892,552,33444,256
2021-05-28,Sonoma,097,501317,30151,30270,333,30603,321
2021-05-28,Stanislaus,099,539301,56463,56278,5879,62157,974
2021-05-28,Sutter,101,95872,9471,9511,84,9595,111
2021-05-28,Tehama,103,63373,5091,5064,570,5634,63
2021-05-28,Trinity,105,12862,483,328,91,419,3
2021-05-28,Tulare,107,460477,50253,49375,8892,58267,846
2021-05-28,Tuolumne,109,53932,4039,4090,43,4133,63
2021-05-28,Ventura,111,848112,81418,80985,2952,83937,1021
2021-05-28,Yolo,113,214977,14034,14050,238,14288,210
2021-05-28,Yuba,115,75493,6074,6050,121,6171,48
2021-05-27,Alameda,001,1643700,88200,88342,1912,90254,1274
2021-05-27,Alpine,003,1148,87,88,0,88,0
2021-05-27,Amador,005,37829,3675,3680,32,3712,46
2021-05-27,Butte,007,227075,12548,12401,1841,14242,190
2021-05-27,Calaveras,009,45235,2167,2163,13,2176,55
2021-05-27,Colusa,011,21464,1946,1952,310,2262,15
2021-05-27,Contra Costa,013,1133247,69694,69245,1262,70507,813
2021-05-27,Del Norte,015,27424,1418,1388,13,1401,8
2021-05-27,El Dorado,017,186661,10325,10248,742,10990,112
2021-05-27,Fresno,019,978130,102776,102413,8596,111009,1704
2021-05-27,Glenn,021,27897,2436,2415,555,2970,18
2021-05-27,Humboldt,023,135768,4278,4260,38,4298,42
2021-05-27,Imperial,025,180216,28619,28728,2682,31410,736
2021-05-27,Inyo,027,18085,1404,1404,12,1416,35
2021-05-27,Kern,029,883053,97366,96364,10833,107197,1322
2021-05-27,Kings,031,150075,23158,22953,1074,24027,245
2021-05-27,Lake,033,64148,3531,3509,9,3518,45
2021-05-27,Lassen,035,31185,5215,5170,112,5282,6
2021-05-27,Los Angeles,037,10098052,1207479,1201927,40463,1242390,24348
2021-05-27,Madera,039,155013,16631,16527,927,17454,240
2021-05-27,Marin,041,260295,14114,14061,252,14313,229
2021-05-27,Mariposa,043,17540,432,427,11,438,5
2021-05-27,Mendocino,045,87422,4010,3945,83,4028,47
2021-05-27,Merced,047,269075,31030,31161,1028,32189,455
2021-05-27,Modoc,049,8938,376,374,130,504,3
2021-05-27,Mono,051,14174,1264,1276,17,1293,3
2021-05-27,Monterey,053,433212,43176,43032,1832,44864,379
2021-05-27,Napa,055,140530,9895,9934,35,9969,82
2021-05-27,Nevada,057,99092,4835,4807,188,4995,71
2021-05-27,Orange,059,3164182,255574,254438,11242,265680,5059
2021-05-27,Placer,061,380077,23335,22966,1491,24457,293
2021-05-27,Plumas,063,18699,706,687,11,698,4
2021-05-27,Riverside,065,2383286,294225,288835,13860,302695,4443
2021-05-27,Sacramento,067,1510023,106365,106015,1742,107757,1642
2021-05-27,San Benito,069,59416,6054,6074,112,6186,63
2021-05-27,San Bernardino,071,2135413,293342,292755,8907,301662,4756
2021-05-27,San Diego,073,3302833,280963,279960,14970,294930,3756
2021-05-27,San Francisco,075,870044,36759,36980,1268,38248,546
2021-05-27,San Joaquin,077,732212,73223,72714,3493,76207,1388
2021-05-27,San Luis Obispo,079,281455,21414,21171,734,21905,256
2021-05-27,San Mateo,081,765935,42344,42345,468,42813,436
2021-05-27,Santa Barbara,083,443738,34455,34355,1113,35468,456
2021-05-27,Santa Clara,085,1922200,118666,119452,744,120196,2053
2021-05-27,Santa Cruz,087,273765,16247,16134,797,16931,207
2021-05-27,Shasta,089,179085,12335,12380,1570,13950,202
2021-05-27,Sierra,091,2930,57,54,12,66,0
2021-05-27,Siskiyou,093,43540,1932,1846,355,2201,18
2021-05-27,Solano,095,438530,32880,32855,551,33406,257
2021-05-27,Sonoma,097,501317,30124,30253,329,30582,321
2021-05-27,Stanislaus,099,539301,56438,56207,5878,62085,974
2021-05-27,Sutter,101,95872,9467,9501,84,9585,111
2021-05-27,Tehama,103,63373,5088,5064,569,5633,63
2021-05-27,Trinity,105,12862,483,328,91,419,3
2021-05-27,Tulare,107,460477,50239,49366,8883,58249,840
2021-05-27,Tuolumne,109,53932,4038,4090,43,4133,66
2021-05-27,Ventura,111,848112,81405,80965,2949,83914,1023
2021-05-27,Yolo,113,214977,14031,14036,238,14274,213
2021-05-27,Yuba,115,75493,6069,6040,120,6160,48
2021-05-26,Alameda,001,1643700,88171,88297,1912,90209,1266
2021-05-26,Alpine,003,1148,87,88,0,88,0
2021-05-26,Amador,005,37829,3675,3679,32,3711,46
2021-05-26,Butte,007,227075,12539,12332,1840,14172,190
2021-05-26,Calaveras,009,45235,2166,2154,13,2167,55
2021-05-26,Colusa,011,21464,1945,1952,310,2262,15
2021-05-26,Contra Costa,013,1133247,69657,69210,1262,70472,812
2021-05-26,Del Norte,015,27424,1418,1386,12,1398,8
2021-05-26,El Dorado,017,186661,10321,10242,741,10983,112
2021-05-26,Fresno,019,978130,102743,102374,8591,110965,1702
2021-05-26,Glenn,021,27897,2435,2415,555,2970,18
2021-05-26,Humboldt,023,135768,4273,4246,38,4284,42
2021-05-26,Imperial,025,180216,28614,28712,2680,31392,734
2021-05-26,Inyo,027,18085,1404,1403,12,1415,36
2021-05-26,Kern,029,883053,97341,96343,10826,107169,1320
2021-05-26,Kings,031,150075,23154,22950,1073,24023,245
2021-05-26,Lake,033,64148,3530,3508,9,3517,45
2021-05-26,Lassen,035,31185,5214,5164,112,5276,6
2021-05-26,Los Angeles,037,10098052,1207311,1198100,40447,1238547,24221
2021-05-26,Madera,039,155013,16628,16520,927,17447,240
2021-05-26,Marin,041,260295,14111,14061,251,14312,227
2021-05-26,Mariposa,043,17540,432,427,11,438,5
2021-05-26,Mendocino,045,87422,4004,3938,83,4021,47
2021-05-26,Merced,047,269075,31021,31139,1028,32167,455
2021-05-26,Modoc,049,8938,376,371,129,500,3
2021-05-26,Mono,051,14174,1264,1274,17,1291,3
2021-05-26,Monterey,053,433212,43170,43018,1831,44849,379
2021-05-26,Napa,055,140530,9888,9932,33,9965,82
2021-05-26,Nevada,057,99092,4830,4803,188,4991,70
2021-05-26,Orange,059,3164182,255538,254368,11239,265607,5058
2021-05-26,Placer,061,380077,23311,22940,1491,24431,293
2021-05-26,Plumas,063,18699,705,685,11,696,4
2021-05-26,Riverside,065,2383286,294179,288782,13853,302635,4443
2021-05-26,Sacramento,067,1510023,106279,105919,1738,107657,1637
2021-05-26,San Benito,069,59416,6054,6074,112,6186,63
2021-05-26,San Bernardino,071,2135413,293307,292662,8906,301568,4755
2021-05-26,San Diego,073,3302833,280888,279859,14960,294819,3755
2021-05-26,San Francisco,075,870044,36747,36954,1268,38222,546
2021-05-26,San Joaquin,077,732212,73181,72681,3490,76171,1388
2021-05-26,San Luis Obispo,079,281455,21408,21163,734,21897,256
2021-05-26,San Mateo,081,765935,42335,42331,468,42799,436
2021-05-26,Santa Barbara,083,443738,34446,34348,1113,35461,459
2021-05-26,Santa Clara,085,1922200,118639,119421,743,120164,2031
2021-05-26,Santa Cruz,087,273765,16246,16139,797,16936,207
2021-05-26,Shasta,089,179085,12320,12357,1567,13924,202
2021-05-26,Sierra,091,2930,57,54,12,66,0
2021-05-26,Siskiyou,093,43540,1930,1847,353,2200,18
2021-05-26,Solano,095,438530,32844,32831,551,33382,257
2021-05-26,Sonoma,097,501317,30097,30230,329,30559,321
2021-05-26,Stanislaus,099,539301,56416,56193,5876,62069,974
2021-05-26,Sutter,101,95872,9462,9495,84,9579,112
2021-05-26,Tehama,103,63373,5087,5054,566,5620,63
2021-05-26,Trinity,105,12862,483,328,91,419,3
2021-05-26,Tulare,107,460477,50232,49352,8879,58231,839
2021-05-26,Tuolumne,109,53932,4034,4088,42,4130,66
2021-05-26,Ventura,111,848112,81382,80944,2947,83891,1023
2021-05-26,Yolo,113,214977,14028,14025,238,14263,213
2021-05-26,Yuba,115,75493,6064,6036,120,6156,49
2021-05-25,Alameda,001,1643700,88140,88237,1912,90149,1263
2021-05-25,Alpine,003,1148,87,88,0,88,0
2021-05-25,Amador,005,37829,3670,3676,32,3708,46
2021-05-25,Butte,007,227075,12528,12295,1839,14134,189
2021-05-25,Calaveras,009,45235,2164,2148,13,2161,55
2021-05-25,Colusa,011,21464,1944,1949,310,2259,15
2021-05-25,Contra Costa,013,1133247,69605,69167,1257,70424,809
2021-05-25,Del Norte,015,27424,1418,1385,12,1397,8
2021-05-25,El Dorado,017,186661,10314,10240,740,10980,112
2021-05-25,Fresno,019,978130,102722,102329,8590,110919,1701
2021-05-25,Glenn,021,27897,2434,2414,554,2968,17
2021-05-25,Humboldt,023,135768,4266,4231,36,4267,42
2021-05-25,Imperial,025,180216,28607,28586,2680,31266,735
2021-05-25,Inyo,027,18085,1404,1402,12,1414,36
2021-05-25,Kern,029,883053,97310,96319,10812,107131,1319
2021-05-25,Kings,031,150075,23147,22944,1073,24017,245
2021-05-25,Lake,033,64148,3529,3508,9,3517,44
2021-05-25,Lassen,035,31185,5210,5164,112,5276,6
2021-05-25,Los Angeles,037,10098052,1207124,1197940,40429,1238369,24212
2021-05-25,Madera,039,155013,16623,16519,926,17445,240
2021-05-25,Marin,041,260295,14105,14053,251,14304,227
2021-05-25,Mariposa,043,17540,431,427,11,438,5
2021-05-25,Mendocino,045,87422,3999,3928,83,4011,47
2021-05-25,Merced,047,269075,31000,31132,1028,32160,455
2021-05-25,Modoc,049,8938,375,367,129,496,3
2021-05-25,Mono,051,14174,1264,1274,17,1291,3
2021-05-25,Monterey,053,433212,43166,43012,1830,44842,379
2021-05-25,Napa,055,140530,9886,9926,33,9959,82
2021-05-25,Nevada,057,99092,4824,4795,188,4983,70
2021-05-25,Orange,059,3164182,255509,254321,11238,265559,5057
2021-05-25,Placer,061,380077,23300,22920,1489,24409,292
2021-05-25,Plumas,063,18699,705,684,11,695,4
2021-05-25,Riverside,065,2383286,294140,288725,13850,302575,4443
2021-05-25,Sacramento,067,1510023,106198,105828,1735,107563,1633
2021-05-25,San Benito,069,59416,6054,6073,112,6185,63
2021-05-25,San Bernardino,071,2135413,293247,292485,8904,301389,4755
2021-05-25,San Diego,073,3302833,280806,279786,14955,294741,3753
2021-05-25,San Francisco,075,870044,36724,36939,1268,38207,546
2021-05-25,San Joaquin,077,732212,73139,72628,3487,76115,1387
2021-05-25,San Luis Obispo,079,281455,21405,21153,734,21887,256
2021-05-25,San Mateo,081,765935,42325,42268,468,42736,435
2021-05-25,Santa Barbara,083,443738,34443,34337,1113,35450,459
2021-05-25,Santa Clara,085,1922200,118615,119393,742,120135,2032
2021-05-25,Santa Cruz,087,273765,16241,16141,797,16938,207
2021-05-25,Shasta,089,179085,12311,12328,1565,13893,202
2021-05-25,Sierra,091,2930,56,54,12,66,0
2021-05-25,Siskiyou,093,43540,1929,1845,352,2197,18
2021-05-25,Solano,095,438530,32824,32817,550,33367,256
2021-05-25,Sonoma,097,501317,30068,30207,328,30535,321
2021-05-25,Stanislaus,099,539301,56380,56168,5873,62041,974
2021-05-25,Sutter,101,95872,9458,9495,84,9579,112
2021-05-25,Tehama,103,63373,5085,5048,565,5613,63
2021-05-25,Trinity,105,12862,483,328,90,418,3
2021-05-25,Tulare,107,460477,50222,49326,8871,58197,838
2021-05-25,Tuolumne,109,53932,4034,4084,42,4126,66
2021-05-25,Ventura,111,848112,81364,80905,2947,83852,1022
2021-05-25,Yolo,113,214977,14020,14018,236,14254,213
2021-05-25,Yuba,115,75493,6057,6028,120,6148,49
2021-05-24,Alameda,001,1643700,88100,88182,1910,90092,1263
2021-05-24,Alpine,003,1148,87,88,0,88,0
2021-05-24,Amador,005,37829,3668,3675,32,3707,46
2021-05-24,Butte,007,227075,12515,12279,1836,14115,189
2021-05-24,Calaveras,009,45235,2162,2146,13,2159,54
2021-05-24,Colusa,011,21464,1944,1949,310,2259,15
2021-05-24,Contra Costa,013,1133247,69564,69107,1253,70360,809
2021-05-24,Del Norte,015,27424,1417,1384,12,1396,8
2021-05-24,El Dorado,017,186661,10304,10227,739,10966,112
2021-05-24,Fresno,019,978130,102680,102289,8589,110878,1698
2021-05-24,Glenn,021,27897,2434,2413,554,2967,17
2021-05-24,Humboldt,023,135768,4259,4225,36,4261,42
2021-05-24,Imperial,025,180216,28605,28575,2680,31255,735
2021-05-24,Inyo,027,18085,1404,1402,12,1414,36
2021-05-24,Kern,029,883053,97283,96296,10807,107103,1319
2021-05-24,Kings,031,150075,23143,22940,1073,24013,246
2021-05-24,Lake,033,64148,3527,3506,9,3515,43
2021-05-24,Lassen,035,31185,5206,5163,112,5275,6
2021-05-24,Los Angeles,037,10098052,1206952,1197782,40415,1238197,24201
2021-05-24,Madera,039,155013,16619,16513,925,17438,239
2021-05-24,Marin,041,260295,14103,14051,251,14302,227
2021-05-24,Mariposa,043,17540,430,427,11,438,5
2021-05-24,Mendocino,045,87422,3997,3919,83,4002,47
2021-05-24,Merced,047,269075,30990,31128,1027,32155,455
2021-05-24,Modoc,049,8938,375,366,128,494,3
2021-05-24,Mono,051,14174,1264,1270,17,1287,3
2021-05-24,Monterey,053,433212,43161,43005,1829,44834,379
2021-05-24,Napa,055,140530,9886,9924,33,9957,82
2021-05-24,Nevada,057,99092,4821,4790,188,4978,70
2021-05-24,Orange,059,3164182,255475,254287,11228,265515,5056
2021-05-24,Placer,061,380077,23281,22895,1488,24383,292
2021-05-24,Plumas,063,18699,704,683,11,694,4
2021-05-24,Riverside,065,2383286,294083,288669,13840,302509,4442
2021-05-24,Sacramento,067,1510023,106083,105716,1734,107450,1632
2021-05-24,San Benito,069,59416,6054,6072,112,6184,63
2021-05-24,San Bernardino,071,2135413,293207,292343,8903,301246,4747
2021-05-24,San Diego,073,3302833,280698,279715,14945,294660,3749
2021-05-24,San Francisco,075,870044,36704,36934,1265,38199,547
2021-05-24,San Joaquin,077,732212,73107,72586,3487,76073,1371
2021-05-24,San Luis Obispo,079,281455,21387,21146,733,21879,256
2021-05-24,San Mateo,081,765935,42315,42249,468,42717,433
2021-05-24,Santa Barbara,083,443738,34438,34322,1113,35435,459
2021-05-24,Santa Clara,085,1922200,118583,119358,742,120100,2030
2021-05-24,Santa Cruz,087,273765,16235,16135,797,16932,207
2021-05-24,Shasta,089,179085,12294,12315,1562,13877,201
2021-05-24,Sierra,091,2930,56,54,12,66,0
2021-05-24,Siskiyou,093,43540,1926,1840,352,2192,17
2021-05-24,Solano,095,438530,32800,32792,549,33341,254
2021-05-24,Sonoma,097,501317,30053,30187,328,30515,321
2021-05-24,Stanislaus,099,539301,56346,56128,5869,61997,974
2021-05-24,Sutter,101,95872,9452,9486,84,9570,113
2021-05-24,Tehama,103,63373,5082,5043,563,5606,63
2021-05-24,Trinity,105,12862,483,328,90,418,3
2021-05-24,Tulare,107,460477,50215,49318,8867,58185,838
2021-05-24,Tuolumne,109,53932,4034,4083,42,4125,65
2021-05-24,Ventura,111,848112,81351,80876,2945,83821,1022
2021-05-24,Yolo,113,214977,14003,14012,234,14246,213
2021-05-24,Yuba,115,75493,6048,6022,120,6142,49
2021-05-23,Alameda,001,1643700,88037,88157,1908,90065,1263
2021-05-23,Alpine,003,1148,87,88,0,88,0
2021-05-23,Amador,005,37829,3667,3673,32,3705,46
2021-05-23,Butte,007,227075,12501,12271,1835,14106,189
2021-05-23,Calaveras,009,45235,2154,2144,13,2157,54
2021-05-23,Colusa,011,21464,1944,1949,308,2257,15
2021-05-23,Contra Costa,013,1133247,69520,69075,1251,70326,809
2021-05-23,Del Norte,015,27424,1413,1383,12,1395,8
2021-05-23,El Dorado,017,186661,10298,10222,739,10961,112
2021-05-23,Fresno,019,978130,102635,102270,8584,110854,1698
2021-05-23,Glenn,021,27897,2432,2413,554,2967,17
2021-05-23,Humboldt,023,135768,4241,4216,36,4252,42
2021-05-23,Imperial,025,180216,28599,28569,2679,31248,735
2021-05-23,Inyo,027,18085,1404,1402,12,1414,36
2021-05-23,Kern,029,883053,97259,96282,10799,107081,1319
2021-05-23,Kings,031,150075,23130,22939,1071,24010,246
2021-05-23,Lake,033,64148,3524,3504,9,3513,43
2021-05-23,Lassen,035,31185,5202,5163,111,5274,6
2021-05-23,Los Angeles,037,10098052,1206763,1197633,40404,1238037,24197
2021-05-23,Madera,039,155013,16613,16504,925,17429,239
2021-05-23,Marin,041,260295,14094,14048,250,14298,227
2021-05-23,Mariposa,043,17540,430,427,11,438,5
2021-05-23,Mendocino,045,87422,3991,3913,82,3995,47
2021-05-23,Merced,047,269075,30981,31118,1027,32145,455
2021-05-23,Modoc,049,8938,371,366,128,494,3
2021-05-23,Mono,051,14174,1263,1270,17,1287,3
2021-05-23,Monterey,053,433212,43151,43003,1829,44832,379
2021-05-23,Napa,055,140530,9882,9923,33,9956,82
2021-05-23,Nevada,057,99092,4811,4790,188,4978,70
2021-05-23,Orange,059,3164182,255437,254277,11222,265499,5050
2021-05-23,Placer,061,380077,23261,22888,1488,24376,292
2021-05-23,Plumas,063,18699,703,683,11,694,4
2021-05-23,Riverside,065,2383286,294015,288641,13836,302477,4442
2021-05-23,Sacramento,067,1510023,105967,105663,1731,107394,1632
2021-05-23,San Benito,069,59416,6053,6072,112,6184,63
2021-05-23,San Bernardino,071,2135413,293156,292327,8902,301229,4747
2021-05-23,San Diego,073,3302833,280608,279690,14934,294624,3751
2021-05-23,San Francisco,075,870044,36693,36927,1264,38191,547
2021-05-23,San Joaquin,077,732212,73058,72571,3485,76056,1371
2021-05-23,San Luis Obispo,079,281455,21377,21141,732,21873,256
2021-05-23,San Mateo,081,765935,42298,42248,468,42716,433
2021-05-23,Santa Barbara,083,443738,34431,34319,1113,35432,459
2021-05-23,Santa Clara,085,1922200,118559,119333,742,120075,2030
2021-05-23,Santa Cruz,087,273765,16232,16130,797,16927,207
2021-05-23,Shasta,089,179085,12277,12313,1558,13871,201
2021-05-23,Sierra,091,2930,56,54,12,66,0
2021-05-23,Siskiyou,093,43540,1921,1826,345,2171,17
2021-05-23,Solano,095,438530,32782,32780,548,33328,254
2021-05-23,Sonoma,097,501317,30024,30168,327,30495,321
2021-05-23,Stanislaus,099,539301,56298,56104,5866,61970,974
2021-05-23,Sutter,101,95872,9443,9479,84,9563,113
2021-05-23,Tehama,103,63373,5075,5041,561,5602,63
2021-05-23,Trinity,105,12862,483,328,90,418,3
2021-05-23,Tulare,107,460477,50201,49310,8863,58173,838
2021-05-23,Tuolumne,109,53932,4031,4081,42,4123,65
2021-05-23,Ventura,111,848112,81321,80872,2944,83816,1022
2021-05-23,Yolo,113,214977,13991,14004,231,14235,213
2021-05-23,Yuba,115,75493,6043,6017,120,6137,49
2021-05-22,Alameda,001,1643700,88010,88101,1908,90009,1263
2021-05-22,Alpine,003,1148,87,88,0,88,0
2021-05-22,Amador,005,37829,3666,3672,32,3704,46
2021-05-22,Butte,007,227075,12489,12265,1834,14099,189
2021-05-22,Calaveras,009,45235,2150,2141,13,2154,54
2021-05-22,Colusa,011,21464,1940,1949,307,2256,15
2021-05-22,Contra Costa,013,1133247,69487,69004,1250,70254,809
2021-05-22,Del Norte,015,27424,1412,1381,12,1393,8
2021-05-22,El Dorado,017,186661,10293,10215,738,10953,112
2021-05-22,Fresno,019,978130,102621,102238,8582,110820,1698
2021-05-22,Glenn,021,27897,2432,2412,554,2966,17
2021-05-22,Humboldt,023,135768,4232,4194,35,4229,42
2021-05-22,Imperial,025,180216,28590,28574,2679,31253,735
2021-05-22,Inyo,027,18085,1404,1402,12,1414,36
2021-05-22,Kern,029,883053,97247,96260,10792,107052,1319
2021-05-22,Kings,031,150075,23130,22936,1071,24007,246
2021-05-22,Lake,033,64148,3521,3502,9,3511,43
2021-05-22,Lassen,035,31185,5202,5163,111,5274,6
2021-05-22,Los Angeles,037,10098052,1206654,1197454,40396,1237850,24192
2021-05-22,Madera,039,155013,16610,16503,925,17428,239
2021-05-22,Marin,041,260295,14091,14043,250,14293,227
2021-05-22,Mariposa,043,17540,430,427,11,438,5
2021-05-22,Mendocino,045,87422,3985,3908,82,3990,47
2021-05-22,Merced,047,269075,30971,31099,1027,32126,455
2021-05-22,Modoc,049,8938,371,366,128,494,3
2021-05-22,Mono,051,14174,1261,1270,17,1287,3
2021-05-22,Monterey,053,433212,43145,42998,1829,44827,379
2021-05-22,Napa,055,140530,9881,9918,33,9951,82
2021-05-22,Nevada,057,99092,4804,4787,187,4974,70
2021-05-22,Orange,059,3164182,255416,254238,11217,265455,5048
2021-05-22,Placer,061,380077,23247,22865,1487,24352,292
2021-05-22,Plumas,063,18699,702,683,11,694,4
2021-05-22,Riverside,065,2383286,293983,288580,13835,302415,4442
2021-05-22,Sacramento,067,1510023,105892,105551,1728,107279,1632
2021-05-22,San Benito,069,59416,6053,6071,112,6183,63
2021-05-22,San Bernardino,071,2135413,293131,292292,8902,301194,4747
2021-05-22,San Diego,073,3302833,280549,279614,14926,294540,3751
2021-05-22,San Francisco,075,870044,36683,36906,1262,38168,547
2021-05-22,San Joaquin,077,732212,73036,72528,3482,76010,1371
2021-05-22,San Luis Obispo,079,281455,21369,21134,731,21865,256
2021-05-22,San Mateo,081,765935,42288,42218,468,42686,433
2021-05-22,Santa Barbara,083,443738,34427,34313,1112,35425,459
2021-05-22,Santa Clara,085,1922200,118536,119292,742,120034,2030
2021-05-22,Santa Cruz,087,273765,16232,16125,797,16922,207
2021-05-22,Shasta,089,179085,12270,12307,1555,13862,201
2021-05-22,Sierra,091,2930,56,54,12,66,0
2021-05-22,Siskiyou,093,43540,1920,1824,344,2168,17
2021-05-22,Solano,095,438530,32769,32753,548,33301,254
2021-05-22,Sonoma,097,501317,30012,30154,327,30481,321
2021-05-22,Stanislaus,099,539301,56274,56069,5865,61934,974
2021-05-22,Sutter,101,95872,9438,9476,84,9560,113
2021-05-22,Tehama,103,63373,5074,5036,561,5597,63
2021-05-22,Trinity,105,12862,483,328,90,418,3
2021-05-22,Tulare,107,460477,50196,49299,8858,58157,838
2021-05-22,Tuolumne,109,53932,4031,4078,42,4120,65
2021-05-22,Ventura,111,848112,81317,80859,2944,83803,1022
2021-05-22,Yolo,113,214977,13989,13997,231,14228,213
2021-05-22,Yuba,115,75493,6040,6010,120,6130,49
2021-05-21,Alameda,001,1643700,87984,88041,1907,89948,1263
2021-05-21,Alpine,003,1148,87,88,0,88,0
2021-05-21,Amador,005,37829,3663,3672,32,3704,46
2021-05-21,Butte,007,227075,12483,12236,1832,14068,188
2021-05-21,Calaveras,009,45235,2148,2138,13,2151,54
2021-05-21,Colusa,011,21464,1940,1947,307,2254,15
2021-05-21,Contra Costa,013,1133247,69444,68965,1249,70214,810
2021-05-21,Del Norte,015,27424,1411,1376,12,1388,8
2021-05-21,El Dorado,017,186661,10289,10204,738,10942,112
2021-05-21,Fresno,019,978130,102593,102189,8580,110769,1698
2021-05-21,Glenn,021,27897,2431,2408,554,2962,17
2021-05-21,Humboldt,023,135768,4225,4175,35,4210,42
2021-05-21,Imperial,025,180216,28583,28572,2678,31250,732
2021-05-21,Inyo,027,18085,1404,1402,12,1414,36
2021-05-21,Kern,029,883053,97233,96233,10785,107018,1318
2021-05-21,Kings,031,150075,23130,22927,1071,23998,246
2021-05-21,Lake,033,64148,3519,3500,9,3509,43
2021-05-21,Lassen,035,31185,5201,5161,111,5272,6
2021-05-21,Los Angeles,037,10098052,1206536,1197263,40388,1237651,24180
2021-05-21,Madera,039,155013,16609,16500,924,17424,238
2021-05-21,Marin,041,260295,14086,14042,250,14292,227
2021-05-21,Mariposa,043,17540,429,427,11,438,5
2021-05-21,Mendocino,045,87422,3980,3897,82,3979,47
2021-05-21,Merced,047,269075,30963,31076,1027,32103,455
2021-05-21,Modoc,049,8938,371,365,128,493,3
2021-05-21,Mono,051,14174,1261,1269,17,1286,3
2021-05-21,Monterey,053,433212,43143,42995,1829,44824,379
2021-05-21,Napa,055,140530,9877,9913,33,9946,82
2021-05-21,Nevada,057,99092,4803,4779,187,4966,70
2021-05-21,Orange,059,3164182,255396,254171,11215,265386,5042
2021-05-21,Placer,061,380077,23238,22853,1487,24340,292
2021-05-21,Plumas,063,18699,702,683,10,693,4
2021-05-21,Riverside,065,2383286,293956,288499,13828,302327,4442
2021-05-21,Sacramento,067,1510023,105824,105476,1725,107201,1632
2021-05-21,San Benito,069,59416,6053,6068,112,6180,63
2021-05-21,San Bernardino,071,2135413,293099,292205,8900,301105,4744
2021-05-21,San Diego,073,3302833,280476,279554,14916,294470,3748
2021-05-21,San Francisco,075,870044,36678,36879,1262,38141,546
2021-05-21,San Joaquin,077,732212,73016,72467,3480,75947,1371
2021-05-21,San Luis Obispo,079,281455,21363,21128,728,21856,256
2021-05-21,San Mateo,081,765935,42275,42163,467,42630,432
2021-05-21,Santa Barbara,083,443738,34422,34302,1112,35414,459
2021-05-21,Santa Clara,085,1922200,118509,119247,742,119989,2029
2021-05-21,Santa Cruz,087,273765,16228,16120,797,16917,207
2021-05-21,Shasta,089,179085,12253,12289,1553,13842,201
2021-05-21,Sierra,091,2930,56,54,12,66,0
2021-05-21,Siskiyou,093,43540,1919,1815,344,2159,16
2021-05-21,Solano,095,438530,32754,32742,548,33290,254
2021-05-21,Sonoma,097,501317,29999,30126,327,30453,321
2021-05-21,Stanislaus,099,539301,56244,56036,5863,61899,975
2021-05-21,Sutter,101,95872,9436,9470,84,9554,113
2021-05-21,Tehama,103,63373,5068,5030,561,5591,63
2021-05-21,Trinity,105,12862,483,329,89,418,3
2021-05-21,Tulare,107,460477,50191,49271,8856,58127,838
2021-05-21,Tuolumne,109,53932,4029,4079,42,4121,65
2021-05-21,Ventura,111,848112,81309,80821,2941,83762,1021
2021-05-21,Yolo,113,214977,13983,13983,231,14214,213
2021-05-21,Yuba,115,75493,6034,6006,120,6126,49
2021-05-20,Alameda,001,1643700,87941,87975,1905,89880,1264
2021-05-20,Alpine,003,1148,87,88,0,88,0
2021-05-20,Amador,005,37829,3662,3671,32,3703,46
2021-05-20,Butte,007,227075,12476,12220,1829,14049,188
2021-05-20,Calaveras,009,45235,2144,2138,13,2151,54
2021-05-20,Colusa,011,21464,1939,1946,305,2251,15
2021-05-20,Contra Costa,013,1133247,69399,68913,1247,70160,809
2021-05-20,Del Norte,015,27424,1411,1373,12,1385,8
2021-05-20,El Dorado,017,186661,10279,10188,738,10926,112
2021-05-20,Fresno,019,978130,102571,102135,8578,110713,1696
2021-05-20,Glenn,021,27897,2428,2406,554,2960,17
2021-05-20,Humboldt,023,135768,4208,4162,34,4196,42
2021-05-20,Imperial,025,180216,28578,28551,2678,31229,732
2021-05-20,Inyo,027,18085,1404,1402,12,1414,36
2021-05-20,Kern,029,883053,97212,96204,10778,106982,1317
2021-05-20,Kings,031,150075,23128,22922,1071,23993,246
2021-05-20,Lake,033,64148,3516,3500,9,3509,43
2021-05-20,Lassen,035,31185,5199,5160,110,5270,6
2021-05-20,Los Angeles,037,10098052,1206379,1197073,40378,1237451,24168
2021-05-20,Madera,039,155013,16603,16499,922,17421,238
2021-05-20,Marin,041,260295,14082,14036,249,14285,227
2021-05-20,Mariposa,043,17540,429,426,11,437,5
2021-05-20,Mendocino,045,87422,3973,3897,82,3979,47
2021-05-20,Merced,047,269075,30950,31046,1026,32072,454
2021-05-20,Modoc,049,8938,371,365,128,493,3
2021-05-20,Mono,051,14174,1260,1269,17,1286,3
2021-05-20,Monterey,053,433212,43137,42984,1828,44812,379
2021-05-20,Napa,055,140530,9874,9913,33,9946,82
2021-05-20,Nevada,057,99092,4802,4775,187,4962,70
2021-05-20,Orange,059,3164182,255353,254127,11212,265339,5038
2021-05-20,Placer,061,380077,23225,22823,1486,24309,292
2021-05-20,Plumas,063,18699,700,682,10,692,4
2021-05-20,Riverside,065,2383286,293908,288453,13823,302276,4442
2021-05-20,Sacramento,067,1510023,105728,105414,1722,107136,1629
2021-05-20,San Benito,069,59416,6052,6067,112,6179,63
2021-05-20,San Bernardino,071,2135413,293053,292153,8899,301052,4728
2021-05-20,San Diego,073,3302833,280388,279490,14904,294394,3749
2021-05-20,San Francisco,075,870044,36669,36860,1262,38122,546
2021-05-20,San Joaquin,077,732212,72978,72388,3478,75866,1371
2021-05-20,San Luis Obispo,079,281455,21351,21095,726,21821,256
2021-05-20,San Mateo,081,765935,42261,42152,465,42617,432
2021-05-20,Santa Barbara,083,443738,34418,34293,1112,35405,459
2021-05-20,Santa Clara,085,1922200,118488,119222,742,119964,2029
2021-05-20,Santa Cruz,087,273765,16223,16119,797,16916,207
2021-05-20,Shasta,089,179085,12240,12266,1550,13816,200
2021-05-20,Sierra,091,2930,56,54,12,66,0
2021-05-20,Siskiyou,093,43540,1912,1811,343,2154,16
2021-05-20,Solano,095,438530,32739,32725,548,33273,253
2021-05-20,Sonoma,097,501317,29982,30107,326,30433,321
2021-05-20,Stanislaus,099,539301,56215,55979,5861,61840,970
2021-05-20,Sutter,101,95872,9432,9467,84,9551,113
2021-05-20,Tehama,103,63373,5066,5029,561,5590,63
2021-05-20,Trinity,105,12862,483,329,88,417,3
2021-05-20,Tulare,107,460477,50180,49217,8853,58070,837
2021-05-20,Tuolumne,109,53932,4028,4077,42,4119,65
2021-05-20,Ventura,111,848112,81298,80800,2941,83741,1019
2021-05-20,Yolo,113,214977,13978,13973,231,14204,211
2021-05-20,Yuba,115,75493,6025,6002,120,6122,49
2021-05-19,Alameda,001,1643700,87902,87889,1904,89793,1260
2021-05-19,Alpine,003,1148,87,88,0,88,0
2021-05-19,Amador,005,37829,3662,3669,32,3701,46
2021-05-19,Butte,007,227075,12465,12198,1829,14027,188
2021-05-19,Calaveras,009,45235,2140,2132,13,2145,54
2021-05-19,Colusa,011,21464,1939,1945,303,2248,15
2021-05-19,Contra Costa,013,1133247,69352,68836,1247,70083,808
2021-05-19,Del Norte,015,27424,1409,1371,12,1383,8
2021-05-19,El Dorado,017,186661,10274,10179,737,10916,112
2021-05-19,Fresno,019,978130,102540,102085,8575,110660,1693
2021-05-19,Glenn,021,27897,2428,2404,554,2958,17
2021-05-19,Humboldt,023,135768,4198,4143,34,4177,42
2021-05-19,Imperial,025,180216,28569,28550,2678,31228,732
2021-05-19,Inyo,027,18085,1404,1402,12,1414,36
2021-05-19,Kern,029,883053,97183,96173,10771,106944,1316
2021-05-19,Kings,031,150075,23122,22919,1071,23990,246
2021-05-19,Lake,033,64148,3516,3497,9,3506,43
2021-05-19,Lassen,035,31185,5198,5157,110,5267,6
2021-05-19,Los Angeles,037,10098052,1206182,1196856,40364,1237220,24143
2021-05-19,Madera,039,155013,16600,16496,922,17418,238
2021-05-19,Marin,041,260295,14078,14033,247,14280,227
2021-05-19,Mariposa,043,17540,429,425,11,436,5
2021-05-19,Mendocino,045,87422,3969,3886,82,3968,47
2021-05-19,Merced,047,269075,30934,31044,1026,32070,452
2021-05-19,Modoc,049,8938,371,364,125,489,3
2021-05-19,Mono,051,14174,1260,1266,17,1283,3
2021-05-19,Monterey,053,433212,43132,42973,1827,44800,379
2021-05-19,Napa,055,140530,9871,9906,33,9939,82
2021-05-19,Nevada,057,99092,4800,4769,187,4956,70
2021-05-19,Orange,059,3164182,255316,254087,11202,265289,5035
2021-05-19,Placer,061,380077,23206,22784,1481,24265,291
2021-05-19,Plumas,063,18699,700,682,10,692,4
2021-05-19,Riverside,065,2383286,293862,288398,13821,302219,4442
2021-05-19,Sacramento,067,1510023,105649,105225,1721,106946,1629
2021-05-19,San Benito,069,59416,6051,6064,112,6176,63
2021-05-19,San Bernardino,071,2135413,293009,292078,8896,300974,4725
2021-05-19,San Diego,073,3302833,280303,279345,14883,294228,3746
2021-05-19,San Francisco,075,870044,36656,36835,1261,38096,546
2021-05-19,San Joaquin,077,732212,72935,72338,3473,75811,1369
2021-05-19,San Luis Obispo,079,281455,21343,21085,725,21810,256
2021-05-19,San Mateo,081,765935,42254,42126,465,42591,429
2021-05-19,Santa Barbara,083,443738,34410,34292,1112,35404,459
2021-05-19,Santa Clara,085,1922200,118448,119176,741,119917,2015
2021-05-19,Santa Cruz,087,273765,16219,16121,796,16917,207
2021-05-19,Shasta,089,179085,12222,12233,1547,13780,200
2021-05-19,Sierra,091,2930,56,54,12,66,0
2021-05-19,Siskiyou,093,43540,1909,1803,342,2145,16
2021-05-19,Solano,095,438530,32712,32678,546,33224,253
2021-05-19,Sonoma,097,501317,29967,30080,326,30406,321
2021-05-19,Stanislaus,099,539301,56195,55912,5856,61768,967
2021-05-19,Sutter,101,95872,9425,9459,83,9542,113
2021-05-19,Tehama,103,63373,5057,5026,557,5583,63
2021-05-19,Trinity,105,12862,483,329,88,417,3
2021-05-19,Tulare,107,460477,50167,49163,8848,58011,837
2021-05-19,Tuolumne,109,53932,4028,4074,42,4116,64
2021-05-19,Ventura,111,848112,81283,80747,2940,83687,1019
2021-05-19,Yolo,113,214977,13972,13961,230,14191,211
2021-05-19,Yuba,115,75493,6021,5993,120,6113,49
2021-05-18,Alameda,001,1643700,87828,87816,1904,89720,1254
2021-05-18,Alpine,003,1148,87,88,0,88,0
2021-05-18,Amador,005,37829,3662,3669,32,3701,46
2021-05-18,Butte,007,227075,12452,12164,1826,13990,191
2021-05-18,Calaveras,009,45235,2136,2131,13,2144,54
2021-05-18,Colusa,011,21464,1939,1943,303,2246,14
2021-05-18,Contra Costa,013,1133247,69295,68750,1246,69996,808
2021-05-18,Del Norte,015,27424,1406,1371,12,1383,8
2021-05-18,El Dorado,017,186661,10263,10169,736,10905,112
2021-05-18,Fresno,019,978130,102504,102056,8572,110628,1690
2021-05-18,Glenn,021,27897,2422,2403,553,2956,17
2021-05-18,Humboldt,023,135768,4180,4132,34,4166,42
2021-05-18,Imperial,025,180216,28564,28538,2676,31214,730
2021-05-18,Inyo,027,18085,1404,1401,12,1413,36
2021-05-18,Kern,029,883053,97150,96128,10757,106885,1315
2021-05-18,Kings,031,150075,23116,22916,1071,23987,247
2021-05-18,Lake,033,64148,3514,3495,9,3504,43
2021-05-18,Lassen,035,31185,5197,5157,109,5266,6
2021-05-18,Los Angeles,037,10098052,1206002,1196668,40353,1237021,24133
2021-05-18,Madera,039,155013,16590,16491,921,17412,238
2021-05-18,Marin,041,260295,14075,14026,247,14273,227
2021-05-18,Mariposa,043,17540,429,424,11,435,5
2021-05-18,Mendocino,045,87422,3957,3877,81,3958,47
2021-05-18,Merced,047,269075,30915,31036,1026,32062,452
2021-05-18,Modoc,049,8938,370,364,124,488,3
2021-05-18,Mono,051,14174,1259,1265,17,1282,3
2021-05-18,Monterey,053,433212,43126,43001,1827,44828,379
2021-05-18,Napa,055,140530,9871,9905,33,9938,82
2021-05-18,Nevada,057,99092,4793,4762,187,4949,70
2021-05-18,Orange,059,3164182,255276,254041,11192,265233,5031
2021-05-18,Placer,061,380077,23173,22726,1477,24203,291
2021-05-18,Plumas,063,18699,700,682,10,692,4
2021-05-18,Riverside,065,2383286,293807,288354,13814,302168,4438
2021-05-18,Sacramento,067,1510023,105547,105083,1719,106802,1629
2021-05-18,San Benito,069,59416,6050,6065,112,6177,63
2021-05-18,San Bernardino,071,2135413,292951,292014,8891,300905,4722
2021-05-18,San Diego,073,3302833,280195,279254,14874,294128,3742
2021-05-18,San Francisco,075,870044,36636,36818,1261,38079,546
2021-05-18,San Joaquin,077,732212,72888,72282,3469,75751,1368
2021-05-18,San Luis Obispo,079,281455,21333,21080,723,21803,256
2021-05-18,San Mateo,081,765935,42242,42099,464,42563,428
2021-05-18,Santa Barbara,083,443738,34401,34278,1112,35390,459
2021-05-18,Santa Clara,085,1922200,118421,119171,741,119912,2014
2021-05-18,Santa Cruz,087,273765,16211,16137,796,16933,207
2021-05-18,Shasta,089,179085,12204,12197,1541,13738,200
2021-05-18,Sierra,091,2930,56,54,12,66,0
2021-05-18,Siskiyou,093,43540,1908,1799,342,2141,16
2021-05-18,Solano,095,438530,32687,32644,546,33190,253
2021-05-18,Sonoma,097,501317,29947,30054,325,30379,321
2021-05-18,Stanislaus,099,539301,56159,55860,5856,61716,959
2021-05-18,Sutter,101,95872,9417,9453,83,9536,113
2021-05-18,Tehama,103,63373,5051,5020,555,5575,63
2021-05-18,Trinity,105,12862,483,329,87,416,3
2021-05-18,Tulare,107,460477,50159,49142,8843,57985,836
2021-05-18,Tuolumne,109,53932,4026,4073,42,4115,64
2021-05-18,Ventura,111,848112,81267,80726,2938,83664,1017
2021-05-18,Yolo,113,214977,13964,13951,230,14181,211
2021-05-18,Yuba,115,75493,6017,5989,120,6109,49
2021-05-17,Alameda,001,1643700,87775,87766,1901,89667,1253
2021-05-17,Alpine,003,1148,87,88,0,88,0
2021-05-17,Amador,005,37829,3659,3668,32,3700,46
2021-05-17,Butte,007,227075,12444,12144,1826,13970,192
2021-05-17,Calaveras,009,45235,2136,2131,13,2144,53
2021-05-17,Colusa,011,21464,1939,1943,303,2246,14
2021-05-17,Contra Costa,013,1133247,69240,68720,1245,69965,805
2021-05-17,Del Norte,015,27424,1401,1369,12,1381,8
2021-05-17,El Dorado,017,186661,10246,10163,736,10899,112
2021-05-17,Fresno,019,978130,102460,102013,8564,110577,1690
2021-05-17,Glenn,021,27897,2422,2401,553,2954,17
2021-05-17,Humboldt,023,135768,4169,4112,34,4146,42
2021-05-17,Imperial,025,180216,28558,28533,2674,31207,729
2021-05-17,Inyo,027,18085,1404,1401,12,1413,36
2021-05-17,Kern,029,883053,97121,96095,10739,106834,1315
2021-05-17,Kings,031,150075,23113,22918,1071,23989,246
2021-05-17,Lake,033,64148,3509,3489,9,3498,43
2021-05-17,Lassen,035,31185,5194,5156,108,5264,6
2021-05-17,Los Angeles,037,10098052,1205821,1196556,40347,1236903,24123
2021-05-17,Madera,039,155013,16583,16486,921,17407,238
2021-05-17,Marin,041,260295,14069,14021,247,14268,227
2021-05-17,Mariposa,043,17540,428,423,11,434,5
2021-05-17,Mendocino,045,87422,3948,3868,81,3949,46
2021-05-17,Merced,047,269075,30900,31031,1026,32057,450
2021-05-17,Modoc,049,8938,369,362,124,486,3
2021-05-17,Mono,051,14174,1255,1265,17,1282,3
2021-05-17,Monterey,053,433212,43119,42995,1827,44822,379
2021-05-17,Napa,055,140530,9870,9894,33,9927,82
2021-05-17,Nevada,057,99092,4789,4761,186,4947,70
2021-05-17,Orange,059,3164182,255229,253993,11185,265178,5031
2021-05-17,Placer,061,380077,23150,22706,1470,24176,289
2021-05-17,Plumas,063,18699,700,682,10,692,4
2021-05-17,Riverside,065,2383286,293738,288304,13810,302114,4433
2021-05-17,Sacramento,067,1510023,105440,105035,1717,106752,1629
2021-05-17,San Benito,069,59416,6047,6067,112,6179,63
2021-05-17,San Bernardino,071,2135413,292901,291989,8883,300872,4724
2021-05-17,San Diego,073,3302833,280063,279146,14852,293998,3742
2021-05-17,San Francisco,075,870044,36624,36816,1259,38075,546
2021-05-17,San Joaquin,077,732212,72850,72234,3466,75700,1359
2021-05-17,San Luis Obispo,079,281455,21324,21079,721,21800,256
2021-05-17,San Mateo,081,765935,42214,42083,464,42547,428
2021-05-17,Santa Barbara,083,443738,34394,34275,1112,35387,459
2021-05-17,Santa Clara,085,1922200,118384,119116,739,119855,2015
2021-05-17,Santa Cruz,087,273765,16208,16151,796,16947,206
2021-05-17,Shasta,089,179085,12182,12163,1540,13703,200
2021-05-17,Sierra,091,2930,56,54,12,66,0
2021-05-17,Siskiyou,093,43540,1899,1795,339,2134,15
2021-05-17,Solano,095,438530,32669,32627,545,33172,253
2021-05-17,Sonoma,097,501317,29924,30043,324,30367,321
2021-05-17,Stanislaus,099,539301,56111,55839,5849,61688,951
2021-05-17,Sutter,101,95872,9410,9447,83,9530,113
2021-05-17,Tehama,103,63373,5047,5016,554,5570,63
2021-05-17,Trinity,105,12862,483,328,87,415,3
2021-05-17,Tulare,107,460477,50137,49107,8838,57945,836
2021-05-17,Tuolumne,109,53932,4026,4071,42,4113,64
2021-05-17,Ventura,111,848112,81247,80699,2938,83637,1017
2021-05-17,Yolo,113,214977,13957,13941,230,14171,211
2021-05-17,Yuba,115,75493,6009,5987,120,6107,49
2021-05-16,Alameda,001,1643700,87711,87743,1901,89644,1253
2021-05-16,Alpine,003,1148,87,88,0,88,0
2021-05-16,Amador,005,37829,3658,3667,32,3699,46
2021-05-16,Butte,007,227075,12430,12140,1825,13965,192
2021-05-16,Calaveras,009,45235,2134,2129,13,2142,53
2021-05-16,Colusa,011,21464,1937,1943,303,2246,14
2021-05-16,Contra Costa,013,1133247,69172,68694,1243,69937,805
2021-05-16,Del Norte,015,27424,1398,1365,12,1377,8
2021-05-16,El Dorado,017,186661,10230,10159,735,10894,112
2021-05-16,Fresno,019,978130,102416,101987,8558,110545,1690
2021-05-16,Glenn,021,27897,2422,2401,552,2953,17
2021-05-16,Humboldt,023,135768,4155,4104,34,4138,42
2021-05-16,Imperial,025,180216,28547,28516,2673,31189,729
2021-05-16,Inyo,027,18085,1404,1401,12,1413,36
2021-05-16,Kern,029,883053,97088,96083,10719,106802,1315
2021-05-16,Kings,031,150075,23109,22918,1068,23986,246
2021-05-16,Lake,033,64148,3506,3489,9,3498,43
2021-05-16,Lassen,035,31185,5193,5156,108,5264,6
2021-05-16,Los Angeles,037,10098052,1205595,1196397,40331,1236728,24120
2021-05-16,Madera,039,155013,16578,16483,918,17401,238
2021-05-16,Marin,041,260295,14066,14015,247,14262,227
2021-05-16,Mariposa,043,17540,428,423,11,434,5
2021-05-16,Mendocino,045,87422,3938,3863,81,3944,46
2021-05-16,Merced,047,269075,30879,31023,1024,32047,450
2021-05-16,Modoc,049,8938,369,362,124,486,3
2021-05-16,Mono,051,14174,1255,1265,17,1282,3
2021-05-16,Monterey,053,433212,43114,42991,1827,44818,379
2021-05-16,Napa,055,140530,9867,9891,33,9924,82
2021-05-16,Nevada,057,99092,4785,4755,186,4941,70
2021-05-16,Orange,059,3164182,255197,253962,11182,265144,5031
2021-05-16,Placer,061,380077,23118,22696,1464,24160,289
2021-05-16,Plumas,063,18699,699,682,10,692,4
2021-05-16,Riverside,065,2383286,293662,288259,13801,302060,4433
2021-05-16,Sacramento,067,1510023,105326,105013,1715,106728,1628
2021-05-16,San Benito,069,59416,6046,6067,111,6178,63
2021-05-16,San Bernardino,071,2135413,292829,291940,8881,300821,4724
2021-05-16,San Diego,073,3302833,279945,279099,14839,293938,3742
2021-05-16,San Francisco,075,870044,36600,36808,1258,38066,546
2021-05-16,San Joaquin,077,732212,72801,72218,3461,75679,1359
2021-05-16,San Luis Obispo,079,281455,21316,21072,720,21792,256
2021-05-16,San Mateo,081,765935,42203,42063,463,42526,428
2021-05-16,Santa Barbara,083,443738,34387,34270,1112,35382,459
2021-05-16,Santa Clara,085,1922200,118354,119098,738,119836,2015
2021-05-16,Santa Cruz,087,273765,16206,16143,796,16939,206
2021-05-16,Shasta,089,179085,12166,12156,1536,13692,200
2021-05-16,Sierra,091,2930,56,54,12,66,0
2021-05-16,Siskiyou,093,43540,1895,1790,338,2128,15
2021-05-16,Solano,095,438530,32636,32619,543,33162,253
2021-05-16,Sonoma,097,501317,29905,30033,324,30357,321
2021-05-16,Stanislaus,099,539301,56058,55814,5838,61652,951
2021-05-16,Sutter,101,95872,9403,9445,83,9528,113
2021-05-16,Tehama,103,63373,5043,5013,553,5566,63
2021-05-16,Trinity,105,12862,483,328,87,415,3
2021-05-16,Tulare,107,460477,50120,49091,8835,57926,837
2021-05-16,Tuolumne,109,53932,4022,4070,42,4112,64
2021-05-16,Ventura,111,848112,81216,80689,2938,83627,1017
2021-05-16,Yolo,113,214977,13942,13938,230,14168,211
2021-05-16,Yuba,115,75493,6006,5987,120,6107,49
2021-05-15,Alameda,001,1643700,87685,87677,1900,89577,1252
2021-05-15,Alpine,003,1148,87,88,0,88,0
2021-05-15,Amador,005,37829,3658,3666,32,3698,46
2021-05-15,Butte,007,227075,12423,12095,1824,13919,192
2021-05-15,Calaveras,009,45235,2133,2126,13,2139,53
2021-05-15,Colusa,011,21464,1937,1941,301,2242,14
2021-05-15,Contra Costa,013,1133247,69126,68658,1243,69901,805
2021-05-15,Del Norte,015,27424,1393,1359,12,1371,8
2021-05-15,El Dorado,017,186661,10218,10156,734,10890,112
2021-05-15,Fresno,019,978130,102379,101957,8556,110513,1690
2021-05-15,Glenn,021,27897,2422,2400,552,2952,17
2021-05-15,Humboldt,023,135768,4145,4080,34,4114,42
2021-05-15,Imperial,025,180216,28544,28504,2672,31176,729
2021-05-15,Inyo,027,18085,1404,1402,12,1414,36
2021-05-15,Kern,029,883053,97074,96061,10705,106766,1315
2021-05-15,Kings,031,150075,23108,22913,1068,23981,246
2021-05-15,Lake,033,64148,3505,3485,9,3494,43
2021-05-15,Lassen,035,31185,5190,5156,107,5263,6
2021-05-15,Los Angeles,037,10098052,1205472,1196255,40318,1236573,24115
2021-05-15,Madera,039,155013,16575,16482,918,17400,238
2021-05-15,Marin,041,260295,14062,14012,247,14259,227
2021-05-15,Mariposa,043,17540,428,423,11,434,5
2021-05-15,Mendocino,045,87422,3935,3861,81,3942,46
2021-05-15,Merced,047,269075,30858,31012,1024,32036,450
2021-05-15,Modoc,049,8938,369,362,124,486,3
2021-05-15,Mono,051,14174,1255,1265,17,1282,3
2021-05-15,Monterey,053,433212,43110,42982,1827,44809,379
2021-05-15,Napa,055,140530,9864,9887,33,9920,82
2021-05-15,Nevada,057,99092,4784,4755,186,4941,70
2021-05-15,Orange,059,3164182,255170,253919,11175,265094,5030
2021-05-15,Placer,061,380077,23097,22688,1464,24152,289
2021-05-15,Plumas,063,18699,699,681,10,691,4
2021-05-15,Riverside,065,2383286,293620,288203,13796,301999,4433
2021-05-15,Sacramento,067,1510023,105254,104929,1712,106641,1628
2021-05-15,San Benito,069,59416,6046,6066,111,6177,63
2021-05-15,San Bernardino,071,2135413,292787,291892,8879,300771,4724
2021-05-15,San Diego,073,3302833,279874,278991,14824,293815,3737
2021-05-15,San Francisco,075,870044,36584,36795,1256,38051,546
2021-05-15,San Joaquin,077,732212,72775,72197,3459,75656,1359
2021-05-15,San Luis Obispo,079,281455,21313,21061,719,21780,256
2021-05-15,San Mateo,081,765935,42187,42059,463,42522,428
2021-05-15,Santa Barbara,083,443738,34379,34259,1112,35371,459
2021-05-15,Santa Clara,085,1922200,118333,119060,738,119798,2016
2021-05-15,Santa Cruz,087,273765,16202,16137,796,16933,206
2021-05-15,Shasta,089,179085,12154,12152,1533,13685,200
2021-05-15,Sierra,091,2930,56,54,12,66,0
2021-05-15,Siskiyou,093,43540,1889,1788,336,2124,15
2021-05-15,Solano,095,438530,32627,32604,542,33146,253
2021-05-15,Sonoma,097,501317,29886,30020,324,30344,321
2021-05-15,Stanislaus,099,539301,56027,55795,5831,61626,952
2021-05-15,Sutter,101,95872,9401,9436,83,9519,113
2021-05-15,Tehama,103,63373,5039,5012,552,5564,63
2021-05-15,Trinity,105,12862,483,328,87,415,3
2021-05-15,Tulare,107,460477,50110,49080,8831,57911,837
2021-05-15,Tuolumne,109,53932,4020,4064,42,4106,63
2021-05-15,Ventura,111,848112,81205,80662,2938,83600,1017
2021-05-15,Yolo,113,214977,13935,13932,229,14161,211
2021-05-15,Yuba,115,75493,6003,5979,119,6098,49
2021-05-14,Alameda,001,1643700,87651,87621,1898,89519,1249
2021-05-14,Alpine,003,1148,87,88,0,88,0
2021-05-14,Amador,005,37829,3658,3665,32,3697,46
2021-05-14,Butte,007,227075,12414,12076,1821,13897,192
2021-05-14,Calaveras,009,45235,2129,2121,13,2134,53
2021-05-14,Colusa,011,21464,1936,1940,300,2240,14
2021-05-14,Contra Costa,013,1133247,69084,68589,1241,69830,806
2021-05-14,Del Norte,015,27424,1393,1355,12,1367,8
2021-05-14,El Dorado,017,186661,10211,10143,733,10876,113
2021-05-14,Fresno,019,978130,102350,101917,8550,110467,1688
2021-05-14,Glenn,021,27897,2421,2398,552,2950,17
2021-05-14,Humboldt,023,135768,4138,4050,34,4084,37
2021-05-14,Imperial,025,180216,28537,28485,2671,31156,728
2021-05-14,Inyo,027,18085,1404,1400,12,1412,36
2021-05-14,Kern,029,883053,97044,96033,10696,106729,1311
2021-05-14,Kings,031,150075,23107,22910,1068,23978,246
2021-05-14,Lake,033,64148,3501,3483,9,3492,43
2021-05-14,Lassen,035,31185,5190,5154,107,5261,6
2021-05-14,Los Angeles,037,10098052,1205337,1196038,40313,1236351,24101
2021-05-14,Madera,039,155013,16572,16474,918,17392,238
2021-05-14,Marin,041,260295,14058,14010,247,14257,227
2021-05-14,Mariposa,043,17540,428,422,11,433,5
2021-05-14,Mendocino,045,87422,3933,3855,81,3936,46
2021-05-14,Merced,047,269075,30848,31010,1024,32034,450
2021-05-14,Modoc,049,8938,369,362,124,486,3
2021-05-14,Mono,051,14174,1254,1265,17,1282,3
2021-05-14,Monterey,053,433212,43105,42973,1827,44800,380
2021-05-14,Napa,055,140530,9861,9883,33,9916,82
2021-05-14,Nevada,057,99092,4779,4745,186,4931,70
2021-05-14,Orange,059,3164182,255136,253855,11168,265023,5028
2021-05-14,Placer,061,380077,23078,22660,1458,24118,287
2021-05-14,Plumas,063,18699,698,680,10,690,4
2021-05-14,Riverside,065,2383286,293570,288140,13793,301933,4433
2021-05-14,Sacramento,067,1510023,105165,104828,1711,106539,1627
2021-05-14,San Benito,069,59416,6046,6064,111,6175,63
2021-05-14,San Bernardino,071,2135413,292739,291834,8879,300713,4721
2021-05-14,San Diego,073,3302833,279801,278853,14813,293666,3732
2021-05-14,San Francisco,075,870044,36575,36771,1252,38023,545
2021-05-14,San Joaquin,077,732212,72743,72160,3452,75612,1359
2021-05-14,San Luis Obispo,079,281455,21309,21051,719,21770,256
2021-05-14,San Mateo,081,765935,42177,42041,463,42504,428
2021-05-14,Santa Barbara,083,443738,34369,34243,1112,35355,456
2021-05-14,Santa Clara,085,1922200,118304,119006,738,119744,2014
2021-05-14,Santa Cruz,087,273765,16197,16130,796,16926,207
2021-05-14,Shasta,089,179085,12148,12130,1528,13658,200
2021-05-14,Sierra,091,2930,56,54,12,66,0
2021-05-14,Siskiyou,093,43540,1882,1779,335,2114,14
2021-05-14,Solano,095,438530,32607,32585,541,33126,252
2021-05-14,Sonoma,097,501317,29867,30007,324,30331,321
2021-05-14,Stanislaus,099,539301,55992,55752,5825,61577,950
2021-05-14,Sutter,101,95872,9392,9433,81,9514,113
2021-05-14,Tehama,103,63373,5032,5005,552,5557,63
2021-05-14,Trinity,105,12862,483,328,87,415,3
2021-05-14,Tulare,107,460477,50093,49060,8826,57886,836
2021-05-14,Tuolumne,109,53932,4020,4060,42,4102,63
2021-05-14,Ventura,111,848112,81191,80628,2938,83566,1014
2021-05-14,Yolo,113,214977,13930,13922,225,14147,210
2021-05-14,Yuba,115,75493,5999,5970,119,6089,47
2021-05-13,Alameda,001,1643700,87608,87557,1897,89454,1250
2021-05-13,Alpine,003,1148,87,88,0,88,0
2021-05-13,Amador,005,37829,3658,3662,32,3694,46
2021-05-13,Butte,007,227075,12400,12051,1820,13871,196
2021-05-13,Calaveras,009,45235,2127,2120,13,2133,53
2021-05-13,Colusa,011,21464,1935,1939,296,2235,14
2021-05-13,Contra Costa,013,1133247,69036,68522,1240,69762,806
2021-05-13,Del Norte,015,27424,1391,1354,12,1366,8
2021-05-13,El Dorado,017,186661,10208,10133,733,10866,112
2021-05-13,Fresno,019,978130,102321,101862,8549,110411,1687
2021-05-13,Glenn,021,27897,2420,2395,552,2947,17
2021-05-13,Humboldt,023,135768,4120,4027,34,4061,37
2021-05-13,Imperial,025,180216,28522,28468,2669,31137,729
2021-05-13,Inyo,027,18085,1404,1400,12,1412,36
2021-05-13,Kern,029,883053,97020,95996,10677,106673,1311
2021-05-13,Kings,031,150075,23106,22904,1068,23972,246
2021-05-13,Lake,033,64148,3501,3479,9,3488,43
2021-05-13,Lassen,035,31185,5190,5152,106,5258,6
2021-05-13,Los Angeles,037,10098052,1205148,1195504,40299,1235803,24083
2021-05-13,Madera,039,155013,16564,16467,918,17385,238
2021-05-13,Marin,041,260295,14053,14004,245,14249,227
2021-05-13,Mariposa,043,17540,428,422,11,433,5
2021-05-13,Mendocino,045,87422,3929,3846,81,3927,46
2021-05-13,Merced,047,269075,30841,30989,1023,32012,450
2021-05-13,Modoc,049,8938,369,362,124,486,3
2021-05-13,Mono,051,14174,1254,1265,17,1282,3
2021-05-13,Monterey,053,433212,43090,42966,1827,44793,380
2021-05-13,Napa,055,140530,9854,9877,33,9910,82
2021-05-13,Nevada,057,99092,4775,4743,185,4928,70
2021-05-13,Orange,059,3164182,255091,253778,11166,264944,5026
2021-05-13,Placer,061,380077,23051,22668,1451,24119,288
2021-05-13,Plumas,063,18699,698,680,10,690,4
2021-05-13,Riverside,065,2383286,293504,288067,13788,301855,4433
2021-05-13,Sacramento,067,1510023,105079,104711,1709,106420,1626
2021-05-13,San Benito,069,59416,6044,6062,111,6173,63
2021-05-13,San Bernardino,071,2135413,292673,291765,8879,300644,4722
2021-05-13,San Diego,073,3302833,279687,278592,14796,293388,3729
2021-05-13,San Francisco,075,870044,36551,36741,1250,37991,544
2021-05-13,San Joaquin,077,732212,72701,72096,3448,75544,1357
2021-05-13,San Luis Obispo,079,281455,21294,21043,718,21761,255
2021-05-13,San Mateo,081,765935,42160,42059,463,42522,426
2021-05-13,Santa Barbara,083,443738,34357,34242,1112,35354,456
2021-05-13,Santa Clara,085,1922200,118277,118952,738,119690,2013
2021-05-13,Santa Cruz,087,273765,16191,16129,796,16925,208
2021-05-13,Shasta,089,179085,12128,12111,1524,13635,200
2021-05-13,Sierra,091,2930,56,54,12,66,0
2021-05-13,Siskiyou,093,43540,1875,1769,332,2101,14
2021-05-13,Solano,095,438530,32594,32548,539,33087,252
2021-05-13,Sonoma,097,501317,29842,29991,324,30315,321
2021-05-13,Stanislaus,099,539301,55954,55678,5819,61497,949
2021-05-13,Sutter,101,95872,9387,9431,80,9511,112
2021-05-13,Tehama,103,63373,5027,4997,552,5549,63
2021-05-13,Trinity,105,12862,482,327,86,413,3
2021-05-13,Tulare,107,460477,50067,49032,8818,57850,837
2021-05-13,Tuolumne,109,53932,4019,4059,42,4101,63
2021-05-13,Ventura,111,848112,81161,80615,2937,83552,1012
2021-05-13,Yolo,113,214977,13921,13914,223,14137,210
2021-05-13,Yuba,115,75493,5990,5962,119,6081,47
2021-05-12,Alameda,001,1643700,87576,87482,1895,89377,1261
2021-05-12,Alpine,003,1148,87,88,0,88,0
2021-05-12,Amador,005,37829,3658,3658,32,3690,46
2021-05-12,Butte,007,227075,12390,12026,1820,13846,199
2021-05-12,Calaveras,009,45235,2124,2119,13,2132,53
2021-05-12,Colusa,011,21464,1933,1939,295,2234,14
2021-05-12,Contra Costa,013,1133247,68977,68462,1234,69696,805
2021-05-12,Del Norte,015,27424,1389,1352,12,1364,8
2021-05-12,El Dorado,017,186661,10198,10123,733,10856,112
2021-05-12,Fresno,019,978130,102272,101838,8538,110376,1688
2021-05-12,Glenn,021,27897,2417,2391,552,2943,17
2021-05-12,Humboldt,023,135768,4092,3982,34,4016,37
2021-05-12,Imperial,025,180216,28504,28443,2666,31109,726
2021-05-12,Inyo,027,18085,1404,1400,12,1412,36
2021-05-12,Kern,029,883053,96984,95955,10670,106625,1310
2021-05-12,Kings,031,150075,23104,22896,1068,23964,246
2021-05-12,Lake,033,64148,3499,3476,9,3485,43
2021-05-12,Lassen,035,31185,5188,5151,106,5257,6
2021-05-12,Los Angeles,037,10098052,1204963,1195318,40284,1235602,24067
2021-05-12,Madera,039,155013,16557,16462,917,17379,238
2021-05-12,Marin,041,260295,14048,13997,245,14242,227
2021-05-12,Mariposa,043,17540,428,422,11,433,5
2021-05-12,Mendocino,045,87422,3919,3836,81,3917,46
2021-05-12,Merced,047,269075,30825,30941,1023,31964,450
2021-05-12,Modoc,049,8938,368,362,124,486,3
2021-05-12,Mono,051,14174,1254,1265,17,1282,3
2021-05-12,Monterey,053,433212,43078,42950,1826,44776,380
2021-05-12,Napa,055,140530,9848,9870,33,9903,82
2021-05-12,Nevada,057,99092,4771,4738,185,4923,70
2021-05-12,Orange,059,3164182,255040,253587,11162,264749,5024
2021-05-12,Placer,061,380077,23033,22652,1444,24096,288
2021-05-12,Plumas,063,18699,698,681,10,691,4
2021-05-12,Riverside,065,2383286,293434,287830,13784,301614,4431
2021-05-12,Sacramento,067,1510023,104984,104592,1707,106299,1621
2021-05-12,San Benito,069,59416,6044,6062,111,6173,63
2021-05-12,San Bernardino,071,2135413,292624,291505,8874,300379,4715
2021-05-12,San Diego,073,3302833,279583,278402,14775,293177,3729
2021-05-12,San Francisco,075,870044,36531,36720,1249,37969,544
2021-05-12,San Joaquin,077,732212,72647,72043,3444,75487,1356
2021-05-12,San Luis Obispo,079,281455,21284,21021,718,21739,255
2021-05-12,San Mateo,081,765935,42151,42038,462,42500,426
2021-05-12,Santa Barbara,083,443738,34349,34218,1112,35330,456
2021-05-12,Santa Clara,085,1922200,118233,118897,738,119635,2005
2021-05-12,Santa Cruz,087,273765,16185,16123,796,16919,207
2021-05-12,Shasta,089,179085,12108,12092,1522,13614,200
2021-05-12,Sierra,091,2930,56,54,12,66,0
2021-05-12,Siskiyou,093,43540,1871,1760,331,2091,13
2021-05-12,Solano,095,438530,32570,32519,539,33058,252
2021-05-12,Sonoma,097,501317,29830,29976,324,30300,320
2021-05-12,Stanislaus,099,539301,55913,55632,5812,61444,919
2021-05-12,Sutter,101,95872,9384,9427,80,9507,112
2021-05-12,Tehama,103,63373,5022,4989,552,5541,62
2021-05-12,Trinity,105,12862,482,327,86,413,3
2021-05-12,Tulare,107,460477,50051,49001,8810,57811,838
2021-05-12,Tuolumne,109,53932,4018,4056,42,4098,63
2021-05-12,Ventura,111,848112,81142,80577,2937,83514,1010
2021-05-12,Yolo,113,214977,13913,13910,222,14132,210
2021-05-12,Yuba,115,75493,5987,5956,119,6075,47
2021-05-11,Alameda,001,1643700,87511,87413,1891,89304,1290
2021-05-11,Alpine,003,1148,87,88,0,88,0
2021-05-11,Amador,005,37829,3656,3657,32,3689,46
2021-05-11,Butte,007,227075,12375,12008,1817,13825,199
2021-05-11,Calaveras,009,45235,2124,2118,13,2131,52
2021-05-11,Colusa,011,21464,1932,1939,295,2234,14
2021-05-11,Contra Costa,013,1133247,68917,68406,1233,69639,806
2021-05-11,Del Norte,015,27424,1387,1347,12,1359,8
2021-05-11,El Dorado,017,186661,10192,10108,732,10840,112
2021-05-11,Fresno,019,978130,102226,101792,8533,110325,1686
2021-05-11,Glenn,021,27897,2416,2387,551,2938,17
2021-05-11,Humboldt,023,135768,4071,3964,33,3997,37
2021-05-11,Imperial,025,180216,28496,28413,2662,31075,722
2021-05-11,Inyo,027,18085,1403,1402,12,1414,36
2021-05-11,Kern,029,883053,96956,95938,10657,106595,1310
2021-05-11,Kings,031,150075,23096,22887,1068,23955,246
2021-05-11,Lake,033,64148,3498,3473,9,3482,43
2021-05-11,Lassen,035,31185,5186,5148,106,5254,6
2021-05-11,Los Angeles,037,10098052,1204726,1195100,40267,1235367,24048
2021-05-11,Madera,039,155013,16553,16459,916,17375,238
2021-05-11,Marin,041,260295,14041,13987,245,14232,227
2021-05-11,Mariposa,043,17540,428,421,11,432,5
2021-05-11,Mendocino,045,87422,3911,3821,81,3902,46
2021-05-11,Merced,047,269075,30816,30893,1023,31916,449
2021-05-11,Modoc,049,8938,368,362,123,485,3
2021-05-11,Mono,051,14174,1254,1265,17,1282,3
2021-05-11,Monterey,053,433212,43070,42934,1825,44759,380
2021-05-11,Napa,055,140530,9841,9870,33,9903,81
2021-05-11,Nevada,057,99092,4767,4737,185,4922,70
2021-05-11,Orange,059,3164182,254976,253545,11155,264700,5017
2021-05-11,Placer,061,380077,23011,22615,1440,24055,287
2021-05-11,Plumas,063,18699,696,679,10,689,4
2021-05-11,Riverside,065,2383286,293372,287757,13779,301536,4429
2021-05-11,Sacramento,067,1510023,104885,104496,1704,106200,1616
2021-05-11,San Benito,069,59416,6041,6058,111,6169,63
2021-05-11,San Bernardino,071,2135413,292564,291421,8872,300293,4707
2021-05-11,San Diego,073,3302833,279448,278308,14756,293064,3725
2021-05-11,San Francisco,075,870044,36511,36707,1249,37956,543
2021-05-11,San Joaquin,077,732212,72599,71999,3441,75440,1356
2021-05-11,San Luis Obispo,079,281455,21277,21008,716,21724,255
2021-05-11,San Mateo,081,765935,42132,41985,461,42446,425
2021-05-11,Santa Barbara,083,443738,34339,34207,1112,35319,456
2021-05-11,Santa Clara,085,1922200,118186,118857,737,119594,2005
2021-05-11,Santa Cruz,087,273765,16181,16113,796,16909,206
2021-05-11,Shasta,089,179085,12085,12050,1516,13566,200
2021-05-11,Sierra,091,2930,56,54,12,66,0
2021-05-11,Siskiyou,093,43540,1861,1756,329,2085,13
2021-05-11,Solano,095,438530,32552,32499,537,33036,250
2021-05-11,Sonoma,097,501317,29815,29966,324,30290,318
2021-05-11,Stanislaus,099,539301,55865,55589,5808,61397,909
2021-05-11,Sutter,101,95872,9377,9417,80,9497,112
2021-05-11,Tehama,103,63373,5018,4985,551,5536,62
2021-05-11,Trinity,105,12862,482,327,85,412,3
2021-05-11,Tulare,107,460477,50024,48974,8796,57770,837
2021-05-11,Tuolumne,109,53932,4017,4056,42,4098,63
2021-05-11,Ventura,111,848112,81118,80544,2934,83478,1008
2021-05-11,Yolo,113,214977,13900,13902,219,14121,210
2021-05-11,Yuba,115,75493,5978,5950,119,6069,46
2021-05-10,Alameda,001,1643700,87443,87366,1890,89256,1284
2021-05-10,Alpine,003,1148,87,88,0,88,0
2021-05-10,Amador,005,37829,3655,3657,32,3689,46
2021-05-10,Butte,007,227075,12359,11993,1812,13805,199
2021-05-10,Calaveras,009,45235,2117,2118,13,2131,52
2021-05-10,Colusa,011,21464,1932,1939,295,2234,14
2021-05-10,Contra Costa,013,1133247,68853,68357,1233,69590,806
2021-05-10,Del Norte,015,27424,1384,1339,12,1351,8
2021-05-10,El Dorado,017,186661,10178,10093,732,10825,113
2021-05-10,Fresno,019,978130,102194,101755,8527,110282,1682
2021-05-10,Glenn,021,27897,2415,2384,550,2934,17
2021-05-10,Humboldt,023,135768,4041,3961,33,3994,36
2021-05-10,Imperial,025,180216,28482,28397,2658,31055,722
2021-05-10,Inyo,027,18085,1403,1401,12,1413,36
2021-05-10,Kern,029,883053,96913,95920,10643,106563,1310
2021-05-10,Kings,031,150075,23085,22884,1067,23951,246
2021-05-10,Lake,033,64148,3490,3471,9,3480,43
2021-05-10,Lassen,035,31185,5182,5148,106,5254,5
2021-05-10,Los Angeles,037,10098052,1204459,1194976,40252,1235228,24030
2021-05-10,Madera,039,155013,16543,16450,916,17366,238
2021-05-10,Marin,041,260295,14038,13981,245,14226,228
2021-05-10,Mariposa,043,17540,427,420,11,431,5
2021-05-10,Mendocino,045,87422,3905,3818,81,3899,46
2021-05-10,Merced,047,269075,30805,30880,1023,31903,448
2021-05-10,Modoc,049,8938,368,361,123,484,3
2021-05-10,Mono,051,14174,1254,1265,17,1282,3
2021-05-10,Monterey,053,433212,43064,42927,1820,44747,380
2021-05-10,Napa,055,140530,9839,9860,33,9893,81
2021-05-10,Nevada,057,99092,4760,4735,185,4920,70
2021-05-10,Orange,059,3164182,254923,253484,11149,264633,5008
2021-05-10,Placer,061,380077,22989,22590,1437,24027,286
2021-05-10,Plumas,063,18699,695,679,10,689,4
2021-05-10,Riverside,065,2383286,293303,287689,13773,301462,4427
2021-05-10,Sacramento,067,1510023,104774,104378,1699,106077,1613
2021-05-10,San Benito,069,59416,6040,6058,111,6169,63
2021-05-10,San Bernardino,071,2135413,292513,291360,8871,300231,4707
2021-05-10,San Diego,073,3302833,279284,278183,14729,292912,3725
2021-05-10,San Francisco,075,870044,36492,36683,1249,37932,543
2021-05-10,San Joaquin,077,732212,72562,71954,3427,75381,1356
2021-05-10,San Luis Obispo,079,281455,21259,20993,715,21708,256
2021-05-10,San Mateo,081,765935,42115,41926,461,42387,424
2021-05-10,Santa Barbara,083,443738,34331,34201,1112,35313,456
2021-05-10,Santa Clara,085,1922200,118127,118822,737,119559,2003
2021-05-10,Santa Cruz,087,273765,16176,16114,796,16910,206
2021-05-10,Shasta,089,179085,12071,12036,1512,13548,200
2021-05-10,Sierra,091,2930,56,54,12,66,0
2021-05-10,Siskiyou,093,43540,1851,1752,327,2079,13
2021-05-10,Solano,095,438530,32532,32466,535,33001,250
2021-05-10,Sonoma,097,501317,29799,29955,323,30278,318
2021-05-10,Stanislaus,099,539301,55791,55541,5802,61343,898
2021-05-10,Sutter,101,95872,9371,9412,80,9492,111
2021-05-10,Tehama,103,63373,5014,4980,551,5531,62
2021-05-10,Trinity,105,12862,482,327,83,410,3
2021-05-10,Tulare,107,460477,50001,48956,8790,57746,837
2021-05-10,Tuolumne,109,53932,4013,4054,41,4095,63
2021-05-10,Ventura,111,848112,81102,80501,2933,83434,1008
2021-05-10,Yolo,113,214977,13888,13898,217,14115,209
2021-05-10,Yuba,115,75493,5976,5942,119,6061,46
2021-05-09,Alameda,001,1643700,87373,87292,1887,89179,1284
2021-05-09,Alpine,003,1148,87,88,0,88,0
2021-05-09,Amador,005,37829,3653,3655,32,3687,46
2021-05-09,Butte,007,227075,12341,11985,1808,13793,199
2021-05-09,Calaveras,009,45235,2116,2116,13,2129,52
2021-05-09,Colusa,011,21464,1931,1940,295,2235,14
2021-05-09,Contra Costa,013,1133247,68790,68302,1231,69533,806
2021-05-09,Del Norte,015,27424,1377,1338,12,1350,8
2021-05-09,El Dorado,017,186661,10164,10089,728,10817,113
2021-05-09,Fresno,019,978130,102156,101729,8518,110247,1682
2021-05-09,Glenn,021,27897,2408,2382,547,2929,17
2021-05-09,Humboldt,023,135768,4021,3950,33,3983,36
2021-05-09,Imperial,025,180216,28459,28388,2650,31038,722
2021-05-09,Inyo,027,18085,1403,1401,11,1412,36
2021-05-09,Kern,029,883053,96885,95903,10633,106536,1310
2021-05-09,Kings,031,150075,23076,22878,1067,23945,246
2021-05-09,Lake,033,64148,3486,3471,9,3480,43
2021-05-09,Lassen,035,31185,5180,5147,106,5253,5
2021-05-09,Los Angeles,037,10098052,1204201,1194820,40237,1235057,24026
2021-05-09,Madera,039,155013,16534,16444,910,17354,238
2021-05-09,Marin,041,260295,14027,13979,244,14223,228
2021-05-09,Mariposa,043,17540,424,420,11,431,5
2021-05-09,Mendocino,045,87422,3895,3814,81,3895,46
2021-05-09,Merced,047,269075,30782,30883,1023,31906,448
2021-05-09,Modoc,049,8938,368,360,123,483,3
2021-05-09,Mono,051,14174,1254,1264,17,1281,3
2021-05-09,Monterey,053,433212,43046,42918,1820,44738,380
2021-05-09,Napa,055,140530,9828,9857,33,9890,81
2021-05-09,Nevada,057,99092,4753,4727,185,4912,70
2021-05-09,Orange,059,3164182,254869,253451,11141,264592,5008
2021-05-09,Placer,061,380077,22963,22566,1434,24000,286
2021-05-09,Plumas,063,18699,694,679,10,689,4
2021-05-09,Riverside,065,2383286,293223,287644,13767,301411,4427
2021-05-09,Sacramento,067,1510023,104625,104309,1693,106002,1612
2021-05-09,San Benito,069,59416,6038,6056,111,6167,63
2021-05-09,San Bernardino,071,2135413,292430,291337,8865,300202,4707
2021-05-09,San Diego,073,3302833,279117,277950,14707,292657,3725
2021-05-09,San Francisco,075,870044,36466,36669,1247,37916,543
2021-05-09,San Joaquin,077,732212,72516,71927,3426,75353,1356
2021-05-09,San Luis Obispo,079,281455,21248,20999,715,21714,256
2021-05-09,San Mateo,081,765935,42085,41903,461,42364,424
2021-05-09,Santa Barbara,083,443738,34318,34196,1111,35307,456
2021-05-09,Santa Clara,085,1922200,118073,118798,736,119534,2003
2021-05-09,Santa Cruz,087,273765,16170,16094,796,16890,206
2021-05-09,Shasta,089,179085,12041,12034,1507,13541,200
2021-05-09,Sierra,091,2930,56,54,12,66,0
2021-05-09,Siskiyou,093,43540,1844,1741,324,2065,13
2021-05-09,Solano,095,438530,32493,32434,533,32967,250
2021-05-09,Sonoma,097,501317,29785,29953,322,30275,318
2021-05-09,Stanislaus,099,539301,55725,55511,5798,61309,898
2021-05-09,Sutter,101,95872,9365,9413,80,9493,111
2021-05-09,Tehama,103,63373,5009,4979,551,5530,62
2021-05-09,Trinity,105,12862,482,327,83,410,3
2021-05-09,Tulare,107,460477,49974,48948,8785,57733,837
2021-05-09,Tuolumne,109,53932,4011,4053,41,4094,63
2021-05-09,Ventura,111,848112,81087,80487,2932,83419,1008
2021-05-09,Yolo,113,214977,13877,13897,217,14114,209
2021-05-09,Yuba,115,75493,5970,5934,119,6053,46
2021-05-08,Alameda,001,1643700,87331,87213,1883,89096,1284
2021-05-08,Alpine,003,1148,87,88,0,88,0
2021-05-08,Amador,005,37829,3651,3652,32,3684,46
2021-05-08,Butte,007,227075,12329,11962,1807,13769,199
2021-05-08,Calaveras,009,45235,2115,2114,13,2127,52
2021-05-08,Colusa,011,21464,1931,1939,295,2234,14
2021-05-08,Contra Costa,013,1133247,68757,68223,1229,69452,803
2021-05-08,Del Norte,015,27424,1374,1335,12,1347,8
2021-05-08,El Dorado,017,186661,10150,10079,728,10807,113
2021-05-08,Fresno,019,978130,102120,101676,8513,110189,1682
2021-05-08,Glenn,021,27897,2406,2382,545,2927,17
2021-05-08,Humboldt,023,135768,4005,3939,33,3972,36
2021-05-08,Imperial,025,180216,28450,28373,2650,31023,721
2021-05-08,Inyo,027,18085,1403,1402,11,1413,36
2021-05-08,Kern,029,883053,96860,95880,10620,106500,1310
2021-05-08,Kings,031,150075,23073,22872,1066,23938,246
2021-05-08,Lake,033,64148,3485,3470,9,3479,43
2021-05-08,Lassen,035,31185,5179,5145,106,5251,5
2021-05-08,Los Angeles,037,10098052,1204047,1194584,40221,1234805,24022
2021-05-08,Madera,039,155013,16530,16442,910,17352,238
2021-05-08,Marin,041,260295,14024,13974,243,14217,228
2021-05-08,Mariposa,043,17540,424,420,11,431,5
2021-05-08,Mendocino,045,87422,3890,3810,80,3890,46
2021-05-08,Merced,047,269075,30772,30876,1023,31899,448
2021-05-08,Modoc,049,8938,368,360,122,482,3
2021-05-08,Mono,051,14174,1254,1262,17,1279,3
2021-05-08,Monterey,053,433212,43041,42914,1819,44733,380
2021-05-08,Napa,055,140530,9821,9853,33,9886,81
2021-05-08,Nevada,057,99092,4750,4716,185,4901,70
2021-05-08,Orange,059,3164182,254835,253412,11137,264549,5006
2021-05-08,Placer,061,380077,22945,22547,1432,23979,286
2021-05-08,Plumas,063,18699,693,679,10,689,4
2021-05-08,Riverside,065,2383286,293180,287574,13765,301339,4427
2021-05-08,Sacramento,067,1510023,104540,104208,1690,105898,1610
2021-05-08,San Benito,069,59416,6037,6048,111,6159,63
2021-05-08,San Bernardino,071,2135413,292387,291296,8865,300161,4707
2021-05-08,San Diego,073,3302833,279034,277760,14689,292449,3725
2021-05-08,San Francisco,075,870044,36443,36642,1247,37889,543
2021-05-08,San Joaquin,077,732212,72487,71869,3417,75286,1356
2021-05-08,San Luis Obispo,079,281455,21237,20992,715,21707,256
2021-05-08,San Mateo,081,765935,42074,41871,461,42332,424
2021-05-08,Santa Barbara,083,443738,34305,34185,1111,35296,456
2021-05-08,Santa Clara,085,1922200,118042,118751,736,119487,2003
2021-05-08,Santa Cruz,087,273765,16167,16089,796,16885,206
2021-05-08,Shasta,089,179085,12031,12030,1503,13533,200
2021-05-08,Sierra,091,2930,56,54,12,66,0
2021-05-08,Siskiyou,093,43540,1843,1741,320,2061,13
2021-05-08,Solano,095,438530,32469,32395,531,32926,249
2021-05-08,Sonoma,097,501317,29772,29942,322,30264,318
2021-05-08,Stanislaus,099,539301,55694,55467,5794,61261,898
2021-05-08,Sutter,101,95872,9362,9413,80,9493,111
2021-05-08,Tehama,103,63373,5007,4977,551,5528,62
2021-05-08,Trinity,105,12862,482,327,83,410,3
2021-05-08,Tulare,107,460477,49961,48929,8775,57704,837
2021-05-08,Tuolumne,109,53932,4010,4050,41,4091,63
2021-05-08,Ventura,111,848112,81076,80481,2929,83410,1008
2021-05-08,Yolo,113,214977,13874,13894,216,14110,209
2021-05-08,Yuba,115,75493,5962,5928,119,6047,46
2021-05-07,Alameda,001,1643700,87278,87128,1883,89011,1280
2021-05-07,Alpine,003,1148,87,88,0,88,0
2021-05-07,Amador,005,37829,3648,3651,32,3683,46
2021-05-07,Butte,007,227075,12308,11943,1804,13747,199
2021-05-07,Calaveras,009,45235,2113,2114,13,2127,52
2021-05-07,Colusa,011,21464,1931,1937,295,2232,14
2021-05-07,Contra Costa,013,1133247,68710,68156,1227,69383,804
2021-05-07,Del Norte,015,27424,1369,1329,12,1341,8
2021-05-07,El Dorado,017,186661,10137,10065,727,10792,112
2021-05-07,Fresno,019,978130,102087,101625,8512,110137,1684
2021-05-07,Glenn,021,27897,2403,2381,544,2925,17
2021-05-07,Humboldt,023,135768,3990,3919,33,3952,36
2021-05-07,Imperial,025,180216,28442,28352,2650,31002,721
2021-05-07,Inyo,027,18085,1403,1402,11,1413,36
2021-05-07,Kern,029,883053,96847,95839,10608,106447,1308
2021-05-07,Kings,031,150075,23072,22857,1065,23922,246
2021-05-07,Lake,033,64148,3483,3467,9,3476,43
2021-05-07,Lassen,035,31185,5178,5144,105,5249,5
2021-05-07,Los Angeles,037,10098052,1203867,1194294,40214,1234508,24008
2021-05-07,Madera,039,155013,16525,16439,910,17349,238
2021-05-07,Marin,041,260295,14020,13968,243,14211,228
2021-05-07,Mariposa,043,17540,423,419,11,430,5
2021-05-07,Mendocino,045,87422,3884,3805,80,3885,46
2021-05-07,Merced,047,269075,30769,30862,1023,31885,446
2021-05-07,Modoc,049,8938,368,360,122,482,3
2021-05-07,Mono,051,14174,1253,1261,17,1278,3
2021-05-07,Monterey,053,433212,43035,42909,1817,44726,380
2021-05-07,Napa,055,140530,9820,9849,33,9882,81
2021-05-07,Nevada,057,99092,4746,4704,185,4889,70
2021-05-07,Orange,059,3164182,254795,253338,11129,264467,5000
2021-05-07,Placer,061,380077,22925,22524,1430,23954,286
2021-05-07,Plumas,063,18699,693,678,10,688,4
2021-05-07,Riverside,065,2383286,293122,287479,13764,301243,4426
2021-05-07,Sacramento,067,1510023,104468,104068,1685,105753,1609
2021-05-07,San Benito,069,59416,6036,6048,111,6159,63
2021-05-07,San Bernardino,071,2135413,292345,291185,8860,300045,4697
2021-05-07,San Diego,073,3302833,278948,277534,14673,292207,3718
2021-05-07,San Francisco,075,870044,36430,36616,1246,37862,543
2021-05-07,San Joaquin,077,732212,72446,71804,3415,75219,1351
2021-05-07,San Luis Obispo,079,281455,21230,20979,715,21694,256
2021-05-07,San Mateo,081,765935,42059,41844,461,42305,424
2021-05-07,Santa Barbara,083,443738,34295,34166,1111,35277,453
2021-05-07,Santa Clara,085,1922200,118009,118691,735,119426,2002
2021-05-07,Santa Cruz,087,273765,16164,16074,796,16870,206
2021-05-07,Shasta,089,179085,12009,12005,1501,13506,200
2021-05-07,Sierra,091,2930,56,54,12,66,0
2021-05-07,Siskiyou,093,43540,1840,1723,320,2043,13
2021-05-07,Solano,095,438530,32441,32352,529,32881,249
2021-05-07,Sonoma,097,501317,29754,29925,320,30245,318
2021-05-07,Stanislaus,099,539301,55654,55407,5789,61196,896
2021-05-07,Sutter,101,95872,9362,9407,80,9487,111
2021-05-07,Tehama,103,63373,5000,4974,551,5525,57
2021-05-07,Trinity,105,12862,482,327,83,410,3
2021-05-07,Tulare,107,460477,49944,48913,8770,57683,837
2021-05-07,Tuolumne,109,53932,4008,4048,41,4089,63
2021-05-07,Ventura,111,848112,81052,80444,2929,83373,1008
2021-05-07,Yolo,113,214977,13868,13875,215,14090,209
2021-05-07,Yuba,115,75493,5952,5910,119,6029,46
2021-05-06,Alameda,001,1643700,87202,87028,1880,88908,1278
2021-05-06,Alpine,003,1148,87,88,0,88,0
2021-05-06,Amador,005,37829,3646,3650,32,3682,46
2021-05-06,Butte,007,227075,12288,11929,1799,13728,198
2021-05-06,Calaveras,009,45235,2113,2111,13,2124,52
2021-05-06,Colusa,011,21464,1931,1935,295,2230,14
2021-05-06,Contra Costa,013,1133247,68655,68076,1224,69300,802
2021-05-06,Del Norte,015,27424,1361,1324,12,1336,6
2021-05-06,El Dorado,017,186661,10130,10048,727,10775,112
2021-05-06,Fresno,019,978130,102043,101536,8508,110044,1680
2021-05-06,Glenn,021,27897,2402,2380,543,2923,17
2021-05-06,Humboldt,023,135768,3965,3898,33,3931,36
2021-05-06,Imperial,025,180216,28431,28311,2649,30960,720
2021-05-06,Inyo,027,18085,1403,1401,11,1412,36
2021-05-06,Kern,029,883053,96822,95801,10591,106392,1307
2021-05-06,Kings,031,150075,23065,22848,1064,23912,246
2021-05-06,Lake,033,64148,3482,3465,9,3474,43
2021-05-06,Lassen,035,31185,5177,5143,105,5248,1
2021-05-06,Los Angeles,037,10098052,1203625,1193954,40198,1234152,23991
2021-05-06,Madera,039,155013,16517,16430,910,17340,238
2021-05-06,Marin,041,260295,14016,13956,243,14199,228
2021-05-06,Mariposa,043,17540,422,419,11,430,5
2021-05-06,Mendocino,045,87422,3873,3802,80,3882,46
2021-05-06,Merced,047,269075,30754,30863,1022,31885,444
2021-05-06,Modoc,049,8938,368,360,122,482,3
2021-05-06,Mono,051,14174,1251,1261,17,1278,3
2021-05-06,Monterey,053,433212,43020,42899,1817,44716,379
2021-05-06,Napa,055,140530,9814,9843,33,9876,81
2021-05-06,Nevada,057,99092,4745,4687,185,4872,70
2021-05-06,Orange,059,3164182,254727,253286,11123,264409,4991
2021-05-06,Placer,061,380077,22903,22493,1430,23923,286
2021-05-06,Plumas,063,18699,693,678,10,688,4
2021-05-06,Riverside,065,2383286,293048,287399,13759,301158,4422
2021-05-06,Sacramento,067,1510023,104352,103956,1682,105638,1609
2021-05-06,San Benito,069,59416,6035,6045,111,6156,63
2021-05-06,San Bernardino,071,2135413,292275,291085,8859,299944,4683
2021-05-06,San Diego,073,3302833,278821,277324,14650,291974,3716
2021-05-06,San Francisco,075,870044,36415,36599,1246,37845,543
2021-05-06,San Joaquin,077,732212,72391,71729,3412,75141,1350
2021-05-06,San Luis Obispo,079,281455,21218,20965,713,21678,256
2021-05-06,San Mateo,081,765935,42040,41802,460,42262,424
2021-05-06,Santa Barbara,083,443738,34282,34152,1111,35263,453
2021-05-06,Santa Clara,085,1922200,117968,118591,735,119326,2001
2021-05-06,Santa Cruz,087,273765,16157,16050,796,16846,206
2021-05-06,Shasta,089,179085,11987,11983,1495,13478,199
2021-05-06,Sierra,091,2930,56,54,12,66,0
2021-05-06,Siskiyou,093,43540,1830,1711,319,2030,12
2021-05-06,Solano,095,438530,32415,32320,521,32841,249
2021-05-06,Sonoma,097,501317,29746,29911,320,30231,318
2021-05-06,Stanislaus,099,539301,55598,55323,5784,61107,834
2021-05-06,Sutter,101,95872,9356,9396,80,9476,111
2021-05-06,Tehama,103,63373,4995,4970,551,5521,53
2021-05-06,Trinity,105,12862,482,327,83,410,3
2021-05-06,Tulare,107,460477,49919,48890,8755,57645,836
2021-05-06,Tuolumne,109,53932,4004,4047,41,4088,63
2021-05-06,Ventura,111,848112,81021,80411,2926,83337,1005
2021-05-06,Yolo,113,214977,13860,13871,212,14083,209
2021-05-06,Yuba,115,75493,5940,5901,119,6020,46
2021-05-05,Alameda,001,1643700,87141,86950,1878,88828,1278
2021-05-05,Alpine,003,1148,87,88,0,88,0
2021-05-05,Amador,005,37829,3643,3650,32,3682,46
2021-05-05,Butte,007,227075,12270,11907,1796,13703,198
2021-05-05,Calaveras,009,45235,2109,2103,13,2116,52
2021-05-05,Colusa,011,21464,1930,1933,295,2228,14
2021-05-05,Contra Costa,013,1133247,68590,67997,1220,69217,803
2021-05-05,Del Norte,015,27424,1358,1317,12,1329,6
2021-05-05,El Dorado,017,186661,10119,10020,726,10746,111
2021-05-05,Fresno,019,978130,101994,101491,8499,109990,1680
2021-05-05,Glenn,021,27897,2399,2380,542,2922,17
2021-05-05,Humboldt,023,135768,3946,3886,32,3918,36
2021-05-05,Imperial,025,180216,28390,28295,2642,30937,720
2021-05-05,Inyo,027,18085,1402,1401,11,1412,36
2021-05-05,Kern,029,883053,96778,95753,10587,106340,1304
2021-05-05,Kings,031,150075,23059,22840,1063,23903,246
2021-05-05,Lake,033,64148,3479,3458,9,3467,43
2021-05-05,Lassen,035,31185,5177,5143,104,5247,1
2021-05-05,Los Angeles,037,10098052,1203358,1193608,40184,1233792,23977
2021-05-05,Madera,039,155013,16515,16423,910,17333,235
2021-05-05,Marin,041,260295,14008,13950,242,14192,228
2021-05-05,Mariposa,043,17540,422,418,11,429,5
2021-05-05,Mendocino,045,87422,3869,3799,80,3879,46
2021-05-05,Merced,047,269075,30733,30844,1022,31866,444
2021-05-05,Modoc,049,8938,367,361,121,482,3
2021-05-05,Mono,051,14174,1251,1260,17,1277,3
2021-05-05,Monterey,053,433212,43007,42870,1814,44684,379
2021-05-05,Napa,055,140530,9808,9833,33,9866,81
2021-05-05,Nevada,057,99092,4742,4666,185,4851,70
2021-05-05,Orange,059,3164182,254669,253237,11118,264355,4978
2021-05-05,Placer,061,380077,22871,22362,1426,23788,287
2021-05-05,Plumas,063,18699,693,677,10,687,4
2021-05-05,Riverside,065,2383286,292953,287353,13750,301103,4414
2021-05-05,Sacramento,067,1510023,104264,103476,1677,105153,1607
2021-05-05,San Benito,069,59416,6026,6046,111,6157,63
2021-05-05,San Bernardino,071,2135413,292200,291008,8855,299863,4677
2021-05-05,San Diego,073,3302833,278684,277098,14631,291729,3716
2021-05-05,San Francisco,075,870044,36400,36577,1245,37822,543
2021-05-05,San Joaquin,077,732212,72339,71638,3409,75047,1345
2021-05-05,San Luis Obispo,079,281455,21210,20958,713,21671,256
2021-05-05,San Mateo,081,765935,42011,41755,459,42214,415
2021-05-05,Santa Barbara,083,443738,34267,34139,1110,35249,453
2021-05-05,Santa Clara,085,1922200,117938,118482,732,119214,1992
2021-05-05,Santa Cruz,087,273765,16151,16013,796,16809,207
2021-05-05,Shasta,089,179085,11971,11939,1491,13430,200
2021-05-05,Sierra,091,2930,56,54,12,66,0
2021-05-05,Siskiyou,093,43540,1813,1706,311,2017,11
2021-05-05,Solano,095,438530,32380,32250,519,32769,249
2021-05-05,Sonoma,097,501317,29733,29879,320,30199,318
2021-05-05,Stanislaus,099,539301,55541,55231,5782,61013,807
2021-05-05,Sutter,101,95872,9350,9387,80,9467,111
2021-05-05,Tehama,103,63373,4991,4968,551,5519,53
2021-05-05,Trinity,105,12862,482,326,83,409,3
2021-05-05,Tulare,107,460477,49895,48875,8748,57623,835
2021-05-05,Tuolumne,109,53932,4001,4040,41,4081,63
2021-05-05,Ventura,111,848112,80993,80372,2922,83294,1005
2021-05-05,Yolo,113,214977,13856,13846,210,14056,209
2021-05-05,Yuba,115,75493,5930,5895,118,6013,44
2021-05-04,Alameda,001,1643700,87049,86894,1878,88772,1277
2021-05-04,Alpine,003,1148,87,88,0,88,0
2021-05-04,Amador,005,37829,3643,3650,32,3682,46
2021-05-04,Butte,007,227075,12246,11883,1795,13678,198
2021-05-04,Calaveras,009,45235,2105,2100,13,2113,52
2021-05-04,Colusa,011,21464,1929,1933,295,2228,14
2021-05-04,Contra Costa,013,1133247,68510,67931,1218,69149,799
2021-05-04,Del Norte,015,27424,1358,1314,12,1326,6
2021-05-04,El Dorado,017,186661,10108,10009,722,10731,110
2021-05-04,Fresno,019,978130,101939,101451,8492,109943,1677
2021-05-04,Glenn,021,27897,2396,2379,539,2918,17
2021-05-04,Humboldt,023,135768,3920,3877,32,3909,36
2021-05-04,Imperial,025,180216,28371,28276,2639,30915,720
2021-05-04,Inyo,027,18085,1402,1399,11,1410,36
2021-05-04,Kern,029,883053,96742,95720,10569,106289,1301
2021-05-04,Kings,031,150075,23045,22822,1060,23882,246
2021-05-04,Lake,033,64148,3478,3454,9,3463,43
2021-05-04,Lassen,035,31185,5176,5142,104,5246,1
2021-05-04,Los Angeles,037,10098052,1203068,1193453,40171,1233624,23957
2021-05-04,Madera,039,155013,16514,16418,910,17328,235
2021-05-04,Marin,041,260295,14000,13935,242,14177,228
2021-05-04,Mariposa,043,17540,422,418,11,429,5
2021-05-04,Mendocino,045,87422,3864,3794,80,3874,46
2021-05-04,Merced,047,269075,30716,30829,1022,31851,444
2021-05-04,Modoc,049,8938,366,360,120,480,3
2021-05-04,Mono,051,14174,1251,1260,17,1277,3
2021-05-04,Monterey,053,433212,42995,42845,1813,44658,380
2021-05-04,Napa,055,140530,9799,9824,33,9857,81
2021-05-04,Nevada,057,99092,4735,4656,185,4841,70
2021-05-04,Orange,059,3164182,254601,253177,11110,264287,4977
2021-05-04,Placer,061,380077,22843,22326,1423,23749,287
2021-05-04,Plumas,063,18699,692,675,10,685,4
2021-05-04,Riverside,065,2383286,292869,287285,13743,301028,4411
2021-05-04,Sacramento,067,1510023,104135,103383,1672,105055,1604
2021-05-04,San Benito,069,59416,6025,6039,111,6150,63
2021-05-04,San Bernardino,071,2135413,292123,290934,8848,299782,4668
2021-05-04,San Diego,073,3302833,278517,276879,14614,291493,3713
2021-05-04,San Francisco,075,870044,36382,36550,1245,37795,541
2021-05-04,San Joaquin,077,732212,72278,71582,3404,74986,1342
2021-05-04,San Luis Obispo,079,281455,21204,20923,711,21634,255
2021-05-04,San Mateo,081,765935,41985,41708,459,42167,415
2021-05-04,Santa Barbara,083,443738,34252,34131,1109,35240,453
2021-05-04,Santa Clara,085,1922200,117875,118431,731,119162,1988
2021-05-04,Santa Cruz,087,273765,16145,16005,796,16801,207
2021-05-04,Shasta,089,179085,11951,11923,1485,13408,198
2021-05-04,Sierra,091,2930,56,54,12,66,0
2021-05-04,Siskiyou,093,43540,1806,1694,309,2003,11
2021-05-04,Solano,095,438530,32339,32220,517,32737,249
2021-05-04,Sonoma,097,501317,29713,29867,319,30186,318
2021-05-04,Stanislaus,099,539301,55485,55165,5779,60944,807
2021-05-04,Sutter,101,95872,9345,9375,80,9455,111
2021-05-04,Tehama,103,63373,4988,4959,550,5509,53
2021-05-04,Trinity,105,12862,482,326,83,409,3
2021-05-04,Tulare,107,460477,49868,48857,8740,57597,835
2021-05-04,Tuolumne,109,53932,3999,4041,41,4082,61
2021-05-04,Ventura,111,848112,80964,80351,2920,83271,1005
2021-05-04,Yolo,113,214977,13843,13820,208,14028,208
2021-05-04,Yuba,115,75493,5924,5891,118,6009,44
2021-05-03,Alameda,001,1643700,86973,86845,1873,88718,1272
2021-05-03,Alpine,003,1148,87,88,0,88,0
2021-05-03,Amador,005,37829,3643,3651,32,3683,46
2021-05-03,Butte,007,227075,12236,11864,1792,13656,198
2021-05-03,Calaveras,009,45235,2103,2099,13,2112,50
2021-05-03,Colusa,011,21464,1928,1931,293,2224,14
2021-05-03,Contra Costa,013,1133247,68451,67895,1214,69109,799
2021-05-03,Del Norte,015,27424,1353,1306,11,1317,6
2021-05-03,El Dorado,017,186661,10090,9984,717,10701,110
2021-05-03,Fresno,019,978130,101883,101405,8482,109887,1678
2021-05-03,Glenn,021,27897,2396,2375,538,2913,17
2021-05-03,Humboldt,023,135768,3905,3865,32,3897,36
2021-05-03,Imperial,025,180216,28349,28280,2636,30916,720
2021-05-03,Inyo,027,18085,1401,1398,11,1409,36
2021-05-03,Kern,029,883053,96705,95693,10558,106251,1299
2021-05-03,Kings,031,150075,23036,22821,1060,23881,246
2021-05-03,Lake,033,64148,3476,3446,9,3455,43
2021-05-03,Lassen,035,31185,5175,5142,104,5246,1
2021-05-03,Los Angeles,037,10098052,1202800,1193261,40145,1233406,23942
2021-05-03,Madera,039,155013,16509,16414,909,17323,235
2021-05-03,Marin,041,260295,13994,13927,242,14169,228
2021-05-03,Mariposa,043,17540,422,418,11,429,5
2021-05-03,Mendocino,045,87422,3857,3792,80,3872,46
2021-05-03,Merced,047,269075,30705,30814,1020,31834,444
2021-05-03,Modoc,049,8938,366,360,120,480,3
2021-05-03,Mono,051,14174,1251,1259,17,1276,3
2021-05-03,Monterey,053,433212,42983,42837,1811,44648,380
2021-05-03,Napa,055,140530,9794,9815,33,9848,81
2021-05-03,Nevada,057,99092,4727,4650,185,4835,70
2021-05-03,Orange,059,3164182,254543,253107,11101,264208,4968
2021-05-03,Placer,061,380077,22812,22289,1417,23706,287
2021-05-03,Plumas,063,18699,691,675,10,685,4
2021-05-03,Riverside,065,2383286,292795,287233,13742,300975,4412
2021-05-03,Sacramento,067,1510023,103982,103303,1662,104965,1602
2021-05-03,San Benito,069,59416,6024,6038,111,6149,63
2021-05-03,San Bernardino,071,2135413,292055,290886,8845,299731,4659
2021-05-03,San Diego,073,3302833,278354,276693,14589,291282,3712
2021-05-03,San Francisco,075,870044,36356,36538,1245,37783,541
2021-05-03,San Joaquin,077,732212,72228,71504,3401,74905,1325
2021-05-03,San Luis Obispo,079,281455,21188,20915,708,21623,254
2021-05-03,San Mateo,081,765935,41962,41689,458,42147,413
2021-05-03,Santa Barbara,083,443738,34240,34119,1109,35228,453
2021-05-03,Santa Clara,085,1922200,117821,118373,730,119103,1988
2021-05-03,Santa Cruz,087,273765,16142,16000,796,16796,207
2021-05-03,Shasta,089,179085,11928,11890,1480,13370,197
2021-05-03,Sierra,091,2930,56,54,12,66,0
2021-05-03,Siskiyou,093,43540,1800,1683,303,1986,11
2021-05-03,Solano,095,438530,32298,32201,516,32717,249
2021-05-03,Sonoma,097,501317,29701,29855,316,30171,318
2021-05-03,Stanislaus,099,539301,55419,55116,5770,60886,774
2021-05-03,Sutter,101,95872,9333,9370,80,9450,111
2021-05-03,Tehama,103,63373,4980,4952,550,5502,53
2021-05-03,Trinity,105,12862,482,326,83,409,3
2021-05-03,Tulare,107,460477,49850,48844,8730,57574,835
2021-05-03,Tuolumne,109,53932,3998,4038,41,4079,61
2021-05-03,Ventura,111,848112,80942,80291,2920,83211,1005
2021-05-03,Yolo,113,214977,13829,13809,207,14016,208
2021-05-03,Yuba,115,75493,5919,5880,118,5998,44
2021-05-02,Alameda,001,1643700,86888,86784,1871,88655,1272
2021-05-02,Alpine,003,1148,87,88,0,88,0
2021-05-02,Amador,005,37829,3643,3650,32,3682,46
2021-05-02,Butte,007,227075,12212,11859,1790,13649,198
2021-05-02,Calaveras,009,45235,2099,2098,13,2111,50
2021-05-02,Colusa,011,21464,1927,1931,292,2223,14
2021-05-02,Contra Costa,013,1133247,68366,67843,1212,69055,800
2021-05-02,Del Norte,015,27424,1346,1305,11,1316,6
2021-05-02,El Dorado,017,186661,10075,9962,716,10678,110
2021-05-02,Fresno,019,978130,101811,101372,8471,109843,1678
2021-05-02,Glenn,021,27897,2395,2374,536,2910,17
2021-05-02,Humboldt,023,135768,3893,3858,31,3889,36
2021-05-02,Imperial,025,180216,28315,28275,2627,30902,721
2021-05-02,Inyo,027,18085,1399,1398,11,1409,36
2021-05-02,Kern,029,883053,96647,95668,10551,106219,1299
2021-05-02,Kings,031,150075,23018,22816,1059,23875,246
2021-05-02,Lake,033,64148,3474,3443,9,3452,43
2021-05-02,Lassen,035,31185,5174,5142,103,5245,1
2021-05-02,Los Angeles,037,10098052,1202448,1193056,40124,1233180,23943
2021-05-02,Madera,039,155013,16503,16410,909,17319,235
2021-05-02,Marin,041,260295,13984,13917,242,14159,228
2021-05-02,Mariposa,043,17540,422,419,11,430,5
2021-05-02,Mendocino,045,87422,3852,3787,80,3867,46
2021-05-02,Merced,047,269075,30685,30793,1016,31809,444
2021-05-02,Modoc,049,8938,365,360,120,480,3
2021-05-02,Mono,051,14174,1250,1259,17,1276,3
2021-05-02,Monterey,053,433212,42969,42837,1810,44647,380
2021-05-02,Napa,055,140530,9790,9805,33,9838,81
2021-05-02,Nevada,057,99092,4711,4635,185,4820,70
2021-05-02,Orange,059,3164182,254469,253025,11087,264112,4968
2021-05-02,Placer,061,380077,22783,22264,1414,23678,287
2021-05-02,Plumas,063,18699,691,675,10,685,4
2021-05-02,Riverside,065,2383286,292695,287197,13732,300929,4412
2021-05-02,Sacramento,067,1510023,103843,103153,1654,104807,1602
2021-05-02,San Benito,069,59416,6019,6037,111,6148,63
2021-05-02,San Bernardino,071,2135413,291956,290859,8843,299702,4655
2021-05-02,San Diego,073,3302833,278158,276521,14562,291083,3712
2021-05-02,San Francisco,075,870044,36330,36522,1245,37767,541
2021-05-02,San Joaquin,077,732212,72164,71447,3395,74842,1325
2021-05-02,San Luis Obispo,079,281455,21167,20910,707,21617,254
2021-05-02,San Mateo,081,765935,41946,41656,457,42113,412
2021-05-02,Santa Barbara,083,443738,34226,34106,1109,35215,453
2021-05-02,Santa Clara,085,1922200,117747,118321,730,119051,1988
2021-05-02,Santa Cruz,087,273765,16137,15995,795,16790,207
2021-05-02,Shasta,089,179085,11912,11885,1472,13357,197
2021-05-02,Sierra,091,2930,56,54,12,66,0
2021-05-02,Siskiyou,093,43540,1789,1661,302,1963,11
2021-05-02,Solano,095,438530,32259,32151,512,32663,249
2021-05-02,Sonoma,097,501317,29679,29842,316,30158,318
2021-05-02,Stanislaus,099,539301,55345,55057,5763,60820,774
2021-05-02,Sutter,101,95872,9327,9363,80,9443,111
2021-05-02,Tehama,103,63373,4975,4950,548,5498,53
2021-05-02,Trinity,105,12862,482,326,83,409,3
2021-05-02,Tulare,107,460477,49832,48834,8722,57556,835
2021-05-02,Tuolumne,109,53932,3995,4038,41,4079,61
2021-05-02,Ventura,111,848112,80904,80284,2919,83203,1005
2021-05-02,Yolo,113,214977,13817,13799,206,14005,208
2021-05-02,Yuba,115,75493,5909,5879,118,5997,44
2021-05-01,Alameda,001,1643700,86845,86704,1868,88572,1270
2021-05-01,Alpine,003,1148,87,88,0,88,0
2021-05-01,Amador,005,37829,3643,3650,32,3682,46
2021-05-01,Butte,007,227075,12198,11845,1785,13630,198
2021-05-01,Calaveras,009,45235,2097,2096,13,2109,50
2021-05-01,Colusa,011,21464,1926,1931,292,2223,14
2021-05-01,Contra Costa,013,1133247,68314,67779,1209,68988,800
2021-05-01,Del Norte,015,27424,1345,1292,11,1303,6
2021-05-01,El Dorado,017,186661,10061,9944,714,10658,110
2021-05-01,Fresno,019,978130,101766,101326,8465,109791,1678
2021-05-01,Glenn,021,27897,2392,2369,535,2904,17
2021-05-01,Humboldt,023,135768,3879,3845,31,3876,36
2021-05-01,Imperial,025,180216,28308,28262,2627,30889,721
2021-05-01,Inyo,027,18085,1399,1397,11,1408,36
2021-05-01,Kern,029,883053,96620,95645,10540,106185,1299
2021-05-01,Kings,031,150075,23015,22797,1058,23855,246
2021-05-01,Lake,033,64148,3472,3441,9,3450,43
2021-05-01,Lassen,035,31185,5172,5142,103,5245,1
2021-05-01,Los Angeles,037,10098052,1202278,1192781,40110,1232891,23946
2021-05-01,Madera,039,155013,16499,16408,909,17317,235
2021-05-01,Marin,041,260295,13976,13902,242,14144,228
2021-05-01,Mariposa,043,17540,422,418,11,429,5
2021-05-01,Mendocino,045,87422,3850,3782,80,3862,46
2021-05-01,Merced,047,269075,30668,30771,1015,31786,444
2021-05-01,Modoc,049,8938,365,361,120,481,3
2021-05-01,Mono,051,14174,1250,1258,17,1275,3
2021-05-01,Monterey,053,433212,42963,42828,1810,44638,379
2021-05-01,Napa,055,140530,9787,9800,33,9833,81
2021-05-01,Nevada,057,99092,4706,4625,185,4810,70
2021-05-01,Orange,059,3164182,254426,252969,11077,264046,4964
2021-05-01,Placer,061,380077,22757,22240,1412,23652,287
2021-05-01,Plumas,063,18699,690,675,10,685,4
2021-05-01,Riverside,065,2383286,292656,287129,13730,300859,4412
2021-05-01,Sacramento,067,1510023,103762,103043,1653,104696,1602
2021-05-01,San Benito,069,59416,6016,6030,111,6141,63
2021-05-01,San Bernardino,071,2135413,291913,290802,8842,299644,4652
2021-05-01,San Diego,073,3302833,278034,276367,14541,290908,3706
2021-05-01,San Francisco,075,870044,36315,36496,1245,37741,541
2021-05-01,San Joaquin,077,732212,72115,71389,3393,74782,1325
2021-05-01,San Luis Obispo,079,281455,21162,20896,707,21603,254
2021-05-01,San Mateo,081,765935,41917,41617,456,42073,411
2021-05-01,Santa Barbara,083,443738,34221,34085,1108,35193,453
2021-05-01,Santa Clara,085,1922200,117695,118265,728,118993,1988
2021-05-01,Santa Cruz,087,273765,16134,15984,795,16779,207
2021-05-01,Shasta,089,179085,11892,11878,1465,13343,197
2021-05-01,Sierra,091,2930,56,53,12,65,0
2021-05-01,Siskiyou,093,43540,1781,1653,301,1954,11
2021-05-01,Solano,095,438530,32229,32124,504,32628,249
2021-05-01,Sonoma,097,501317,29676,29835,316,30151,318
2021-05-01,Stanislaus,099,539301,55310,55005,5757,60762,774
2021-05-01,Sutter,101,95872,9324,9358,80,9438,110
2021-05-01,Tehama,103,63373,4974,4950,547,5497,53
2021-05-01,Trinity,105,12862,482,326,82,408,3
2021-05-01,Tulare,107,460477,49825,48818,8716,57534,835
2021-05-01,Tuolumne,109,53932,3989,4035,41,4076,61
2021-05-01,Ventura,111,848112,80886,80268,2919,83187,1005
2021-05-01,Yolo,113,214977,13810,13784,204,13988,208
2021-05-01,Yuba,115,75493,5907,5875,118,5993,44
2021-04-30,Alameda,001,1643700,86784,86602,1865,88467,1268
2021-04-30,Alpine,003,1148,87,88,0,88,0
2021-04-30,Amador,005,37829,3641,3650,32,3682,46
2021-04-30,Butte,007,227075,12179,11812,1781,13593,197
2021-04-30,Calaveras,009,45235,2096,2087,13,2100,50
2021-04-30,Colusa,011,21464,1926,1931,291,2222,14
2021-04-30,Contra Costa,013,1133247,68266,67684,1206,68890,800
2021-04-30,Del Norte,015,27424,1333,1276,11,1287,6
2021-04-30,El Dorado,017,186661,10047,9906,714,10620,110
2021-04-30,Fresno,019,978130,101720,101263,8461,109724,1670
2021-04-30,Glenn,021,27897,2391,2369,535,2904,17
2021-04-30,Humboldt,023,135768,3866,3834,31,3865,36
2021-04-30,Imperial,025,180216,28299,28244,2624,30868,721
2021-04-30,Inyo,027,18085,1399,1397,11,1408,36
2021-04-30,Kern,029,883053,96603,95605,10536,106141,1298
2021-04-30,Kings,031,150075,23012,22793,1057,23850,246
2021-04-30,Lake,033,64148,3468,3440,9,3449,43
2021-04-30,Lassen,035,31185,5171,5140,103,5243,1
2021-04-30,Los Angeles,037,10098052,1202067,1192393,40097,1232490,23919
2021-04-30,Madera,039,155013,16493,16395,909,17304,235
2021-04-30,Marin,041,260295,13968,13895,240,14135,228
2021-04-30,Mariposa,043,17540,422,417,11,428,5
2021-04-30,Mendocino,045,87422,3846,3777,80,3857,46
2021-04-30,Merced,047,269075,30655,30740,1014,31754,444
2021-04-30,Modoc,049,8938,364,360,120,480,3
2021-04-30,Mono,051,14174,1250,1258,17,1275,3
2021-04-30,Monterey,053,433212,42949,42810,1809,44619,379
2021-04-30,Napa,055,140530,9783,9792,33,9825,81
2021-04-30,Nevada,057,99092,4698,4608,185,4793,70
2021-04-30,Orange,059,3164182,254368,252883,11071,263954,4956
2021-04-30,Placer,061,380077,22738,22190,1408,23598,287
2021-04-30,Plumas,063,18699,690,677,10,687,4
2021-04-30,Riverside,065,2383286,292598,287030,13723,300753,4412
2021-04-30,Sacramento,067,1510023,103661,102864,1649,104513,1596
2021-04-30,San Benito,069,59416,6012,6024,110,6134,63
2021-04-30,San Bernardino,071,2135413,291853,290704,8841,299545,4640
2021-04-30,San Diego,073,3302833,277938,276157,14530,290687,3702
2021-04-30,San Francisco,075,870044,36304,36453,1244,37697,538
2021-04-30,San Joaquin,077,732212,72063,71311,3390,74701,1306
2021-04-30,San Luis Obispo,079,281455,21156,20884,707,21591,255
2021-04-30,San Mateo,081,765935,41903,41583,455,42038,380
2021-04-30,Santa Barbara,083,443738,34208,34061,1108,35169,451
2021-04-30,Santa Clara,085,1922200,117637,118170,724,118894,1988
2021-04-30,Santa Cruz,087,273765,16129,15975,795,16770,207
2021-04-30,Shasta,089,179085,11871,11848,1462,13310,197
2021-04-30,Sierra,091,2930,56,53,12,65,0
2021-04-30,Siskiyou,093,43540,1770,1628,298,1926,11
2021-04-30,Solano,095,438530,32197,32050,501,32551,249
2021-04-30,Sonoma,097,501317,29666,29816,314,30130,318
2021-04-30,Stanislaus,099,539301,55259,54938,5754,60692,774
2021-04-30,Sutter,101,95872,9322,9353,80,9433,110
2021-04-30,Tehama,103,63373,4971,4944,547,5491,53
2021-04-30,Trinity,105,12862,482,326,82,408,3
2021-04-30,Tulare,107,460477,49815,48797,8700,57497,836
2021-04-30,Tuolumne,109,53932,3988,4033,41,4074,61
2021-04-30,Ventura,111,848112,80846,80232,2914,83146,1004
2021-04-30,Yolo,113,214977,13798,13756,204,13960,208
2021-04-30,Yuba,115,75493,5899,5870,118,5988,44
2021-04-29,Alameda,001,1643700,86717,86490,1864,88354,1263
2021-04-29,Alpine,003,1148,87,88,0,88,0
2021-04-29,Amador,005,37829,3641,3649,32,3681,46
2021-04-29,Butte,007,227075,12164,11787,1779,13566,196
2021-04-29,Calaveras,009,45235,2093,2082,13,2095,50
2021-04-29,Colusa,011,21464,1926,1929,291,2220,14
2021-04-29,Contra Costa,013,1133247,68211,67606,1203,68809,795
2021-04-29,Del Norte,015,27424,1329,1271,11,1282,6
2021-04-29,El Dorado,017,186661,10027,9884,711,10595,107
2021-04-29,Fresno,019,978130,101666,101189,8450,109639,1667
2021-04-29,Glenn,021,27897,2388,2369,535,2904,17
2021-04-29,Humboldt,023,135768,3852,3815,31,3846,36
2021-04-29,Imperial,025,180216,28287,28235,2623,30858,720
2021-04-29,Inyo,027,18085,1399,1396,11,1407,36
2021-04-29,Kern,029,883053,96570,95547,10532,106079,1295
2021-04-29,Kings,031,150075,23002,22777,1052,23829,245
2021-04-29,Lake,033,64148,3460,3438,9,3447,43
2021-04-29,Lassen,035,31185,5171,5140,103,5243,1
2021-04-29,Los Angeles,037,10098052,1201789,1192068,40076,1232144,23899
2021-04-29,Madera,039,155013,16488,16383,908,17291,235
2021-04-29,Marin,041,260295,13964,13884,232,14116,228
2021-04-29,Mariposa,043,17540,421,416,11,427,5
2021-04-29,Mendocino,045,87422,3840,3774,80,3854,46
2021-04-29,Merced,047,269075,30636,30706,1013,31719,444
2021-04-29,Modoc,049,8938,364,360,120,480,3
2021-04-29,Mono,051,14174,1247,1259,17,1276,3
2021-04-29,Monterey,053,433212,42932,42797,1808,44605,379
2021-04-29,Napa,055,140530,9769,9789,33,9822,81
2021-04-29,Nevada,057,99092,4687,4590,185,4775,70
2021-04-29,Orange,059,3164182,254298,252823,11056,263879,4934
2021-04-29,Placer,061,380077,22713,22161,1406,23567,286
2021-04-29,Plumas,063,18699,689,676,10,686,4
2021-04-29,Riverside,065,2383286,292530,286947,13721,300668,4409
2021-04-29,Sacramento,067,1510023,103528,102686,1639,104325,1593
2021-04-29,San Benito,069,59416,6011,6023,110,6133,63
2021-04-29,San Bernardino,071,2135413,291781,290606,8836,299442,4609
2021-04-29,San Diego,073,3302833,277787,275961,14513,290474,3700
2021-04-29,San Francisco,075,870044,36279,36412,1244,37656,537
2021-04-29,San Joaquin,077,732212,71997,71225,3385,74610,1301
2021-04-29,San Luis Obispo,079,281455,21145,20876,707,21583,255
2021-04-29,San Mateo,081,765935,41875,41538,454,41992,358
2021-04-29,Santa Barbara,083,443738,34192,34039,1106,35145,448
2021-04-29,Santa Clara,085,1922200,117582,118082,721,118803,1984
2021-04-29,Santa Cruz,087,273765,16123,15961,795,16756,205
2021-04-29,Shasta,089,179085,11840,11836,1454,13290,193
2021-04-29,Sierra,091,2930,56,53,12,65,0
2021-04-29,Siskiyou,093,43540,1761,1615,295,1910,11
2021-04-29,Solano,095,438530,32156,32002,497,32499,248
2021-04-29,Sonoma,097,501317,29651,29785,311,30096,318
2021-04-29,Stanislaus,099,539301,55192,54836,5749,60585,774
2021-04-29,Sutter,101,95872,9315,9346,80,9426,110
2021-04-29,Tehama,103,63373,4963,4939,547,5486,53
2021-04-29,Trinity,105,12862,482,326,82,408,3
2021-04-29,Tulare,107,460477,49797,48785,8689,57474,832
2021-04-29,Tuolumne,109,53932,3987,4030,41,4071,58
2021-04-29,Ventura,111,848112,80812,80188,2912,83100,1002
2021-04-29,Yolo,113,214977,13778,13745,203,13948,205
2021-04-29,Yuba,115,75493,5889,5865,118,5983,44
2021-04-28,Alameda,001,1643700,86645,86390,1860,88250,1260
2021-04-28,Alpine,003,1148,87,88,0,88,0
2021-04-28,Amador,005,37829,3641,3646,32,3678,46
2021-04-28,Butte,007,227075,12144,11762,1774,13536,196
2021-04-28,Calaveras,009,45235,2089,2078,12,2090,50
2021-04-28,Colusa,011,21464,1923,1927,290,2217,14
2021-04-28,Contra Costa,013,1133247,68151,67539,1201,68740,795
2021-04-28,Del Norte,015,27424,1321,1267,11,1278,6
2021-04-28,El Dorado,017,186661,10002,9873,711,10584,107
2021-04-28,Fresno,019,978130,101619,101161,8440,109601,1666
2021-04-28,Glenn,021,27897,2385,2368,535,2903,17
2021-04-28,Humboldt,023,135768,3836,3796,31,3827,36
2021-04-28,Imperial,025,180216,28273,28177,2622,30799,720
2021-04-28,Inyo,027,18085,1399,1396,10,1406,36
2021-04-28,Kern,029,883053,96541,95494,10523,106017,1295
2021-04-28,Kings,031,150075,22990,22767,1050,23817,245
2021-04-28,Lake,033,64148,3457,3433,9,3442,43
2021-04-28,Lassen,035,31185,5171,5138,103,5241,1
2021-04-28,Los Angeles,037,10098052,1201487,1191729,40049,1231778,23858
2021-04-28,Madera,039,155013,16484,16372,908,17280,235
2021-04-28,Marin,041,260295,13953,13866,232,14098,227
2021-04-28,Mariposa,043,17540,418,415,11,426,5
2021-04-28,Mendocino,045,87422,3834,3770,78,3848,46
2021-04-28,Merced,047,269075,30618,30649,1013,31662,443
2021-04-28,Modoc,049,8938,364,360,120,480,3
2021-04-28,Mono,051,14174,1247,1258,17,1275,3
2021-04-28,Monterey,053,433212,42927,42776,1808,44584,379
2021-04-28,Napa,055,140530,9758,9777,33,9810,81
2021-04-28,Nevada,057,99092,4667,4570,185,4755,70
2021-04-28,Orange,059,3164182,254218,252747,11044,263791,4931
2021-04-28,Placer,061,380077,22686,22115,1405,23520,285
2021-04-28,Plumas,063,18699,689,676,10,686,4
2021-04-28,Riverside,065,2383286,292474,286868,13715,300583,4407
2021-04-28,Sacramento,067,1510023,103407,102613,1635,104248,1591
2021-04-28,San Benito,069,59416,6009,6021,110,6131,63
2021-04-28,San Bernardino,071,2135413,291702,290548,8826,299374,4582
2021-04-28,San Diego,073,3302833,277633,275821,14499,290320,3698
2021-04-28,San Francisco,075,870044,36249,36382,1243,37625,534
2021-04-28,San Joaquin,077,732212,71917,71171,3377,74548,1301
2021-04-28,San Luis Obispo,079,281455,21137,20851,707,21558,255
2021-04-28,San Mateo,081,765935,41850,41498,452,41950,358
2021-04-28,Santa Barbara,083,443738,34178,34003,1106,35109,448
2021-04-28,Santa Clara,085,1922200,117513,117997,719,118716,1969
2021-04-28,Santa Cruz,087,273765,16119,15943,794,16737,205
2021-04-28,Shasta,089,179085,11824,11815,1447,13262,192
2021-04-28,Sierra,091,2930,56,51,12,63,0
2021-04-28,Siskiyou,093,43540,1748,1603,292,1895,11
2021-04-28,Solano,095,438530,32124,31982,492,32474,248
2021-04-28,Sonoma,097,501317,29637,29773,307,30080,318
2021-04-28,Stanislaus,099,539301,55137,54745,5746,60491,774
2021-04-28,Sutter,101,95872,9310,9343,80,9423,110
2021-04-28,Tehama,103,63373,4958,4930,546,5476,53
2021-04-28,Trinity,105,12862,482,326,82,408,3
2021-04-28,Tulare,107,460477,49779,48754,8674,57428,832
2021-04-28,Tuolumne,109,53932,3984,4029,41,4070,58
2021-04-28,Ventura,111,848112,80777,80172,2910,83082,1000
2021-04-28,Yolo,113,214977,13764,13721,202,13923,205
2021-04-28,Yuba,115,75493,5883,5857,118,5975,44
2021-04-27,Alameda,001,1643700,86555,86301,1854,88155,1260
2021-04-27,Alpine,003,1148,87,88,0,88,0
2021-04-27,Amador,005,37829,3641,3645,32,3677,46
2021-04-27,Butte,007,227075,12119,11738,1768,13506,196
2021-04-27,Calaveras,009,45235,2087,2076,12,2088,50
2021-04-27,Colusa,011,21464,1922,1926,290,2216,14
2021-04-27,Contra Costa,013,1133247,68082,67470,1197,68667,791
2021-04-27,Del Norte,015,27424,1309,1266,11,1277,6
2021-04-27,El Dorado,017,186661,9973,9866,708,10574,106
2021-04-27,Fresno,019,978130,101554,101138,8430,109568,1663
2021-04-27,Glenn,021,27897,2385,2368,535,2903,17
2021-04-27,Humboldt,023,135768,3824,3780,31,3811,35
2021-04-27,Imperial,025,180216,28257,28149,2616,30765,720
2021-04-27,Inyo,027,18085,1399,1396,10,1406,36
2021-04-27,Kern,029,883053,96484,95466,10513,105979,1295
2021-04-27,Kings,031,150075,22975,22759,1048,23807,244
2021-04-27,Lake,033,64148,3456,3431,9,3440,43
2021-04-27,Lassen,035,31185,5171,5137,103,5240,1
2021-04-27,Los Angeles,037,10098052,1201164,1191504,40019,1231523,23825
2021-04-27,Madera,039,155013,16477,16365,908,17273,235
2021-04-27,Marin,041,260295,13932,13855,232,14087,227
2021-04-27,Mariposa,043,17540,417,413,11,424,5
2021-04-27,Mendocino,045,87422,3830,3765,78,3843,46
2021-04-27,Merced,047,269075,30577,30620,1013,31633,443
2021-04-27,Modoc,049,8938,363,360,120,480,3
2021-04-27,Mono,051,14174,1247,1257,17,1274,3
2021-04-27,Monterey,053,433212,42909,42752,1805,44557,379
2021-04-27,Napa,055,140530,9751,9774,31,9805,81
2021-04-27,Nevada,057,99092,4652,4557,185,4742,70
2021-04-27,Orange,059,3164182,254148,252667,11039,263706,4925
2021-04-27,Placer,061,380077,22656,22050,1401,23451,285
2021-04-27,Plumas,063,18699,688,675,10,685,4
2021-04-27,Riverside,065,2383286,292398,286820,13711,300531,4405
2021-04-27,Sacramento,067,1510023,103278,102595,1625,104220,1589
2021-04-27,San Benito,069,59416,6004,6016,110,6126,63
2021-04-27,San Bernardino,071,2135413,291635,290461,8821,299282,4575
2021-04-27,San Diego,073,3302833,277476,275685,14479,290164,3692
2021-04-27,San Francisco,075,870044,36221,36358,1242,37600,533
2021-04-27,San Joaquin,077,732212,71863,71104,3371,74475,1301
2021-04-27,San Luis Obispo,079,281455,21130,20841,707,21548,255
2021-04-27,San Mateo,081,765935,41815,41474,451,41925,358
2021-04-27,Santa Barbara,083,443738,34154,33973,1105,35078,448
2021-04-27,Santa Clara,085,1922200,117463,117945,718,118663,1969
2021-04-27,Santa Cruz,087,273765,16112,15905,793,16698,205
2021-04-27,Shasta,089,179085,11796,11802,1440,13242,192
2021-04-27,Sierra,091,2930,56,51,12,63,0
2021-04-27,Siskiyou,093,43540,1733,1597,291,1888,11
2021-04-27,Solano,095,438530,32076,31964,491,32455,248
2021-04-27,Sonoma,097,501317,29619,29761,306,30067,318
2021-04-27,Stanislaus,099,539301,55067,54695,5738,60433,752
2021-04-27,Sutter,101,95872,9305,9342,80,9422,110
2021-04-27,Tehama,103,63373,4955,4922,542,5464,53
2021-04-27,Trinity,105,12862,482,326,82,408,3
2021-04-27,Tulare,107,460477,49762,48744,8665,57409,832
2021-04-27,Tuolumne,109,53932,3981,4028,41,4069,58
2021-04-27,Ventura,111,848112,80748,80152,2908,83060,1000
2021-04-27,Yolo,113,214977,13750,13697,201,13898,205
2021-04-27,Yuba,115,75493,5883,5853,118,5971,44
2021-04-26,Alameda,001,1643700,86461,86230,1851,88081,1256
2021-04-26,Alpine,003,1148,87,88,0,88,0
2021-04-26,Amador,005,37829,3640,3645,32,3677,46
2021-04-26,Butte,007,227075,12095,11720,1763,13483,196
2021-04-26,Calaveras,009,45235,2081,2074,12,2086,50
2021-04-26,Colusa,011,21464,1922,1925,289,2214,14
2021-04-26,Contra Costa,013,1133247,68015,67392,1193,68585,789
2021-04-26,Del Norte,015,27424,1300,1263,11,1274,6
2021-04-26,El Dorado,017,186661,9952,9849,707,10556,106
2021-04-26,Fresno,019,978130,101499,101099,8417,109516,1662
2021-04-26,Glenn,021,27897,2383,2367,535,2902,17
2021-04-26,Humboldt,023,135768,3814,3764,30,3794,35
2021-04-26,Imperial,025,180216,28244,28148,2613,30761,720
2021-04-26,Inyo,027,18085,1398,1396,10,1406,36
2021-04-26,Kern,029,883053,96457,95429,10507,105936,1295
2021-04-26,Kings,031,150075,22972,22756,1045,23801,244
2021-04-26,Lake,033,64148,3451,3428,9,3437,43
2021-04-26,Lassen,035,31185,5171,5138,103,5241,1
2021-04-26,Los Angeles,037,10098052,1200835,1191253,40000,1231253,23802
2021-04-26,Madera,039,155013,16465,16353,907,17260,231
2021-04-26,Marin,041,260295,13917,13849,232,14081,227
2021-04-26,Mariposa,043,17540,416,410,11,421,5
2021-04-26,Mendocino,045,87422,3828,3757,77,3834,46
2021-04-26,Merced,047,269075,30560,30611,1010,31621,443
2021-04-26,Modoc,049,8938,363,360,120,480,3
2021-04-26,Mono,051,14174,1247,1258,17,1275,3
2021-04-26,Monterey,053,433212,42893,42740,1804,44544,379
2021-04-26,Napa,055,140530,9739,9769,31,9800,79
2021-04-26,Nevada,057,99092,4631,4548,185,4733,70
2021-04-26,Orange,059,3164182,254065,252592,11029,263621,4919
2021-04-26,Placer,061,380077,22628,22032,1396,23428,285
2021-04-26,Plumas,063,18699,688,670,10,680,4
2021-04-26,Riverside,065,2383286,292336,286724,13703,300427,4401
2021-04-26,Sacramento,067,1510023,103106,102459,1613,104072,1587
2021-04-26,San Benito,069,59416,6002,6013,110,6123,63
2021-04-26,San Bernardino,071,2135413,291583,290394,8820,299214,4572
2021-04-26,San Diego,073,3302833,277301,275541,14451,289992,3692
2021-04-26,San Francisco,075,870044,36193,36330,1241,37571,532
2021-04-26,San Joaquin,077,732212,71797,71050,3363,74413,1301
2021-04-26,San Luis Obispo,079,281455,21122,20830,706,21536,255
2021-04-26,San Mateo,081,765935,41785,41457,451,41908,357
2021-04-26,Santa Barbara,083,443738,34123,33948,1105,35053,448
2021-04-26,Santa Clara,085,1922200,117363,117874,715,118589,1968
2021-04-26,Santa Cruz,087,273765,16103,15877,793,16670,205
2021-04-26,Shasta,089,179085,11779,11787,1434,13221,192
2021-04-26,Sierra,091,2930,55,51,12,63,0
2021-04-26,Siskiyou,093,43540,1723,1592,288,1880,11
2021-04-26,Solano,095,438530,32031,31913,489,32402,247
2021-04-26,Sonoma,097,501317,29596,29755,304,30059,318
2021-04-26,Stanislaus,099,539301,54977,54638,5732,60370,744
2021-04-26,Sutter,101,95872,9300,9328,80,9408,110
2021-04-26,Tehama,103,63373,4950,4920,539,5459,53
2021-04-26,Trinity,105,12862,482,326,82,408,3
2021-04-26,Tulare,107,460477,49742,48735,8656,57391,831
2021-04-26,Tuolumne,109,53932,3980,4024,41,4065,58
2021-04-26,Ventura,111,848112,80723,80137,2905,83042,999
2021-04-26,Yolo,113,214977,13730,13684,198,13882,205
2021-04-26,Yuba,115,75493,5881,5851,118,5969,44
2021-04-25,Alameda,001,1643700,86360,86162,1845,88007,1256
2021-04-25,Alpine,003,1148,87,87,0,87,0
2021-04-25,Amador,005,37829,3639,3643,32,3675,46
2021-04-25,Butte,007,227075,12066,11709,1756,13465,196
2021-04-25,Calaveras,009,45235,2076,2072,11,2083,50
2021-04-25,Colusa,011,21464,1921,1924,289,2213,14
2021-04-25,Contra Costa,013,1133247,67923,67316,1192,68508,789
2021-04-25,Del Norte,015,27424,1294,1259,11,1270,6
2021-04-25,El Dorado,017,186661,9935,9837,705,10542,106
2021-04-25,Fresno,019,978130,101440,101061,8405,109466,1662
2021-04-25,Glenn,021,27897,2383,2366,535,2901,17
2021-04-25,Humboldt,023,135768,3801,3751,30,3781,35
2021-04-25,Imperial,025,180216,28218,28136,2611,30747,720
2021-04-25,Inyo,027,18085,1398,1396,10,1406,36
2021-04-25,Kern,029,883053,96391,95398,10495,105893,1295
2021-04-25,Kings,031,150075,22958,22755,1043,23798,244
2021-04-25,Lake,033,64148,3449,3427,9,3436,43
2021-04-25,Lassen,035,31185,5169,5138,103,5241,1
2021-04-25,Los Angeles,037,10098052,1200499,1190970,39980,1230950,23799
2021-04-25,Madera,039,155013,16453,16346,907,17253,231
2021-04-25,Marin,041,260295,13908,13852,232,14084,227
2021-04-25,Mariposa,043,17540,416,410,11,421,5
2021-04-25,Mendocino,045,87422,3821,3757,77,3834,46
2021-04-25,Merced,047,269075,30526,30586,1009,31595,443
2021-04-25,Modoc,049,8938,363,360,120,480,3
2021-04-25,Mono,051,14174,1247,1257,17,1274,3
2021-04-25,Monterey,053,433212,42880,42737,1802,44539,379
2021-04-25,Napa,055,140530,9734,9762,31,9793,79
2021-04-25,Nevada,057,99092,4619,4536,185,4721,70
2021-04-25,Orange,059,3164182,253989,252531,11023,263554,4919
2021-04-25,Placer,061,380077,22582,22011,1388,23399,285
2021-04-25,Plumas,063,18699,687,670,10,680,4
2021-04-25,Riverside,065,2383286,292243,286651,13697,300348,4401
2021-04-25,Sacramento,067,1510023,102938,102319,1603,103922,1587
2021-04-25,San Benito,069,59416,6000,6014,109,6123,63
2021-04-25,San Bernardino,071,2135413,291508,290357,8812,299169,4571
2021-04-25,San Diego,073,3302833,277088,275412,14418,289830,3692
2021-04-25,San Francisco,075,870044,36162,36310,1241,37551,532
2021-04-25,San Joaquin,077,732212,71702,70987,3353,74340,1301
2021-04-25,San Luis Obispo,079,281455,21103,20820,704,21524,255
2021-04-25,San Mateo,081,765935,41750,41465,450,41915,356
2021-04-25,Santa Barbara,083,443738,34097,33931,1105,35036,448
2021-04-25,Santa Clara,085,1922200,117284,117778,713,118491,1968
2021-04-25,Santa Cruz,087,273765,16097,15868,791,16659,205
2021-04-25,Shasta,089,179085,11756,11784,1429,13213,192
2021-04-25,Sierra,091,2930,55,51,12,63,0
2021-04-25,Siskiyou,093,43540,1712,1580,286,1866,11
2021-04-25,Solano,095,438530,31984,31864,481,32345,247
2021-04-25,Sonoma,097,501317,29578,29756,304,30060,318
2021-04-25,Stanislaus,099,539301,54881,54543,5724,60267,744
2021-04-25,Sutter,101,95872,9294,9326,80,9406,110
2021-04-25,Tehama,103,63373,4946,4916,537,5453,53
2021-04-25,Trinity,105,12862,482,326,82,408,3
2021-04-25,Tulare,107,460477,49726,48728,8643,57371,831
2021-04-25,Tuolumne,109,53932,3978,4022,41,4063,58
2021-04-25,Ventura,111,848112,80699,80110,2905,83015,999
2021-04-25,Yolo,113,214977,13704,13667,197,13864,205
2021-04-25,Yuba,115,75493,5878,5849,117,5966,44
2021-04-24,Alameda,001,1643700,86305,86016,1843,87859,1257
2021-04-24,Alpine,003,1148,87,86,0,86,0
2021-04-24,Amador,005,37829,3638,3640,32,3672,46
2021-04-24,Butte,007,227075,12050,11678,1754,13432,196
2021-04-24,Calaveras,009,45235,2072,2067,11,2078,50
2021-04-24,Colusa,011,21464,1920,1921,289,2210,14
2021-04-24,Contra Costa,013,1133247,67852,67222,1190,68412,789
2021-04-24,Del Norte,015,27424,1289,1255,11,1266,6
2021-04-24,El Dorado,017,186661,9924,9814,704,10518,106
2021-04-24,Fresno,019,978130,101409,100991,8399,109390,1662
2021-04-24,Glenn,021,27897,2383,2363,535,2898,17
2021-04-24,Humboldt,023,135768,3787,3722,30,3752,35
2021-04-24,Imperial,025,180216,28211,28124,2610,30734,720
2021-04-24,Inyo,027,18085,1397,1396,10,1406,36
2021-04-24,Kern,029,883053,96372,95365,10485,105850,1295
2021-04-24,Kings,031,150075,22955,22749,1043,23792,244
2021-04-24,Lake,033,64148,3448,3426,9,3435,43
2021-04-24,Lassen,035,31185,5168,5137,103,5240,1
2021-04-24,Los Angeles,037,10098052,1200267,1190603,39964,1230567,23802
2021-04-24,Madera,039,155013,16450,16338,907,17245,231
2021-04-24,Marin,041,260295,13900,13847,232,14079,227
2021-04-24,Mariposa,043,17540,416,409,11,420,5
2021-04-24,Mendocino,045,87422,3819,3754,75,3829,46
2021-04-24,Merced,047,269075,30506,30559,1009,31568,443
2021-04-24,Modoc,049,8938,363,360,120,480,3
2021-04-24,Mono,051,14174,1247,1256,17,1273,3
2021-04-24,Monterey,053,433212,42868,42727,1801,44528,379
2021-04-24,Napa,055,140530,9728,9756,31,9787,79
2021-04-24,Nevada,057,99092,4612,4522,185,4707,70
2021-04-24,Orange,059,3164182,253945,252441,11017,263458,4910
2021-04-24,Placer,061,380077,22569,21983,1387,23370,285
2021-04-24,Plumas,063,18699,686,670,10,680,4
2021-04-24,Riverside,065,2383286,292175,286552,13693,300245,4400
2021-04-24,Sacramento,067,1510023,102855,102179,1596,103775,1587
2021-04-24,San Benito,069,59416,5998,6007,109,6116,63
2021-04-24,San Bernardino,071,2135413,291460,290264,8811,299075,4568
2021-04-24,San Diego,073,3302833,276985,275252,14398,289650,3688
2021-04-24,San Francisco,075,870044,36133,36285,1236,37521,532
2021-04-24,San Joaquin,077,732212,71659,70911,3350,74261,1301
2021-04-24,San Luis Obispo,079,281455,21093,20797,703,21500,255
2021-04-24,San Mateo,081,765935,41737,41424,448,41872,355
2021-04-24,Santa Barbara,083,443738,34082,33911,1104,35015,448
2021-04-24,Santa Clara,085,1922200,117229,117674,711,118385,1968
2021-04-24,Santa Cruz,087,273765,16089,15840,791,16631,205
2021-04-24,Shasta,089,179085,11738,11770,1426,13196,192
2021-04-24,Sierra,091,2930,55,51,12,63,0
2021-04-24,Siskiyou,093,43540,1702,1574,285,1859,11
2021-04-24,Solano,095,438530,31961,31821,478,32299,247
2021-04-24,Sonoma,097,501317,29576,29739,304,30043,318
2021-04-24,Stanislaus,099,539301,54832,54455,5721,60176,744
2021-04-24,Sutter,101,95872,9291,9316,80,9396,110
2021-04-24,Tehama,103,63373,4941,4907,537,5444,53
2021-04-24,Trinity,105,12862,482,326,82,408,3
2021-04-24,Tulare,107,460477,49715,48705,8633,57338,830
2021-04-24,Tuolumne,109,53932,3974,4020,41,4061,58
2021-04-24,Ventura,111,848112,80686,80097,2903,83000,999
2021-04-24,Yolo,113,214977,13693,13653,197,13850,205
2021-04-24,Yuba,115,75493,5876,5837,117,5954,44
2021-04-23,Alameda,001,1643700,86231,85935,1840,87775,1256
2021-04-23,Alpine,003,1148,86,86,0,86,0
2021-04-23,Amador,005,37829,3637,3637,32,3669,46
2021-04-23,Butte,007,227075,12029,11672,1749,13421,196
2021-04-23,Calaveras,009,45235,2069,2064,11,2075,50
2021-04-23,Colusa,011,21464,1919,1921,289,2210,14
2021-04-23,Contra Costa,013,1133247,67798,67164,1188,68352,785
2021-04-23,Del Norte,015,27424,1288,1254,11,1265,6
2021-04-23,El Dorado,017,186661,9907,9788,701,10489,106
2021-04-23,Fresno,019,978130,101368,100928,8393,109321,1662
2021-04-23,Glenn,021,27897,2383,2361,534,2895,17
2021-04-23,Humboldt,023,135768,3777,3698,30,3728,35
2021-04-23,Imperial,025,180216,28196,28108,2609,30717,720
2021-04-23,Inyo,027,18085,1397,1395,10,1405,36
2021-04-23,Kern,029,883053,96347,95330,10479,105809,1295
2021-04-23,Kings,031,150075,22952,22735,1043,23778,244
2021-04-23,Lake,033,64148,3446,3425,9,3434,43
2021-04-23,Lassen,035,31185,5168,5141,103,5244,1
2021-04-23,Los Angeles,037,10098052,1199997,1190264,39940,1230204,23785
2021-04-23,Madera,039,155013,16441,16328,907,17235,231
2021-04-23,Marin,041,260295,13895,13838,232,14070,227
2021-04-23,Mariposa,043,17540,415,405,11,416,5
2021-04-23,Mendocino,045,87422,3817,3745,74,3819,46
2021-04-23,Merced,047,269075,30489,30530,1008,31538,443
2021-04-23,Modoc,049,8938,363,360,120,480,3
2021-04-23,Mono,051,14174,1245,1256,17,1273,3
2021-04-23,Monterey,053,433212,42862,42722,1801,44523,377
2021-04-23,Napa,055,140530,9723,9752,31,9783,79
2021-04-23,Nevada,057,99092,4603,4510,185,4695,70
2021-04-23,Orange,059,3164182,253901,252399,11010,263409,4904
2021-04-23,Placer,061,380077,22546,21959,1386,23345,282
2021-04-23,Plumas,063,18699,685,670,10,680,4
2021-04-23,Riverside,065,2383286,292116,286456,13688,300144,4399
2021-04-23,Sacramento,067,1510023,102768,102041,1593,103634,1586
2021-04-23,San Benito,069,59416,5996,6005,109,6114,63
2021-04-23,San Bernardino,071,2135413,291409,290189,8810,298999,4568
2021-04-23,San Diego,073,3302833,276846,275097,14375,289472,3684
2021-04-23,San Francisco,075,870044,36117,36252,1235,37487,532
2021-04-23,San Joaquin,077,732212,71603,70840,3347,74187,1295
2021-04-23,San Luis Obispo,079,281455,21084,20781,702,21483,255
2021-04-23,San Mateo,081,765935,41711,41386,448,41834,355
2021-04-23,Santa Barbara,083,443738,34072,33895,1102,34997,447
2021-04-23,Santa Clara,085,1922200,117167,117593,710,118303,1965
2021-04-23,Santa Cruz,087,273765,16082,15802,791,16593,205
2021-04-23,Shasta,089,179085,11731,11759,1425,13184,192
2021-04-23,Sierra,091,2930,55,51,12,63,0
2021-04-23,Siskiyou,093,43540,1690,1567,284,1851,11
2021-04-23,Solano,095,438530,31929,31784,474,32258,247
2021-04-23,Sonoma,097,501317,29562,29727,304,30031,318
2021-04-23,Stanislaus,099,539301,54770,54391,5713,60104,744
2021-04-23,Sutter,101,95872,9289,9312,80,9392,110
2021-04-23,Tehama,103,63373,4938,4906,537,5443,53
2021-04-23,Trinity,105,12862,482,326,82,408,3
2021-04-23,Tulare,107,460477,49698,48694,8626,57320,829
2021-04-23,Tuolumne,109,53932,3973,4020,41,4061,58
2021-04-23,Ventura,111,848112,80667,80095,2903,82998,996
2021-04-23,Yolo,113,214977,13681,13647,197,13844,205
2021-04-23,Yuba,115,75493,5873,5828,117,5945,44
2021-04-22,Alameda,001,1643700,86141,85829,1839,87668,1253
2021-04-22,Alpine,003,1148,86,86,0,86,0
2021-04-22,Amador,005,37829,3636,3633,32,3665,46
2021-04-22,Butte,007,227075,12015,11656,1746,13402,196
2021-04-22,Calaveras,009,45235,2067,2059,11,2070,50
2021-04-22,Colusa,011,21464,1917,1920,287,2207,14
2021-04-22,Contra Costa,013,1133247,67726,67029,1184,68213,782
2021-04-22,Del Norte,015,27424,1283,1252,11,1263,6
2021-04-22,El Dorado,017,186661,9895,9773,698,10471,106
2021-04-22,Fresno,019,978130,101323,100864,8382,109246,1657
2021-04-22,Glenn,021,27897,2382,2361,534,2895,17
2021-04-22,Humboldt,023,135768,3768,3680,30,3710,35
2021-04-22,Imperial,025,180216,28175,28096,2606,30702,720
2021-04-22,Inyo,027,18085,1396,1394,10,1404,36
2021-04-22,Kern,029,883053,96304,95292,10464,105756,1299
2021-04-22,Kings,031,150075,22942,22725,1043,23768,243
2021-04-22,Lake,033,64148,3444,3423,9,3432,43
2021-04-22,Lassen,035,31185,5168,5155,103,5258,1
2021-04-22,Los Angeles,037,10098052,1199675,1189878,39919,1229797,23762
2021-04-22,Madera,039,155013,16422,16316,907,17223,231
2021-04-22,Marin,041,260295,13887,13832,232,14064,227
2021-04-22,Mariposa,043,17540,414,403,11,414,5
2021-04-22,Mendocino,045,87422,3811,3729,74,3803,46
2021-04-22,Merced,047,269075,30454,30490,1007,31497,443
2021-04-22,Modoc,049,8938,363,360,120,480,3
2021-04-22,Mono,051,14174,1245,1254,17,1271,3
2021-04-22,Monterey,053,433212,42855,42708,1799,44507,377
2021-04-22,Napa,055,140530,9713,9734,31,9765,79
2021-04-22,Nevada,057,99092,4593,4504,183,4687,70
2021-04-22,Orange,059,3164182,253828,252307,10997,263304,4898
2021-04-22,Placer,061,380077,22516,21916,1382,23298,282
2021-04-22,Plumas,063,18699,684,670,10,680,4
2021-04-22,Riverside,065,2383286,292017,286362,13679,300041,4398
2021-04-22,Sacramento,067,1510023,102619,101870,1584,103454,1585
2021-04-22,San Benito,069,59416,5992,5998,109,6107,63
2021-04-22,San Bernardino,071,2135413,291340,290125,8801,298926,4571
2021-04-22,San Diego,073,3302833,276680,275913,14353,290266,3684
2021-04-22,San Francisco,075,870044,36094,36218,1232,37450,532
2021-04-22,San Joaquin,077,732212,71544,70751,3340,74091,1295
2021-04-22,San Luis Obispo,079,281455,21070,20761,702,21463,255
2021-04-22,San Mateo,081,765935,41685,41345,446,41791,355
2021-04-22,Santa Barbara,083,443738,34049,33870,1101,34971,446
2021-04-22,Santa Clara,085,1922200,117079,117457,706,118163,1954
2021-04-22,Santa Cruz,087,273765,16079,15737,790,16527,205
2021-04-22,Shasta,089,179085,11716,11738,1423,13161,192
2021-04-22,Sierra,091,2930,55,51,12,63,0
2021-04-22,Siskiyou,093,43540,1686,1564,283,1847,11
2021-04-22,Solano,095,438530,31884,31731,471,32202,247
2021-04-22,Sonoma,097,501317,29547,29705,300,30005,318
2021-04-22,Stanislaus,099,539301,54697,54313,5707,60020,744
2021-04-22,Sutter,101,95872,9285,9302,80,9382,110
2021-04-22,Tehama,103,63373,4932,4896,533,5429,53
2021-04-22,Trinity,105,12862,482,326,82,408,3
2021-04-22,Tulare,107,460477,49678,48669,8617,57286,828
2021-04-22,Tuolumne,109,53932,3969,4020,41,4061,58
2021-04-22,Ventura,111,848112,80641,80073,2901,82974,996
2021-04-22,Yolo,113,214977,13660,13616,197,13813,205
2021-04-22,Yuba,115,75493,5863,5825,117,5942,44
2021-04-21,Alameda,001,1643700,86062,85762,1837,87599,1249
2021-04-21,Alpine,003,1148,86,86,0,86,0
2021-04-21,Amador,005,37829,3633,3632,32,3664,46
2021-04-21,Butte,007,227075,11995,11643,1744,13387,196
2021-04-21,Calaveras,009,45235,2059,2057,11,2068,50
2021-04-21,Colusa,011,21464,1915,1920,286,2206,14
2021-04-21,Contra Costa,013,1133247,67660,66981,1183,68164,782
2021-04-21,Del Norte,015,27424,1279,1252,11,1263,6
2021-04-21,El Dorado,017,186661,9878,9760,695,10455,106
2021-04-21,Fresno,019,978130,101267,100838,8376,109214,1654
2021-04-21,Glenn,021,27897,2381,2361,534,2895,17
2021-04-21,Humboldt,023,135768,3749,3642,30,3672,35
2021-04-21,Imperial,025,180216,28163,28052,2605,30657,719
2021-04-21,Inyo,027,18085,1396,1392,10,1402,36
2021-04-21,Kern,029,883053,96258,95257,10454,105711,1297
2021-04-21,Kings,031,150075,22935,22713,1042,23755,243
2021-04-21,Lake,033,64148,3441,3421,9,3430,43
2021-04-21,Lassen,035,31185,5167,5156,103,5259,1
2021-04-21,Los Angeles,037,10098052,1199333,1189530,39900,1229430,23729
2021-04-21,Madera,039,155013,16417,16309,907,17216,231
2021-04-21,Marin,041,260295,13872,13822,232,14054,227
2021-04-21,Mariposa,043,17540,413,402,11,413,5
2021-04-21,Mendocino,045,87422,3809,3729,74,3803,46
2021-04-21,Merced,047,269075,30434,30471,1005,31476,442
2021-04-21,Modoc,049,8938,363,360,120,480,3
2021-04-21,Mono,051,14174,1245,1254,17,1271,3
2021-04-21,Monterey,053,433212,42840,42699,1797,44496,377
2021-04-21,Napa,055,140530,9707,9727,31,9758,79
2021-04-21,Nevada,057,99092,4579,4499,183,4682,70
2021-04-21,Orange,059,3164182,253751,252243,10984,263227,4889
2021-04-21,Placer,061,380077,22485,21896,1377,23273,282
2021-04-21,Plumas,063,18699,684,670,10,680,4
2021-04-21,Riverside,065,2383286,291923,286299,13672,299971,4388
2021-04-21,Sacramento,067,1510023,102490,101803,1578,103381,1579
2021-04-21,San Benito,069,59416,5989,5998,109,6107,63
2021-04-21,San Bernardino,071,2135413,291264,290049,8799,298848,4572
2021-04-21,San Diego,073,3302833,276471,275632,14315,289947,3681
2021-04-21,San Francisco,075,870044,36074,36194,1231,37425,529
2021-04-21,San Joaquin,077,732212,71489,70687,3330,74017,1295
2021-04-21,San Luis Obispo,079,281455,21055,20724,701,21425,255
2021-04-21,San Mateo,081,765935,41654,41318,445,41763,355
2021-04-21,Santa Barbara,083,443738,34030,33830,1100,34930,445
2021-04-21,Santa Clara,085,1922200,117001,117318,700,118018,1946
2021-04-21,Santa Cruz,087,273765,16070,15698,790,16488,204
2021-04-21,Shasta,089,179085,11697,11722,1421,13143,192
2021-04-21,Sierra,091,2930,55,51,12,63,0
2021-04-21,Siskiyou,093,43540,1679,1557,283,1840,11
2021-04-21,Solano,095,438530,31845,31712,470,32182,244
2021-04-21,Sonoma,097,501317,29535,29697,299,29996,318
2021-04-21,Stanislaus,099,539301,54636,54290,5701,59991,742
2021-04-21,Sutter,101,95872,9277,9297,80,9377,110
2021-04-21,Tehama,103,63373,4925,4893,532,5425,53
2021-04-21,Trinity,105,12862,482,326,82,408,3
2021-04-21,Tulare,107,460477,49663,48653,8604,57257,828
2021-04-21,Tuolumne,109,53932,3966,4019,41,4060,58
2021-04-21,Ventura,111,848112,80609,80039,2898,82937,996
2021-04-21,Yolo,113,214977,13640,13606,196,13802,200
2021-04-21,Yuba,115,75493,5856,5822,116,5938,44
2021-04-20,Alameda,001,1643700,85967,85652,1835,87487,1248
2021-04-20,Alpine,003,1148,85,85,0,85,0
2021-04-20,Amador,005,37829,3632,3631,32,3663,46
2021-04-20,Butte,007,227075,11977,11619,1742,13361,196
2021-04-20,Calaveras,009,45235,2058,2053,11,2064,50
2021-04-20,Colusa,011,21464,1915,1915,285,2200,14
2021-04-20,Contra Costa,013,1133247,67576,66889,1180,68069,782
2021-04-20,Del Norte,015,27424,1278,1250,11,1261,6
2021-04-20,El Dorado,017,186661,9850,9743,693,10436,106
2021-04-20,Fresno,019,978130,101209,100768,8366,109134,1650
2021-04-20,Glenn,021,27897,2379,2359,533,2892,17
2021-04-20,Humboldt,023,135768,3731,3612,30,3642,35
2021-04-20,Imperial,025,180216,28144,28024,2601,30625,719
2021-04-20,Inyo,027,18085,1396,1393,10,1403,36
2021-04-20,Kern,029,883053,96222,95223,10438,105661,1295
2021-04-20,Kings,031,150075,22929,22693,1039,23732,243
2021-04-20,Lake,033,64148,3439,3418,9,3427,43
2021-04-20,Lassen,035,31185,5167,5155,103,5258,1
2021-04-20,Los Angeles,037,10098052,1198986,1189256,39870,1229126,23694
2021-04-20,Madera,039,155013,16411,16301,907,17208,231
2021-04-20,Marin,041,260295,13858,13807,232,14039,227
2021-04-20,Mariposa,043,17540,412,402,11,413,5
2021-04-20,Mendocino,045,87422,3808,3726,74,3800,46
2021-04-20,Merced,047,269075,30407,30439,1004,31443,441
2021-04-20,Modoc,049,8938,363,359,120,479,3
2021-04-20,Mono,051,14174,1244,1254,17,1271,3
2021-04-20,Monterey,053,433212,42829,42663,1795,44458,363
2021-04-20,Napa,055,140530,9703,9711,31,9742,79
2021-04-20,Nevada,057,99092,4561,4485,183,4668,70
2021-04-20,Orange,059,3164182,253661,252134,10972,263106,4887
2021-04-20,Placer,061,380077,22451,21846,1373,23219,282
2021-04-20,Plumas,063,18699,683,670,10,680,4
2021-04-20,Riverside,065,2383286,291826,286194,13667,299861,4388
2021-04-20,Sacramento,067,1510023,102352,101629,1570,103199,1574
2021-04-20,San Benito,069,59416,5986,5988,109,6097,63
2021-04-20,San Bernardino,071,2135413,291183,289905,8797,298702,4569
2021-04-20,San Diego,073,3302833,276240,275369,14282,289651,3674
2021-04-20,San Francisco,075,870044,36054,36117,1230,37347,529
2021-04-20,San Joaquin,077,732212,71416,70590,3321,73911,1289
2021-04-20,San Luis Obispo,079,281455,21032,20691,693,21384,254
2021-04-20,San Mateo,081,765935,41623,41251,445,41696,355
2021-04-20,Santa Barbara,083,443738,34011,33803,1100,34903,445
2021-04-20,Santa Clara,085,1922200,116903,117228,696,117924,1944
2021-04-20,Santa Cruz,087,273765,16058,15647,790,16437,204
2021-04-20,Shasta,089,179085,11681,11677,1418,13095,189
2021-04-20,Sierra,091,2930,55,51,12,63,0
2021-04-20,Siskiyou,093,43540,1671,1551,282,1833,10
2021-04-20,Solano,095,438530,31789,31673,466,32139,243
2021-04-20,Sonoma,097,501317,29526,29676,297,29973,311
2021-04-20,Stanislaus,099,539301,54571,54236,5688,59924,735
2021-04-20,Sutter,101,95872,9273,9279,80,9359,109
2021-04-20,Tehama,103,63373,4920,4887,531,5418,52
2021-04-20,Trinity,105,12862,482,326,82,408,3
2021-04-20,Tulare,107,460477,49641,48650,8596,57246,831
2021-04-20,Tuolumne,109,53932,3966,4014,41,4055,58
2021-04-20,Ventura,111,848112,80581,80018,2896,82914,995
2021-04-20,Yolo,113,214977,13620,13581,195,13776,200
2021-04-20,Yuba,115,75493,5846,5814,116,5930,44
2021-04-19,Alameda,001,1643700,85849,85583,1831,87414,1247
2021-04-19,Alpine,003,1148,85,85,0,85,0
2021-04-19,Amador,005,37829,3631,3629,32,3661,46
2021-04-19,Butte,007,227075,11959,11601,1737,13338,196
2021-04-19,Calaveras,009,45235,2056,2050,11,2061,50
2021-04-19,Colusa,011,21464,1915,1913,284,2197,14
2021-04-19,Contra Costa,013,1133247,67498,66833,1178,68011,782
2021-04-19,Del Norte,015,27424,1276,1247,11,1258,6
2021-04-19,El Dorado,017,186661,9834,9726,688,10414,106
2021-04-19,Fresno,019,978130,101141,100702,8354,109056,1646
2021-04-19,Glenn,021,27897,2379,2358,532,2890,17
2021-04-19,Humboldt,023,135768,3711,3602,28,3630,35
2021-04-19,Imperial,025,180216,28123,27995,2601,30596,719
2021-04-19,Inyo,027,18085,1396,1392,10,1402,36
2021-04-19,Kern,029,883053,96192,95162,10423,105585,1290
2021-04-19,Kings,031,150075,22914,22688,1039,23727,243
2021-04-19,Lake,033,64148,3438,3416,9,3425,43
2021-04-19,Lassen,035,31185,5166,5156,103,5259,1
2021-04-19,Los Angeles,037,10098052,1198607,1188945,39845,1228790,23666
2021-04-19,Madera,039,155013,16400,16289,906,17195,231
2021-04-19,Marin,041,260295,13847,13804,231,14035,226
2021-04-19,Mariposa,043,17540,411,401,11,412,5
2021-04-19,Mendocino,045,87422,3806,3722,74,3796,46
2021-04-19,Merced,047,269075,30378,30422,1003,31425,441
2021-04-19,Modoc,049,8938,363,359,120,479,3
2021-04-19,Mono,051,14174,1243,1254,17,1271,3
2021-04-19,Monterey,053,433212,42816,42642,1790,44432,356
2021-04-19,Napa,055,140530,9695,9680,31,9711,79
2021-04-19,Nevada,057,99092,4545,4477,183,4660,70
2021-04-19,Orange,059,3164182,253543,252013,10957,262970,4883
2021-04-19,Placer,061,380077,22428,21814,1369,23183,282
2021-04-19,Plumas,063,18699,683,665,10,675,4
2021-04-19,Riverside,065,2383286,291731,286087,13657,299744,4371
2021-04-19,Sacramento,067,1510023,102217,101482,1560,103042,1572
2021-04-19,San Benito,069,59416,5978,5989,109,6098,63
2021-04-19,San Bernardino,071,2135413,291098,289738,8791,298529,4561
2021-04-19,San Diego,073,3302833,275992,275113,14249,289362,3674
2021-04-19,San Francisco,075,870044,36017,36094,1228,37322,529
2021-04-19,San Joaquin,077,732212,71336,70514,3315,73829,1289
2021-04-19,San Luis Obispo,079,281455,21006,20669,687,21356,254
2021-04-19,San Mateo,081,765935,41590,41226,444,41670,355
2021-04-19,Santa Barbara,083,443738,33997,33786,1100,34886,446
2021-04-19,Santa Clara,085,1922200,116792,117099,692,117791,1944
2021-04-19,Santa Cruz,087,273765,16046,15600,790,16390,204
2021-04-19,Shasta,089,179085,11666,11662,1410,13072,189
2021-04-19,Sierra,091,2930,55,51,12,63,0
2021-04-19,Siskiyou,093,43540,1661,1544,282,1826,10
2021-04-19,Solano,095,438530,31750,31643,461,32104,239
2021-04-19,Sonoma,097,501317,29507,29667,297,29964,311
2021-04-19,Stanislaus,099,539301,54495,54179,5684,59863,728
2021-04-19,Sutter,101,95872,9262,9269,80,9349,109
2021-04-19,Tehama,103,63373,4914,4878,531,5409,52
2021-04-19,Trinity,105,12862,482,326,81,407,3
2021-04-19,Tulare,107,460477,49625,48630,8583,57213,831
2021-04-19,Tuolumne,109,53932,3965,4010,41,4051,58
2021-04-19,Ventura,111,848112,80555,80000,2894,82894,996
2021-04-19,Yolo,113,214977,13607,13572,193,13765,200
2021-04-19,Yuba,115,75493,5839,5804,115,5919,44
2021-04-18,Alameda,001,1643700,85734,85481,1823,87304,1247
2021-04-18,Alpine,003,1148,85,85,0,85,0
2021-04-18,Amador,005,37829,3628,3627,32,3659,46
2021-04-18,Butte,007,227075,11941,11591,1732,13323,196
2021-04-18,Calaveras,009,45235,2050,2047,11,2058,50
2021-04-18,Colusa,011,21464,1911,1912,283,2195,14
2021-04-18,Contra Costa,013,1133247,67395,66750,1174,67924,782
2021-04-18,Del Norte,015,27424,1276,1240,11,1251,6
2021-04-18,El Dorado,017,186661,9811,9710,686,10396,106
2021-04-18,Fresno,019,978130,101083,100621,8348,108969,1646
2021-04-18,Glenn,021,27897,2374,2358,532,2890,17
2021-04-18,Humboldt,023,135768,3683,3590,28,3618,35
2021-04-18,Imperial,025,180216,28108,27991,2596,30587,719
2021-04-18,Inyo,027,18085,1395,1392,10,1402,36
2021-04-18,Kern,029,883053,96156,95129,10408,105537,1290
2021-04-18,Kings,031,150075,22905,22685,1039,23724,243
2021-04-18,Lake,033,64148,3437,3413,9,3422,43
2021-04-18,Lassen,035,31185,5163,5156,103,5259,1
2021-04-18,Los Angeles,037,10098052,1198147,1188620,39822,1228442,23648
2021-04-18,Madera,039,155013,16389,16277,905,17182,231
2021-04-18,Marin,041,260295,13840,13801,230,14031,226
2021-04-18,Mariposa,043,17540,410,400,10,410,5
2021-04-18,Mendocino,045,87422,3803,3722,74,3796,46
2021-04-18,Merced,047,269075,30341,30405,1002,31407,441
2021-04-18,Modoc,049,8938,363,359,120,479,3
2021-04-18,Mono,051,14174,1243,1254,17,1271,3
2021-04-18,Monterey,053,433212,42804,42638,1789,44427,356
2021-04-18,Napa,055,140530,9679,9674,31,9705,79
2021-04-18,Nevada,057,99092,4530,4464,183,4647,70
2021-04-18,Orange,059,3164182,253429,251940,10950,262890,4883
2021-04-18,Placer,061,380077,22385,21783,1364,23147,282
2021-04-18,Plumas,063,18699,682,665,10,675,4
2021-04-18,Riverside,065,2383286,291641,286043,13653,299696,4371
2021-04-18,Sacramento,067,1510023,102042,101354,1554,102908,1572
2021-04-18,San Benito,069,59416,5976,5989,109,6098,63
2021-04-18,San Bernardino,071,2135413,291005,289691,8782,298473,4556
2021-04-18,San Diego,073,3302833,275713,274961,14214,289175,3674
2021-04-18,San Francisco,075,870044,35980,36073,1224,37297,525
2021-04-18,San Joaquin,077,732212,71255,70466,3306,73772,1289
2021-04-18,San Luis Obispo,079,281455,20984,20656,681,21337,254
2021-04-18,San Mateo,081,765935,41561,41201,443,41644,352
2021-04-18,Santa Barbara,083,443738,33962,33769,1099,34868,446
2021-04-18,Santa Clara,085,1922200,116624,116996,687,117683,1944
2021-04-18,Santa Cruz,087,273765,16036,15580,789,16369,204
2021-04-18,Shasta,089,179085,11645,11658,1407,13065,189
2021-04-18,Sierra,091,2930,55,51,12,63,0
2021-04-18,Siskiyou,093,43540,1650,1538,281,1819,10
2021-04-18,Solano,095,438530,31700,31606,460,32066,239
2021-04-18,Sonoma,097,501317,29491,29660,295,29955,311
2021-04-18,Stanislaus,099,539301,54413,54132,5678,59810,728
2021-04-18,Sutter,101,95872,9248,9261,80,9341,109
2021-04-18,Tehama,103,63373,4905,4877,530,5407,52
2021-04-18,Trinity,105,12862,482,326,81,407,3
2021-04-18,Tulare,107,460477,49612,48618,8578,57196,829
2021-04-18,Tuolumne,109,53932,3964,4008,40,4048,58
2021-04-18,Ventura,111,848112,80524,79984,2891,82875,996
2021-04-18,Yolo,113,214977,13595,13562,191,13753,200
2021-04-18,Yuba,115,75493,5832,5804,115,5919,44
2021-04-17,Alameda,001,1643700,85661,85367,1821,87188,1247
2021-04-17,Alpine,003,1148,85,85,0,85,0
2021-04-17,Amador,005,37829,3626,3625,32,3657,46
2021-04-17,Butte,007,227075,11921,11573,1728,13301,196
2021-04-17,Calaveras,009,45235,2048,2045,11,2056,50
2021-04-17,Colusa,011,21464,1911,1912,283,2195,14
2021-04-17,Contra Costa,013,1133247,67347,66657,1166,67823,782
2021-04-17,Del Norte,015,27424,1276,1238,11,1249,6
2021-04-17,El Dorado,017,186661,9796,9692,683,10375,106
2021-04-17,Fresno,019,978130,101050,100562,8343,108905,1646
2021-04-17,Glenn,021,27897,2374,2357,532,2889,17
2021-04-17,Humboldt,023,135768,3659,3579,28,3607,35
2021-04-17,Imperial,025,180216,28097,27987,2596,30583,719
2021-04-17,Inyo,027,18085,1392,1392,10,1402,36
2021-04-17,Kern,029,883053,96138,95102,10404,105506,1290
2021-04-17,Kings,031,150075,22900,22678,1038,23716,243
2021-04-17,Lake,033,64148,3436,3409,9,3418,43
2021-04-17,Lassen,035,31185,5163,5154,103,5257,1
2021-04-17,Los Angeles,037,10098052,1197887,1188262,39792,1228054,23653
2021-04-17,Madera,039,155013,16385,16260,904,17164,231
2021-04-17,Marin,041,260295,13836,13797,230,14027,226
2021-04-17,Mariposa,043,17540,409,398,10,408,5
2021-04-17,Mendocino,045,87422,3800,3721,74,3795,46
2021-04-17,Merced,047,269075,30325,30392,1001,31393,441
2021-04-17,Modoc,049,8938,363,357,120,477,3
2021-04-17,Mono,051,14174,1243,1253,17,1270,3
2021-04-17,Monterey,053,433212,42795,42630,1787,44417,356
2021-04-17,Napa,055,140530,9675,9666,31,9697,79
2021-04-17,Nevada,057,99092,4522,4457,183,4640,70
2021-04-17,Orange,059,3164182,253360,251873,10938,262811,4878
2021-04-17,Placer,061,380077,22362,21736,1359,23095,282
2021-04-17,Plumas,063,18699,681,666,10,676,4
2021-04-17,Riverside,065,2383286,291572,285963,13645,299608,4371
2021-04-17,Sacramento,067,1510023,101932,101172,1543,102715,1572
2021-04-17,San Benito,069,59416,5970,5986,109,6095,63
2021-04-17,San Bernardino,071,2135413,290950,289624,8779,298403,4555
2021-04-17,San Diego,073,3302833,275566,274812,14180,288992,3674
2021-04-17,San Francisco,075,870044,35958,36032,1221,37253,523
2021-04-17,San Joaquin,077,732212,71215,70372,3296,73668,1288
2021-04-17,San Luis Obispo,079,281455,20971,20642,678,21320,254
2021-04-17,San Mateo,081,765935,41538,41157,443,41600,352
2021-04-17,Santa Barbara,083,443738,33931,33738,1097,34835,446
2021-04-17,Santa Clara,085,1922200,116532,116887,685,117572,1944
2021-04-17,Santa Cruz,087,273765,16030,15571,789,16360,204
2021-04-17,Shasta,089,179085,11630,11647,1406,13053,189
2021-04-17,Sierra,091,2930,55,51,12,63,0
2021-04-17,Siskiyou,093,43540,1645,1539,278,1817,10
2021-04-17,Solano,095,438530,31669,31541,457,31998,239
2021-04-17,Sonoma,097,501317,29484,29637,295,29932,311
2021-04-17,Stanislaus,099,539301,54376,54058,5673,59731,728
2021-04-17,Sutter,101,95872,9242,9252,80,9332,109
2021-04-17,Tehama,103,63373,4899,4875,529,5404,52
2021-04-17,Trinity,105,12862,482,326,81,407,3
2021-04-17,Tulare,107,460477,49600,48603,8574,57177,829
2021-04-17,Tuolumne,109,53932,3962,4005,40,4045,58
2021-04-17,Ventura,111,848112,80503,79964,2891,82855,996
2021-04-17,Yolo,113,214977,13585,13580,191,13771,200
2021-04-17,Yuba,115,75493,5827,5802,114,5916,44
2021-04-16,Alameda,001,1643700,85581,85243,1819,87062,1245
2021-04-16,Alpine,003,1148,85,85,0,85,0
2021-04-16,Amador,005,37829,3621,3621,32,3653,46
2021-04-16,Butte,007,227075,11909,11549,1726,13275,196
2021-04-16,Calaveras,009,45235,2046,2042,11,2053,50
2021-04-16,Colusa,011,21464,1909,1911,283,2194,14
2021-04-16,Contra Costa,013,1133247,67293,66569,1163,67732,782
2021-04-16,Del Norte,015,27424,1275,1237,11,1248,6
2021-04-16,El Dorado,017,186661,9776,9665,679,10344,106
2021-04-16,Fresno,019,978130,101000,100500,8337,108837,1643
2021-04-16,Glenn,021,27897,2374,2355,532,2887,17
2021-04-16,Humboldt,023,135768,3638,3570,27,3597,35
2021-04-16,Imperial,025,180216,28087,27962,2596,30558,719
2021-04-16,Inyo,027,18085,1392,1392,10,1402,36
2021-04-16,Kern,029,883053,96109,95066,10401,105467,1288
2021-04-16,Kings,031,150075,22896,22667,1037,23704,243
2021-04-16,Lake,033,64148,3430,3406,9,3415,43
2021-04-16,Lassen,035,31185,5162,5155,103,5258,1
2021-04-16,Los Angeles,037,10098052,1197586,1187818,39756,1227574,23627
2021-04-16,Madera,039,155013,16379,16250,903,17153,231
2021-04-16,Marin,041,260295,13833,13788,230,14018,226
2021-04-16,Mariposa,043,17540,408,396,9,405,5
2021-04-16,Mendocino,045,87422,3798,3719,74,3793,46
2021-04-16,Merced,047,269075,30310,30355,1001,31356,438
2021-04-16,Modoc,049,8938,363,355,120,475,3
2021-04-16,Mono,051,14174,1243,1253,17,1270,3
2021-04-16,Monterey,053,433212,42784,42620,1784,44404,351
2021-04-16,Napa,055,140530,9667,9653,31,9684,79
2021-04-16,Nevada,057,99092,4513,4443,183,4626,70
2021-04-16,Orange,059,3164182,253296,251770,10929,262699,4873
2021-04-16,Placer,061,380077,22335,21680,1355,23035,282
2021-04-16,Plumas,063,18699,680,665,10,675,4
2021-04-16,Riverside,065,2383286,291495,285818,13643,299461,4369
2021-04-16,Sacramento,067,1510023,101834,100993,1538,102531,1572
2021-04-16,San Benito,069,59416,5968,5982,109,6091,63
2021-04-16,San Bernardino,071,2135413,290903,289424,8778,298202,4550
2021-04-16,San Diego,073,3302833,275412,274567,14162,288729,3662
2021-04-16,San Francisco,075,870044,35932,35993,1218,37211,517
2021-04-16,San Joaquin,077,732212,71148,70280,3288,73568,1288
2021-04-16,San Luis Obispo,079,281455,20959,20623,677,21300,253
2021-04-16,San Mateo,081,765935,41509,41107,442,41549,352
2021-04-16,Santa Barbara,083,443738,33913,33703,1097,34800,446
2021-04-16,Santa Clara,085,1922200,116432,116693,682,117375,1941
2021-04-16,Santa Cruz,087,273765,16028,15539,789,16328,204
2021-04-16,Shasta,089,179085,11618,11623,1405,13028,189
2021-04-16,Sierra,091,2930,55,51,12,63,0
2021-04-16,Siskiyou,093,43540,1641,1530,276,1806,10
2021-04-16,Solano,095,438530,31630,31470,454,31924,239
2021-04-16,Sonoma,097,501317,29473,29617,295,29912,311
2021-04-16,Stanislaus,099,539301,54328,53983,5671,59654,728
2021-04-16,Sutter,101,95872,9236,9247,80,9327,109
2021-04-16,Tehama,103,63373,4898,4866,529,5395,52
2021-04-16,Trinity,105,12862,482,326,81,407,3
2021-04-16,Tulare,107,460477,49588,48583,8570,57153,830
2021-04-16,Tuolumne,109,53932,3959,4005,40,4045,58
2021-04-16,Ventura,111,848112,80478,79942,2886,82828,994
2021-04-16,Yolo,113,214977,13572,13559,189,13748,198
2021-04-16,Yuba,115,75493,5824,5795,113,5908,44
2021-04-15,Alameda,001,1643700,85473,85089,1817,86906,1246
2021-04-15,Alpine,003,1148,85,85,0,85,0
2021-04-15,Amador,005,37829,3620,3616,32,3648,46
2021-04-15,Butte,007,227075,11894,11529,1723,13252,196
2021-04-15,Calaveras,009,45235,2045,2039,11,2050,50
2021-04-15,Colusa,011,21464,1907,1909,282,2191,14
2021-04-15,Contra Costa,013,1133247,67220,66480,1159,67639,781
2021-04-15,Del Norte,015,27424,1268,1235,11,1246,6
2021-04-15,El Dorado,017,186661,9761,9639,677,10316,106
2021-04-15,Fresno,019,978130,100938,100431,8331,108762,1642
2021-04-15,Glenn,021,27897,2374,2354,532,2886,17
2021-04-15,Humboldt,023,135768,3617,3561,27,3588,35
2021-04-15,Imperial,025,180216,28059,27920,2593,30513,718
2021-04-15,Inyo,027,18085,1392,1393,10,1403,36
2021-04-15,Kern,029,883053,96076,94989,10388,105377,1289
2021-04-15,Kings,031,150075,22882,22648,1037,23685,242
2021-04-15,Lake,033,64148,3429,3399,9,3408,43
2021-04-15,Lassen,035,31185,5161,5152,103,5255,1
2021-04-15,Los Angeles,037,10098052,1197181,1187274,39720,1226994,23598
2021-04-15,Madera,039,155013,16364,16234,903,17137,231
2021-04-15,Marin,041,260295,13829,13783,229,14012,226
2021-04-15,Mariposa,043,17540,406,395,9,404,5
2021-04-15,Mendocino,045,87422,3797,3714,74,3788,46
2021-04-15,Merced,047,269075,30284,30325,1000,31325,437
2021-04-15,Modoc,049,8938,363,355,120,475,3
2021-04-15,Mono,051,14174,1242,1253,17,1270,3
2021-04-15,Monterey,053,433212,42774,42604,1782,44386,347
2021-04-15,Napa,055,140530,9659,9645,31,9676,79
2021-04-15,Nevada,057,99092,4501,4434,182,4616,70
2021-04-15,Orange,059,3164182,253201,251679,10917,262596,4857
2021-04-15,Placer,061,380077,22304,21614,1348,22962,281
2021-04-15,Plumas,063,18699,678,665,10,675,4
2021-04-15,Riverside,065,2383286,291391,285698,13636,299334,4363
2021-04-15,Sacramento,067,1510023,101704,100782,1524,102306,1570
2021-04-15,San Benito,069,59416,5965,5969,108,6077,63
2021-04-15,San Bernardino,071,2135413,290812,289288,8771,298059,4544
2021-04-15,San Diego,073,3302833,275165,274250,14103,288353,3653
2021-04-15,San Francisco,075,870044,35913,35947,1216,37163,510
2021-04-15,San Joaquin,077,732212,71067,70189,3280,73469,1288
2021-04-15,San Luis Obispo,079,281455,20943,20591,674,21265,253
2021-04-15,San Mateo,081,765935,41470,41050,441,41491,352
2021-04-15,Santa Barbara,083,443738,33895,33672,1093,34765,446
2021-04-15,Santa Clara,085,1922200,116326,116602,678,117280,1927
2021-04-15,Santa Cruz,087,273765,16018,15509,789,16298,203
2021-04-15,Shasta,089,179085,11604,11597,1401,12998,191
2021-04-15,Sierra,091,2930,55,51,12,63,0
2021-04-15,Siskiyou,093,43540,1635,1524,275,1799,10
2021-04-15,Solano,095,438530,31592,31394,453,31847,239
2021-04-15,Sonoma,097,501317,29459,29587,295,29882,311
2021-04-15,Stanislaus,099,539301,54274,53918,5662,59580,728
2021-04-15,Sutter,101,95872,9229,9237,80,9317,109
2021-04-15,Tehama,103,63373,4897,4854,528,5382,52
2021-04-15,Trinity,105,12862,482,326,81,407,3
2021-04-15,Tulare,107,460477,49567,48556,8570,57126,829
2021-04-15,Tuolumne,109,53932,3959,4003,40,4043,57
2021-04-15,Ventura,111,848112,80459,79917,2884,82801,989
2021-04-15,Yolo,113,214977,13553,13547,187,13734,198
2021-04-15,Yuba,115,75493,5821,5788,113,5901,44
2021-04-14,Alameda,001,1643700,85376,85009,1816,86825,1247
2021-04-14,Alpine,003,1148,85,85,0,85,0
2021-04-14,Amador,005,37829,3619,3613,32,3645,46
2021-04-14,Butte,007,227075,11881,11513,1722,13235,196
2021-04-14,Calaveras,009,45235,2044,2037,11,2048,50
2021-04-14,Colusa,011,21464,1907,1905,282,2187,14
2021-04-14,Contra Costa,013,1133247,67134,66400,1153,67553,781
2021-04-14,Del Norte,015,27424,1268,1228,11,1239,6
2021-04-14,El Dorado,017,186661,9746,9625,672,10297,106
2021-04-14,Fresno,019,978130,100881,100376,8319,108695,1640
2021-04-14,Glenn,021,27897,2374,2353,532,2885,17
2021-04-14,Humboldt,023,135768,3595,3551,26,3577,35
2021-04-14,Imperial,025,180216,28037,27907,2591,30498,718
2021-04-14,Inyo,027,18085,1392,1392,10,1402,36
2021-04-14,Kern,029,883053,96051,94947,10381,105328,1287
2021-04-14,Kings,031,150075,22873,22641,1035,23676,243
2021-04-14,Lake,033,64148,3424,3396,9,3405,43
2021-04-14,Lassen,035,31185,5160,5151,103,5254,1
2021-04-14,Los Angeles,037,10098052,1196782,1186821,39675,1226496,23579
2021-04-14,Madera,039,155013,16355,16218,903,17121,231
2021-04-14,Marin,041,260295,13827,13768,228,13996,226
2021-04-14,Mariposa,043,17540,405,394,9,403,5
2021-04-14,Mendocino,045,87422,3792,3711,74,3785,46
2021-04-14,Merced,047,269075,30268,30296,998,31294,436
2021-04-14,Modoc,049,8938,363,355,120,475,3
2021-04-14,Mono,051,14174,1241,1252,17,1269,3
2021-04-14,Monterey,053,433212,42758,42595,1778,44373,347
2021-04-14,Napa,055,140530,9648,9643,31,9674,79
2021-04-14,Nevada,057,99092,4494,4421,182,4603,70
2021-04-14,Orange,059,3164182,253096,251568,10898,262466,4849
2021-04-14,Placer,061,380077,22271,21575,1347,22922,280
2021-04-14,Plumas,063,18699,678,665,10,675,4
2021-04-14,Riverside,065,2383286,291281,285583,13630,299213,4358
2021-04-14,Sacramento,067,1510023,101529,100645,1510,102155,1570
2021-04-14,San Benito,069,59416,5963,5960,108,6068,62
2021-04-14,San Bernardino,071,2135413,290744,289078,8769,297847,4523
2021-04-14,San Diego,073,3302833,274954,273969,14074,288043,3648
2021-04-14,San Francisco,075,870044,35875,35898,1215,37113,510
2021-04-14,San Joaquin,077,732212,70997,70095,3274,73369,1288
2021-04-14,San Luis Obispo,079,281455,20920,20561,664,21225,253
2021-04-14,San Mateo,081,765935,41430,40982,438,41420,352
2021-04-14,Santa Barbara,083,443738,33866,33650,1093,34743,445
2021-04-14,Santa Clara,085,1922200,116209,116488,675,117163,1922
2021-04-14,Santa Cruz,087,273765,16008,15481,789,16270,203
2021-04-14,Shasta,089,179085,11578,11581,1399,12980,190
2021-04-14,Sierra,091,2930,55,51,12,63,0
2021-04-14,Siskiyou,093,43540,1627,1518,274,1792,10
2021-04-14,Solano,095,438530,31539,31357,446,31803,239
2021-04-14,Sonoma,097,501317,29451,29572,293,29865,311
2021-04-14,Stanislaus,099,539301,54203,53836,5653,59489,727
2021-04-14,Sutter,101,95872,9221,9230,80,9310,106
2021-04-14,Tehama,103,63373,4891,4853,527,5380,52
2021-04-14,Trinity,105,12862,482,326,81,407,3
2021-04-14,Tulare,107,460477,49541,48527,8567,57094,827
2021-04-14,Tuolumne,109,53932,3958,3997,40,4037,57
2021-04-14,Ventura,111,848112,80423,79891,2882,82773,986
2021-04-14,Yolo,113,214977,13537,13530,185,13715,198
2021-04-14,Yuba,115,75493,5819,5778,113,5891,44
2021-04-13,Alameda,001,1643700,85270,84921,1813,86734,1239
2021-04-13,Alpine,003,1148,85,85,0,85,0
2021-04-13,Amador,005,37829,3616,3609,32,3641,46
2021-04-13,Butte,007,227075,11863,11497,1719,13216,196
2021-04-13,Calaveras,009,45235,2042,2035,11,2046,50
2021-04-13,Colusa,011,21464,1905,1905,280,2185,14
2021-04-13,Contra Costa,013,1133247,67046,66304,1153,67457,778
2021-04-13,Del Norte,015,27424,1263,1221,11,1232,6
2021-04-13,El Dorado,017,186661,9720,9609,669,10278,106
2021-04-13,Fresno,019,978130,100800,100357,8313,108670,1636
2021-04-13,Glenn,021,27897,2373,2351,532,2883,17
2021-04-13,Humboldt,023,135768,3578,3540,26,3566,35
2021-04-13,Imperial,025,180216,28018,27887,2583,30470,718
2021-04-13,Inyo,027,18085,1392,1391,10,1401,36
2021-04-13,Kern,029,883053,96007,94908,10369,105277,1285
2021-04-13,Kings,031,150075,22857,22636,1034,23670,243
2021-04-13,Lake,033,64148,3421,3390,9,3399,43
2021-04-13,Lassen,035,31185,5159,5147,103,5250,1
2021-04-13,Los Angeles,037,10098052,1196328,1186482,39634,1226116,23526
2021-04-13,Madera,039,155013,16345,16207,901,17108,231
2021-04-13,Marin,041,260295,13819,13760,227,13987,224
2021-04-13,Mariposa,043,17540,404,394,6,400,5
2021-04-13,Mendocino,045,87422,3786,3702,74,3776,46
2021-04-13,Merced,047,269075,30238,30276,995,31271,435
2021-04-13,Modoc,049,8938,363,355,120,475,3
2021-04-13,Mono,051,14174,1241,1251,17,1268,3
2021-04-13,Monterey,053,433212,42747,42577,1778,44355,347
2021-04-13,Napa,055,140530,9638,9627,31,9658,79
2021-04-13,Nevada,057,99092,4482,4415,182,4597,69
2021-04-13,Orange,059,3164182,253001,251491,10881,262372,4836
2021-04-13,Placer,061,380077,22234,21534,1344,22878,280
2021-04-13,Plumas,063,18699,677,665,10,675,4
2021-04-13,Riverside,065,2383286,291162,285505,13624,299129,4348
2021-04-13,Sacramento,067,1510023,101354,100551,1505,102056,1569
2021-04-13,San Benito,069,59416,5960,5946,108,6054,62
2021-04-13,San Bernardino,071,2135413,290628,288929,8763,297692,4521
2021-04-13,San Diego,073,3302833,274700,273709,14039,287748,3623
2021-04-13,San Francisco,075,870044,35839,35869,1211,37080,506
2021-04-13,San Joaquin,077,732212,70889,70034,3266,73300,1288
2021-04-13,San Luis Obispo,079,281455,20893,20536,654,21190,253
2021-04-13,San Mateo,081,765935,41385,40955,438,41393,353
2021-04-13,Santa Barbara,083,443738,33843,33613,1090,34703,444
2021-04-13,Santa Clara,085,1922200,116080,116363,674,117037,1923
2021-04-13,Santa Cruz,087,273765,16001,15449,789,16238,203
2021-04-13,Shasta,089,179085,11558,11536,1396,12932,189
2021-04-13,Sierra,091,2930,55,51,12,63,0
2021-04-13,Siskiyou,093,43540,1619,1511,271,1782,10
2021-04-13,Solano,095,438530,31490,31335,442,31777,239
2021-04-13,Sonoma,097,501317,29443,29544,292,29836,311
2021-04-13,Stanislaus,099,539301,54131,53797,5644,59441,722
2021-04-13,Sutter,101,95872,9217,9226,80,9306,106
2021-04-13,Tehama,103,63373,4884,4850,524,5374,52
2021-04-13,Trinity,105,12862,482,326,81,407,3
2021-04-13,Tulare,107,460477,49528,48511,8564,57075,825
2021-04-13,Tuolumne,109,53932,3956,3995,40,4035,57
2021-04-13,Ventura,111,848112,80391,79854,2880,82734,986
2021-04-13,Yolo,113,214977,13525,13516,184,13700,198
2021-04-13,Yuba,115,75493,5810,5776,113,5889,44
2021-04-12,Alameda,001,1643700,85168,84817,1811,86628,1238
2021-04-12,Alpine,003,1148,85,85,0,85,0
2021-04-12,Amador,005,37829,3615,3607,32,3639,46
2021-04-12,Butte,007,227075,11848,11488,1715,13203,193
2021-04-12,Calaveras,009,45235,2038,2033,11,2044,50
2021-04-12,Colusa,011,21464,1903,1904,278,2182,14
2021-04-12,Contra Costa,013,1133247,66966,66176,1153,67329,777
2021-04-12,Del Norte,015,27424,1260,1216,11,1227,6
2021-04-12,El Dorado,017,186661,9703,9588,667,10255,106
2021-04-12,Fresno,019,978130,100739,100277,8290,108567,1633
2021-04-12,Glenn,021,27897,2372,2349,532,2881,17
2021-04-12,Humboldt,023,135768,3564,3533,25,3558,35
2021-04-12,Imperial,025,180216,27988,27851,2579,30430,717
2021-04-12,Inyo,027,18085,1392,1390,10,1400,36
2021-04-12,Kern,029,883053,95970,94861,10359,105220,1283
2021-04-12,Kings,031,150075,22849,22621,1033,23654,241
2021-04-12,Lake,033,64148,3417,3380,9,3389,43
2021-04-12,Lassen,035,31185,5158,5147,103,5250,1
2021-04-12,Los Angeles,037,10098052,1195825,1186145,39597,1225742,23505
2021-04-12,Madera,039,155013,16333,16174,899,17073,231
2021-04-12,Marin,041,260295,13806,13751,225,13976,224
2021-04-12,Mariposa,043,17540,403,394,6,400,5
2021-04-12,Mendocino,045,87422,3785,3699,74,3773,46
2021-04-12,Merced,047,269075,30207,30261,992,31253,435
2021-04-12,Modoc,049,8938,361,352,120,472,3
2021-04-12,Mono,051,14174,1241,1251,17,1268,3
2021-04-12,Monterey,053,433212,42733,42555,1776,44331,346
2021-04-12,Napa,055,140530,9624,9603,31,9634,80
2021-04-12,Nevada,057,99092,4471,4408,182,4590,69
2021-04-12,Orange,059,3164182,252914,251350,10860,262210,4826
2021-04-12,Placer,061,380077,22183,21475,1341,22816,278
2021-04-12,Plumas,063,18699,675,666,10,676,4
2021-04-12,Riverside,065,2383286,291051,285361,13618,298979,4336
2021-04-12,Sacramento,067,1510023,101180,100394,1500,101894,1566
2021-04-12,San Benito,069,59416,5952,5942,107,6049,62
2021-04-12,San Bernardino,071,2135413,290521,288736,8751,297487,4493
2021-04-12,San Diego,073,3302833,274439,273431,14010,287441,3621
2021-04-12,San Francisco,075,870044,35805,35841,1210,37051,506
2021-04-12,San Joaquin,077,732212,70817,69968,3259,73227,1288
2021-04-12,San Luis Obispo,079,281455,20848,20515,641,21156,253
2021-04-12,San Mateo,081,765935,41343,40920,434,41354,353
2021-04-12,Santa Barbara,083,443738,33811,33606,1090,34696,444
2021-04-12,Santa Clara,085,1922200,115952,116252,672,116924,1923
2021-04-12,Santa Cruz,087,273765,15981,15406,789,16195,203
2021-04-12,Shasta,089,179085,11541,11509,1392,12901,189
2021-04-12,Sierra,091,2930,55,51,12,63,0
2021-04-12,Siskiyou,093,43540,1608,1511,268,1779,7
2021-04-12,Solano,095,438530,31448,31305,439,31744,238
2021-04-12,Sonoma,097,501317,29415,29500,292,29792,310
2021-04-12,Stanislaus,099,539301,54065,53722,5637,59359,707
2021-04-12,Sutter,101,95872,9206,9221,80,9301,106
2021-04-12,Tehama,103,63373,4875,4834,520,5354,52
2021-04-12,Trinity,105,12862,482,324,81,405,3
2021-04-12,Tulare,107,460477,49508,48495,8554,57049,824
2021-04-12,Tuolumne,109,53932,3952,3993,40,4033,57
2021-04-12,Ventura,111,848112,80358,79818,2878,82696,985
2021-04-12,Yolo,113,214977,13511,13510,183,13693,198
2021-04-12,Yuba,115,75493,5804,5773,113,5886,43
2021-04-11,Alameda,001,1643700,85031,84756,1806,86562,1238
2021-04-11,Alpine,003,1148,85,85,0,85,0
2021-04-11,Amador,005,37829,3613,3605,32,3637,46
2021-04-11,Butte,007,227075,11813,11487,1711,13198,193
2021-04-11,Calaveras,009,45235,2034,2036,11,2047,50
2021-04-11,Colusa,011,21464,1902,1904,277,2181,14
2021-04-11,Contra Costa,013,1133247,66857,66107,1151,67258,777
2021-04-11,Del Norte,015,27424,1254,1214,11,1225,6
2021-04-11,El Dorado,017,186661,9689,9575,664,10239,106
2021-04-11,Fresno,019,978130,100671,100230,8280,108510,1633
2021-04-11,Glenn,021,27897,2368,2348,532,2880,17
2021-04-11,Humboldt,023,135768,3554,3523,25,3548,35
2021-04-11,Imperial,025,180216,27964,27841,2577,30418,717
2021-04-11,Inyo,027,18085,1392,1390,10,1400,36
2021-04-11,Kern,029,883053,95909,94830,10351,105181,1283
2021-04-11,Kings,031,150075,22840,22618,1030,23648,241
2021-04-11,Lake,033,64148,3413,3377,9,3386,43
2021-04-11,Lassen,035,31185,5154,5147,103,5250,1
2021-04-11,Los Angeles,037,10098052,1195313,1185757,39555,1225312,23503
2021-04-11,Madera,039,155013,16314,16166,898,17064,231
2021-04-11,Marin,041,260295,13799,13741,224,13965,226
2021-04-11,Mariposa,043,17540,403,394,6,400,5
2021-04-11,Mendocino,045,87422,3783,3696,74,3770,46
2021-04-11,Merced,047,269075,30169,30249,991,31240,435
2021-04-11,Modoc,049,8938,360,352,118,470,3
2021-04-11,Mono,051,14174,1240,1250,17,1267,3
2021-04-11,Monterey,053,433212,42727,42547,1769,44316,346
2021-04-11,Napa,055,140530,9613,9592,31,9623,80
2021-04-11,Nevada,057,99092,4457,4394,182,4576,69
2021-04-11,Orange,059,3164182,252787,251233,10849,262082,4826
2021-04-11,Placer,061,380077,22126,21458,1336,22794,278
2021-04-11,Plumas,063,18699,675,666,10,676,4
2021-04-11,Riverside,065,2383286,290917,285269,13608,298877,4336
2021-04-11,Sacramento,067,1510023,101009,100296,1488,101784,1566
2021-04-11,San Benito,069,59416,5944,5941,106,6047,62
2021-04-11,San Bernardino,071,2135413,290414,288686,8745,297431,4492
2021-04-11,San Diego,073,3302833,274141,273287,13951,287238,3621
2021-04-11,San Francisco,075,870044,35769,35815,1207,37022,498
2021-04-11,San Joaquin,077,732212,70731,69939,3248,73187,1288
2021-04-11,San Luis Obispo,079,281455,20822,20501,638,21139,253
2021-04-11,San Mateo,081,765935,41285,40901,433,41334,353
2021-04-11,Santa Barbara,083,443738,33776,33591,1089,34680,444
2021-04-11,Santa Clara,085,1922200,115816,116161,669,116830,1923
2021-04-11,Santa Cruz,087,273765,15969,15382,789,16171,203
2021-04-11,Shasta,089,179085,11497,11504,1391,12895,189
2021-04-11,Sierra,091,2930,55,51,12,63,0
2021-04-11,Siskiyou,093,43540,1601,1509,265,1774,7
2021-04-11,Solano,095,438530,31394,31268,435,31703,238
2021-04-11,Sonoma,097,501317,29389,29496,288,29784,310
2021-04-11,Stanislaus,099,539301,53982,53683,5628,59311,707
2021-04-11,Sutter,101,95872,9197,9222,80,9302,106
2021-04-11,Tehama,103,63373,4872,4832,519,5351,52
2021-04-11,Trinity,105,12862,482,324,81,405,3
2021-04-11,Tulare,107,460477,49494,48479,8547,57026,824
2021-04-11,Tuolumne,109,53932,3950,3993,40,4033,57
2021-04-11,Ventura,111,848112,80310,79800,2873,82673,985
2021-04-11,Yolo,113,214977,13491,13496,181,13677,198
2021-04-11,Yuba,115,75493,5794,5768,113,5881,43
2021-04-10,Alameda,001,1643700,84967,84626,1806,86432,1238
2021-04-10,Alpine,003,1148,85,85,0,85,0
2021-04-10,Amador,005,37829,3611,3603,32,3635,46
2021-04-10,Butte,007,227075,11802,11482,1710,13192,193
2021-04-10,Calaveras,009,45235,2032,2032,11,2043,50
2021-04-10,Colusa,011,21464,1902,1902,277,2179,14
2021-04-10,Contra Costa,013,1133247,66796,66001,1148,67149,778
2021-04-10,Del Norte,015,27424,1251,1212,11,1223,6
2021-04-10,El Dorado,017,186661,9677,9549,661,10210,106
2021-04-10,Fresno,019,978130,100638,100135,8273,108408,1633
2021-04-10,Glenn,021,27897,2368,2343,532,2875,17
2021-04-10,Humboldt,023,135768,3544,3508,25,3533,35
2021-04-10,Imperial,025,180216,27950,27816,2577,30393,717
2021-04-10,Inyo,027,18085,1392,1387,10,1397,36
2021-04-10,Kern,029,883053,95895,94802,10345,105147,1284
2021-04-10,Kings,031,150075,22836,22614,1028,23642,241
2021-04-10,Lake,033,64148,3408,3368,9,3377,43
2021-04-10,Lassen,035,31185,5154,5146,102,5248,1
2021-04-10,Los Angeles,037,10098052,1195038,1185246,39538,1224784,23493
2021-04-10,Madera,039,155013,16306,16143,897,17040,231
2021-04-10,Marin,041,260295,13794,13731,224,13955,226
2021-04-10,Mariposa,043,17540,400,393,6,399,5
2021-04-10,Mendocino,045,87422,3781,3696,74,3770,46
2021-04-10,Merced,047,269075,30150,30225,990,31215,435
2021-04-10,Modoc,049,8938,360,352,118,470,3
2021-04-10,Mono,051,14174,1240,1249,17,1266,3
2021-04-10,Monterey,053,433212,42716,42527,1768,44295,346
2021-04-10,Napa,055,140530,9606,9569,31,9600,79
2021-04-10,Nevada,057,99092,4450,4379,182,4561,69
2021-04-10,Orange,059,3164182,252694,251139,10843,261982,4818
2021-04-10,Placer,061,380077,22095,21402,1330,22732,278
2021-04-10,Plumas,063,18699,675,666,10,676,4
2021-04-10,Riverside,065,2383286,290837,285082,13600,298682,4336
2021-04-10,Sacramento,067,1510023,100906,100048,1486,101534,1566
2021-04-10,San Benito,069,59416,5933,5932,105,6037,62
2021-04-10,San Bernardino,071,2135413,290350,288590,8738,297328,4489
2021-04-10,San Diego,073,3302833,273925,273058,13931,286989,3613
2021-04-10,San Francisco,075,870044,35739,35774,1204,36978,498
2021-04-10,San Joaquin,077,732212,70696,69852,3238,73090,1288
2021-04-10,San Luis Obispo,079,281455,20806,20461,637,21098,253
2021-04-10,San Mateo,081,765935,41252,40878,433,41311,350
2021-04-10,Santa Barbara,083,443738,33748,33541,1087,34628,444
2021-04-10,Santa Clara,085,1922200,115720,116015,668,116683,1923
2021-04-10,Santa Cruz,087,273765,15963,15360,789,16149,203
2021-04-10,Shasta,089,179085,11488,11492,1388,12880,189
2021-04-10,Sierra,091,2930,55,51,12,63,0
2021-04-10,Siskiyou,093,43540,1598,1512,265,1777,7
2021-04-10,Solano,095,438530,31360,31218,431,31649,238
2021-04-10,Sonoma,097,501317,29374,29469,288,29757,310
2021-04-10,Stanislaus,099,539301,53947,53596,5622,59218,707
2021-04-10,Sutter,101,95872,9195,9214,80,9294,106
2021-04-10,Tehama,103,63373,4870,4820,517,5337,52
2021-04-10,Trinity,105,12862,482,324,81,405,3
2021-04-10,Tulare,107,460477,49485,48470,8541,57011,824
2021-04-10,Tuolumne,109,53932,3947,3991,40,4031,57
2021-04-10,Ventura,111,848112,80282,79758,2871,82629,985
2021-04-10,Yolo,113,214977,13483,13494,180,13674,198
2021-04-10,Yuba,115,75493,5791,5757,112,5869,43
2021-04-09,Alameda,001,1643700,84900,84404,1798,86202,1237
2021-04-09,Alpine,003,1148,85,85,0,85,0
2021-04-09,Amador,005,37829,3610,3600,32,3632,46
2021-04-09,Butte,007,227075,11792,11454,1709,13163,193
2021-04-09,Calaveras,009,45235,2031,2028,11,2039,50
2021-04-09,Colusa,011,21464,1902,1898,277,2175,14
2021-04-09,Contra Costa,013,1133247,66703,65857,1142,66999,777
2021-04-09,Del Norte,015,27424,1250,1207,11,1218,6
2021-04-09,El Dorado,017,186661,9655,9528,657,10185,106
2021-04-09,Fresno,019,978130,100604,100027,8268,108295,1630
2021-04-09,Glenn,021,27897,2368,2337,532,2869,17
2021-04-09,Humboldt,023,135768,3535,3496,25,3521,35
2021-04-09,Imperial,025,180216,27935,27764,2575,30339,717
2021-04-09,Inyo,027,18085,1391,1386,10,1396,36
2021-04-09,Kern,029,883053,95857,94675,10343,105018,1282
2021-04-09,Kings,031,150075,22827,22595,1025,23620,242
2021-04-09,Lake,033,64148,3404,3362,9,3371,43
2021-04-09,Lassen,035,31185,5154,5140,102,5242,1
2021-04-09,Los Angeles,037,10098052,1194669,1184501,39510,1224011,23458
2021-04-09,Madera,039,155013,16303,16118,897,17015,231
2021-04-09,Marin,041,260295,13787,13721,224,13945,226
2021-04-09,Mariposa,043,17540,400,393,6,399,5
2021-04-09,Mendocino,045,87422,3779,3693,74,3767,46
2021-04-09,Merced,047,269075,30121,30179,989,31168,435
2021-04-09,Modoc,049,8938,359,352,118,470,3
2021-04-09,Mono,051,14174,1240,1247,17,1264,3
2021-04-09,Monterey,053,433212,42707,42481,1764,44245,344
2021-04-09,Napa,055,140530,9587,9574,31,9605,80
2021-04-09,Nevada,057,99092,4442,4373,182,4555,69
2021-04-09,Orange,059,3164182,252620,250852,10838,261690,4813
2021-04-09,Placer,061,380077,22064,21327,1322,22649,278
2021-04-09,Plumas,063,18699,674,666,10,676,4
2021-04-09,Riverside,065,2383286,290754,284562,13594,298156,4325
2021-04-09,Sacramento,067,1510023,100750,99722,1480,101202,1564
2021-04-09,San Benito,069,59416,5928,5925,104,6029,62
2021-04-09,San Bernardino,071,2135413,290281,288000,8735,296735,4467
2021-04-09,San Diego,073,3302833,273727,272697,13889,286586,3600
2021-04-09,San Francisco,075,870044,35698,35716,1199,36915,497
2021-04-09,San Joaquin,077,732212,70632,69675,3226,72901,1281
2021-04-09,San Luis Obispo,079,281455,20791,20427,637,21064,252
2021-04-09,San Mateo,081,765935,41216,40800,432,41232,350
2021-04-09,Santa Barbara,083,443738,33725,33424,1084,34508,444
2021-04-09,Santa Clara,085,1922200,115636,115749,666,116415,1923
2021-04-09,Santa Cruz,087,273765,15958,15331,789,16120,203
2021-04-09,Shasta,089,179085,11478,11478,1385,12863,188
2021-04-09,Sierra,091,2930,55,51,12,63,0
2021-04-09,Siskiyou,093,43540,1595,1510,264,1774,7
2021-04-09,Solano,095,438530,31327,31166,426,31592,238
2021-04-09,Sonoma,097,501317,29361,29433,288,29721,310
2021-04-09,Stanislaus,099,539301,53892,53504,5613,59117,705
2021-04-09,Sutter,101,95872,9188,9201,80,9281,106
2021-04-09,Tehama,103,63373,4864,4806,517,5323,52
2021-04-09,Trinity,105,12862,481,324,81,405,3
2021-04-09,Tulare,107,460477,49481,48430,8535,56965,824
2021-04-09,Tuolumne,109,53932,3946,3986,40,4026,57
2021-04-09,Ventura,111,848112,80254,79698,2871,82569,987
2021-04-09,Yolo,113,214977,13471,13478,178,13656,198
2021-04-09,Yuba,115,75493,5784,5754,112,5866,43
2021-04-08,Alameda,001,1643700,84792,84213,1795,86008,1232
2021-04-08,Alpine,003,1148,85,85,0,85,0
2021-04-08,Amador,005,37829,3606,3595,32,3627,46
2021-04-08,Butte,007,227075,11781,11414,1708,13122,193
2021-04-08,Calaveras,009,45235,2029,2027,11,2038,50
2021-04-08,Colusa,011,21464,1901,1897,277,2174,14
2021-04-08,Contra Costa,013,1133247,66595,65706,1139,66845,775
2021-04-08,Del Norte,015,27424,1244,1201,11,1212,6
2021-04-08,El Dorado,017,186661,9639,9513,652,10165,106
2021-04-08,Fresno,019,978130,100540,99935,8261,108196,1627
2021-04-08,Glenn,021,27897,2367,2337,532,2869,17
2021-04-08,Humboldt,023,135768,3525,3486,25,3511,35
2021-04-08,Imperial,025,180216,27907,27744,2572,30316,713
2021-04-08,Inyo,027,18085,1390,1386,10,1396,36
2021-04-08,Kern,029,883053,95811,94493,10330,104823,1281
2021-04-08,Kings,031,150075,22820,22589,1023,23612,243
2021-04-08,Lake,033,64148,3397,3360,9,3369,43
2021-04-08,Lassen,035,31185,5153,5136,102,5238,1
2021-04-08,Los Angeles,037,10098052,1194170,1184443,39472,1223915,23416
2021-04-08,Madera,039,155013,16291,16103,897,17000,231
2021-04-08,Marin,041,260295,13780,13704,224,13928,226
2021-04-08,Mariposa,043,17540,399,393,6,399,5
2021-04-08,Mendocino,045,87422,3777,3690,74,3764,45
2021-04-08,Merced,047,269075,30099,30163,989,31152,430
2021-04-08,Modoc,049,8938,359,352,118,470,3
2021-04-08,Mono,051,14174,1238,1247,17,1264,3
2021-04-08,Monterey,053,433212,42685,42437,1759,44196,342
2021-04-08,Napa,055,140530,9571,9569,31,9600,80
2021-04-08,Nevada,057,99092,4431,4367,182,4549,69
2021-04-08,Orange,059,3164182,252510,250529,10823,261352,4797
2021-04-08,Placer,061,380077,22022,21258,1313,22571,277
2021-04-08,Plumas,063,18699,674,665,10,675,4
2021-04-08,Riverside,065,2383286,290640,283853,13589,297442,4296
2021-04-08,Sacramento,067,1510023,100611,99319,1469,100788,1561
2021-04-08,San Benito,069,59416,5925,5914,102,6016,62
2021-04-08,San Bernardino,071,2135413,290184,287190,8732,295922,4445
2021-04-08,San Diego,073,3302833,273497,272495,13853,286348,3592
2021-04-08,San Francisco,075,870044,35674,35657,1198,36855,494
2021-04-08,San Joaquin,077,732212,70560,69479,3220,72699,1279
2021-04-08,San Luis Obispo,079,281455,20772,20402,635,21037,252
2021-04-08,San Mateo,081,765935,41176,40749,432,41181,350
2021-04-08,Santa Barbara,083,443738,33701,33309,1083,34392,444
2021-04-08,Santa Clara,085,1922200,115530,115487,665,116152,1905
2021-04-08,Santa Cruz,087,273765,15951,15296,789,16085,203
2021-04-08,Shasta,089,179085,11468,11466,1381,12847,186
2021-04-08,Sierra,091,2930,55,51,12,63,0
2021-04-08,Siskiyou,093,43540,1592,1511,264,1775,7
2021-04-08,Solano,095,438530,31277,31120,426,31546,238
2021-04-08,Sonoma,097,501317,29341,29410,287,29697,310
2021-04-08,Stanislaus,099,539301,53814,53401,5603,59004,706
2021-04-08,Sutter,101,95872,9184,9195,80,9275,106
2021-04-08,Tehama,103,63373,4860,4802,517,5319,52
2021-04-08,Trinity,105,12862,481,324,81,405,3
2021-04-08,Tulare,107,460477,49468,48409,8525,56934,821
2021-04-08,Tuolumne,109,53932,3946,3986,40,4026,57
2021-04-08,Ventura,111,848112,80217,79626,2867,82493,986
2021-04-08,Yolo,113,214977,13462,13468,177,13645,198
2021-04-08,Yuba,115,75493,5780,5743,112,5855,43
2021-04-07,Alameda,001,1643700,84708,84130,1793,85923,1224
2021-04-07,Alpine,003,1148,85,85,0,85,0
2021-04-07,Amador,005,37829,3603,3590,32,3622,46
2021-04-07,Butte,007,227075,11777,11405,1705,13110,193
2021-04-07,Calaveras,009,45235,2028,2022,11,2033,50
2021-04-07,Colusa,011,21464,1897,1894,276,2170,14
2021-04-07,Contra Costa,013,1133247,66509,65619,1138,66757,775
2021-04-07,Del Norte,015,27424,1242,1198,11,1209,6
2021-04-07,El Dorado,017,186661,9618,9500,646,10146,106
2021-04-07,Fresno,019,978130,100475,99865,8250,108115,1627
2021-04-07,Glenn,021,27897,2365,2337,531,2868,17
2021-04-07,Humboldt,023,135768,3512,3484,25,3509,35
2021-04-07,Imperial,025,180216,27883,27704,2566,30270,713
2021-04-07,Inyo,027,18085,1389,1386,10,1396,36
2021-04-07,Kern,029,883053,95775,94456,10315,104771,1275
2021-04-07,Kings,031,150075,22818,22589,1023,23612,243
2021-04-07,Lake,033,64148,3395,3358,9,3367,43
2021-04-07,Lassen,035,31185,5153,5137,102,5239,1
2021-04-07,Los Angeles,037,10098052,1193729,1183862,39452,1223314,23372
2021-04-07,Madera,039,155013,16272,16090,896,16986,231
2021-04-07,Marin,041,260295,13769,13688,223,13911,225
2021-04-07,Mariposa,043,17540,398,391,6,397,5
2021-04-07,Mendocino,045,87422,3776,3691,74,3765,45
2021-04-07,Merced,047,269075,30076,30132,985,31117,430
2021-04-07,Modoc,049,8938,359,351,118,469,3
2021-04-07,Mono,051,14174,1238,1246,17,1263,3
2021-04-07,Monterey,053,433212,42667,42427,1758,44185,341
2021-04-07,Napa,055,140530,9557,9556,31,9587,80
2021-04-07,Nevada,057,99092,4425,4364,182,4546,69
2021-04-07,Orange,059,3164182,252385,250378,10801,261179,4778
2021-04-07,Placer,061,380077,21978,21227,1305,22532,276
2021-04-07,Plumas,063,18699,674,665,10,675,4
2021-04-07,Riverside,065,2383286,290520,283749,13579,297328,4285
2021-04-07,Sacramento,067,1510023,100443,99202,1463,100665,1544
2021-04-07,San Benito,069,59416,5920,5912,101,6013,62
2021-04-07,San Bernardino,071,2135413,290065,286978,8727,295705,4433
2021-04-07,San Diego,073,3302833,273271,272195,13824,286019,3588
2021-04-07,San Francisco,075,870044,35634,35618,1194,36812,493
2021-04-07,San Joaquin,077,732212,70489,69375,3215,72590,1278
2021-04-07,San Luis Obispo,079,281455,20746,20373,632,21005,252
2021-04-07,San Mateo,081,765935,41132,40693,432,41125,350
2021-04-07,Santa Barbara,083,443738,33675,33289,1080,34369,444
2021-04-07,Santa Clara,085,1922200,115398,115311,663,115974,1900
2021-04-07,Santa Cruz,087,273765,15940,15275,789,16064,203
2021-04-07,Shasta,089,179085,11456,11456,1377,12833,184
2021-04-07,Sierra,091,2930,55,51,12,63,0
2021-04-07,Siskiyou,093,43540,1586,1512,263,1775,7
2021-04-07,Solano,095,438530,31226,31097,425,31522,238
2021-04-07,Sonoma,097,501317,29323,29394,286,29680,310
2021-04-07,Stanislaus,099,539301,53746,53344,5593,58937,686
2021-04-07,Sutter,101,95872,9181,9188,80,9268,106
2021-04-07,Tehama,103,63373,4852,4802,515,5317,52
2021-04-07,Trinity,105,12862,481,322,81,403,3
2021-04-07,Tulare,107,460477,49453,48386,8515,56901,820
2021-04-07,Tuolumne,109,53932,3944,3982,40,4022,57
2021-04-07,Ventura,111,848112,80183,79595,2865,82460,986
2021-04-07,Yolo,113,214977,13447,13450,175,13625,198
2021-04-07,Yuba,115,75493,5776,5737,112,5849,43
2021-04-06,Alameda,001,1643700,84595,84091,1790,85881,1223
2021-04-06,Alpine,003,1148,85,85,0,85,0
2021-04-06,Amador,005,37829,3602,3587,32,3619,45
2021-04-06,Butte,007,227075,11762,11396,1703,13099,193
2021-04-06,Calaveras,009,45235,2024,2021,11,2032,50
2021-04-06,Colusa,011,21464,1895,1894,274,2168,14
2021-04-06,Contra Costa,013,1133247,66431,65575,1137,66712,774
2021-04-06,Del Norte,015,27424,1237,1197,11,1208,6
2021-04-06,El Dorado,017,186661,9588,9489,644,10133,106
2021-04-06,Fresno,019,978130,100411,99814,8244,108058,1626
2021-04-06,Glenn,021,27897,2364,2335,530,2865,17
2021-04-06,Humboldt,023,135768,3503,3477,25,3502,35
2021-04-06,Imperial,025,180216,27850,27661,2557,30218,713
2021-04-06,Inyo,027,18085,1389,1379,10,1389,36
2021-04-06,Kern,029,883053,95731,94422,10309,104731,1259
2021-04-06,Kings,031,150075,22812,22587,1023,23610,240
2021-04-06,Lake,033,64148,3392,3358,9,3367,43
2021-04-06,Lassen,035,31185,5151,5137,102,5239,1
2021-04-06,Los Angeles,037,10098052,1193217,1183499,39413,1222912,23323
2021-04-06,Madera,039,155013,16252,16085,891,16976,230
2021-04-06,Marin,041,260295,13760,13675,219,13894,224
2021-04-06,Mariposa,043,17540,398,390,6,396,5
2021-04-06,Mendocino,045,87422,3774,3686,74,3760,45
2021-04-06,Merced,047,269075,30046,30100,980,31080,430
2021-04-06,Modoc,049,8938,358,351,118,469,3
2021-04-06,Mono,051,14174,1238,1246,17,1263,3
2021-04-06,Monterey,053,433212,42658,42412,1757,44169,341
2021-04-06,Napa,055,140530,9538,9509,31,9540,78
2021-04-06,Nevada,057,99092,4415,4356,180,4536,69
2021-04-06,Orange,059,3164182,252276,250304,10788,261092,4771
2021-04-06,Placer,061,380077,21930,21184,1303,22487,276
2021-04-06,Plumas,063,18699,674,665,10,675,4
2021-04-06,Riverside,065,2383286,290339,283622,13568,297190,4264
2021-04-06,Sacramento,067,1510023,100235,99110,1457,100567,1537
2021-04-06,San Benito,069,59416,5911,5907,101,6008,62
2021-04-06,San Bernardino,071,2135413,289952,286792,8717,295509,4428
2021-04-06,San Diego,073,3302833,273009,271867,13796,285663,3585
2021-04-06,San Francisco,075,870044,35591,35572,1194,36766,488
2021-04-06,San Joaquin,077,732212,70406,69316,3203,72519,1278
2021-04-06,San Luis Obispo,079,281455,20724,20350,629,20979,252
2021-04-06,San Mateo,081,765935,41084,40649,431,41080,350
2021-04-06,Santa Barbara,083,443738,33657,33257,1079,34336,443
2021-04-06,Santa Clara,085,1922200,115227,115184,662,115846,1900
2021-04-06,Santa Cruz,087,273765,15930,15252,789,16041,203
2021-04-06,Shasta,089,179085,11435,11443,1375,12818,184
2021-04-06,Sierra,091,2930,55,51,12,63,0
2021-04-06,Siskiyou,093,43540,1582,1510,262,1772,7
2021-04-06,Solano,095,438530,31179,31078,424,31502,237
2021-04-06,Sonoma,097,501317,29297,29386,284,29670,311
2021-04-06,Stanislaus,099,539301,53690,53304,5587,58891,686
2021-04-06,Sutter,101,95872,9171,9179,80,9259,106
2021-04-06,Tehama,103,63373,4843,4798,515,5313,52
2021-04-06,Trinity,105,12862,481,321,81,402,3
2021-04-06,Tulare,107,460477,49410,48372,8511,56883,819
2021-04-06,Tuolumne,109,53932,3944,3981,40,4021,57
2021-04-06,Ventura,111,848112,80146,79556,2863,82419,983
2021-04-06,Yolo,113,214977,13434,13443,174,13617,198
2021-04-06,Yuba,115,75493,5772,5733,111,5844,43
2021-04-05,Alameda,001,1643700,84479,84007,1786,85793,1219
2021-04-05,Alpine,003,1148,85,85,0,85,0
2021-04-05,Amador,005,37829,3599,3584,32,3616,45
2021-04-05,Butte,007,227075,11747,11384,1703,13087,193
2021-04-05,Calaveras,009,45235,2022,2019,11,2030,50
2021-04-05,Colusa,011,21464,1895,1894,273,2167,14
2021-04-05,Contra Costa,013,1133247,66364,65457,1135,66592,774
2021-04-05,Del Norte,015,27424,1235,1189,11,1200,6
2021-04-05,El Dorado,017,186661,9573,9463,644,10107,106
2021-04-05,Fresno,019,978130,100323,99755,8236,107991,1622
2021-04-05,Glenn,021,27897,2363,2335,530,2865,17
2021-04-05,Humboldt,023,135768,3494,3475,25,3500,35
2021-04-05,Imperial,025,180216,27818,27604,2552,30156,710
2021-04-05,Inyo,027,18085,1386,1377,10,1387,36
2021-04-05,Kern,029,883053,95676,94401,10284,104685,1249
2021-04-05,Kings,031,150075,22808,22580,1023,23603,239
2021-04-05,Lake,033,64148,3384,3359,9,3368,43
2021-04-05,Lassen,035,31185,5151,5138,101,5239,1
2021-04-05,Los Angeles,037,10098052,1192681,1183200,39365,1222565,23302
2021-04-05,Madera,039,155013,16237,16065,890,16955,230
2021-04-05,Marin,041,260295,13746,13666,215,13881,221
2021-04-05,Mariposa,043,17540,398,390,6,396,5
2021-04-05,Mendocino,045,87422,3772,3687,74,3761,45
2021-04-05,Merced,047,269075,30021,30068,978,31046,427
2021-04-05,Modoc,049,8938,356,346,118,464,3
2021-04-05,Mono,051,14174,1238,1246,17,1263,3
2021-04-05,Monterey,053,433212,42645,42396,1753,44149,341
2021-04-05,Napa,055,140530,9515,9492,31,9523,78
2021-04-05,Nevada,057,99092,4404,4346,180,4526,69
2021-04-05,Orange,059,3164182,252161,250177,10764,260941,4759
2021-04-05,Placer,061,380077,21884,21133,1296,22429,276
2021-04-05,Plumas,063,18699,674,666,10,676,4
2021-04-05,Riverside,065,2383286,290202,283549,13556,297105,4237
2021-04-05,Sacramento,067,1510023,100073,98908,1449,100357,1533
2021-04-05,San Benito,069,59416,5905,5904,101,6005,61
2021-04-05,San Bernardino,071,2135413,289842,286597,8714,295311,4425
2021-04-05,San Diego,073,3302833,272760,271655,13755,285410,3583
2021-04-05,San Francisco,075,870044,35560,35538,1194,36732,488
2021-04-05,San Joaquin,077,732212,70317,69214,3194,72408,1268
2021-04-05,San Luis Obispo,079,281455,20687,20333,629,20962,252
2021-04-05,San Mateo,081,765935,41040,40609,430,41039,350
2021-04-05,Santa Barbara,083,443738,33622,33235,1079,34314,443
2021-04-05,Santa Clara,085,1922200,115060,115091,659,115750,1893
2021-04-05,Santa Cruz,087,273765,15923,15228,789,16017,201
2021-04-05,Shasta,089,179085,11414,11435,1372,12807,184
2021-04-05,Sierra,091,2930,55,50,12,62,0
2021-04-05,Siskiyou,093,43540,1579,1509,260,1769,7
2021-04-05,Solano,095,438530,31139,31026,422,31448,237
2021-04-05,Sonoma,097,501317,29265,29361,282,29643,311
2021-04-05,Stanislaus,099,539301,53610,53238,5584,58822,686
2021-04-05,Sutter,101,95872,9164,9169,80,9249,106
2021-04-05,Tehama,103,63373,4837,4794,515,5309,52
2021-04-05,Trinity,105,12862,480,321,81,402,3
2021-04-05,Tulare,107,460477,49398,48356,8504,56860,818
2021-04-05,Tuolumne,109,53932,3943,3980,40,4020,57
2021-04-05,Ventura,111,848112,80115,79549,2860,82409,983
2021-04-05,Yolo,113,214977,13420,13427,173,13600,198
2021-04-05,Yuba,115,75493,5767,5728,110,5838,43
2021-04-04,Alameda,001,1643700,84360,83951,1782,85733,1219
2021-04-04,Alpine,003,1148,85,85,0,85,0
2021-04-04,Amador,005,37829,3593,3582,32,3614,45
2021-04-04,Butte,007,227075,11732,11375,1702,13077,193
2021-04-04,Calaveras,009,45235,2018,2020,11,2031,50
2021-04-04,Colusa,011,21464,1894,1893,273,2166,14
2021-04-04,Contra Costa,013,1133247,66258,65408,1130,66538,774
2021-04-04,Del Norte,015,27424,1227,1186,11,1197,6
2021-04-04,El Dorado,017,186661,9554,9455,641,10096,106
2021-04-04,Fresno,019,978130,100249,99702,8224,107926,1622
2021-04-04,Glenn,021,27897,2360,2335,529,2864,17
2021-04-04,Humboldt,023,135768,3483,3472,25,3497,35
2021-04-04,Imperial,025,180216,27762,27588,2550,30138,710
2021-04-04,Inyo,027,18085,1382,1377,10,1387,36
2021-04-04,Kern,029,883053,95632,94388,10263,104651,1247
2021-04-04,Kings,031,150075,22806,22580,1022,23602,239
2021-04-04,Lake,033,64148,3378,3355,8,3363,43
2021-04-04,Lassen,035,31185,5149,5138,101,5239,1
2021-04-04,Los Angeles,037,10098052,1192136,1182872,39321,1222193,23301
2021-04-04,Madera,039,155013,16211,16052,886,16938,230
2021-04-04,Marin,041,260295,13733,13663,214,13877,221
2021-04-04,Mariposa,043,17540,398,390,6,396,5
2021-04-04,Mendocino,045,87422,3769,3684,74,3758,45
2021-04-04,Merced,047,269075,29978,30048,975,31023,427
2021-04-04,Modoc,049,8938,356,346,118,464,3
2021-04-04,Mono,051,14174,1237,1245,17,1262,3
2021-04-04,Monterey,053,433212,42628,42391,1752,44143,341
2021-04-04,Napa,055,140530,9503,9486,31,9517,78
2021-04-04,Nevada,057,99092,4392,4337,180,4517,69
2021-04-04,Orange,059,3164182,252026,250117,10748,260865,4759
2021-04-04,Placer,061,380077,21837,21104,1278,22382,276
2021-04-04,Plumas,063,18699,674,666,10,676,4
2021-04-04,Riverside,065,2383286,290076,283537,13552,297089,4237
2021-04-04,Sacramento,067,1510023,99874,98821,1440,100261,1531
2021-04-04,San Benito,069,59416,5895,5901,97,5998,61
2021-04-04,San Bernardino,071,2135413,289702,286561,8706,295267,4423
2021-04-04,San Diego,073,3302833,272448,271528,13714,285242,3583
2021-04-04,San Francisco,075,870044,35506,35525,1191,36716,488
2021-04-04,San Joaquin,077,732212,70216,69147,3182,72329,1268
2021-04-04,San Luis Obispo,079,281455,20655,20328,621,20949,252
2021-04-04,San Mateo,081,765935,40997,40587,428,41015,350
2021-04-04,Santa Barbara,083,443738,33586,33213,1079,34292,443
2021-04-04,Santa Clara,085,1922200,114894,114976,652,115628,1893
2021-04-04,Santa Cruz,087,273765,15914,15219,789,16008,201
2021-04-04,Shasta,089,179085,11388,11433,1371,12804,184
2021-04-04,Sierra,091,2930,55,50,12,62,0
2021-04-04,Siskiyou,093,43540,1576,1509,256,1765,7
2021-04-04,Solano,095,438530,31092,31002,420,31422,237
2021-04-04,Sonoma,097,501317,29233,29340,280,29620,311
2021-04-04,Stanislaus,099,539301,53517,53181,5576,58757,686
2021-04-04,Sutter,101,95872,9157,9164,80,9244,106
2021-04-04,Tehama,103,63373,4824,4792,514,5306,52
2021-04-04,Trinity,105,12862,478,321,81,402,3
2021-04-04,Tulare,107,460477,49384,48343,8496,56839,818
2021-04-04,Tuolumne,109,53932,3935,3980,40,4020,57
2021-04-04,Ventura,111,848112,80072,79526,2858,82384,983
2021-04-04,Yolo,113,214977,13399,13425,172,13597,198
2021-04-04,Yuba,115,75493,5760,5722,110,5832,43
2021-04-03,Alameda,001,1643700,84293,83861,1780,85641,1218
2021-04-03,Alpine,003,1148,85,85,0,85,0
2021-04-03,Amador,005,37829,3590,3577,32,3609,45
2021-04-03,Butte,007,227075,11728,11359,1698,13057,193
2021-04-03,Calaveras,009,45235,2016,2019,11,2030,50
2021-04-03,Colusa,011,21464,1894,1891,273,2164,14
2021-04-03,Contra Costa,013,1133247,66186,65338,1130,66468,774
2021-04-03,Del Norte,015,27424,1222,1183,11,1194,6
2021-04-03,El Dorado,017,186661,9545,9448,640,10088,106
2021-04-03,Fresno,019,978130,100192,99602,8219,107821,1622
2021-04-03,Glenn,021,27897,2359,2334,528,2862,17
2021-04-03,Humboldt,023,135768,3481,3467,25,3492,35
2021-04-03,Imperial,025,180216,27746,27572,2547,30119,710
2021-04-03,Inyo,027,18085,1381,1376,10,1386,36
2021-04-03,Kern,029,883053,95606,94369,10247,104616,1243
2021-04-03,Kings,031,150075,22804,22580,1022,23602,239
2021-04-03,Lake,033,64148,3377,3350,8,3358,43
2021-04-03,Lassen,035,31185,5148,5136,101,5237,1
2021-04-03,Los Angeles,037,10098052,1191829,1182402,39304,1221706,23301
2021-04-03,Madera,039,155013,16202,16051,884,16935,230
2021-04-03,Marin,041,260295,13725,13658,213,13871,221
2021-04-03,Mariposa,043,17540,398,390,5,395,5
2021-04-03,Mendocino,045,87422,3768,3684,74,3758,45
2021-04-03,Merced,047,269075,29963,30031,975,31006,427
2021-04-03,Modoc,049,8938,356,346,118,464,3
2021-04-03,Mono,051,14174,1237,1245,17,1262,3
2021-04-03,Monterey,053,433212,42615,42376,1750,44126,341
2021-04-03,Napa,055,140530,9494,9473,31,9504,78
2021-04-03,Nevada,057,99092,4388,4323,180,4503,69
2021-04-03,Orange,059,3164182,251945,249982,10730,260712,4755
2021-04-03,Placer,061,380077,21806,21060,1274,22334,276
2021-04-03,Plumas,063,18699,674,666,10,676,4
2021-04-03,Riverside,065,2383286,289998,283423,13549,296972,4237
2021-04-03,Sacramento,067,1510023,99766,98660,1434,100094,1531
2021-04-03,San Benito,069,59416,5892,5893,96,5989,61
2021-04-03,San Bernardino,071,2135413,289638,286473,8700,295173,4422
2021-04-03,San Diego,073,3302833,272279,271335,13697,285032,3571
2021-04-03,San Francisco,075,870044,35487,35488,1189,36677,489
2021-04-03,San Joaquin,077,732212,70175,69100,3166,72266,1268
2021-04-03,San Luis Obispo,079,281455,20636,20301,621,20922,252
2021-04-03,San Mateo,081,765935,40972,40560,428,40988,350
2021-04-03,Santa Barbara,083,443738,33560,33172,1078,34250,443
2021-04-03,Santa Clara,085,1922200,114786,114865,650,115515,1893
2021-04-03,Santa Cruz,087,273765,15907,15205,789,15994,201
2021-04-03,Shasta,089,179085,11380,11418,1371,12789,184
2021-04-03,Sierra,091,2930,55,50,12,62,0
2021-04-03,Siskiyou,093,43540,1575,1509,256,1765,7
2021-04-03,Solano,095,438530,31071,30970,417,31387,237
2021-04-03,Sonoma,097,501317,29217,29315,279,29594,311
2021-04-03,Stanislaus,099,539301,53482,53137,5570,58707,686
2021-04-03,Sutter,101,95872,9151,9158,80,9238,106
2021-04-03,Tehama,103,63373,4816,4788,514,5302,52
2021-04-03,Trinity,105,12862,478,321,81,402,3
2021-04-03,Tulare,107,460477,49374,48327,8492,56819,818
2021-04-03,Tuolumne,109,53932,3935,3980,40,4020,57
2021-04-03,Ventura,111,848112,80051,79489,2856,82345,983
2021-04-03,Yolo,113,214977,13393,13414,172,13586,198
2021-04-03,Yuba,115,75493,5754,5716,110,5826,43
2021-04-02,Alameda,001,1643700,84220,83776,1777,85553,1217
2021-04-02,Alpine,003,1148,85,85,0,85,0
2021-04-02,Amador,005,37829,3586,3573,31,3604,45
2021-04-02,Butte,007,227075,11719,11350,1698,13048,193
2021-04-02,Calaveras,009,45235,2014,2010,11,2021,50
2021-04-02,Colusa,011,21464,1894,1891,273,2164,14
2021-04-02,Contra Costa,013,1133247,66122,65299,1129,66428,774
2021-04-02,Del Norte,015,27424,1219,1174,11,1185,6
2021-04-02,El Dorado,017,186661,9532,9437,637,10074,106
2021-04-02,Fresno,019,978130,100138,99551,8208,107759,1620
2021-04-02,Glenn,021,27897,2359,2331,528,2859,17
2021-04-02,Humboldt,023,135768,3477,3465,25,3490,35
2021-04-02,Imperial,025,180216,27734,27553,2541,30094,710
2021-04-02,Inyo,027,18085,1381,1377,10,1387,36
2021-04-02,Kern,029,883053,95588,94348,10244,104592,1233
2021-04-02,Kings,031,150075,22804,22571,1019,23590,239
2021-04-02,Lake,033,64148,3375,3348,8,3356,43
2021-04-02,Lassen,035,31185,5148,5134,101,5235,1
2021-04-02,Los Angeles,037,10098052,1191519,1181682,39283,1220965,23264
2021-04-02,Madera,039,155013,16193,16036,883,16919,230
2021-04-02,Marin,041,260295,13717,13649,213,13862,221
2021-04-02,Mariposa,043,17540,396,390,5,395,5
2021-04-02,Mendocino,045,87422,3765,3682,74,3756,45
2021-04-02,Merced,047,269075,29938,29998,975,30973,426
2021-04-02,Modoc,049,8938,353,346,118,464,3
2021-04-02,Mono,051,14174,1237,1246,17,1263,3
2021-04-02,Monterey,053,433212,42605,42359,1747,44106,341
2021-04-02,Napa,055,140530,9479,9453,31,9484,78
2021-04-02,Nevada,057,99092,4384,4323,180,4503,69
2021-04-02,Orange,059,3164182,251850,249891,10718,260609,4748
2021-04-02,Placer,061,380077,21770,21035,1268,22303,275
2021-04-02,Plumas,063,18699,674,666,10,676,4
2021-04-02,Riverside,065,2383286,289912,283328,13540,296868,4213
2021-04-02,Sacramento,067,1510023,99659,98648,1427,100075,1527
2021-04-02,San Benito,069,59416,5890,5888,94,5982,61
2021-04-02,San Bernardino,071,2135413,289566,286308,8696,295004,4417
2021-04-02,San Diego,073,3302833,272092,271036,13671,284707,3568
2021-04-02,San Francisco,075,870044,35452,35451,1187,36638,488
2021-04-02,San Joaquin,077,732212,70110,68996,3151,72147,1268
2021-04-02,San Luis Obispo,079,281455,20619,20271,620,20891,252
2021-04-02,San Mateo,081,765935,40930,40514,428,40942,350
2021-04-02,Santa Barbara,083,443738,33532,33145,1078,34223,443
2021-04-02,Santa Clara,085,1922200,114675,114777,648,115425,1882
2021-04-02,Santa Cruz,087,273765,15899,15216,789,16005,202
2021-04-02,Shasta,089,179085,11375,11377,1364,12741,181
2021-04-02,Sierra,091,2930,55,50,12,62,0
2021-04-02,Siskiyou,093,43540,1575,1508,255,1763,7
2021-04-02,Solano,095,438530,31042,30951,414,31365,237
2021-04-02,Sonoma,097,501317,29196,29288,278,29566,311
2021-04-02,Stanislaus,099,539301,53437,53073,5564,58637,687
2021-04-02,Sutter,101,95872,9143,9131,80,9211,106
2021-04-02,Tehama,103,63373,4809,4775,513,5288,52
2021-04-02,Trinity,105,12862,478,320,81,401,3
2021-04-02,Tulare,107,460477,49368,48306,8486,56792,818
2021-04-02,Tuolumne,109,53932,3932,3980,40,4020,57
2021-04-02,Ventura,111,848112,80024,79434,2854,82288,982
2021-04-02,Yolo,113,214977,13383,13381,172,13553,197
2021-04-02,Yuba,115,75493,5750,5709,110,5819,44
2021-04-01,Alameda,001,1643700,84141,83574,1772,85346,1216
2021-04-01,Alpine,003,1148,85,85,0,85,0
2021-04-01,Amador,005,37829,3582,3558,31,3589,45
2021-04-01,Butte,007,227075,11701,11328,1696,13024,193
2021-04-01,Calaveras,009,45235,2011,2006,11,2017,50
2021-04-01,Colusa,011,21464,1891,1890,273,2163,14
2021-04-01,Contra Costa,013,1133247,66063,65176,1127,66303,771
2021-04-01,Del Norte,015,27424,1214,1138,11,1149,6
2021-04-01,El Dorado,017,186661,9523,9393,633,10026,106
2021-04-01,Fresno,019,978130,100085,99317,8200,107517,1616
2021-04-01,Glenn,021,27897,2359,2322,527,2849,17
2021-04-01,Humboldt,023,135768,3473,3464,25,3489,35
2021-04-01,Imperial,025,180216,27704,27520,2536,30056,710
2021-04-01,Inyo,027,18085,1380,1374,10,1384,36
2021-04-01,Kern,029,883053,95552,94244,10232,104476,1233
2021-04-01,Kings,031,150075,22797,22560,1018,23578,239
2021-04-01,Lake,033,64148,3370,3337,8,3345,43
2021-04-01,Lassen,035,31185,5147,5132,101,5233,1
2021-04-01,Los Angeles,037,10098052,1191026,1181101,39254,1220355,23220
2021-04-01,Madera,039,155013,16177,16023,883,16906,230
2021-04-01,Marin,041,260295,13707,13635,213,13848,221
2021-04-01,Mariposa,043,17540,394,389,5,394,5
2021-04-01,Mendocino,045,87422,3765,3680,74,3754,45
2021-04-01,Merced,047,269075,29905,29820,975,30795,425
2021-04-01,Modoc,049,8938,352,346,118,464,3
2021-04-01,Mono,051,14174,1237,1245,17,1262,3
2021-04-01,Monterey,053,433212,42597,42324,1745,44069,339
2021-04-01,Napa,055,140530,9467,9410,31,9441,78
2021-04-01,Nevada,057,99092,4374,4288,179,4467,68
2021-04-01,Orange,059,3164182,251730,249617,10701,260318,4742
2021-04-01,Placer,061,380077,21731,20909,1256,22165,274
2021-04-01,Plumas,063,18699,674,664,10,674,4
2021-04-01,Riverside,065,2383286,289807,283128,13537,296665,4193
2021-04-01,Sacramento,067,1510023,99515,97952,1414,99366,1521
2021-04-01,San Benito,069,59416,5882,5878,93,5971,61
2021-04-01,San Bernardino,071,2135413,289450,286086,8687,294773,4404
2021-04-01,San Diego,073,3302833,271869,270540,13641,284181,3555
2021-04-01,San Francisco,075,870044,35431,35386,1184,36570,488
2021-04-01,San Joaquin,077,732212,70028,68802,3143,71945,1262
2021-04-01,San Luis Obispo,079,281455,20590,20235,619,20854,252
2021-04-01,San Mateo,081,765935,40889,40454,428,40882,350
2021-04-01,Santa Barbara,083,443738,33485,33096,1073,34169,443
2021-04-01,Santa Clara,085,1922200,114562,114606,647,115253,1874
2021-04-01,Santa Cruz,087,273765,15884,15271,789,16060,202
2021-04-01,Shasta,089,179085,11360,11355,1359,12714,181
2021-04-01,Sierra,091,2930,55,50,12,62,0
2021-04-01,Siskiyou,093,43540,1573,1507,254,1761,7
2021-04-01,Solano,095,438530,31009,30850,411,31261,237
2021-04-01,Sonoma,097,501317,29165,29241,271,29512,311
2021-04-01,Stanislaus,099,539301,53375,52825,5558,58383,687
2021-04-01,Sutter,101,95872,9131,9105,80,9185,106
2021-04-01,Tehama,103,63373,4803,4764,510,5274,52
2021-04-01,Trinity,105,12862,478,319,81,400,3
2021-04-01,Tulare,107,460477,49345,48279,8476,56755,817
2021-04-01,Tuolumne,109,53932,3930,3978,40,4018,57
2021-04-01,Ventura,111,848112,80000,79369,2853,82222,977
2021-04-01,Yolo,113,214977,13370,13342,172,13514,197
2021-04-01,Yuba,115,75493,5745,5694,110,5804,44
2021-03-31,Alameda,001,1643700,84059,83475,1767,85242,1215
2021-03-31,Alpine,003,1148,85,85,0,85,0
2021-03-31,Amador,005,37829,3579,3556,31,3587,45
2021-03-31,Butte,007,227075,11691,11321,1692,13013,193
2021-03-31,Calaveras,009,45235,2009,2005,11,2016,50
2021-03-31,Colusa,011,21464,1891,1890,273,2163,14
2021-03-31,Contra Costa,013,1133247,65978,65109,1126,66235,769
2021-03-31,Del Norte,015,27424,1205,1129,11,1140,6
2021-03-31,El Dorado,017,186661,9506,9390,633,10023,106
2021-03-31,Fresno,019,978130,99992,99240,8184,107424,1616
2021-03-31,Glenn,021,27897,2355,2318,525,2843,17
2021-03-31,Humboldt,023,135768,3467,3460,25,3485,35
2021-03-31,Imperial,025,180216,27684,27506,2535,30041,710
2021-03-31,Inyo,027,18085,1377,1373,9,1382,35
2021-03-31,Kern,029,883053,95509,94205,10223,104428,1229
2021-03-31,Kings,031,150075,22794,22540,1018,23558,239
2021-03-31,Lake,033,64148,3366,3332,8,3340,43
2021-03-31,Lassen,035,31185,5143,5132,101,5233,1
2021-03-31,Los Angeles,037,10098052,1190558,1180538,39216,1219754,23171
2021-03-31,Madera,039,155013,16163,16015,882,16897,229
2021-03-31,Marin,041,260295,13696,13624,213,13837,221
2021-03-31,Mariposa,043,17540,394,389,5,394,5
2021-03-31,Mendocino,045,87422,3759,3675,74,3749,45
2021-03-31,Merced,047,269075,29876,29780,975,30755,423
2021-03-31,Modoc,049,8938,352,346,118,464,3
2021-03-31,Mono,051,14174,1237,1245,17,1262,3
2021-03-31,Monterey,053,433212,42580,42309,1743,44052,338
2021-03-31,Napa,055,140530,9449,9401,31,9432,78
2021-03-31,Nevada,057,99092,4368,4283,179,4462,68
2021-03-31,Orange,059,3164182,251619,249518,10686,260204,4731
2021-03-31,Placer,061,380077,21681,20885,1249,22134,271
2021-03-31,Plumas,063,18699,673,663,10,673,4
2021-03-31,Riverside,065,2383286,289705,283006,13526,296532,4171
2021-03-31,Sacramento,067,1510023,99340,97760,1407,99167,1519
2021-03-31,San Benito,069,59416,5872,5875,93,5968,61
2021-03-31,San Bernardino,071,2135413,289356,285916,8684,294600,4356
2021-03-31,San Diego,073,3302833,271637,270288,13606,283894,3555
2021-03-31,San Francisco,075,870044,35386,35347,1183,36530,474
2021-03-31,San Joaquin,077,732212,69939,68685,3127,71812,1259
2021-03-31,San Luis Obispo,079,281455,20568,20215,618,20833,251
2021-03-31,San Mateo,081,765935,40859,40423,428,40851,350
2021-03-31,Santa Barbara,083,443738,33453,33052,1071,34123,443
2021-03-31,Santa Clara,085,1922200,114435,114499,647,115146,1874
2021-03-31,Santa Cruz,087,273765,15871,15295,788,16083,201
2021-03-31,Shasta,089,179085,11348,11327,1351,12678,179
2021-03-31,Sierra,091,2930,55,50,12,62,0
2021-03-31,Siskiyou,093,43540,1572,1505,254,1759,7
2021-03-31,Solano,095,438530,30963,30824,410,31234,235
2021-03-31,Sonoma,097,501317,29138,29216,271,29487,311
2021-03-31,Stanislaus,099,539301,53307,52782,5546,58328,687
2021-03-31,Sutter,101,95872,9120,9111,80,9191,106
2021-03-31,Tehama,103,63373,4798,4762,508,5270,52
2021-03-31,Trinity,105,12862,478,319,81,400,3
2021-03-31,Tulare,107,460477,49325,48261,8460,56721,816
2021-03-31,Tuolumne,109,53932,3929,3976,40,4016,57
2021-03-31,Ventura,111,848112,79968,79326,2849,82175,969
2021-03-31,Yolo,113,214977,13353,13359,171,13530,197
2021-03-31,Yuba,115,75493,5738,5686,110,5796,44
2021-03-30,Alameda,001,1643700,83959,83395,1764,85159,1211
2021-03-30,Alpine,003,1148,85,85,0,85,0
2021-03-30,Amador,005,37829,3576,3551,31,3582,45
2021-03-30,Butte,007,227075,11679,11296,1689,12985,193
2021-03-30,Calaveras,009,45235,2005,1997,11,2008,50
2021-03-30,Colusa,011,21464,1890,1890,272,2162,14
2021-03-30,Contra Costa,013,1133247,65889,65041,1124,66165,767
2021-03-30,Del Norte,015,27424,1197,1118,10,1128,6
2021-03-30,El Dorado,017,186661,9487,9381,630,10011,105
2021-03-30,Fresno,019,978130,99927,99156,8171,107327,1609
2021-03-30,Glenn,021,27897,2355,2310,524,2834,17
2021-03-30,Humboldt,023,135768,3465,3461,25,3486,35
2021-03-30,Imperial,025,180216,27656,27471,2533,30004,706
2021-03-30,Inyo,027,18085,1377,1374,9,1383,35
2021-03-30,Kern,029,883053,95467,94151,10214,104365,1221
2021-03-30,Kings,031,150075,22790,22530,1016,23546,238
2021-03-30,Lake,033,64148,3360,3330,8,3338,43
2021-03-30,Lassen,035,31185,5143,5132,101,5233,1
2021-03-30,Los Angeles,037,10098052,1190062,1180044,39194,1219238,23136
2021-03-30,Madera,039,155013,16153,16003,878,16881,229
2021-03-30,Marin,041,260295,13687,13611,205,13816,221
2021-03-30,Mariposa,043,17540,394,388,5,393,5
2021-03-30,Mendocino,045,87422,3757,3670,74,3744,45
2021-03-30,Merced,047,269075,29839,29731,975,30706,423
2021-03-30,Modoc,049,8938,351,346,118,464,3
2021-03-30,Mono,051,14174,1236,1245,17,1262,3
2021-03-30,Monterey,053,433212,42554,42308,1741,44049,338
2021-03-30,Napa,055,140530,9434,9391,31,9422,78
2021-03-30,Nevada,057,99092,4356,4266,178,4444,68
2021-03-30,Orange,059,3164182,251491,249412,10659,260071,4727
2021-03-30,Placer,061,380077,21641,20866,1243,22109,271
2021-03-30,Plumas,063,18699,673,661,10,671,4
2021-03-30,Riverside,065,2383286,289580,282930,13517,296447,4154
2021-03-30,Sacramento,067,1510023,99203,97718,1404,99122,1516
2021-03-30,San Benito,069,59416,5866,5870,93,5963,61
2021-03-30,San Bernardino,071,2135413,289247,285758,8675,294433,4343
2021-03-30,San Diego,073,3302833,271398,269998,13568,283566,3555
2021-03-30,San Francisco,075,870044,35336,35325,1182,36507,474
2021-03-30,San Joaquin,077,732212,69851,68613,3117,71730,1232
2021-03-30,San Luis Obispo,079,281455,20548,20194,618,20812,251
2021-03-30,San Mateo,081,765935,40815,40377,428,40805,349
2021-03-30,Santa Barbara,083,443738,33428,33016,1071,34087,441
2021-03-30,Santa Clara,085,1922200,114313,114413,646,115059,1873
2021-03-30,Santa Cruz,087,273765,15865,15278,788,16066,201
2021-03-30,Shasta,089,179085,11340,11316,1350,12666,184
2021-03-30,Sierra,091,2930,55,50,12,62,0
2021-03-30,Siskiyou,093,43540,1571,1501,254,1755,7
2021-03-30,Solano,095,438530,30933,30802,409,31211,232
2021-03-30,Sonoma,097,501317,29106,29198,271,29469,311
2021-03-30,Stanislaus,099,539301,53229,52690,5538,58228,677
2021-03-30,Sutter,101,95872,9116,9107,79,9186,106
2021-03-30,Tehama,103,63373,4789,4748,507,5255,52
2021-03-30,Trinity,105,12862,478,316,81,397,3
2021-03-30,Tulare,107,460477,49310,48249,8451,56700,815
2021-03-30,Tuolumne,109,53932,3924,3972,40,4012,57
2021-03-30,Ventura,111,848112,79924,79282,2846,82128,958
2021-03-30,Yolo,113,214977,13340,13353,171,13524,195
2021-03-30,Yuba,115,75493,5727,5679,104,5783,42
2021-03-29,Alameda,001,1643700,83859,83338,1762,85100,1211
2021-03-29,Alpine,003,1148,85,85,0,85,0
2021-03-29,Amador,005,37829,3570,3549,31,3580,45
2021-03-29,Butte,007,227075,11671,11291,1686,12977,191
2021-03-29,Calaveras,009,45235,2003,1998,11,2009,50
2021-03-29,Colusa,011,21464,1890,1889,271,2160,14
2021-03-29,Contra Costa,013,1133247,65820,64971,1123,66094,767
2021-03-29,Del Norte,015,27424,1192,1116,9,1125,6
2021-03-29,El Dorado,017,186661,9467,9374,625,9999,105
2021-03-29,Fresno,019,978130,99844,99085,8156,107241,1606
2021-03-29,Glenn,021,27897,2348,2310,524,2834,17
2021-03-29,Humboldt,023,135768,3460,3459,25,3484,34
2021-03-29,Imperial,025,180216,27635,27442,2531,29973,704
2021-03-29,Inyo,027,18085,1377,1372,9,1381,35
2021-03-29,Kern,029,883053,95420,94098,10195,104293,1220
2021-03-29,Kings,031,150075,22778,22522,1015,23537,238
2021-03-29,Lake,033,64148,3357,3325,8,3333,43
2021-03-29,Lassen,035,31185,5143,5131,101,5232,1
2021-03-29,Los Angeles,037,10098052,1189565,1179736,39154,1218890,23108
2021-03-29,Madera,039,155013,16133,15987,876,16863,210
2021-03-29,Marin,041,260295,13675,13600,202,13802,220
2021-03-29,Mariposa,043,17540,393,388,5,393,5
2021-03-29,Mendocino,045,87422,3754,3667,74,3741,45
2021-03-29,Merced,047,269075,29815,29699,975,30674,422
2021-03-29,Modoc,049,8938,350,344,118,462,3
2021-03-29,Mono,051,14174,1235,1243,17,1260,3
2021-03-29,Monterey,053,433212,42538,42305,1736,44041,337
2021-03-29,Napa,055,140530,9418,9379,31,9410,78
2021-03-29,Nevada,057,99092,4349,4258,178,4436,68
2021-03-29,Orange,059,3164182,251381,249295,10647,259942,4713
2021-03-29,Placer,061,380077,21606,20827,1236,22063,267
2021-03-29,Plumas,063,18699,672,660,10,670,4
2021-03-29,Riverside,065,2383286,289477,282867,13516,296383,4133
2021-03-29,Sacramento,067,1510023,99010,97577,1396,98973,1514
2021-03-29,San Benito,069,59416,5859,5865,93,5958,61
2021-03-29,San Bernardino,071,2135413,289150,285615,8671,294286,4335
2021-03-29,San Diego,073,3302833,271132,269771,13542,283313,3547
2021-03-29,San Francisco,075,870044,35301,35291,1179,36470,474
2021-03-29,San Joaquin,077,732212,69765,68537,3104,71641,1211
2021-03-29,San Luis Obispo,079,281455,20513,20176,617,20793,250
2021-03-29,San Mateo,081,765935,40773,40357,427,40784,348
2021-03-29,Santa Barbara,083,443738,33394,32983,1070,34053,439
2021-03-29,Santa Clara,085,1922200,114204,114335,641,114976,1871
2021-03-29,Santa Cruz,087,273765,15854,15249,787,16036,201
2021-03-29,Shasta,089,179085,11322,11313,1348,12661,183
2021-03-29,Sierra,091,2930,55,50,12,62,0
2021-03-29,Siskiyou,093,43540,1569,1497,254,1751,6
2021-03-29,Solano,095,438530,30894,30762,407,31169,232
2021-03-29,Sonoma,097,501317,29083,29184,268,29452,310
2021-03-29,Stanislaus,099,539301,53145,52614,5531,58145,677
2021-03-29,Sutter,101,95872,9109,9105,79,9184,106
2021-03-29,Tehama,103,63373,4781,4742,506,5248,52
2021-03-29,Trinity,105,12862,478,314,81,395,3
2021-03-29,Tulare,107,460477,49282,48226,8440,56666,815
2021-03-29,Tuolumne,109,53932,3922,3969,40,4009,57
2021-03-29,Ventura,111,848112,79882,79252,2846,82098,956
2021-03-29,Yolo,113,214977,13321,13346,171,13517,195
2021-03-29,Yuba,115,75493,5720,5671,103,5774,42
2021-03-28,Alameda,001,1643700,83738,83239,1760,84999,1212
2021-03-28,Alpine,003,1148,85,85,0,85,0
2021-03-28,Amador,005,37829,3566,3541,31,3572,45
2021-03-28,Butte,007,227075,11658,11285,1684,12969,191
2021-03-28,Calaveras,009,45235,2001,1995,11,2006,50
2021-03-28,Colusa,011,21464,1889,1889,271,2160,14
2021-03-28,Contra Costa,013,1133247,65746,64878,1119,65997,767
2021-03-28,Del Norte,015,27424,1185,1107,7,1114,6
2021-03-28,El Dorado,017,186661,9452,9371,623,9994,105
2021-03-28,Fresno,019,978130,99762,99004,8144,107148,1606
2021-03-28,Glenn,021,27897,2344,2309,522,2831,17
2021-03-28,Humboldt,023,135768,3457,3452,24,3476,34
2021-03-28,Imperial,025,180216,27607,27426,2528,29954,704
2021-03-28,Inyo,027,18085,1376,1372,9,1381,35
2021-03-28,Kern,029,883053,95375,94084,10184,104268,1219
2021-03-28,Kings,031,150075,22773,22514,1012,23526,238
2021-03-28,Lake,033,64148,3352,3320,8,3328,43
2021-03-28,Lassen,035,31185,5143,5131,100,5231,1
2021-03-28,Los Angeles,037,10098052,1189013,1179316,39096,1218412,23101
2021-03-28,Madera,039,155013,16118,15973,875,16848,210
2021-03-28,Marin,041,260295,13662,13594,200,13794,221
2021-03-28,Mariposa,043,17540,393,388,5,393,5
2021-03-28,Mendocino,045,87422,3752,3666,74,3740,45
2021-03-28,Merced,047,269075,29758,29679,975,30654,422
2021-03-28,Modoc,049,8938,350,344,118,462,3
2021-03-28,Mono,051,14174,1234,1242,17,1259,3
2021-03-28,Monterey,053,433212,42515,42294,1732,44026,337
2021-03-28,Napa,055,140530,9404,9368,31,9399,78
2021-03-28,Nevada,057,99092,4335,4239,178,4417,68
2021-03-28,Orange,059,3164182,251226,249238,10637,259875,4713
2021-03-28,Placer,061,380077,21562,20796,1230,22026,267
2021-03-28,Plumas,063,18699,670,657,10,667,4
2021-03-28,Riverside,065,2383286,289363,282811,13508,296319,4132
2021-03-28,Sacramento,067,1510023,98836,97425,1390,98815,1514
2021-03-28,San Benito,069,59416,5854,5862,93,5955,61
2021-03-28,San Bernardino,071,2135413,289030,285570,8663,294233,4332
2021-03-28,San Diego,073,3302833,270856,269476,13513,282989,3547
2021-03-28,San Francisco,075,870044,35255,35286,1175,36461,474
2021-03-28,San Joaquin,077,732212,69641,68459,3085,71544,1211
2021-03-28,San Luis Obispo,079,281455,20478,20172,614,20786,250
2021-03-28,San Mateo,081,765935,40728,40305,427,40732,348
2021-03-28,Santa Barbara,083,443738,33352,32953,1069,34022,439
2021-03-28,Santa Clara,085,1922200,114104,114232,637,114869,1871
2021-03-28,Santa Cruz,087,273765,15839,15238,786,16024,201
2021-03-28,Shasta,089,179085,11296,11308,1337,12645,183
2021-03-28,Sierra,091,2930,55,50,12,62,0
2021-03-28,Siskiyou,093,43540,1569,1497,253,1750,6
2021-03-28,Solano,095,438530,30857,30719,405,31124,232
2021-03-28,Sonoma,097,501317,29047,29161,266,29427,310
2021-03-28,Stanislaus,099,539301,53057,52567,5518,58085,678
2021-03-28,Sutter,101,95872,9100,9094,79,9173,106
2021-03-28,Tehama,103,63373,4771,4740,504,5244,52
2021-03-28,Trinity,105,12862,476,314,80,394,3
2021-03-28,Tulare,107,460477,49253,48218,8434,56652,815
2021-03-28,Tuolumne,109,53932,3919,3969,39,4008,57
2021-03-28,Ventura,111,848112,79831,79222,2841,82063,956
2021-03-28,Yolo,113,214977,13304,13325,170,13495,194
2021-03-28,Yuba,115,75493,5716,5662,103,5765,42
2021-03-27,Alameda,001,1643700,83667,83169,1756,84925,1211
2021-03-27,Alpine,003,1148,85,85,0,85,0
2021-03-27,Amador,005,37829,3561,3538,31,3569,45
2021-03-27,Butte,007,227075,11651,11278,1683,12961,191
2021-03-27,Calaveras,009,45235,1998,1992,11,2003,50
2021-03-27,Colusa,011,21464,1889,1889,271,2160,14
2021-03-27,Contra Costa,013,1133247,65676,64804,1116,65920,767
2021-03-27,Del Norte,015,27424,1175,1104,7,1111,6
2021-03-27,El Dorado,017,186661,9438,9367,623,9990,105
2021-03-27,Fresno,019,978130,99709,98901,8138,107039,1606
2021-03-27,Glenn,021,27897,2343,2308,522,2830,17
2021-03-27,Humboldt,023,135768,3452,3442,24,3466,34
2021-03-27,Imperial,025,180216,27595,27406,2525,29931,704
2021-03-27,Inyo,027,18085,1374,1372,9,1381,35
2021-03-27,Kern,029,883053,95355,94041,10173,104214,1217
2021-03-27,Kings,031,150075,22770,22502,1012,23514,238
2021-03-27,Lake,033,64148,3350,3317,8,3325,43
2021-03-27,Lassen,035,31185,5143,5129,100,5229,1
2021-03-27,Los Angeles,037,10098052,1188699,1178831,39070,1217901,23103
2021-03-27,Madera,039,155013,16111,15968,873,16841,210
2021-03-27,Marin,041,260295,13657,13579,200,13779,222
2021-03-27,Mariposa,043,17540,393,386,5,391,5
2021-03-27,Mendocino,045,87422,3750,3666,74,3740,45
2021-03-27,Merced,047,269075,29725,29647,973,30620,422
2021-03-27,Modoc,049,8938,350,344,118,462,3
2021-03-27,Mono,051,14174,1232,1241,17,1258,3
2021-03-27,Monterey,053,433212,42505,42271,1732,44003,337
2021-03-27,Napa,055,140530,9392,9360,31,9391,78
2021-03-27,Nevada,057,99092,4325,4231,178,4409,68
2021-03-27,Orange,059,3164182,251131,249160,10621,259781,4698
2021-03-27,Placer,061,380077,21542,20717,1223,21940,267
2021-03-27,Plumas,063,18699,669,655,10,665,4
2021-03-27,Riverside,065,2383286,289301,282707,13500,296207,4132
2021-03-27,Sacramento,067,1510023,98746,97247,1388,98635,1513
2021-03-27,San Benito,069,59416,5852,5862,91,5953,61
2021-03-27,San Bernardino,071,2135413,288968,285480,8662,294142,4325
2021-03-27,San Diego,073,3302833,270685,269271,13491,282762,3540
2021-03-27,San Francisco,075,870044,35232,35244,1173,36417,474
2021-03-27,San Joaquin,077,732212,69581,68365,3077,71442,1211
2021-03-27,San Luis Obispo,079,281455,20467,20153,611,20764,250
2021-03-27,San Mateo,081,765935,40705,40264,427,40691,348
2021-03-27,Santa Barbara,083,443738,33329,32921,1069,33990,439
2021-03-27,Santa Clara,085,1922200,114008,114124,635,114759,1871
2021-03-27,Santa Cruz,087,273765,15833,15215,786,16001,201
2021-03-27,Shasta,089,179085,11285,11288,1335,12623,183
2021-03-27,Sierra,091,2930,55,50,12,62,0
2021-03-27,Siskiyou,093,43540,1569,1497,253,1750,6
2021-03-27,Solano,095,438530,30829,30669,404,31073,232
2021-03-27,Sonoma,097,501317,29032,29133,264,29397,310
2021-03-27,Stanislaus,099,539301,52992,52497,5510,58007,678
2021-03-27,Sutter,101,95872,9093,9093,79,9172,106
2021-03-27,Tehama,103,63373,4765,4738,502,5240,52
2021-03-27,Trinity,105,12862,476,313,80,393,3
2021-03-27,Tulare,107,460477,49237,48203,8427,56630,813
2021-03-27,Tuolumne,109,53932,3916,3968,39,4007,57
2021-03-27,Ventura,111,848112,79804,79184,2839,82023,956
2021-03-27,Yolo,113,214977,13299,13317,169,13486,194
2021-03-27,Yuba,115,75493,5714,5657,103,5760,42
2021-03-26,Alameda,001,1643700,83605,83043,1754,84797,1208
2021-03-26,Alpine,003,1148,85,85,0,85,0
2021-03-26,Amador,005,37829,3556,3532,31,3563,45
2021-03-26,Butte,007,227075,11640,11278,1683,12961,191
2021-03-26,Calaveras,009,45235,1995,1989,11,2000,50
2021-03-26,Colusa,011,21464,1889,1889,271,2160,14
2021-03-26,Contra Costa,013,1133247,65616,64699,1113,65812,761
2021-03-26,Del Norte,015,27424,1172,1101,7,1108,6
2021-03-26,El Dorado,017,186661,9433,9353,623,9976,105
2021-03-26,Fresno,019,978130,99647,98731,8128,106859,1601
2021-03-26,Glenn,021,27897,2343,2307,521,2828,17
2021-03-26,Humboldt,023,135768,3450,3431,24,3455,34
2021-03-26,Imperial,025,180216,27571,27374,2525,29899,701
2021-03-26,Inyo,027,18085,1373,1369,9,1378,35
2021-03-26,Kern,029,883053,95329,93949,10167,104116,1211
2021-03-26,Kings,031,150075,22762,22493,1010,23503,239
2021-03-26,Lake,033,64148,3349,3314,8,3322,43
2021-03-26,Lassen,035,31185,5142,5131,100,5231,1
2021-03-26,Los Angeles,037,10098052,1188363,1178213,39057,1217270,23080
2021-03-26,Madera,039,155013,16101,15952,873,16825,210
2021-03-26,Marin,041,260295,13651,13553,195,13748,221
2021-03-26,Mariposa,043,17540,393,386,5,391,5
2021-03-26,Mendocino,045,87422,3749,3664,74,3738,45
2021-03-26,Merced,047,269075,29702,29613,972,30585,419
2021-03-26,Modoc,049,8938,350,344,118,462,3
2021-03-26,Mono,051,14174,1231,1236,17,1253,3
2021-03-26,Monterey,053,433212,42492,42241,1728,43969,338
2021-03-26,Napa,055,140530,9382,9349,31,9380,78
2021-03-26,Nevada,057,99092,4305,4222,178,4400,83
2021-03-26,Orange,059,3164182,251068,248995,10607,259602,4671
2021-03-26,Placer,061,380077,21516,20679,1222,21901,259
2021-03-26,Plumas,063,18699,668,654,10,664,4
2021-03-26,Riverside,065,2383286,289223,282602,13494,296096,4109
2021-03-26,Sacramento,067,1510023,98645,97040,1383,98423,1509
2021-03-26,San Benito,069,59416,5849,5855,91,5946,61
2021-03-26,San Bernardino,071,2135413,288912,285313,8660,293973,4288
2021-03-26,San Diego,073,3302833,270507,269045,13465,282510,3525
2021-03-26,San Francisco,075,870044,35206,35186,1173,36359,472
2021-03-26,San Joaquin,077,732212,69518,68249,3073,71322,1202
2021-03-26,San Luis Obispo,079,281455,20454,20118,611,20729,250
2021-03-26,San Mateo,081,765935,40670,40199,427,40626,348
2021-03-26,Santa Barbara,083,443738,33299,32895,1068,33963,439
2021-03-26,Santa Clara,085,1922200,113910,113959,634,114593,1868
2021-03-26,Santa Cruz,087,273765,15818,15199,785,15984,201
2021-03-26,Shasta,089,179085,11276,11276,1329,12605,182
2021-03-26,Sierra,091,2930,55,50,12,62,0
2021-03-26,Siskiyou,093,43540,1569,1493,252,1745,6
2021-03-26,Solano,095,438530,30804,30640,404,31044,205
2021-03-26,Sonoma,097,501317,29016,29101,261,29362,310
2021-03-26,Stanislaus,099,539301,52924,52420,5506,57926,678
2021-03-26,Sutter,101,95872,9090,9082,79,9161,104
2021-03-26,Tehama,103,63373,4764,4722,501,5223,51
2021-03-26,Trinity,105,12862,476,311,80,391,3
2021-03-26,Tulare,107,460477,49222,48179,8420,56599,813
2021-03-26,Tuolumne,109,53932,3915,3965,39,4004,57
2021-03-26,Ventura,111,848112,79770,79122,2837,81959,953
2021-03-26,Yolo,113,214977,13292,13299,167,13466,194
2021-03-26,Yuba,115,75493,5704,5653,103,5756,42
2021-03-25,Alameda,001,1643700,83511,82945,1752,84697,1206
2021-03-25,Alpine,003,1148,85,84,0,84,0
2021-03-25,Amador,005,37829,3554,3530,31,3561,45
2021-03-25,Butte,007,227075,11630,11270,1683,12953,188
2021-03-25,Calaveras,009,45235,1994,1982,11,1993,50
2021-03-25,Colusa,011,21464,1889,1888,271,2159,14
2021-03-25,Contra Costa,013,1133247,65549,64606,1110,65716,757
2021-03-25,Del Norte,015,27424,1166,1095,7,1102,6
2021-03-25,El Dorado,017,186661,9423,9331,623,9954,105
2021-03-25,Fresno,019,978130,99529,98602,8115,106717,1593
2021-03-25,Glenn,021,27897,2342,2302,520,2822,17
2021-03-25,Humboldt,023,135768,3445,3423,24,3447,34
2021-03-25,Imperial,025,180216,27555,27352,2524,29876,699
2021-03-25,Inyo,027,18085,1373,1369,9,1378,35
2021-03-25,Kern,029,883053,95297,93857,10162,104019,1206
2021-03-25,Kings,031,150075,22752,22472,1010,23482,237
2021-03-25,Lake,033,64148,3344,3312,8,3320,43
2021-03-25,Lassen,035,31185,5142,5129,100,5229,1
2021-03-25,Los Angeles,037,10098052,1187925,1177490,39024,1216514,23051
2021-03-25,Madera,039,155013,16082,15937,871,16808,210
2021-03-25,Marin,041,260295,13641,13538,192,13730,219
2021-03-25,Mariposa,043,17540,393,386,5,391,5
2021-03-25,Mendocino,045,87422,3748,3664,74,3738,45
2021-03-25,Merced,047,269075,29668,29576,965,30541,416
2021-03-25,Modoc,049,8938,350,343,118,461,3
2021-03-25,Mono,051,14174,1231,1235,17,1252,3
2021-03-25,Monterey,053,433212,42471,42220,1723,43943,336
2021-03-25,Napa,055,140530,9363,9321,31,9352,78
2021-03-25,Nevada,057,99092,4287,4202,176,4378,84
2021-03-25,Orange,059,3164182,250954,248871,10587,259458,4655
2021-03-25,Placer,061,380077,21475,20639,1215,21854,252
2021-03-25,Plumas,063,18699,668,654,10,664,4
2021-03-25,Riverside,065,2383286,289126,282492,13483,295975,4078
2021-03-25,Sacramento,067,1510023,98499,96823,1381,98204,1505
2021-03-25,San Benito,069,59416,5846,5850,91,5941,61
2021-03-25,San Bernardino,071,2135413,288831,285134,8655,293789,4222
2021-03-25,San Diego,073,3302833,270279,268623,13434,282057,3520
2021-03-25,San Francisco,075,870044,35166,35154,1171,36325,468
2021-03-25,San Joaquin,077,732212,69421,68089,3035,71124,1196
2021-03-25,San Luis Obispo,079,281455,20436,20076,611,20687,250
2021-03-25,San Mateo,081,765935,40630,40147,427,40574,348
2021-03-25,Santa Barbara,083,443738,33272,32857,1068,33925,439
2021-03-25,Santa Clara,085,1922200,113806,113877,632,114509,1868
2021-03-25,Santa Cruz,087,273765,15797,15170,785,15955,201
2021-03-25,Shasta,089,179085,11259,11262,1326,12588,181
2021-03-25,Sierra,091,2930,55,50,12,62,0
2021-03-25,Siskiyou,093,43540,1567,1491,251,1742,6
2021-03-25,Solano,095,438530,30743,30583,402,30985,193
2021-03-25,Sonoma,097,501317,28982,29060,257,29317,310
2021-03-25,Stanislaus,099,539301,52857,52321,5499,57820,678
2021-03-25,Sutter,101,95872,9081,9069,79,9148,104
2021-03-25,Tehama,103,63373,4762,4719,500,5219,52
2021-03-25,Trinity,105,12862,476,310,80,390,3
2021-03-25,Tulare,107,460477,49195,48148,8408,56556,811
2021-03-25,Tuolumne,109,53932,3914,3962,39,4001,57
2021-03-25,Ventura,111,848112,79729,79045,2833,81878,952
2021-03-25,Yolo,113,214977,13286,13287,167,13454,194
2021-03-25,Yuba,115,75493,5698,5647,97,5744,42
2021-03-24,Alameda,001,1643700,83418,82871,1749,84620,1199
2021-03-24,Alpine,003,1148,85,84,0,84,0
2021-03-24,Amador,005,37829,3548,3529,31,3560,45
2021-03-24,Butte,007,227075,11620,11252,1679,12931,187
2021-03-24,Calaveras,009,45235,1991,1975,11,1986,50
2021-03-24,Colusa,011,21464,1889,1886,271,2157,14
2021-03-24,Contra Costa,013,1133247,65469,64539,1109,65648,755
2021-03-24,Del Norte,015,27424,1161,1087,7,1094,6
2021-03-24,El Dorado,017,186661,9417,9319,622,9941,105
2021-03-24,Fresno,019,978130,99439,98437,8100,106537,1585
2021-03-24,Glenn,021,27897,2341,2297,519,2816,17
2021-03-24,Humboldt,023,135768,3442,3414,24,3438,34
2021-03-24,Imperial,025,180216,27546,27325,2524,29849,699
2021-03-24,Inyo,027,18085,1373,1368,9,1377,35
2021-03-24,Kern,029,883053,95249,93800,10153,103953,1198
2021-03-24,Kings,031,150075,22737,22456,1008,23464,237
2021-03-24,Lake,033,64148,3340,3307,8,3315,43
2021-03-24,Lassen,035,31185,5140,5130,99,5229,1
2021-03-24,Los Angeles,037,10098052,1187438,1177015,38991,1216006,22993
2021-03-24,Madera,039,155013,16073,15918,870,16788,210
2021-03-24,Marin,041,260295,13627,13526,190,13716,219
2021-03-24,Mariposa,043,17540,393,384,5,389,5
2021-03-24,Mendocino,045,87422,3745,3660,74,3734,45
2021-03-24,Merced,047,269075,29627,29525,965,30490,415
2021-03-24,Modoc,049,8938,349,341,118,459,3
2021-03-24,Mono,051,14174,1230,1243,17,1260,3
2021-03-24,Monterey,053,433212,42449,42201,1720,43921,335
2021-03-24,Napa,055,140530,9343,9310,31,9341,78
2021-03-24,Nevada,057,99092,4272,4191,175,4366,85
2021-03-24,Orange,059,3164182,250841,248775,10569,259344,4638
2021-03-24,Placer,061,380077,21445,20606,1207,21813,250
2021-03-24,Plumas,063,18699,666,652,10,662,4
2021-03-24,Riverside,065,2383286,289042,282410,13480,295890,4058
2021-03-24,Sacramento,067,1510023,98324,96628,1370,97998,1500
2021-03-24,San Benito,069,59416,5845,5847,91,5938,61
2021-03-24,San Bernardino,071,2135413,288744,284983,8653,293636,4170
2021-03-24,San Diego,073,3302833,270065,268413,13406,281819,3509
2021-03-24,San Francisco,075,870044,35139,35103,1168,36271,462
2021-03-24,San Joaquin,077,732212,69350,67978,3023,71001,1196
2021-03-24,San Luis Obispo,079,281455,20406,20021,610,20631,250
2021-03-24,San Mateo,081,765935,40580,40083,427,40510,348
2021-03-24,Santa Barbara,083,443738,33244,32810,1068,33878,438
2021-03-24,Santa Clara,085,1922200,113690,113757,629,114386,1851
2021-03-24,Santa Cruz,087,273765,15783,15138,784,15922,202
2021-03-24,Shasta,089,179085,11240,11243,1324,12567,181
2021-03-24,Sierra,091,2930,55,50,12,62,0
2021-03-24,Siskiyou,093,43540,1565,1490,251,1741,6
2021-03-24,Solano,095,438530,30706,30552,401,30953,178
2021-03-24,Sonoma,097,501317,28962,29034,253,29287,310
2021-03-24,Stanislaus,099,539301,52781,52259,5490,57749,677
2021-03-24,Sutter,101,95872,9065,9049,79,9128,104
2021-03-24,Tehama,103,63373,4756,4719,499,5218,49
2021-03-24,Trinity,105,12862,475,310,80,390,3
2021-03-24,Tulare,107,460477,49184,48109,8395,56504,808
2021-03-24,Tuolumne,109,53932,3912,3961,39,4000,57
2021-03-24,Ventura,111,848112,79677,78993,2826,81819,944
2021-03-24,Yolo,113,214977,13274,13269,167,13436,194
2021-03-24,Yuba,115,75493,5692,5634,94,5728,42
2021-03-23,Alameda,001,1643700,83316,82799,1745,84544,1190
2021-03-23,Alpine,003,1148,85,84,0,84,0
2021-03-23,Amador,005,37829,3542,3524,31,3555,45
2021-03-23,Butte,007,227075,11608,11227,1678,12905,187
2021-03-23,Calaveras,009,45235,1989,1971,11,1982,50
2021-03-23,Colusa,011,21464,1887,1885,270,2155,14
2021-03-23,Contra Costa,013,1133247,65369,64491,1108,65599,750
2021-03-23,Del Norte,015,27424,1156,1082,7,1089,6
2021-03-23,El Dorado,017,186661,9407,9318,619,9937,105
2021-03-23,Fresno,019,978130,99324,98362,8076,106438,1575
2021-03-23,Glenn,021,27897,2336,2293,517,2810,17
2021-03-23,Humboldt,023,135768,3433,3405,24,3429,34
2021-03-23,Imperial,025,180216,27538,27320,2524,29844,699
2021-03-23,Inyo,027,18085,1371,1364,9,1373,35
2021-03-23,Kern,029,883053,95142,93728,10146,103874,1191
2021-03-23,Kings,031,150075,22726,22439,1006,23445,237
2021-03-23,Lake,033,64148,3338,3294,8,3302,43
2021-03-23,Lassen,035,31185,5140,5130,99,5229,1
2021-03-23,Los Angeles,037,10098052,1186917,1176572,38954,1215526,22904
2021-03-23,Madera,039,155013,16057,15908,869,16777,210
2021-03-23,Marin,041,260295,13604,13514,188,13702,221
2021-03-23,Mariposa,043,17540,392,384,5,389,5
2021-03-23,Mendocino,045,87422,3743,3652,74,3726,45
2021-03-23,Merced,047,269075,29594,29485,965,30450,415
2021-03-23,Modoc,049,8938,348,342,118,460,3
2021-03-23,Mono,051,14174,1229,1263,17,1280,3
2021-03-23,Monterey,053,433212,42438,42180,1718,43898,335
2021-03-23,Napa,055,140530,9318,9299,31,9330,78
2021-03-23,Nevada,057,99092,4253,4179,174,4353,89
2021-03-23,Orange,059,3164182,250715,248661,10551,259212,4626
2021-03-23,Placer,061,380077,21410,20567,1203,21770,248
2021-03-23,Plumas,063,18699,666,652,10,662,4
2021-03-23,Riverside,065,2383286,288942,282317,13474,295791,4035
2021-03-23,Sacramento,067,1510023,98132,96521,1366,97887,1496
2021-03-23,San Benito,069,59416,5840,5845,90,5935,61
2021-03-23,San Bernardino,071,2135413,288659,284875,8645,293520,4134
2021-03-23,San Diego,073,3302833,269820,268156,13374,281530,3498
2021-03-23,San Francisco,075,870044,35081,35071,1163,36234,462
2021-03-23,San Joaquin,077,732212,69254,67903,3005,70908,1182
2021-03-23,San Luis Obispo,079,281455,20366,20009,609,20618,250
2021-03-23,San Mateo,081,765935,40524,40032,426,40458,348
2021-03-23,Santa Barbara,083,443738,33206,32771,1067,33838,438
2021-03-23,Santa Clara,085,1922200,113574,113645,626,114271,1848
2021-03-23,Santa Cruz,087,273765,15768,15106,784,15890,201
2021-03-23,Shasta,089,179085,11227,11234,1323,12557,175
2021-03-23,Sierra,091,2930,55,50,12,62,0
2021-03-23,Siskiyou,093,43540,1560,1485,249,1734,6
2021-03-23,Solano,095,438530,30665,30524,400,30924,178
2021-03-23,Sonoma,097,501317,28925,29020,252,29272,310
2021-03-23,Stanislaus,099,539301,52682,52148,5483,57631,677
2021-03-23,Sutter,101,95872,9057,9039,79,9118,104
2021-03-23,Tehama,103,63373,4747,4707,498,5205,46
2021-03-23,Trinity,105,12862,475,310,80,390,3
2021-03-23,Tulare,107,460477,49157,48095,8379,56474,808
2021-03-23,Tuolumne,109,53932,3909,3957,39,3996,57
2021-03-23,Ventura,111,848112,79616,78930,2823,81753,932
2021-03-23,Yolo,113,214977,13263,13255,167,13422,194
2021-03-23,Yuba,115,75493,5687,5628,94,5722,42
2021-03-22,Alameda,001,1643700,83225,82748,1740,84488,1189
2021-03-22,Alpine,003,1148,84,83,0,83,0
2021-03-22,Amador,005,37829,3534,3522,31,3553,44
2021-03-22,Butte,007,227075,11599,11211,1676,12887,185
2021-03-22,Calaveras,009,45235,1985,1963,11,1974,49
2021-03-22,Colusa,011,21464,1885,1885,270,2155,13
2021-03-22,Contra Costa,013,1133247,65274,64432,1106,65538,740
2021-03-22,Del Norte,015,27424,1150,1082,7,1089,6
2021-03-22,El Dorado,017,186661,9391,9310,615,9925,105
2021-03-22,Fresno,019,978130,99226,98276,8064,106340,1556
2021-03-22,Glenn,021,27897,2328,2291,517,2808,17
2021-03-22,Humboldt,023,135768,3428,3403,24,3427,34
2021-03-22,Imperial,025,180216,27523,27302,2521,29823,699
2021-03-22,Inyo,027,18085,1368,1363,9,1372,35
2021-03-22,Kern,029,883053,95071,93675,10130,103805,1178
2021-03-22,Kings,031,150075,22713,22433,1001,23434,236
2021-03-22,Lake,033,64148,3337,3290,8,3298,43
2021-03-22,Lassen,035,31185,5138,5129,99,5228,1
2021-03-22,Los Angeles,037,10098052,1186400,1176205,38924,1215129,22843
2021-03-22,Madera,039,155013,16042,15904,869,16773,210
2021-03-22,Marin,041,260295,13595,13501,187,13688,221
2021-03-22,Mariposa,043,17540,391,381,5,386,5
2021-03-22,Mendocino,045,87422,3741,3653,74,3727,45
2021-03-22,Merced,047,269075,29551,29468,962,30430,413
2021-03-22,Modoc,049,8938,346,342,118,460,3
2021-03-22,Mono,051,14174,1224,1263,17,1280,3
2021-03-22,Monterey,053,433212,42422,42161,1716,43877,335
2021-03-22,Napa,055,140530,9307,9288,31,9319,77
2021-03-22,Nevada,057,99092,4243,4174,170,4344,89
2021-03-22,Orange,059,3164182,250566,248517,10517,259034,4599
2021-03-22,Placer,061,380077,21375,20543,1198,21741,242
2021-03-22,Plumas,063,18699,666,652,10,662,4
2021-03-22,Riverside,065,2383286,288842,282242,13463,295705,4009
2021-03-22,Sacramento,067,1510023,97954,96385,1356,97741,1493
2021-03-22,San Benito,069,59416,5837,5844,89,5933,61
2021-03-22,San Bernardino,071,2135413,288571,284771,8633,293404,4107
2021-03-22,San Diego,073,3302833,269608,267913,13354,281267,3494
2021-03-22,San Francisco,075,870044,35039,35040,1159,36199,462
2021-03-22,San Joaquin,077,732212,69162,67815,2988,70803,1182
2021-03-22,San Luis Obispo,079,281455,20342,20000,608,20608,250
2021-03-22,San Mateo,081,765935,40473,40024,425,40449,348
2021-03-22,Santa Barbara,083,443738,33161,32756,1065,33821,437
2021-03-22,Santa Clara,085,1922200,113454,113575,626,114201,1845
2021-03-22,Santa Cruz,087,273765,15756,15077,783,15860,201
2021-03-22,Shasta,089,179085,11213,11218,1322,12540,150
2021-03-22,Sierra,091,2930,55,50,12,62,0
2021-03-22,Siskiyou,093,43540,1559,1487,248,1735,5
2021-03-22,Solano,095,438530,30625,30490,396,30886,171
2021-03-22,Sonoma,097,501317,28896,29010,248,29258,310
2021-03-22,Stanislaus,099,539301,52598,52083,5478,57561,677
2021-03-22,Sutter,101,95872,9044,9024,79,9103,104
2021-03-22,Tehama,103,63373,4739,4704,498,5202,45
2021-03-22,Trinity,105,12862,475,310,80,390,3
2021-03-22,Tulare,107,460477,49142,48074,8359,56433,807
2021-03-22,Tuolumne,109,53932,3906,3954,39,3993,57
2021-03-22,Ventura,111,848112,79570,78890,2820,81710,927
2021-03-22,Yolo,113,214977,13251,13243,166,13409,190
2021-03-22,Yuba,115,75493,5676,5627,92,5719,42
2021-03-21,Alameda,001,1643700,83138,82684,1737,84421,1187
2021-03-21,Alpine,003,1148,84,83,0,83,0
2021-03-21,Amador,005,37829,3530,3519,31,3550,44
2021-03-21,Butte,007,227075,11583,11208,1671,12879,185
2021-03-21,Calaveras,009,45235,1979,1962,11,1973,49
2021-03-21,Colusa,011,21464,1885,1885,270,2155,13
2021-03-21,Contra Costa,013,1133247,65192,64382,1102,65484,740
2021-03-21,Del Norte,015,27424,1135,1076,7,1083,6
2021-03-21,El Dorado,017,186661,9381,9302,610,9912,105
2021-03-21,Fresno,019,978130,99112,98211,8041,106252,1556
2021-03-21,Glenn,021,27897,2325,2288,516,2804,17
2021-03-21,Humboldt,023,135768,3423,3402,24,3426,34
2021-03-21,Imperial,025,180216,27506,27267,2516,29783,699
2021-03-21,Inyo,027,18085,1368,1363,9,1372,35
2021-03-21,Kern,029,883053,95005,93649,10121,103770,1170
2021-03-21,Kings,031,150075,22696,22422,1001,23423,236
2021-03-21,Lake,033,64148,3333,3286,8,3294,43
2021-03-21,Lassen,035,31185,5138,5129,99,5228,1
2021-03-21,Los Angeles,037,10098052,1185864,1175684,38877,1214561,22834
2021-03-21,Madera,039,155013,16022,15895,867,16762,210
2021-03-21,Marin,041,260295,13579,13495,186,13681,220
2021-03-21,Mariposa,043,17540,391,381,5,386,5
2021-03-21,Mendocino,045,87422,3738,3651,74,3725,45
2021-03-21,Merced,047,269075,29491,29446,956,30402,413
2021-03-21,Modoc,049,8938,346,341,118,459,3
2021-03-21,Mono,051,14174,1219,1263,17,1280,3
2021-03-21,Monterey,053,433212,42397,42153,1713,43866,335
2021-03-21,Napa,055,140530,9286,9282,31,9313,77
2021-03-21,Nevada,057,99092,4230,4169,170,4339,89
2021-03-21,Orange,059,3164182,250433,248442,10490,258932,4598
2021-03-21,Placer,061,380077,21339,20520,1190,21710,242
2021-03-21,Plumas,063,18699,666,653,10,663,4
2021-03-21,Riverside,065,2383286,288734,282187,13452,295639,4009
2021-03-21,Sacramento,067,1510023,97760,96269,1349,97618,1489
2021-03-21,San Benito,069,59416,5831,5842,89,5931,61
2021-03-21,San Bernardino,071,2135413,288481,284732,8627,293359,4094
2021-03-21,San Diego,073,3302833,269348,267724,13328,281052,3494
2021-03-21,San Francisco,075,870044,34992,35012,1153,36165,460
2021-03-21,San Joaquin,077,732212,69040,67729,2970,70699,1182
2021-03-21,San Luis Obispo,079,281455,20310,19979,606,20585,250
2021-03-21,San Mateo,081,765935,40428,39988,424,40412,344
2021-03-21,Santa Barbara,083,443738,33122,32743,1064,33807,437
2021-03-21,Santa Clara,085,1922200,113325,113487,623,114110,1840
2021-03-21,Santa Cruz,087,273765,15749,15064,783,15847,199
2021-03-21,Shasta,089,179085,11193,11215,1321,12536,150
2021-03-21,Sierra,091,2930,55,50,12,62,0
2021-03-21,Siskiyou,093,43540,1559,1486,247,1733,5
2021-03-21,Solano,095,438530,30586,30474,393,30867,171
2021-03-21,Sonoma,097,501317,28867,28986,247,29233,310
2021-03-21,Stanislaus,099,539301,52508,52014,5476,57490,677
2021-03-21,Sutter,101,95872,9031,9021,79,9100,104
2021-03-21,Tehama,103,63373,4735,4701,498,5199,45
2021-03-21,Trinity,105,12862,473,310,80,390,3
2021-03-21,Tulare,107,460477,49126,48060,8347,56407,807
2021-03-21,Tuolumne,109,53932,3904,3953,39,3992,57
2021-03-21,Ventura,111,848112,79507,78863,2815,81678,927
2021-03-21,Yolo,113,214977,13229,13235,166,13401,190
2021-03-21,Yuba,115,75493,5666,5624,92,5716,42
2021-03-20,Alameda,001,1643700,83070,82614,1735,84349,1178
2021-03-20,Alpine,003,1148,84,83,0,83,0
2021-03-20,Amador,005,37829,3528,3518,31,3549,44
2021-03-20,Butte,007,227075,11577,11199,1669,12868,185
2021-03-20,Calaveras,009,45235,1975,1961,11,1972,49
2021-03-20,Colusa,011,21464,1885,1883,270,2153,12
2021-03-20,Contra Costa,013,1133247,65132,64313,1102,65415,713
2021-03-20,Del Norte,015,27424,1134,1075,7,1082,6
2021-03-20,El Dorado,017,186661,9375,9290,610,9900,105
2021-03-20,Fresno,019,978130,99052,98112,8034,106146,1532
2021-03-20,Glenn,021,27897,2324,2288,514,2802,17
2021-03-20,Humboldt,023,135768,3416,3399,24,3423,33
2021-03-20,Imperial,025,180216,27500,27239,2514,29753,695
2021-03-20,Inyo,027,18085,1368,1362,9,1371,35
2021-03-20,Kern,029,883053,94976,93606,10117,103723,1155
2021-03-20,Kings,031,150075,22691,22415,1000,23415,236
2021-03-20,Lake,033,64148,3329,3280,8,3288,43
2021-03-20,Lassen,035,31185,5138,5128,99,5227,1
2021-03-20,Los Angeles,037,10098052,1185565,1175290,38853,1214143,22810
2021-03-20,Madera,039,155013,16014,15891,866,16757,210
2021-03-20,Marin,041,260295,13567,13470,182,13652,220
2021-03-20,Mariposa,043,17540,390,381,5,386,5
2021-03-20,Mendocino,045,87422,3737,3639,74,3713,43
2021-03-20,Merced,047,269075,29460,29411,953,30364,412
2021-03-20,Modoc,049,8938,345,341,118,459,3
2021-03-20,Mono,051,14174,1219,1256,17,1273,3
2021-03-20,Monterey,053,433212,42388,42146,1712,43858,334
2021-03-20,Napa,055,140530,9278,9274,31,9305,77
2021-03-20,Nevada,057,99092,4219,4164,169,4333,89
2021-03-20,Orange,059,3164182,250352,248348,10480,258828,4522
2021-03-20,Placer,061,380077,21316,20505,1188,21693,242
2021-03-20,Plumas,063,18699,663,652,10,662,4
2021-03-20,Riverside,065,2383286,288659,282081,13448,295529,4000
2021-03-20,Sacramento,067,1510023,97649,96126,1346,97472,1488
2021-03-20,San Benito,069,59416,5827,5840,89,5929,61
2021-03-20,San Bernardino,071,2135413,288415,284690,8623,293313,3965
2021-03-20,San Diego,073,3302833,269177,267532,13321,280853,3493
2021-03-20,San Francisco,075,870044,34969,34968,1146,36114,453
2021-03-20,San Joaquin,077,732212,68999,67662,2963,70625,1161
2021-03-20,San Luis Obispo,079,281455,20294,19951,600,20551,250
2021-03-20,San Mateo,081,765935,40394,39958,423,40381,344
2021-03-20,Santa Barbara,083,443738,33097,32723,1063,33786,434
2021-03-20,Santa Clara,085,1922200,113233,113384,622,114006,1799
2021-03-20,Santa Cruz,087,273765,15733,15053,783,15836,199
2021-03-20,Shasta,089,179085,11187,11211,1321,12532,147
2021-03-20,Sierra,091,2930,55,50,12,62,0
2021-03-20,Siskiyou,093,43540,1559,1483,247,1730,5
2021-03-20,Solano,095,438530,30556,30439,393,30832,170
2021-03-20,Sonoma,097,501317,28852,28962,247,29209,309
2021-03-20,Stanislaus,099,539301,52452,51925,5469,57394,673
2021-03-20,Sutter,101,95872,9023,9014,79,9093,103
2021-03-20,Tehama,103,63373,4730,4696,496,5192,33
2021-03-20,Trinity,105,12862,472,310,80,390,3
2021-03-20,Tulare,107,460477,49111,48030,8330,56360,804
2021-03-20,Tuolumne,109,53932,3901,3950,39,3989,57
2021-03-20,Ventura,111,848112,79472,78818,2813,81631,922
2021-03-20,Yolo,113,214977,13225,13226,166,13392,190
2021-03-20,Yuba,115,75493,5663,5621,91,5712,42
2021-03-19,Alameda,001,1643700,82998,82499,1734,84233,1187
2021-03-19,Alpine,003,1148,83,82,0,82,0
2021-03-19,Amador,005,37829,3525,3515,31,3546,44
2021-03-19,Butte,007,227075,11569,11191,1666,12857,185
2021-03-19,Calaveras,009,45235,1974,1957,11,1968,49
2021-03-19,Colusa,011,21464,1884,1883,270,2153,12
2021-03-19,Contra Costa,013,1133247,65073,64195,1099,65294,737
2021-03-19,Del Norte,015,27424,1128,1071,5,1076,6
2021-03-19,El Dorado,017,186661,9366,9274,610,9884,105
2021-03-19,Fresno,019,978130,98968,97969,8021,105990,1527
2021-03-19,Glenn,021,27897,2324,2282,514,2796,17
2021-03-19,Humboldt,023,135768,3407,3388,24,3412,33
2021-03-19,Imperial,025,180216,27488,27218,2511,29729,695
2021-03-19,Inyo,027,18085,1366,1356,9,1365,35
2021-03-19,Kern,029,883053,94943,93534,10104,103638,1152
2021-03-19,Kings,031,150075,22682,22369,997,23366,235
2021-03-19,Lake,033,64148,3323,3262,8,3270,43
2021-03-19,Lassen,035,31185,5138,5126,99,5225,1
2021-03-19,Los Angeles,037,10098052,1185225,1174818,38836,1213654,22752
2021-03-19,Madera,039,155013,16007,15877,865,16742,210
2021-03-19,Marin,041,260295,13555,13441,182,13623,220
2021-03-19,Mariposa,043,17540,389,380,5,385,5
2021-03-19,Mendocino,045,87422,3736,3639,74,3713,45
2021-03-19,Merced,047,269075,29433,29376,951,30327,412
2021-03-19,Modoc,049,8938,345,341,118,459,3
2021-03-19,Mono,051,14174,1217,1244,17,1261,3
2021-03-19,Monterey,053,433212,42379,42125,1710,43835,335
2021-03-19,Napa,055,140530,9266,9256,31,9287,77
2021-03-19,Nevada,057,99092,4208,4156,169,4325,88
2021-03-19,Orange,059,3164182,250252,248146,10471,258617,4501
2021-03-19,Placer,061,380077,21298,20451,1186,21637,242
2021-03-19,Plumas,063,18699,663,650,10,660,4
2021-03-19,Riverside,065,2383286,288576,281937,13443,295380,3989
2021-03-19,Sacramento,067,1510023,97546,95934,1343,97277,1486
2021-03-19,San Benito,069,59416,5827,5845,89,5934,61
2021-03-19,San Bernardino,071,2135413,288344,284501,8621,293122,4017
2021-03-19,San Diego,073,3302833,269042,267173,13311,280484,3491
2021-03-19,San Francisco,075,870044,34924,34936,1143,36079,461
2021-03-19,San Joaquin,077,732212,68929,67515,2949,70464,1180
2021-03-19,San Luis Obispo,079,281455,20274,19913,598,20511,249
2021-03-19,San Mateo,081,765935,40370,39893,423,40316,344
2021-03-19,Santa Barbara,083,443738,33067,32685,1062,33747,435
2021-03-19,Santa Clara,085,1922200,113158,113232,621,113853,1797
2021-03-19,Santa Cruz,087,273765,15726,15026,783,15809,199
2021-03-19,Shasta,089,179085,11180,11104,1319,12423,103
2021-03-19,Sierra,091,2930,54,49,12,61,0
2021-03-19,Siskiyou,093,43540,1559,1480,246,1726,5
2021-03-19,Solano,095,438530,30526,30395,391,30786,172
2021-03-19,Sonoma,097,501317,28831,28932,245,29177,292
2021-03-19,Stanislaus,099,539301,52394,51755,5466,57221,679
2021-03-19,Sutter,101,95872,9021,9005,79,9084,103
2021-03-19,Tehama,103,63373,4723,4685,496,5181,33
2021-03-19,Trinity,105,12862,472,310,80,390,3
2021-03-19,Tulare,107,460477,49088,47989,8307,56296,805
2021-03-19,Tuolumne,109,53932,3898,3946,39,3985,57
2021-03-19,Ventura,111,848112,79439,78753,2809,81562,920
2021-03-19,Yolo,113,214977,13217,13197,166,13363,189
2021-03-19,Yuba,115,75493,5660,5615,90,5705,42
2021-03-18,Alameda,001,1643700,82917,82419,1731,84150,1189
2021-03-18,Alpine,003,1148,83,82,0,82,0
2021-03-18,Amador,005,37829,3521,3513,31,3544,44
2021-03-18,Butte,007,227075,11558,11179,1664,12843,185
2021-03-18,Calaveras,009,45235,1972,1954,11,1965,49
2021-03-18,Colusa,011,21464,1884,1882,270,2152,12
2021-03-18,Contra Costa,013,1133247,65000,64103,1096,65199,739
2021-03-18,Del Norte,015,27424,1119,1059,5,1064,6
2021-03-18,El Dorado,017,186661,9353,9261,609,9870,105
2021-03-18,Fresno,019,978130,98871,97856,8006,105862,1527
2021-03-18,Glenn,021,27897,2320,2275,513,2788,17
2021-03-18,Humboldt,023,135768,3399,3381,24,3405,34
2021-03-18,Imperial,025,180216,27473,27190,2506,29696,695
2021-03-18,Inyo,027,18085,1363,1354,9,1363,35
2021-03-18,Kern,029,883053,94886,93458,10090,103548,1158
2021-03-18,Kings,031,150075,22675,22354,996,23350,235
2021-03-18,Lake,033,64148,3320,3260,8,3268,43
2021-03-18,Lassen,035,31185,5137,5126,99,5225,1
2021-03-18,Los Angeles,037,10098052,1184792,1174205,38808,1213013,22689
2021-03-18,Madera,039,155013,15995,15860,862,16722,211
2021-03-18,Marin,041,260295,13537,13435,181,13616,219
2021-03-18,Mariposa,043,17540,387,380,5,385,5
2021-03-18,Mendocino,045,87422,3726,3630,74,3704,45
2021-03-18,Merced,047,269075,29398,29317,951,30268,410
2021-03-18,Modoc,049,8938,345,341,118,459,3
2021-03-18,Mono,051,14174,1213,1215,16,1231,3
2021-03-18,Monterey,053,433212,42367,42105,1710,43815,335
2021-03-18,Napa,055,140530,9257,9243,31,9274,77
2021-03-18,Nevada,057,99092,4201,4154,169,4323,74
2021-03-18,Orange,059,3164182,250149,248050,10459,258509,4514
2021-03-18,Placer,061,380077,21266,20421,1183,21604,243
2021-03-18,Plumas,063,18699,661,648,10,658,4
2021-03-18,Riverside,065,2383286,288495,281789,13436,295225,3957
2021-03-18,Sacramento,067,1510023,97398,95819,1339,97158,1481
2021-03-18,San Benito,069,59416,5825,5842,89,5931,61
2021-03-18,San Bernardino,071,2135413,288261,284294,8591,292885,4076
2021-03-18,San Diego,073,3302833,268889,266752,13301,280053,3478
2021-03-18,San Francisco,075,870044,34885,34904,1142,36046,461
2021-03-18,San Joaquin,077,732212,68829,67301,2937,70238,1169
2021-03-18,San Luis Obispo,079,281455,20245,19894,597,20491,249
2021-03-18,San Mateo,081,765935,40329,39874,423,40297,344
2021-03-18,Santa Barbara,083,443738,33026,32640,1062,33702,434
2021-03-18,Santa Clara,085,1922200,113041,113119,617,113736,1808
2021-03-18,Santa Cruz,087,273765,15716,14998,783,15781,198
2021-03-18,Shasta,089,179085,11166,11059,1317,12376,100
2021-03-18,Sierra,091,2930,54,49,12,61,0
2021-03-18,Siskiyou,093,43540,1556,1480,245,1725,5
2021-03-18,Solano,095,438530,30484,30352,388,30740,172
2021-03-18,Sonoma,097,501317,28810,28915,243,29158,292
2021-03-18,Stanislaus,099,539301,52322,51615,5462,57077,682
2021-03-18,Sutter,101,95872,9009,8999,79,9078,103
2021-03-18,Tehama,103,63373,4717,4683,495,5178,35
2021-03-18,Trinity,105,12862,472,310,80,390,3
2021-03-18,Tulare,107,460477,49069,47964,8292,56256,805
2021-03-18,Tuolumne,109,53932,3897,3942,39,3981,57
2021-03-18,Ventura,111,848112,79379,78697,2809,81506,918
2021-03-18,Yolo,113,214977,13204,13183,166,13349,191
2021-03-18,Yuba,115,75493,5656,5612,90,5702,42
2021-03-17,Alameda,001,1643700,82841,82353,1726,84079,1185
2021-03-17,Alpine,003,1148,83,82,0,82,0
2021-03-17,Amador,005,37829,3519,3511,31,3542,44
2021-03-17,Butte,007,227075,11549,11170,1662,12832,185
2021-03-17,Calaveras,009,45235,1969,1946,11,1957,49
2021-03-17,Colusa,011,21464,1883,1882,270,2152,12
2021-03-17,Contra Costa,013,1133247,64931,64026,1095,65121,737
2021-03-17,Del Norte,015,27424,1115,1053,5,1058,6
2021-03-17,El Dorado,017,186661,9343,9252,609,9861,105
2021-03-17,Fresno,019,978130,98760,97727,7988,105715,1507
2021-03-17,Glenn,021,27897,2313,2269,512,2781,17
2021-03-17,Humboldt,023,135768,3391,3365,24,3389,33
2021-03-17,Imperial,025,180216,27456,27168,2503,29671,691
2021-03-17,Inyo,027,18085,1361,1351,9,1360,35
2021-03-17,Kern,029,883053,94830,93392,10077,103469,1149
2021-03-17,Kings,031,150075,22659,22336,995,23331,233
2021-03-17,Lake,033,64148,3313,3251,8,3259,43
2021-03-17,Lassen,035,31185,5136,5125,99,5224,1
2021-03-17,Los Angeles,037,10098052,1184338,1173416,38775,1212191,22602
2021-03-17,Madera,039,155013,15988,15835,862,16697,214
2021-03-17,Marin,041,260295,13520,13428,180,13608,218
2021-03-17,Mariposa,043,17540,387,379,5,384,5
2021-03-17,Mendocino,045,87422,3722,3625,74,3699,44
2021-03-17,Merced,047,269075,29370,29250,947,30197,408
2021-03-17,Modoc,049,8938,345,341,118,459,3
2021-03-17,Mono,051,14174,1211,1212,16,1228,3
2021-03-17,Monterey,053,433212,42349,42061,1707,43768,334
2021-03-17,Napa,055,140530,9242,9219,31,9250,76
2021-03-17,Nevada,057,99092,4191,4145,169,4314,74
2021-03-17,Orange,059,3164182,250031,247943,10431,258374,4502
2021-03-17,Placer,061,380077,21238,20369,1182,21551,243
2021-03-17,Plumas,063,18699,660,645,10,655,4
2021-03-17,Riverside,065,2383286,288380,281649,13428,295077,3925
2021-03-17,Sacramento,067,1510023,97270,95650,1334,96984,1477
2021-03-17,San Benito,069,59416,5822,5841,89,5930,61
2021-03-17,San Bernardino,071,2135413,288144,284170,8586,292756,4049
2021-03-17,San Diego,073,3302833,268678,266313,13283,279596,3470
2021-03-17,San Francisco,075,870044,34850,34873,1141,36014,457
2021-03-17,San Joaquin,077,732212,68744,67093,2921,70014,1164
2021-03-17,San Luis Obispo,079,281455,20222,19858,593,20451,249
2021-03-17,San Mateo,081,765935,40299,39838,422,40260,344
2021-03-17,Santa Barbara,083,443738,33004,32585,1061,33646,433
2021-03-17,Santa Clara,085,1922200,112948,112983,616,113599,1805
2021-03-17,Santa Cruz,087,273765,15708,14967,783,15750,199
2021-03-17,Shasta,089,179085,11161,11045,1314,12359,100
2021-03-17,Sierra,091,2930,54,49,12,61,0
2021-03-17,Siskiyou,093,43540,1555,1479,244,1723,5
2021-03-17,Solano,095,438530,30458,30320,386,30706,171
2021-03-17,Sonoma,097,501317,28786,28877,242,29119,292
2021-03-17,Stanislaus,099,539301,52247,51524,5455,56979,682
2021-03-17,Sutter,101,95872,8999,8982,79,9061,103
2021-03-17,Tehama,103,63373,4712,4670,495,5165,34
2021-03-17,Trinity,105,12862,472,308,80,388,3
2021-03-17,Tulare,107,460477,49049,47929,8282,56211,805
2021-03-17,Tuolumne,109,53932,3894,3938,39,3977,57
2021-03-17,Ventura,111,848112,79323,78648,2806,81454,916
2021-03-17,Yolo,113,214977,13187,13169,166,13335,190
2021-03-17,Yuba,115,75493,5653,5603,90,5693,42
2021-03-16,Alameda,001,1643700,82730,82259,1724,83983,1177
2021-03-16,Alpine,003,1148,83,82,0,82,0
2021-03-16,Amador,005,37829,3517,3510,31,3541,44
2021-03-16,Butte,007,227075,11537,11154,1661,12815,184
2021-03-16,Calaveras,009,45235,1964,1945,11,1956,49
2021-03-16,Colusa,011,21464,1882,1882,270,2152,12
2021-03-16,Contra Costa,013,1133247,64848,63951,1092,65043,736
2021-03-16,Del Norte,015,27424,1107,1048,5,1053,6
2021-03-16,El Dorado,017,186661,9328,9249,609,9858,105
2021-03-16,Fresno,019,978130,98622,97638,7968,105606,1498
2021-03-16,Glenn,021,27897,2305,2267,508,2775,17
2021-03-16,Humboldt,023,135768,3387,3351,24,3375,33
2021-03-16,Imperial,025,180216,27445,27143,2500,29643,689
2021-03-16,Inyo,027,18085,1360,1346,9,1355,35
2021-03-16,Kern,029,883053,94764,93340,10062,103402,1144
2021-03-16,Kings,031,150075,22623,22320,994,23314,233
2021-03-16,Lake,033,64148,3305,3246,8,3254,43
2021-03-16,Lassen,035,31185,5135,5126,99,5225,1
2021-03-16,Los Angeles,037,10098052,1183806,1172676,38737,1211413,22527
2021-03-16,Madera,039,155013,15972,15822,860,16682,214
2021-03-16,Marin,041,260295,13502,13419,180,13599,218
2021-03-16,Mariposa,043,17540,384,379,5,384,5
2021-03-16,Mendocino,045,87422,3717,3623,74,3697,44
2021-03-16,Merced,047,269075,29317,29198,946,30144,407
2021-03-16,Modoc,049,8938,345,341,118,459,3
2021-03-16,Mono,051,14174,1210,1207,16,1223,3
2021-03-16,Monterey,053,433212,42330,42023,1707,43730,334
2021-03-16,Napa,055,140530,9232,9209,31,9240,75
2021-03-16,Nevada,057,99092,4182,4132,168,4300,67
2021-03-16,Orange,059,3164182,249892,247843,10412,258255,4479
2021-03-16,Placer,061,380077,21206,20339,1178,21517,240
2021-03-16,Plumas,063,18699,659,643,10,653,4
2021-03-16,Riverside,065,2383286,288266,281540,13416,294956,3893
2021-03-16,Sacramento,067,1510023,97127,95522,1330,96852,1466
2021-03-16,San Benito,069,59416,5817,5831,89,5920,61
2021-03-16,San Bernardino,071,2135413,288014,283980,8579,292559,4032
2021-03-16,San Diego,073,3302833,268446,265903,13270,279173,3462
2021-03-16,San Francisco,075,870044,34821,34833,1136,35969,456
2021-03-16,San Joaquin,077,732212,68642,66856,2909,69765,1163
2021-03-16,San Luis Obispo,079,281455,20192,19832,591,20423,248
2021-03-16,San Mateo,081,765935,40265,39806,420,40226,344
2021-03-16,Santa Barbara,083,443738,32972,32556,1060,33616,433
2021-03-16,Santa Clara,085,1922200,112830,112845,613,113458,1797
2021-03-16,Santa Cruz,087,273765,15702,14926,783,15709,199
2021-03-16,Shasta,089,179085,11145,11035,1312,12347,100
2021-03-16,Sierra,091,2930,53,49,12,61,0
2021-03-16,Siskiyou,093,43540,1552,1477,244,1721,5
2021-03-16,Solano,095,438530,30424,30298,384,30682,171
2021-03-16,Sonoma,097,501317,28753,28850,240,29090,291
2021-03-16,Stanislaus,099,539301,52167,51410,5448,56858,683
2021-03-16,Sutter,101,95872,8991,8970,79,9049,102
2021-03-16,Tehama,103,63373,4709,4660,494,5154,34
2021-03-16,Trinity,105,12862,472,308,79,387,3
2021-03-16,Tulare,107,460477,49001,47895,8274,56169,803
2021-03-16,Tuolumne,109,53932,3891,3938,39,3977,57
2021-03-16,Ventura,111,848112,79257,78671,2799,81470,916
2021-03-16,Yolo,113,214977,13172,13162,166,13328,190
2021-03-16,Yuba,115,75493,5650,5596,89,5685,42
2021-03-15,Alameda,001,1643700,82641,82159,1724,83883,1167
2021-03-15,Alpine,003,1148,83,82,0,82,0
2021-03-15,Amador,005,37829,3516,3506,31,3537,44
2021-03-15,Butte,007,227075,11524,11141,1657,12798,185
2021-03-15,Calaveras,009,45235,1963,1941,11,1952,49
2021-03-15,Colusa,011,21464,1882,1883,270,2153,12
2021-03-15,Contra Costa,013,1133247,64786,63847,1091,64938,732
2021-03-15,Del Norte,015,27424,1104,1048,5,1053,6
2021-03-15,El Dorado,017,186661,9322,9235,609,9844,103
2021-03-15,Fresno,019,978130,98495,97520,7953,105473,1496
2021-03-15,Glenn,021,27897,2300,2261,505,2766,15
2021-03-15,Humboldt,023,135768,3381,3337,24,3361,32
2021-03-15,Imperial,025,180216,27425,27122,2497,29619,684
2021-03-15,Inyo,027,18085,1360,1346,9,1355,35
2021-03-15,Kern,029,883053,94704,93266,10055,103321,1141
2021-03-15,Kings,031,150075,22606,22294,988,23282,233
2021-03-15,Lake,033,64148,3293,3237,8,3245,43
2021-03-15,Lassen,035,31185,5135,5125,99,5224,1
2021-03-15,Los Angeles,037,10098052,1183234,1172445,38705,1211150,22477
2021-03-15,Madera,039,155013,15961,15806,858,16664,214
2021-03-15,Marin,041,260295,13496,13408,179,13587,218
2021-03-15,Mariposa,043,17540,384,376,5,381,5
2021-03-15,Mendocino,045,87422,3713,3615,74,3689,44
2021-03-15,Merced,047,269075,29279,29169,944,30113,407
2021-03-15,Modoc,049,8938,345,340,118,458,3
2021-03-15,Mono,051,14174,1209,1206,16,1222,3
2021-03-15,Monterey,053,433212,42301,42011,1704,43715,333
2021-03-15,Napa,055,140530,9221,9196,31,9227,75
2021-03-15,Nevada,057,99092,4177,4123,167,4290,66
2021-03-15,Orange,059,3164182,249779,247697,10393,258090,4481
2021-03-15,Placer,061,380077,21183,20308,1178,21486,238
2021-03-15,Plumas,063,18699,659,642,10,652,4
2021-03-15,Riverside,065,2383286,288114,281367,13406,294773,3856
2021-03-15,Sacramento,067,1510023,96974,95414,1324,96738,1463
2021-03-15,San Benito,069,59416,5814,5831,89,5920,61
2021-03-15,San Bernardino,071,2135413,287923,283815,8571,292386,4004
2021-03-15,San Diego,073,3302833,268197,265646,13254,278900,3452
2021-03-15,San Francisco,075,870044,34786,34820,1132,35952,456
2021-03-15,San Joaquin,077,732212,68539,66622,2897,69519,1140
2021-03-15,San Luis Obispo,079,281455,20161,19813,587,20400,247
2021-03-15,San Mateo,081,765935,40211,39765,420,40185,344
2021-03-15,Santa Barbara,083,443738,32949,32529,1057,33586,431
2021-03-15,Santa Clara,085,1922200,112729,112729,611,113340,1798
2021-03-15,Santa Cruz,087,273765,15696,14899,782,15681,200
2021-03-15,Shasta,089,179085,11129,11019,1307,12326,92
2021-03-15,Sierra,091,2930,53,49,12,61,0
2021-03-15,Siskiyou,093,43540,1552,1475,244,1719,5
2021-03-15,Solano,095,438530,30395,30258,383,30641,171
2021-03-15,Sonoma,097,501317,28735,28814,237,29051,285
2021-03-15,Stanislaus,099,539301,52088,51357,5441,56798,683
2021-03-15,Sutter,101,95872,8985,8962,79,9041,102
2021-03-15,Tehama,103,63373,4694,4650,493,5143,34
2021-03-15,Trinity,105,12862,472,308,79,387,3
2021-03-15,Tulare,107,460477,48971,47857,8259,56116,800
2021-03-15,Tuolumne,109,53932,3889,3937,38,3975,57
2021-03-15,Ventura,111,848112,79201,78626,2798,81424,910
2021-03-15,Yolo,113,214977,13153,13131,166,13297,190
2021-03-15,Yuba,115,75493,5645,5585,88,5673,42
2021-03-14,Alameda,001,1643700,82556,82116,1721,83837,1168
2021-03-14,Alpine,003,1148,83,82,0,82,0
2021-03-14,Amador,005,37829,3511,3504,31,3535,44
2021-03-14,Butte,007,227075,11511,11140,1653,12793,185
2021-03-14,Calaveras,009,45235,1959,1939,11,1950,49
2021-03-14,Colusa,011,21464,1882,1883,270,2153,12
2021-03-14,Contra Costa,013,1133247,64682,63808,1090,64898,731
2021-03-14,Del Norte,015,27424,1090,1048,5,1053,6
2021-03-14,El Dorado,017,186661,9312,9231,609,9840,103
2021-03-14,Fresno,019,978130,98387,97461,7935,105396,1496
2021-03-14,Glenn,021,27897,2295,2260,502,2762,15
2021-03-14,Humboldt,023,135768,3367,3335,24,3359,32
2021-03-14,Imperial,025,180216,27410,27122,2492,29614,685
2021-03-14,Inyo,027,18085,1356,1346,9,1355,35
2021-03-14,Kern,029,883053,94621,93252,10037,103289,1141
2021-03-14,Kings,031,150075,22587,22292,986,23278,232
2021-03-14,Lake,033,64148,3288,3237,8,3245,43
2021-03-14,Lassen,035,31185,5133,5125,99,5224,1
2021-03-14,Los Angeles,037,10098052,1182657,1172100,38675,1210775,22476
2021-03-14,Madera,039,155013,15936,15804,858,16662,214
2021-03-14,Marin,041,260295,13480,13405,177,13582,218
2021-03-14,Mariposa,043,17540,382,376,5,381,5
2021-03-14,Mendocino,045,87422,3708,3613,74,3687,44
2021-03-14,Merced,047,269075,29211,29149,940,30089,407
2021-03-14,Modoc,049,8938,345,340,118,458,3
2021-03-14,Mono,051,14174,1203,1206,16,1222,3
2021-03-14,Monterey,053,433212,42277,42007,1701,43708,333
2021-03-14,Napa,055,140530,9203,9194,31,9225,75
2021-03-14,Nevada,057,99092,4171,4122,165,4287,66
2021-03-14,Orange,059,3164182,249647,247656,10374,258030,4460
2021-03-14,Placer,061,380077,21148,20288,1170,21458,238
2021-03-14,Plumas,063,18699,657,642,10,652,4
2021-03-14,Riverside,065,2383286,287956,281332,13398,294730,3845
2021-03-14,Sacramento,067,1510023,96796,95343,1319,96662,1462
2021-03-14,San Benito,069,59416,5805,5829,89,5918,61
2021-03-14,San Bernardino,071,2135413,287800,283791,8560,292351,3996
2021-03-14,San Diego,073,3302833,267962,265468,13241,278709,3452
2021-03-14,San Francisco,075,870044,34747,34810,1129,35939,455
2021-03-14,San Joaquin,077,732212,68411,66563,2880,69443,1140
2021-03-14,San Luis Obispo,079,281455,20133,19806,585,20391,247
2021-03-14,San Mateo,081,765935,40172,39744,420,40164,342
2021-03-14,Santa Barbara,083,443738,32905,32514,1055,33569,431
2021-03-14,Santa Clara,085,1922200,112601,112648,610,113258,1796
2021-03-14,Santa Cruz,087,273765,15680,14887,780,15667,200
2021-03-14,Shasta,089,179085,11113,11019,1300,12319,92
2021-03-14,Sierra,091,2930,53,49,12,61,0
2021-03-14,Siskiyou,093,43540,1549,1473,244,1717,5
2021-03-14,Solano,095,438530,30363,30230,378,30608,171
2021-03-14,Sonoma,097,501317,28700,28798,233,29031,284
2021-03-14,Stanislaus,099,539301,51968,51306,5433,56739,690
2021-03-14,Sutter,101,95872,8969,8958,79,9037,102
2021-03-14,Tehama,103,63373,4687,4650,492,5142,34
2021-03-14,Trinity,105,12862,471,308,78,386,3
2021-03-14,Tulare,107,460477,48938,47845,8238,56083,800
2021-03-14,Tuolumne,109,53932,3887,3937,38,3975,57
2021-03-14,Ventura,111,848112,79153,78611,2792,81403,910
2021-03-14,Yolo,113,214977,13130,13128,163,13291,189
2021-03-14,Yuba,115,75493,5635,5583,88,5671,42
2021-03-13,Alameda,001,1643700,82496,82010,1721,83731,1168
2021-03-13,Alpine,003,1148,83,82,0,82,0
2021-03-13,Amador,005,37829,3508,3504,31,3535,44
2021-03-13,Butte,007,227075,11502,11131,1652,12783,185
2021-03-13,Calaveras,009,45235,1958,1939,11,1950,49
2021-03-13,Colusa,011,21464,1882,1882,270,2152,12
2021-03-13,Contra Costa,013,1133247,64621,63689,1090,64779,731
2021-03-13,Del Norte,015,27424,1086,1041,5,1046,6
2021-03-13,El Dorado,017,186661,9304,9221,609,9830,103
2021-03-13,Fresno,019,978130,98328,97324,7915,105239,1495
2021-03-13,Glenn,021,27897,2294,2260,501,2761,15
2021-03-13,Humboldt,023,135768,3360,3325,24,3349,32
2021-03-13,Imperial,025,180216,27404,27099,2488,29587,677
2021-03-13,Inyo,027,18085,1355,1344,9,1353,35
2021-03-13,Kern,029,883053,94582,93197,10031,103228,1140
2021-03-13,Kings,031,150075,22571,22265,985,23250,232
2021-03-13,Lake,033,64148,3281,3234,7,3241,43
2021-03-13,Lassen,035,31185,5133,5125,99,5224,1
2021-03-13,Los Angeles,037,10098052,1182339,1171505,38633,1210138,22451
2021-03-13,Madera,039,155013,15924,15780,858,16638,214
2021-03-13,Marin,041,260295,13474,13391,175,13566,218
2021-03-13,Mariposa,043,17540,381,376,5,381,5
2021-03-13,Mendocino,045,87422,3704,3611,74,3685,44
2021-03-13,Merced,047,269075,29180,29106,940,30046,406
2021-03-13,Modoc,049,8938,345,340,117,457,3
2021-03-13,Mono,051,14174,1203,1207,16,1223,3
2021-03-13,Monterey,053,433212,42267,41989,1699,43688,332
2021-03-13,Napa,055,140530,9197,9190,31,9221,75
2021-03-13,Nevada,057,99092,4164,4111,164,4275,66
2021-03-13,Orange,059,3164182,249566,247514,10358,257872,4423
2021-03-13,Placer,061,380077,21127,20238,1167,21405,239
2021-03-13,Plumas,063,18699,655,642,10,652,4
2021-03-13,Riverside,065,2383286,287864,281191,13390,294581,3848
2021-03-13,Sacramento,067,1510023,96709,95192,1317,96509,1461
2021-03-13,San Benito,069,59416,5802,5823,89,5912,61
2021-03-13,San Bernardino,071,2135413,287746,283727,8554,292281,3972
2021-03-13,San Diego,073,3302833,267807,265270,13227,278497,3444
2021-03-13,San Francisco,075,870044,34730,34784,1120,35904,455
2021-03-13,San Joaquin,077,732212,68355,66480,2858,69338,1141
2021-03-13,San Luis Obispo,079,281455,20115,19789,584,20373,247
2021-03-13,San Mateo,081,765935,40145,39689,419,40108,341
2021-03-13,Santa Barbara,083,443738,32880,32486,1054,33540,431
2021-03-13,Santa Clara,085,1922200,112516,112531,609,113140,1790
2021-03-13,Santa Cruz,087,273765,15673,14875,780,15655,199
2021-03-13,Shasta,089,179085,11105,11021,1297,12318,108
2021-03-13,Sierra,091,2930,52,49,12,61,0
2021-03-13,Siskiyou,093,43540,1547,1470,244,1714,5
2021-03-13,Solano,095,438530,30346,30198,378,30576,171
2021-03-13,Sonoma,097,501317,28680,28762,229,28991,285
2021-03-13,Stanislaus,099,539301,51917,51257,5429,56686,695
2021-03-13,Sutter,101,95872,8962,8948,79,9027,102
2021-03-13,Tehama,103,63373,4685,4647,492,5139,33
2021-03-13,Trinity,105,12862,471,306,78,384,3
2021-03-13,Tulare,107,460477,48912,47818,8230,56048,798
2021-03-13,Tuolumne,109,53932,3884,3937,38,3975,57
2021-03-13,Ventura,111,848112,79101,78693,2792,81485,906
2021-03-13,Yolo,113,214977,13121,13087,163,13250,189
2021-03-13,Yuba,115,75493,5634,5577,88,5665,42
2021-03-12,Alameda,001,1643700,82419,81898,1720,83618,1164
2021-03-12,Alpine,003,1148,83,82,0,82,0
2021-03-12,Amador,005,37829,3505,3503,31,3534,44
2021-03-12,Butte,007,227075,11492,11126,1650,12776,184
2021-03-12,Calaveras,009,45235,1958,1916,11,1927,49
2021-03-12,Colusa,011,21464,1882,1883,270,2153,12
2021-03-12,Contra Costa,013,1133247,64545,63583,1090,64673,728
2021-03-12,Del Norte,015,27424,1080,1033,5,1038,6
2021-03-12,El Dorado,017,186661,9295,9219,609,9828,103
2021-03-12,Fresno,019,978130,98231,97185,7904,105089,1489
2021-03-12,Glenn,021,27897,2293,2258,500,2758,15
2021-03-12,Humboldt,023,135768,3355,3315,24,3339,32
2021-03-12,Imperial,025,180216,27393,27071,2486,29557,677
2021-03-12,Inyo,027,18085,1353,1339,9,1348,35
2021-03-12,Kern,029,883053,94548,93142,10015,103157,1132
2021-03-12,Kings,031,150075,22552,22233,985,23218,232
2021-03-12,Lake,033,64148,3275,3226,6,3232,43
2021-03-12,Lassen,035,31185,5133,5125,98,5223,1
2021-03-12,Los Angeles,037,10098052,1181944,1170860,38616,1209476,22409
2021-03-12,Madera,039,155013,15912,15761,855,16616,214
2021-03-12,Marin,041,260295,13467,13375,175,13550,218
2021-03-12,Mariposa,043,17540,379,376,5,381,5
2021-03-12,Mendocino,045,87422,3701,3605,74,3679,43
2021-03-12,Merced,047,269075,29149,29064,940,30004,403
2021-03-12,Modoc,049,8938,345,340,117,457,3
2021-03-12,Mono,051,14174,1202,1206,16,1222,3
2021-03-12,Monterey,053,433212,42253,41964,1694,43658,329
2021-03-12,Napa,055,140530,9188,9180,31,9211,75
2021-03-12,Nevada,057,99092,4154,4101,164,4265,66
2021-03-12,Orange,059,3164182,249474,247388,10347,257735,4401
2021-03-12,Placer,061,380077,21094,20210,1162,21372,239
2021-03-12,Plumas,063,18699,654,641,10,651,4
2021-03-12,Riverside,065,2383286,287765,281037,13383,294420,3854
2021-03-12,Sacramento,067,1510023,96585,95061,1311,96372,1460
2021-03-12,San Benito,069,59416,5799,5817,89,5906,61
2021-03-12,San Bernardino,071,2135413,287690,283558,8549,292107,3917
2021-03-12,San Diego,073,3302833,267644,264886,13219,278105,3434
2021-03-12,San Francisco,075,870044,34709,34758,1117,35875,452
2021-03-12,San Joaquin,077,732212,68284,66482,2849,69331,1144
2021-03-12,San Luis Obispo,079,281455,20102,19769,582,20351,247
2021-03-12,San Mateo,081,765935,40109,39638,417,40055,341
2021-03-12,Santa Barbara,083,443738,32857,32457,1051,33508,429
2021-03-12,Santa Clara,085,1922200,112421,112396,608,113004,1766
2021-03-12,Santa Cruz,087,273765,15661,14846,778,15624,195
2021-03-12,Shasta,089,179085,11096,11143,1295,12438,153
2021-03-12,Sierra,091,2930,52,49,12,61,0
2021-03-12,Siskiyou,093,43540,1547,1468,243,1711,5
2021-03-12,Solano,095,438530,30327,30180,377,30557,171
2021-03-12,Sonoma,097,501317,28653,28714,229,28943,285
2021-03-12,Stanislaus,099,539301,51858,51146,5423,56569,701
2021-03-12,Sutter,101,95872,8956,8940,79,9019,101
2021-03-12,Tehama,103,63373,4681,4638,491,5129,33
2021-03-12,Trinity,105,12862,470,306,78,384,3
2021-03-12,Tulare,107,460477,48887,47772,8224,55996,798
2021-03-12,Tuolumne,109,53932,3883,3936,38,3974,57
2021-03-12,Ventura,111,848112,79055,78698,2788,81486,899
2021-03-12,Yolo,113,214977,13111,13061,156,13217,189
2021-03-12,Yuba,115,75493,5627,5563,87,5650,42
2021-03-11,Alameda,001,1643700,82328,81809,1715,83524,1164
2021-03-11,Alpine,003,1148,83,78,0,78,0
2021-03-11,Amador,005,37829,3504,3498,31,3529,42
2021-03-11,Butte,007,227075,11481,11110,1648,12758,185
2021-03-11,Calaveras,009,45235,1955,1915,11,1926,49
2021-03-11,Colusa,011,21464,1882,1883,270,2153,12
2021-03-11,Contra Costa,013,1133247,64472,63469,1088,64557,728
2021-03-11,Del Norte,015,27424,1075,1027,5,1032,6
2021-03-11,El Dorado,017,186661,9281,9211,609,9820,101
2021-03-11,Fresno,019,978130,98115,97026,7875,104901,1481
2021-03-11,Glenn,021,27897,2290,2255,500,2755,15
2021-03-11,Humboldt,023,135768,3338,3302,24,3326,32
2021-03-11,Imperial,025,180216,27386,27045,2483,29528,675
2021-03-11,Inyo,027,18085,1348,1335,9,1344,35
2021-03-11,Kern,029,883053,94492,93052,9976,103028,1121
2021-03-11,Kings,031,150075,22537,22183,982,23165,230
2021-03-11,Lake,033,64148,3271,3214,6,3220,42
2021-03-11,Lassen,035,31185,5132,5124,98,5222,1
2021-03-11,Los Angeles,037,10098052,1181411,1170111,38585,1208696,22316
2021-03-11,Madera,039,155013,15901,15725,853,16578,214
2021-03-11,Marin,041,260295,13455,13356,174,13530,217
2021-03-11,Mariposa,043,17540,379,376,5,381,5
2021-03-11,Mendocino,045,87422,3694,3604,74,3678,42
2021-03-11,Merced,047,269075,29101,29001,939,29940,401
2021-03-11,Modoc,049,8938,345,340,117,457,3
2021-03-11,Mono,051,14174,1201,1206,16,1222,3
2021-03-11,Monterey,053,433212,42230,41936,1688,43624,329
2021-03-11,Napa,055,140530,9175,9173,31,9204,75
2021-03-11,Nevada,057,99092,4142,4085,162,4247,66
2021-03-11,Orange,059,3164182,249336,247217,10330,257547,4373
2021-03-11,Placer,061,380077,21052,20178,1158,21336,239
2021-03-11,Plumas,063,18699,653,640,10,650,4
2021-03-11,Riverside,065,2383286,287594,280881,13370,294251,3842
2021-03-11,Sacramento,067,1510023,96444,94912,1308,96220,1455
2021-03-11,San Benito,069,59416,5796,5816,89,5905,61
2021-03-11,San Bernardino,071,2135413,287594,283312,8543,291855,3869
2021-03-11,San Diego,073,3302833,267479,264524,13203,277727,3422
2021-03-11,San Francisco,075,870044,34673,34722,1111,35833,452
2021-03-11,San Joaquin,077,732212,68172,66522,2841,69363,1157
2021-03-11,San Luis Obispo,079,281455,20077,19748,581,20329,247
2021-03-11,San Mateo,081,765935,40072,39590,416,40006,341
2021-03-11,Santa Barbara,083,443738,32829,32408,1046,33454,430
2021-03-11,Santa Clara,085,1922200,112292,112246,605,112851,1765
2021-03-11,Santa Cruz,087,273765,15649,14812,777,15589,193
2021-03-11,Shasta,089,179085,11086,11139,1290,12429,158
2021-03-11,Sierra,091,2930,52,48,12,60,0
2021-03-11,Siskiyou,093,43540,1544,1466,242,1708,5
2021-03-11,Solano,095,438530,30299,30138,376,30514,171
2021-03-11,Sonoma,097,501317,28624,28677,229,28906,285
2021-03-11,Stanislaus,099,539301,51773,51038,5415,56453,707
2021-03-11,Sutter,101,95872,8950,8933,79,9012,101
2021-03-11,Tehama,103,63373,4673,4632,491,5123,33
2021-03-11,Trinity,105,12862,469,304,77,381,3
2021-03-11,Tulare,107,460477,48850,47709,8213,55922,797
2021-03-11,Tuolumne,109,53932,3881,3934,38,3972,57
2021-03-11,Ventura,111,848112,79005,78697,2784,81481,889
2021-03-11,Yolo,113,214977,13093,13041,155,13196,190
2021-03-11,Yuba,115,75493,5623,5553,87,5640,42
2021-03-10,Alameda,001,1643700,82222,81701,1710,83411,1160
2021-03-10,Alpine,003,1148,82,78,0,78,0
2021-03-10,Amador,005,37829,3502,3496,31,3527,42
2021-03-10,Butte,007,227075,11471,11096,1648,12744,185
2021-03-10,Calaveras,009,45235,1949,1913,11,1924,48
2021-03-10,Colusa,011,21464,1882,1882,270,2152,12
2021-03-10,Contra Costa,013,1133247,64372,63372,1084,64456,725
2021-03-10,Del Norte,015,27424,1073,1020,5,1025,5
2021-03-10,El Dorado,017,186661,9268,9203,609,9812,100
2021-03-10,Fresno,019,978130,98008,96866,7859,104725,1471
2021-03-10,Glenn,021,27897,2287,2253,498,2751,15
2021-03-10,Humboldt,023,135768,3328,3296,23,3319,32
2021-03-10,Imperial,025,180216,27371,27051,2483,29534,675
2021-03-10,Inyo,027,18085,1348,1328,9,1337,35
2021-03-10,Kern,029,883053,94426,92965,9955,102920,1102
2021-03-10,Kings,031,150075,22518,22166,981,23147,226
2021-03-10,Lake,033,64148,3261,3207,6,3213,42
2021-03-10,Lassen,035,31185,5132,5120,98,5218,1
2021-03-10,Los Angeles,037,10098052,1180864,1169079,38560,1207639,22199
2021-03-10,Madera,039,155013,15880,15705,850,16555,212
2021-03-10,Marin,041,260295,13445,13348,173,13521,216
2021-03-10,Mariposa,043,17540,379,376,5,381,5
2021-03-10,Mendocino,045,87422,3689,3602,74,3676,42
2021-03-10,Merced,047,269075,29063,28927,936,29863,401
2021-03-10,Modoc,049,8938,344,338,117,455,3
2021-03-10,Mono,051,14174,1197,1204,16,1220,3
2021-03-10,Monterey,053,433212,42208,41920,1684,43604,329
2021-03-10,Napa,055,140530,9166,9165,31,9196,75
2021-03-10,Nevada,057,99092,4138,4074,162,4236,66
2021-03-10,Orange,059,3164182,249187,247075,10315,257390,4342
2021-03-10,Placer,061,380077,21018,20144,1152,21296,239
2021-03-10,Plumas,063,18699,652,639,10,649,4
2021-03-10,Riverside,065,2383286,287453,280708,13356,294064,3822
2021-03-10,Sacramento,067,1510023,96314,94796,1302,96098,1452
2021-03-10,San Benito,069,59416,5787,5811,89,5900,61
2021-03-10,San Bernardino,071,2135413,287501,283140,8537,291677,3841
2021-03-10,San Diego,073,3302833,267257,264094,13191,277285,3413
2021-03-10,San Francisco,075,870044,34638,34688,1103,35791,450
2021-03-10,San Joaquin,077,732212,68070,66483,2824,69307,1156
2021-03-10,San Luis Obispo,079,281455,20053,19710,577,20287,247
2021-03-10,San Mateo,081,765935,40048,39571,416,39987,338
2021-03-10,Santa Barbara,083,443738,32802,32356,1043,33399,429
2021-03-10,Santa Clara,085,1922200,112183,112103,601,112704,1759
2021-03-10,Santa Cruz,087,273765,15634,14790,776,15566,192
2021-03-10,Shasta,089,179085,11076,11125,1287,12412,155
2021-03-10,Sierra,091,2930,52,48,12,60,0
2021-03-10,Siskiyou,093,43540,1542,1458,242,1700,5
2021-03-10,Solano,095,438530,30269,30111,375,30486,170
2021-03-10,Sonoma,097,501317,28589,28638,228,28866,286
2021-03-10,Stanislaus,099,539301,51686,50968,5396,56364,706
2021-03-10,Sutter,101,95872,8939,8918,79,8997,101
2021-03-10,Tehama,103,63373,4662,4623,490,5113,33
2021-03-10,Trinity,105,12862,469,304,77,381,3
2021-03-10,Tulare,107,460477,48802,47659,8195,55854,793
2021-03-10,Tuolumne,109,53932,3880,3931,38,3969,57
2021-03-10,Ventura,111,848112,78928,78609,2782,81391,878
2021-03-10,Yolo,113,214977,13069,13021,155,13176,189
2021-03-10,Yuba,115,75493,5610,5545,86,5631,42
2021-03-09,Alameda,001,1643700,82135,81618,1710,83328,1151
2021-03-09,Alpine,003,1148,82,78,0,78,0
2021-03-09,Amador,005,37829,3500,3494,31,3525,42
2021-03-09,Butte,007,227075,11458,11092,1647,12739,185
2021-03-09,Calaveras,009,45235,1947,1913,11,1924,48
2021-03-09,Colusa,011,21464,1882,1880,270,2150,11
2021-03-09,Contra Costa,013,1133247,64282,63314,1082,64396,723
2021-03-09,Del Norte,015,27424,1065,1017,5,1022,5
2021-03-09,El Dorado,017,186661,9260,9198,609,9807,98
2021-03-09,Fresno,019,978130,97889,96744,7833,104577,1463
2021-03-09,Glenn,021,27897,2283,2251,496,2747,15
2021-03-09,Humboldt,023,135768,3316,3288,22,3310,32
2021-03-09,Imperial,025,180216,27361,27045,2479,29524,675
2021-03-09,Inyo,027,18085,1346,1324,9,1333,35
2021-03-09,Kern,029,883053,94347,92924,9937,102861,1088
2021-03-09,Kings,031,150075,22493,22143,979,23122,226
2021-03-09,Lake,033,64148,3255,3202,6,3208,42
2021-03-09,Lassen,035,31185,5132,5120,98,5218,1
2021-03-09,Los Angeles,037,10098052,1180267,1167967,38527,1206494,22080
2021-03-09,Madera,039,155013,15869,15701,848,16549,211
2021-03-09,Marin,041,260295,13427,13335,171,13506,214
2021-03-09,Mariposa,043,17540,379,376,5,381,5
2021-03-09,Mendocino,045,87422,3685,3595,74,3669,42
2021-03-09,Merced,047,269075,29003,28876,933,29809,399
2021-03-09,Modoc,049,8938,344,338,116,454,3
2021-03-09,Mono,051,14174,1196,1203,16,1219,3
2021-03-09,Monterey,053,433212,42189,41894,1676,43570,329
2021-03-09,Napa,055,140530,9152,9155,31,9186,75
2021-03-09,Nevada,057,99092,4130,4062,162,4224,66
2021-03-09,Orange,059,3164182,249045,246989,10296,257285,4310
2021-03-09,Placer,061,380077,20976,20122,1147,21269,239
2021-03-09,Plumas,063,18699,649,639,10,649,4
2021-03-09,Riverside,065,2383286,287320,280562,13352,293914,3821
2021-03-09,Sacramento,067,1510023,96147,94720,1296,96016,1442
2021-03-09,San Benito,069,59416,5783,5800,89,5889,61
2021-03-09,San Bernardino,071,2135413,287386,282971,8531,291502,3823
2021-03-09,San Diego,073,3302833,267025,263745,13170,276915,3405
2021-03-09,San Francisco,075,870044,34607,34654,1099,35753,450
2021-03-09,San Joaquin,077,732212,67943,66383,2814,69197,1150
2021-03-09,San Luis Obispo,079,281455,20036,19672,570,20242,245
2021-03-09,San Mateo,081,765935,40000,39535,414,39949,336
2021-03-09,Santa Barbara,083,443738,32761,32314,1041,33355,428
2021-03-09,Santa Clara,085,1922200,112072,111963,596,112559,1756
2021-03-09,Santa Cruz,087,273765,15612,14764,775,15539,188
2021-03-09,Shasta,089,179085,11069,11113,1282,12395,155
2021-03-09,Sierra,091,2930,52,48,12,60,0
2021-03-09,Siskiyou,093,43540,1538,1447,240,1687,5
2021-03-09,Solano,095,438530,30233,30090,373,30463,169
2021-03-09,Sonoma,097,501317,28539,28601,225,28826,284
2021-03-09,Stanislaus,099,539301,51588,50884,5387,56271,703
2021-03-09,Sutter,101,95872,8926,8914,79,8993,101
2021-03-09,Tehama,103,63373,4657,4620,490,5110,33
2021-03-09,Trinity,105,12862,469,304,77,381,3
2021-03-09,Tulare,107,460477,48775,47637,8176,55813,792
2021-03-09,Tuolumne,109,53932,3878,3929,38,3967,56
2021-03-09,Ventura,111,848112,78865,78526,2780,81306,863
2021-03-09,Yolo,113,214977,13057,13015,153,13168,189
2021-03-09,Yuba,115,75493,5603,5539,86,5625,42
2021-03-08,Alameda,001,1643700,82024,81543,1709,83252,1142
2021-03-08,Alpine,003,1148,82,78,0,78,0
2021-03-08,Amador,005,37829,3497,3490,31,3521,42
2021-03-08,Butte,007,227075,11445,11082,1646,12728,185
2021-03-08,Calaveras,009,45235,1943,1909,11,1920,48
2021-03-08,Colusa,011,21464,1882,1877,270,2147,11
2021-03-08,Contra Costa,013,1133247,64186,63240,1082,64322,719
2021-03-08,Del Norte,015,27424,1060,1012,5,1017,5
2021-03-08,El Dorado,017,186661,9257,9188,608,9796,97
2021-03-08,Fresno,019,978130,97791,96665,7812,104477,1442
2021-03-08,Glenn,021,27897,2282,2249,496,2745,15
2021-03-08,Humboldt,023,135768,3302,3278,22,3300,31
2021-03-08,Imperial,025,180216,27353,27033,2476,29509,663
2021-03-08,Inyo,027,18085,1344,1320,9,1329,35
2021-03-08,Kern,029,883053,94281,92857,9917,102774,1087
2021-03-08,Kings,031,150075,22472,22130,977,23107,226
2021-03-08,Lake,033,64148,3243,3195,6,3201,42
2021-03-08,Lassen,035,31185,5132,5119,98,5217,1
2021-03-08,Los Angeles,037,10098052,1179646,1163409,38496,1201905,21868
2021-03-08,Madera,039,155013,15859,15691,846,16537,211
2021-03-08,Marin,041,260295,13407,13328,169,13497,214
2021-03-08,Mariposa,043,17540,379,376,5,381,5
2021-03-08,Mendocino,045,87422,3683,3590,73,3663,42
2021-03-08,Merced,047,269075,28943,28841,932,29773,398
2021-03-08,Modoc,049,8938,344,338,116,454,3
2021-03-08,Mono,051,14174,1195,1200,16,1216,3
2021-03-08,Monterey,053,433212,42168,41863,1675,43538,328
2021-03-08,Napa,055,140530,9149,9146,31,9177,75
2021-03-08,Nevada,057,99092,4122,4059,162,4221,66
2021-03-08,Orange,059,3164182,248872,246900,10265,257165,4243
2021-03-08,Placer,061,380077,20941,20102,1136,21238,239
2021-03-08,Plumas,063,18699,648,635,10,645,4
2021-03-08,Riverside,065,2383286,287168,280463,13342,293805,3783
2021-03-08,Sacramento,067,1510023,95978,94654,1291,95945,1438
2021-03-08,San Benito,069,59416,5780,5797,89,5886,61
2021-03-08,San Bernardino,071,2135413,287275,282894,8524,291418,3811
2021-03-08,San Diego,073,3302833,266784,263272,13155,276427,3390
2021-03-08,San Francisco,075,870044,34581,34634,1095,35729,446
2021-03-08,San Joaquin,077,732212,67827,66307,2805,69112,1139
2021-03-08,San Luis Obispo,079,281455,19993,19656,567,20223,245
2021-03-08,San Mateo,081,765935,39951,39492,412,39904,335
2021-03-08,Santa Barbara,083,443738,32729,32293,1041,33334,427
2021-03-08,Santa Clara,085,1922200,111944,111882,594,112476,1756
2021-03-08,Santa Cruz,087,273765,15592,14729,775,15504,188
2021-03-08,Shasta,089,179085,11061,11088,1277,12365,155
2021-03-08,Sierra,091,2930,52,48,12,60,0
2021-03-08,Siskiyou,093,43540,1537,1440,240,1680,5
2021-03-08,Solano,095,438530,30193,30068,371,30439,169
2021-03-08,Sonoma,097,501317,28495,28571,224,28795,284
2021-03-08,Stanislaus,099,539301,51509,50825,5382,56207,690
2021-03-08,Sutter,101,95872,8923,8905,79,8984,100
2021-03-08,Tehama,103,63373,4653,4615,490,5105,33
2021-03-08,Trinity,105,12862,468,302,77,379,3
2021-03-08,Tulare,107,460477,48734,47587,8151,55738,791
2021-03-08,Tuolumne,109,53932,3877,3921,38,3959,56
2021-03-08,Ventura,111,848112,78792,78526,2772,81298,852
2021-03-08,Yolo,113,214977,13034,13000,153,13153,189
2021-03-08,Yuba,115,75493,5593,5530,86,5616,42
2021-03-07,Alameda,001,1643700,81904,81413,1708,83121,1145
2021-03-07,Alpine,003,1148,82,78,0,78,0
2021-03-07,Amador,005,37829,3494,3489,31,3520,42
2021-03-07,Butte,007,227075,11429,11075,1645,12720,185
2021-03-07,Calaveras,009,45235,1939,1906,11,1917,48
2021-03-07,Colusa,011,21464,1882,1876,270,2146,11
2021-03-07,Contra Costa,013,1133247,64087,63148,1080,64228,719
2021-03-07,Del Norte,015,27424,1055,1010,5,1015,5
2021-03-07,El Dorado,017,186661,9254,9184,607,9791,97
2021-03-07,Fresno,019,978130,97613,96549,7790,104339,1442
2021-03-07,Glenn,021,27897,2280,2244,496,2740,15
2021-03-07,Humboldt,023,135768,3292,3274,22,3296,31
2021-03-07,Imperial,025,180216,27344,27019,2474,29493,658
2021-03-07,Inyo,027,18085,1341,1320,9,1329,35
2021-03-07,Kern,029,883053,94194,92746,9887,102633,1086
2021-03-07,Kings,031,150075,22450,22103,977,23080,224
2021-03-07,Lake,033,64148,3237,3192,6,3198,42
2021-03-07,Lassen,035,31185,5131,5119,98,5217,1
2021-03-07,Los Angeles,037,10098052,1178919,1162749,38463,1201212,21857
2021-03-07,Madera,039,155013,15840,15675,846,16521,211
2021-03-07,Marin,041,260295,13399,13313,167,13480,214
2021-03-07,Mariposa,043,17540,378,376,5,381,5
2021-03-07,Mendocino,045,87422,3679,3581,73,3654,42
2021-03-07,Merced,047,269075,28869,28829,928,29757,399
2021-03-07,Modoc,049,8938,344,338,116,454,3
2021-03-07,Mono,051,14174,1193,1199,16,1215,3
2021-03-07,Monterey,053,433212,42147,41858,1672,43530,328
2021-03-07,Napa,055,140530,9139,9137,31,9168,75
2021-03-07,Nevada,057,99092,4108,4052,161,4213,66
2021-03-07,Orange,059,3164182,248680,246771,10238,257009,4218
2021-03-07,Placer,061,380077,20900,20070,1132,21202,239
2021-03-07,Plumas,063,18699,647,635,10,645,4
2021-03-07,Riverside,065,2383286,287020,280379,13333,293712,3779
2021-03-07,Sacramento,067,1510023,95801,94513,1285,95798,1437
2021-03-07,San Benito,069,59416,5773,5795,89,5884,61
2021-03-07,San Bernardino,071,2135413,287124,282860,8519,291379,3810
2021-03-07,San Diego,073,3302833,266502,262965,13131,276096,3390
2021-03-07,San Francisco,075,870044,34547,34594,1090,35684,445
2021-03-07,San Joaquin,077,732212,67691,66252,2792,69044,1139
2021-03-07,San Luis Obispo,079,281455,19956,19614,565,20179,245
2021-03-07,San Mateo,081,765935,39911,39436,409,39845,329
2021-03-07,Santa Barbara,083,443738,32683,32218,1040,33258,425
2021-03-07,Santa Clara,085,1922200,111799,111745,590,112335,1752
2021-03-07,Santa Cruz,087,273765,15570,14715,774,15489,189
2021-03-07,Shasta,089,179085,11048,11083,1269,12352,156
2021-03-07,Sierra,091,2930,51,48,12,60,0
2021-03-07,Siskiyou,093,43540,1536,1435,236,1671,5
2021-03-07,Solano,095,438530,30156,30027,371,30398,169
2021-03-07,Sonoma,097,501317,28446,28533,222,28755,284
2021-03-07,Stanislaus,099,539301,51377,50783,5366,56149,699
2021-03-07,Sutter,101,95872,8913,8900,79,8979,100
2021-03-07,Tehama,103,63373,4646,4614,489,5103,33
2021-03-07,Trinity,105,12862,468,302,77,379,3
2021-03-07,Tulare,107,460477,48675,47569,8120,55689,790
2021-03-07,Tuolumne,109,53932,3876,3922,37,3959,56
2021-03-07,Ventura,111,848112,78700,78487,2770,81257,851
2021-03-07,Yolo,113,214977,13015,12988,153,13141,189
2021-03-07,Yuba,115,75493,5588,5516,86,5602,42
2021-03-06,Alameda,001,1643700,81847,81310,1707,83017,1143
2021-03-06,Alpine,003,1148,82,78,0,78,0
2021-03-06,Amador,005,37829,3490,3487,31,3518,42
2021-03-06,Butte,007,227075,11424,11065,1644,12709,185
2021-03-06,Calaveras,009,45235,1935,1904,11,1915,48
2021-03-06,Colusa,011,21464,1880,1874,270,2144,11
2021-03-06,Contra Costa,013,1133247,64025,63040,1076,64116,719
2021-03-06,Del Norte,015,27424,1050,1000,5,1005,5
2021-03-06,El Dorado,017,186661,9250,9166,607,9773,97
2021-03-06,Fresno,019,978130,97517,96366,7779,104145,1440
2021-03-06,Glenn,021,27897,2280,2241,496,2737,15
2021-03-06,Humboldt,023,135768,3282,3260,22,3282,31
2021-03-06,Imperial,025,180216,27339,27009,2469,29478,658
2021-03-06,Inyo,027,18085,1338,1312,9,1321,35
2021-03-06,Kern,029,883053,94148,92684,9867,102551,1082
2021-03-06,Kings,031,150075,22435,22094,977,23071,224
2021-03-06,Lake,033,64148,3235,3189,6,3195,42
2021-03-06,Lassen,035,31185,5131,5119,98,5217,1
2021-03-06,Los Angeles,037,10098052,1178479,1161745,38435,1200180,21843
2021-03-06,Madera,039,155013,15831,15646,845,16491,211
2021-03-06,Marin,041,260295,13390,13289,167,13456,213
2021-03-06,Mariposa,043,17540,378,376,5,381,5
2021-03-06,Mendocino,045,87422,3677,3579,73,3652,42
2021-03-06,Merced,047,269075,28826,28771,928,29699,399
2021-03-06,Modoc,049,8938,343,338,116,454,3
2021-03-06,Mono,051,14174,1192,1198,16,1214,3
2021-03-06,Monterey,053,433212,42142,41838,1669,43507,327
2021-03-06,Napa,055,140530,9131,9129,31,9160,75
2021-03-06,Nevada,057,99092,4102,4044,161,4205,66
2021-03-06,Orange,059,3164182,248589,246634,10224,256858,4165
2021-03-06,Placer,061,380077,20877,20030,1130,21160,239
2021-03-06,Plumas,063,18699,647,634,10,644,4
2021-03-06,Riverside,065,2383286,286926,280225,13325,293550,3781
2021-03-06,Sacramento,067,1510023,95713,94332,1276,95608,1436
2021-03-06,San Benito,069,59416,5768,5793,89,5882,61
2021-03-06,San Bernardino,071,2135413,287040,282737,8517,291254,3791
2021-03-06,San Diego,073,3302833,266315,262778,13114,275892,3385
2021-03-06,San Francisco,075,870044,34515,34560,1086,35646,435
2021-03-06,San Joaquin,077,732212,67617,66162,2782,68944,1138
2021-03-06,San Luis Obispo,079,281455,19936,19592,563,20155,245
2021-03-06,San Mateo,081,765935,39886,39384,409,39793,329
2021-03-06,Santa Barbara,083,443738,32653,32176,1040,33216,424
2021-03-06,Santa Clara,085,1922200,111704,111570,587,112157,1749
2021-03-06,Santa Cruz,087,273765,15559,14701,774,15475,188
2021-03-06,Shasta,089,179085,11039,11076,1267,12343,158
2021-03-06,Sierra,091,2930,51,48,12,60,0
2021-03-06,Siskiyou,093,43540,1534,1432,236,1668,5
2021-03-06,Solano,095,438530,30127,30000,370,30370,169
2021-03-06,Sonoma,097,501317,28423,28484,220,28704,284
2021-03-06,Stanislaus,099,539301,51307,50691,5360,56051,711
2021-03-06,Sutter,101,95872,8907,8887,79,8966,100
2021-03-06,Tehama,103,63373,4644,4610,486,5096,33
2021-03-06,Trinity,105,12862,468,302,77,379,3
2021-03-06,Tulare,107,460477,48643,47515,8092,55607,789
2021-03-06,Tuolumne,109,53932,3874,3920,37,3957,56
2021-03-06,Ventura,111,848112,78644,78439,2769,81208,848
2021-03-06,Yolo,113,214977,13009,12951,152,13103,189
2021-03-06,Yuba,115,75493,5579,5504,86,5590,42
2021-03-05,Alameda,001,1643700,81761,81215,1706,82921,1141
2021-03-05,Alpine,003,1148,82,78,0,78,0
2021-03-05,Amador,005,37829,3489,3484,31,3515,42
2021-03-05,Butte,007,227075,11413,11050,1643,12693,185
2021-03-05,Calaveras,009,45235,1932,1902,11,1913,48
2021-03-05,Colusa,011,21464,1880,1874,270,2144,11
2021-03-05,Contra Costa,013,1133247,63945,62886,1073,63959,711
2021-03-05,Del Norte,015,27424,1046,995,5,1000,5
2021-03-05,El Dorado,017,186661,9245,9150,606,9756,97
2021-03-05,Fresno,019,978130,97409,96184,7760,103944,1432
2021-03-05,Glenn,021,27897,2277,2241,495,2736,15
2021-03-05,Humboldt,023,135768,3274,3234,22,3256,31
2021-03-05,Imperial,025,180216,27329,26970,2460,29430,651
2021-03-05,Inyo,027,18085,1334,1309,9,1318,35
2021-03-05,Kern,029,883053,94107,92601,9854,102455,1076
2021-03-05,Kings,031,150075,22417,22063,976,23039,224
2021-03-05,Lake,033,64148,3233,3185,6,3191,42
2021-03-05,Lassen,035,31185,5131,5117,96,5213,1
2021-03-05,Los Angeles,037,10098052,1177988,1160688,38406,1199094,21745
2021-03-05,Madera,039,155013,15821,15624,843,16467,211
2021-03-05,Marin,041,260295,13378,13275,166,13441,215
2021-03-05,Mariposa,043,17540,378,375,5,380,4
2021-03-05,Mendocino,045,87422,3674,3577,73,3650,42
2021-03-05,Merced,047,269075,28793,28734,927,29661,399
2021-03-05,Modoc,049,8938,343,337,116,453,3
2021-03-05,Mono,051,14174,1191,1197,16,1213,3
2021-03-05,Monterey,053,433212,42129,41802,1669,43471,325
2021-03-05,Napa,055,140530,9123,9109,31,9140,75
2021-03-05,Nevada,057,99092,4099,4033,161,4194,66
2021-03-05,Orange,059,3164182,248476,246489,10211,256700,4108
2021-03-05,Placer,061,380077,20851,19973,1126,21099,239
2021-03-05,Plumas,063,18699,647,635,10,645,4
2021-03-05,Riverside,065,2383286,286815,280075,13320,293395,3781
2021-03-05,Sacramento,067,1510023,95617,94182,1269,95451,1430
2021-03-05,San Benito,069,59416,5765,5790,89,5879,61
2021-03-05,San Bernardino,071,2135413,286947,282640,8513,291153,3774
2021-03-05,San Diego,073,3302833,266082,262357,13097,275454,3371
2021-03-05,San Francisco,075,870044,34475,34526,1082,35608,430
2021-03-05,San Joaquin,077,732212,67538,66041,2773,68814,1133
2021-03-05,San Luis Obispo,079,281455,19915,19557,561,20118,244
2021-03-05,San Mateo,081,765935,39854,39305,409,39714,326
2021-03-05,Santa Barbara,083,443738,32616,32139,1035,33174,424
2021-03-05,Santa Clara,085,1922200,111609,111384,587,111971,1745
2021-03-05,Santa Cruz,087,273765,15548,14694,774,15468,188
2021-03-05,Shasta,089,179085,11027,11062,1261,12323,148
2021-03-05,Sierra,091,2930,51,48,12,60,0
2021-03-05,Siskiyou,093,43540,1529,1429,235,1664,5
2021-03-05,Solano,095,438530,30110,29951,368,30319,168
2021-03-05,Sonoma,097,501317,28397,28417,220,28637,279
2021-03-05,Stanislaus,099,539301,51256,50606,5350,55956,721
2021-03-05,Sutter,101,95872,8900,8876,79,8955,100
2021-03-05,Tehama,103,63373,4635,4606,486,5092,33
2021-03-05,Trinity,105,12862,468,302,77,379,3
2021-03-05,Tulare,107,460477,48614,47469,8073,55542,789
2021-03-05,Tuolumne,109,53932,3872,3917,37,3954,56
2021-03-05,Ventura,111,848112,78577,78368,2768,81136,839
2021-03-05,Yolo,113,214977,12997,12920,151,13071,188
2021-03-05,Yuba,115,75493,5567,5496,86,5582,42
2021-03-04,Alameda,001,1643700,81652,81115,1705,82820,1136
2021-03-04,Alpine,003,1148,82,78,0,78,0
2021-03-04,Amador,005,37829,3488,3480,31,3511,42
2021-03-04,Butte,007,227075,11406,11033,1642,12675,185
2021-03-04,Calaveras,009,45235,1931,1896,11,1907,48
2021-03-04,Colusa,011,21464,1878,1873,265,2138,11
2021-03-04,Contra Costa,013,1133247,63845,62789,1071,63860,708
2021-03-04,Del Norte,015,27424,1038,989,5,994,5
2021-03-04,El Dorado,017,186661,9230,9133,606,9739,97
2021-03-04,Fresno,019,978130,97245,96023,7741,103764,1422
2021-03-04,Glenn,021,27897,2270,2236,494,2730,15
2021-03-04,Humboldt,023,135768,3260,3212,22,3234,31
2021-03-04,Imperial,025,180216,27316,26946,2457,29403,646
2021-03-04,Inyo,027,18085,1331,1300,9,1309,35
2021-03-04,Kern,029,883053,94018,92525,9835,102360,1070
2021-03-04,Kings,031,150075,22391,22025,973,22998,224
2021-03-04,Lake,033,64148,3225,3181,6,3187,42
2021-03-04,Lassen,035,31185,5131,5116,96,5212,1
2021-03-04,Los Angeles,037,10098052,1177376,1159405,38356,1197761,21610
2021-03-04,Madera,039,155013,15786,15596,840,16436,208
2021-03-04,Marin,041,260295,13362,13240,163,13403,215
2021-03-04,Mariposa,043,17540,378,376,5,381,4
2021-03-04,Mendocino,045,87422,3671,3569,73,3642,42
2021-03-04,Merced,047,269075,28742,28671,925,29596,396
2021-03-04,Modoc,049,8938,342,336,116,452,3
2021-03-04,Mono,051,14174,1191,1197,16,1213,3
2021-03-04,Monterey,053,433212,42109,41771,1667,43438,325
2021-03-04,Napa,055,140530,9115,9094,31,9125,74
2021-03-04,Nevada,057,99092,4089,4020,161,4181,66
2021-03-04,Orange,059,3164182,248319,246354,10194,256548,4096
2021-03-04,Placer,061,380077,20819,19900,1120,21020,239
2021-03-04,Plumas,063,18699,647,634,10,644,4
2021-03-04,Riverside,065,2383286,286685,279871,13307,293178,3766
2021-03-04,Sacramento,067,1510023,95482,93982,1266,95248,1426
2021-03-04,San Benito,069,59416,5765,5781,89,5870,61
2021-03-04,San Bernardino,071,2135413,286816,282407,8509,290916,3757
2021-03-04,San Diego,073,3302833,265821,261858,13053,274911,3359
2021-03-04,San Francisco,075,870044,34440,34480,1079,35559,426
2021-03-04,San Joaquin,077,732212,67444,65931,2764,68695,1129
2021-03-04,San Luis Obispo,079,281455,19878,19520,559,20079,243
2021-03-04,San Mateo,081,765935,39810,39225,408,39633,322
2021-03-04,Santa Barbara,083,443738,32579,32090,1034,33124,423
2021-03-04,Santa Clara,085,1922200,111475,111194,585,111779,1723
2021-03-04,Santa Cruz,087,273765,15529,14669,774,15443,186
2021-03-04,Shasta,089,179085,11024,11050,1252,12302,150
2021-03-04,Sierra,091,2930,51,48,12,60,0
2021-03-04,Siskiyou,093,43540,1522,1427,235,1662,5
2021-03-04,Solano,095,438530,30083,29905,367,30272,168
2021-03-04,Sonoma,097,501317,28342,28379,219,28598,279
2021-03-04,Stanislaus,099,539301,51169,50521,5342,55863,731
2021-03-04,Sutter,101,95872,8888,8849,79,8928,100
2021-03-04,Tehama,103,63373,4627,4604,486,5090,33
2021-03-04,Trinity,105,12862,468,302,77,379,3
2021-03-04,Tulare,107,460477,48569,47398,8048,55446,784
2021-03-04,Tuolumne,109,53932,3866,3916,37,3953,56
2021-03-04,Ventura,111,848112,78487,78184,2765,80949,831
2021-03-04,Yolo,113,214977,12977,12895,151,13046,189
2021-03-04,Yuba,115,75493,5555,5483,86,5569,41
2021-03-03,Alameda,001,1643700,81532,80972,1704,82676,1127
2021-03-03,Alpine,003,1148,82,77,0,77,0
2021-03-03,Amador,005,37829,3486,3478,30,3508,42
2021-03-03,Butte,007,227075,11398,11014,1641,12655,184
2021-03-03,Calaveras,009,45235,1930,1893,11,1904,48
2021-03-03,Colusa,011,21464,1877,1873,265,2138,11
2021-03-03,Contra Costa,013,1133247,63747,62668,1068,63736,708
2021-03-03,Del Norte,015,27424,1035,988,5,993,5
2021-03-03,El Dorado,017,186661,9220,9121,606,9727,97
2021-03-03,Fresno,019,978130,97101,95893,7724,103617,1415
2021-03-03,Glenn,021,27897,2270,2233,494,2727,15
2021-03-03,Humboldt,023,135768,3249,3196,22,3218,30
2021-03-03,Imperial,025,180216,27300,26939,2453,29392,640
2021-03-03,Inyo,027,18085,1323,1294,9,1303,35
2021-03-03,Kern,029,883053,93942,92434,9818,102252,1063
2021-03-03,Kings,031,150075,22375,22009,972,22981,223
2021-03-03,Lake,033,64148,3218,3175,6,3181,40
2021-03-03,Lassen,035,31185,5131,5115,96,5211,1
2021-03-03,Los Angeles,037,10098052,1176737,1157911,38317,1196228,21500
2021-03-03,Madera,039,155013,15767,15553,834,16387,203
2021-03-03,Marin,041,260295,13348,13216,163,13379,214
2021-03-03,Mariposa,043,17540,377,376,5,381,4
2021-03-03,Mendocino,045,87422,3663,3564,73,3637,42
2021-03-03,Merced,047,269075,28690,28625,925,29550,393
2021-03-03,Modoc,049,8938,342,333,115,448,3
2021-03-03,Mono,051,14174,1191,1191,16,1207,3
2021-03-03,Monterey,053,433212,42077,41731,1664,43395,325
2021-03-03,Napa,055,140530,9107,9090,31,9121,72
2021-03-03,Nevada,057,99092,4079,4009,161,4170,66
2021-03-03,Orange,059,3164182,248174,246120,10180,256300,4072
2021-03-03,Placer,061,380077,20793,19851,1117,20968,239
2021-03-03,Plumas,063,18699,646,631,10,641,4
2021-03-03,Riverside,065,2383286,286552,279626,13301,292927,3735
2021-03-03,Sacramento,067,1510023,95321,93819,1258,95077,1419
2021-03-03,San Benito,069,59416,5764,5774,89,5863,61
2021-03-03,San Bernardino,071,2135413,286675,282138,8503,290641,3664
2021-03-03,San Diego,073,3302833,265557,261350,13022,274372,3342
2021-03-03,San Francisco,075,870044,34408,34443,1076,35519,426
2021-03-03,San Joaquin,077,732212,67331,65855,2757,68612,1115
2021-03-03,San Luis Obispo,079,281455,19852,19479,556,20035,241
2021-03-03,San Mateo,081,765935,39764,39189,407,39596,319
2021-03-03,Santa Barbara,083,443738,32541,32027,1034,33061,421
2021-03-03,Santa Clara,085,1922200,111321,110991,583,111574,1720
2021-03-03,Santa Cruz,087,273765,15518,14645,774,15419,185
2021-03-03,Shasta,089,179085,11014,11023,1245,12268,150
2021-03-03,Sierra,091,2930,51,48,12,60,0
2021-03-03,Siskiyou,093,43540,1520,1424,235,1659,5
2021-03-03,Solano,095,438530,30047,29866,366,30232,167
2021-03-03,Sonoma,097,501317,28303,28307,218,28525,279
2021-03-03,Stanislaus,099,539301,51091,50438,5335,55773,730
2021-03-03,Sutter,101,95872,8880,8840,79,8919,99
2021-03-03,Tehama,103,63373,4625,4601,486,5087,32
2021-03-03,Trinity,105,12862,468,302,77,379,3
2021-03-03,Tulare,107,460477,48518,47348,8019,55367,778
2021-03-03,Tuolumne,109,53932,3864,3914,36,3950,56
2021-03-03,Ventura,111,848112,78403,78057,2760,80817,822
2021-03-03,Yolo,113,214977,12964,12890,151,13041,189
2021-03-03,Yuba,115,75493,5542,5479,86,5565,41
2021-03-02,Alameda,001,1643700,81410,80904,1702,82606,1116
2021-03-02,Alpine,003,1148,82,77,0,77,0
2021-03-02,Amador,005,37829,3484,3474,30,3504,42
2021-03-02,Butte,007,227075,11388,11007,1638,12645,182
2021-03-02,Calaveras,009,45235,1922,1890,11,1901,48
2021-03-02,Colusa,011,21464,1877,1872,264,2136,11
2021-03-02,Contra Costa,013,1133247,63636,62557,1064,63621,694
2021-03-02,Del Norte,015,27424,1028,983,5,988,5
2021-03-02,El Dorado,017,186661,9212,9116,606,9722,98
2021-03-02,Fresno,019,978130,96955,95785,7698,103483,1410
2021-03-02,Glenn,021,27897,2264,2232,493,2725,15
2021-03-02,Humboldt,023,135768,3230,3184,22,3206,30
2021-03-02,Imperial,025,180216,27290,26926,2451,29377,637
2021-03-02,Inyo,027,18085,1319,1292,9,1301,35
2021-03-02,Kern,029,883053,93836,92313,9791,102104,1046
2021-03-02,Kings,031,150075,22323,21999,969,22968,217
2021-03-02,Lake,033,64148,3212,3169,6,3175,40
2021-03-02,Lassen,035,31185,5126,5115,95,5210,1
2021-03-02,Los Angeles,037,10098052,1176101,1156826,38272,1195098,21395
2021-03-02,Madera,039,155013,15747,15523,831,16354,194
2021-03-02,Marin,041,260295,13325,13186,162,13348,214
2021-03-02,Mariposa,043,17540,377,376,5,381,4
2021-03-02,Mendocino,045,87422,3660,3562,72,3634,41
2021-03-02,Merced,047,269075,28633,28598,925,29523,389
2021-03-02,Modoc,049,8938,342,332,115,447,3
2021-03-02,Mono,051,14174,1190,1191,16,1207,3
2021-03-02,Monterey,053,433212,42050,41716,1664,43380,325
2021-03-02,Napa,055,140530,9096,9080,31,9111,71
2021-03-02,Nevada,057,99092,4070,3983,160,4143,66
2021-03-02,Orange,059,3164182,248029,246004,10162,256166,4037
2021-03-02,Placer,061,380077,20740,19828,1114,20942,239
2021-03-02,Plumas,063,18699,643,628,10,638,4
2021-03-02,Riverside,065,2383286,286380,279486,13293,292779,3721
2021-03-02,Sacramento,067,1510023,95154,93690,1257,94947,1411
2021-03-02,San Benito,069,59416,5757,5770,89,5859,60
2021-03-02,San Bernardino,071,2135413,286541,281919,8497,290416,3604
2021-03-02,San Diego,073,3302833,265313,260998,13000,273998,3317
2021-03-02,San Francisco,075,870044,34368,34387,1072,35459,424
2021-03-02,San Joaquin,077,732212,67223,65769,2740,68509,1111
2021-03-02,San Luis Obispo,079,281455,19820,19452,556,20008,241
2021-03-02,San Mateo,081,765935,39712,39148,406,39554,317
2021-03-02,Santa Barbara,083,443738,32492,31964,1030,32994,416
2021-03-02,Santa Clara,085,1922200,111142,110832,582,111414,1706
2021-03-02,Santa Cruz,087,273765,15504,14611,772,15383,185
2021-03-02,Shasta,089,179085,11000,11012,1234,12246,149
2021-03-02,Sierra,091,2930,51,48,12,60,0
2021-03-02,Siskiyou,093,43540,1516,1412,233,1645,5
2021-03-02,Solano,095,438530,30014,29827,364,30191,167
2021-03-02,Sonoma,097,501317,28248,28261,218,28479,279
2021-03-02,Stanislaus,099,539301,51004,50359,5323,55682,724
2021-03-02,Sutter,101,95872,8871,8832,79,8911,99
2021-03-02,Tehama,103,63373,4621,4597,485,5082,32
2021-03-02,Trinity,105,12862,468,301,77,378,3
2021-03-02,Tulare,107,460477,48455,47326,7999,55325,783
2021-03-02,Tuolumne,109,53932,3860,3908,36,3944,53
2021-03-02,Ventura,111,848112,78310,77952,2756,80708,780
2021-03-02,Yolo,113,214977,12948,12867,151,13018,189
2021-03-02,Yuba,115,75493,5534,5475,86,5561,41
2021-03-01,Alameda,001,1643700,81283,80805,1700,82505,1105
2021-03-01,Alpine,003,1148,80,77,0,77,0
2021-03-01,Amador,005,37829,3481,3469,30,3499,42
2021-03-01,Butte,007,227075,11373,10981,1634,12615,180
2021-03-01,Calaveras,009,45235,1917,1885,11,1896,46
2021-03-01,Colusa,011,21464,1876,1871,264,2135,11
2021-03-01,Contra Costa,013,1133247,63528,62458,1063,63521,694
2021-03-01,Del Norte,015,27424,1023,982,5,987,5
2021-03-01,El Dorado,017,186661,9188,9085,606,9691,98
2021-03-01,Fresno,019,978130,96817,95677,7675,103352,1405
2021-03-01,Glenn,021,27897,2259,2232,492,2724,15
2021-03-01,Humboldt,023,135768,3211,3179,22,3201,30
2021-03-01,Imperial,025,180216,27280,26913,2443,29356,636
2021-03-01,Inyo,027,18085,1316,1285,9,1294,35
2021-03-01,Kern,029,883053,93747,92219,9765,101984,1041
2021-03-01,Kings,031,150075,22306,21988,963,22951,217
2021-03-01,Lake,033,64148,3207,3164,6,3170,40
2021-03-01,Lassen,035,31185,5124,5111,95,5206,1
2021-03-01,Los Angeles,037,10098052,1175441,1155984,38232,1194216,21293
2021-03-01,Madera,039,155013,15718,15505,821,16326,194
2021-03-01,Marin,041,260295,13297,13161,161,13322,214
2021-03-01,Mariposa,043,17540,377,375,5,380,4
2021-03-01,Mendocino,045,87422,3653,3561,72,3633,41
2021-03-01,Merced,047,269075,28588,28575,921,29496,385
2021-03-01,Modoc,049,8938,339,331,114,445,3
2021-03-01,Mono,051,14174,1189,1192,16,1208,3
2021-03-01,Monterey,053,433212,42025,41697,1662,43359,324
2021-03-01,Napa,055,140530,9088,9056,31,9087,70
2021-03-01,Nevada,057,99092,4051,3979,160,4139,66
2021-03-01,Orange,059,3164182,247836,245852,10148,256000,3976
2021-03-01,Placer,061,380077,20701,19803,1111,20914,239
2021-03-01,Plumas,063,18699,643,628,10,638,4
2021-03-01,Riverside,065,2383286,286161,279323,13286,292609,3680
2021-03-01,Sacramento,067,1510023,95009,93546,1255,94801,1401
2021-03-01,San Benito,069,59416,5752,5772,89,5861,57
2021-03-01,San Bernardino,071,2135413,286397,281685,8493,290178,3603
2021-03-01,San Diego,073,3302833,264996,260622,12967,273589,3303
2021-03-01,San Francisco,075,870044,34324,34318,1064,35382,424
2021-03-01,San Joaquin,077,732212,67114,65699,2730,68429,1097
2021-03-01,San Luis Obispo,079,281455,19798,19429,554,19983,239
2021-03-01,San Mateo,081,765935,39660,39096,406,39502,314
2021-03-01,Santa Barbara,083,443738,32449,31909,1029,32938,413
2021-03-01,Santa Clara,085,1922200,110983,110684,579,111263,1704
2021-03-01,Santa Cruz,087,273765,15485,14575,771,15346,185
2021-03-01,Shasta,089,179085,10988,10990,1231,12221,149
2021-03-01,Sierra,091,2930,51,48,12,60,0
2021-03-01,Siskiyou,093,43540,1512,1408,231,1639,5
2021-03-01,Solano,095,438530,29971,29779,363,30142,166
2021-03-01,Sonoma,097,501317,28200,28222,216,28438,278
2021-03-01,Stanislaus,099,539301,50930,50293,5317,55610,722
2021-03-01,Sutter,101,95872,8860,8825,79,8904,99
2021-03-01,Tehama,103,63373,4615,4595,485,5080,32
2021-03-01,Trinity,105,12862,468,298,76,374,3
2021-03-01,Tulare,107,460477,48417,47275,7965,55240,781
2021-03-01,Tuolumne,109,53932,3857,3907,36,3943,53
2021-03-01,Ventura,111,848112,78229,77849,2755,80604,775
2021-03-01,Yolo,113,214977,12931,12854,149,13003,188
2021-03-01,Yuba,115,75493,5522,5466,86,5552,41
2021-02-28,Alameda,001,1643700,81162,80727,1698,82425,1105
2021-02-28,Alpine,003,1148,80,77,0,77,0
2021-02-28,Amador,005,37829,3476,3466,29,3495,42
2021-02-28,Butte,007,227075,11358,10970,1633,12603,180
2021-02-28,Calaveras,009,45235,1913,1881,11,1892,46
2021-02-28,Colusa,011,21464,1876,1871,263,2134,11
2021-02-28,Contra Costa,013,1133247,63401,62386,1058,63444,694
2021-02-28,Del Norte,015,27424,1021,981,5,986,5
2021-02-28,El Dorado,017,186661,9177,9082,606,9688,98
2021-02-28,Fresno,019,978130,96635,95548,7641,103189,1405
2021-02-28,Glenn,021,27897,2257,2230,490,2720,15
2021-02-28,Humboldt,023,135768,3188,3179,22,3201,30
2021-02-28,Imperial,025,180216,27254,26909,2439,29348,636
2021-02-28,Inyo,027,18085,1311,1282,9,1291,35
2021-02-28,Kern,029,883053,93631,92169,9745,101914,1012
2021-02-28,Kings,031,150075,22285,21967,962,22929,217
2021-02-28,Lake,033,64148,3202,3164,6,3170,40
2021-02-28,Lassen,035,31185,5123,5106,95,5201,1
2021-02-28,Los Angeles,037,10098052,1174653,1155141,38170,1193311,21261
2021-02-28,Madera,039,155013,15676,15496,818,16314,199
2021-02-28,Marin,041,260295,13274,13152,159,13311,214
2021-02-28,Mariposa,043,17540,377,374,5,379,4
2021-02-28,Mendocino,045,87422,3647,3558,72,3630,41
2021-02-28,Merced,047,269075,28525,28546,920,29466,384
2021-02-28,Modoc,049,8938,339,331,114,445,3
2021-02-28,Mono,051,14174,1186,1192,16,1208,3
2021-02-28,Monterey,053,433212,41993,41683,1660,43343,323
2021-02-28,Napa,055,140530,9069,9053,31,9084,70
2021-02-28,Nevada,057,99092,4038,3972,160,4132,66
2021-02-28,Orange,059,3164182,247639,245706,10141,255847,3970
2021-02-28,Placer,061,380077,20655,19775,1109,20884,239
2021-02-28,Plumas,063,18699,643,628,10,638,4
2021-02-28,Riverside,065,2383286,285928,279214,13275,292489,3661
2021-02-28,Sacramento,067,1510023,94825,93463,1250,94713,1398
2021-02-28,San Benito,069,59416,5741,5772,89,5861,57
2021-02-28,San Bernardino,071,2135413,286255,281620,8481,290101,3595
2021-02-28,San Diego,073,3302833,264699,260353,12933,273286,3303
2021-02-28,San Francisco,075,870044,34282,34291,1058,35349,417
2021-02-28,San Joaquin,077,732212,67006,65662,2721,68383,1097
2021-02-28,San Luis Obispo,079,281455,19762,19422,552,19974,237
2021-02-28,San Mateo,081,765935,39607,39059,405,39464,314
2021-02-28,Santa Barbara,083,443738,32397,31877,1029,32906,413
2021-02-28,Santa Clara,085,1922200,110784,110556,576,111132,1704
2021-02-28,Santa Cruz,087,273765,15456,14571,768,15339,185
2021-02-28,Shasta,089,179085,10967,10990,1227,12217,149
2021-02-28,Sierra,091,2930,51,48,12,60,0
2021-02-28,Siskiyou,093,43540,1504,1408,231,1639,5
2021-02-28,Solano,095,438530,29916,29758,357,30115,166
2021-02-28,Sonoma,097,501317,28137,28193,215,28408,279
2021-02-28,Stanislaus,099,539301,50839,50228,5305,55533,728
2021-02-28,Sutter,101,95872,8845,8825,79,8904,99
2021-02-28,Tehama,103,63373,4610,4590,485,5075,32
2021-02-28,Trinity,105,12862,468,298,76,374,3
2021-02-28,Tulare,107,460477,48355,47258,7934,55192,780
2021-02-28,Tuolumne,109,53932,3852,3905,36,3941,53
2021-02-28,Ventura,111,848112,78117,77749,2752,80501,775
2021-02-28,Yolo,113,214977,12908,12851,149,13000,188
2021-02-28,Yuba,115,75493,5512,5461,86,5547,41
2021-02-27,Alameda,001,1643700,81089,80565,1696,82261,1108
2021-02-27,Alpine,003,1148,80,77,0,77,0
2021-02-27,Amador,005,37829,3474,3463,29,3492,42
2021-02-27,Butte,007,227075,11346,10962,1633,12595,180
2021-02-27,Calaveras,009,45235,1908,1875,11,1886,46
2021-02-27,Colusa,011,21464,1875,1869,263,2132,11
2021-02-27,Contra Costa,013,1133247,63331,62248,1055,63303,693
2021-02-27,Del Norte,015,27424,1019,978,5,983,5
2021-02-27,El Dorado,017,186661,9173,9072,606,9678,98
2021-02-27,Fresno,019,978130,96558,95393,7630,103023,1400
2021-02-27,Glenn,021,27897,2256,2225,489,2714,15
2021-02-27,Humboldt,023,135768,3182,3167,22,3189,30
2021-02-27,Imperial,025,180216,27246,26903,2437,29340,633
2021-02-27,Inyo,027,18085,1308,1275,9,1284,35
2021-02-27,Kern,029,883053,93570,92053,9730,101783,996
2021-02-27,Kings,031,150075,22275,21955,959,22914,216
2021-02-27,Lake,033,64148,3199,3156,6,3162,40
2021-02-27,Lassen,035,31185,5123,5106,95,5201,1
2021-02-27,Los Angeles,037,10098052,1174151,1154275,38143,1192418,21158
2021-02-27,Madera,039,155013,15659,15467,817,16284,199
2021-02-27,Marin,041,260295,13250,13134,159,13293,214
2021-02-27,Mariposa,043,17540,377,374,5,379,4
2021-02-27,Mendocino,045,87422,3644,3555,72,3627,41
2021-02-27,Merced,047,269075,28483,28501,912,29413,384
2021-02-27,Modoc,049,8938,339,331,113,444,3
2021-02-27,Mono,051,14174,1184,1191,16,1207,3
2021-02-27,Monterey,053,433212,41984,41665,1659,43324,322
2021-02-27,Napa,055,140530,9058,9038,31,9069,71
2021-02-27,Nevada,057,99092,4032,3960,160,4120,66
2021-02-27,Orange,059,3164182,247512,245542,10130,255672,3960
2021-02-27,Placer,061,380077,20619,19726,1106,20832,239
2021-02-27,Plumas,063,18699,643,628,10,638,4
2021-02-27,Riverside,065,2383286,285818,279048,13265,292313,3663
2021-02-27,Sacramento,067,1510023,94742,93281,1240,94521,1396
2021-02-27,San Benito,069,59416,5740,5767,88,5855,57
2021-02-27,San Bernardino,071,2135413,286176,281471,8476,289947,3527
2021-02-27,San Diego,073,3302833,264509,260091,12895,272986,3284
2021-02-27,San Francisco,075,870044,34248,34260,1055,35315,413
2021-02-27,San Joaquin,077,732212,66960,65578,2719,68297,1100
2021-02-27,San Luis Obispo,079,281455,19741,19411,551,19962,237
2021-02-27,San Mateo,081,765935,39566,38998,404,39402,313
2021-02-27,Santa Barbara,083,443738,32363,31805,1028,32833,411
2021-02-27,Santa Clara,085,1922200,110636,110361,574,110935,1703
2021-02-27,Santa Cruz,087,273765,15447,14552,767,15319,185
2021-02-27,Shasta,089,179085,10961,10985,1223,12208,149
2021-02-27,Sierra,091,2930,51,48,12,60,0
2021-02-27,Siskiyou,093,43540,1502,1407,230,1637,5
2021-02-27,Solano,095,438530,29888,29718,356,30074,165
2021-02-27,Sonoma,097,501317,28093,28141,210,28351,281
2021-02-27,Stanislaus,099,539301,50784,50147,5295,55442,733
2021-02-27,Sutter,101,95872,8840,8820,79,8899,99
2021-02-27,Tehama,103,63373,4605,4584,484,5068,32
2021-02-27,Trinity,105,12862,468,298,76,374,3
2021-02-27,Tulare,107,460477,48318,47209,7908,55117,770
2021-02-27,Tuolumne,109,53932,3849,3899,36,3935,53
2021-02-27,Ventura,111,848112,78044,77623,2749,80372,771
2021-02-27,Yolo,113,214977,12896,12834,149,12983,188
2021-02-27,Yuba,115,75493,5509,5450,86,5536,39
2021-02-26,Alameda,001,1643700,80994,80387,1691,82078,1106
2021-02-26,Alpine,003,1148,80,77,0,77,0
2021-02-26,Amador,005,37829,3468,3457,29,3486,42
2021-02-26,Butte,007,227075,11336,10941,1633,12574,180
2021-02-26,Calaveras,009,45235,1906,1873,11,1884,46
2021-02-26,Colusa,011,21464,1875,1865,263,2128,11
2021-02-26,Contra Costa,013,1133247,63249,62114,1055,63169,685
2021-02-26,Del Norte,015,27424,1015,968,5,973,5
2021-02-26,El Dorado,017,186661,9168,9038,604,9642,98
2021-02-26,Fresno,019,978130,96456,95202,7622,102824,1391
2021-02-26,Glenn,021,27897,2253,2220,489,2709,15
2021-02-26,Humboldt,023,135768,3176,3152,22,3174,30
2021-02-26,Imperial,025,180216,27239,26888,2435,29323,631
2021-02-26,Inyo,027,18085,1306,1271,9,1280,34
2021-02-26,Kern,029,883053,93491,91884,9714,101598,997
2021-02-26,Kings,031,150075,22259,21917,956,22873,216
2021-02-26,Lake,033,64148,3194,3153,6,3159,40
2021-02-26,Lassen,035,31185,5123,5102,95,5197,1
2021-02-26,Los Angeles,037,10098052,1173574,1153131,38083,1191214,21070
2021-02-26,Madera,039,155013,15643,15436,815,16251,199
2021-02-26,Marin,041,260295,13237,13091,159,13250,214
2021-02-26,Mariposa,043,17540,377,375,5,380,4
2021-02-26,Mendocino,045,87422,3639,3549,72,3621,41
2021-02-26,Merced,047,269075,28449,28455,911,29366,382
2021-02-26,Modoc,049,8938,338,330,113,443,3
2021-02-26,Mono,051,14174,1182,1191,16,1207,3
2021-02-26,Monterey,053,433212,41958,41607,1658,43265,322
2021-02-26,Napa,055,140530,9052,9014,31,9045,70
2021-02-26,Nevada,057,99092,4021,3952,160,4112,66
2021-02-26,Orange,059,3164182,247373,245278,10120,255398,3918
2021-02-26,Placer,061,380077,20593,19712,1100,20812,239
2021-02-26,Plumas,063,18699,643,628,10,638,4
2021-02-26,Riverside,065,2383286,285674,278772,13259,292031,3653
2021-02-26,Sacramento,067,1510023,94619,93180,1237,94417,1390
2021-02-26,San Benito,069,59416,5739,5759,88,5847,57
2021-02-26,San Bernardino,071,2135413,286076,281132,8474,289606,3461
2021-02-26,San Diego,073,3302833,264281,259641,12874,272515,3271
2021-02-26,San Francisco,075,870044,34218,34213,1052,35265,413
2021-02-26,San Joaquin,077,732212,66879,65492,2713,68205,1070
2021-02-26,San Luis Obispo,079,281455,19725,19359,549,19908,234
2021-02-26,San Mateo,081,765935,39521,38922,404,39326,313
2021-02-26,Santa Barbara,083,443738,32319,31724,1027,32751,410
2021-02-26,Santa Clara,085,1922200,110504,110168,572,110740,1700
2021-02-26,Santa Cruz,087,273765,15435,14528,766,15294,185
2021-02-26,Shasta,089,179085,10954,10972,1214,12186,149
2021-02-26,Sierra,091,2930,51,47,12,59,0
2021-02-26,Siskiyou,093,43540,1502,1401,229,1630,5
2021-02-26,Solano,095,438530,29854,29651,355,30006,165
2021-02-26,Sonoma,097,501317,28064,28063,209,28272,280
2021-02-26,Stanislaus,099,539301,50728,50054,5287,55341,737
2021-02-26,Sutter,101,95872,8831,8806,79,8885,99
2021-02-26,Tehama,103,63373,4603,4581,484,5065,32
2021-02-26,Trinity,105,12862,467,298,76,374,3
2021-02-26,Tulare,107,460477,48282,47135,7879,55014,770
2021-02-26,Tuolumne,109,53932,3848,3896,36,3932,53
2021-02-26,Ventura,111,848112,77944,77534,2745,80279,765
2021-02-26,Yolo,113,214977,12889,12816,149,12965,188
2021-02-26,Yuba,115,75493,5504,5438,86,5524,39
2021-02-25,Alameda,001,1643700,80873,80181,1690,81871,1093
2021-02-25,Alpine,003,1148,80,77,0,77,0
2021-02-25,Amador,005,37829,3465,3448,29,3477,41
2021-02-25,Butte,007,227075,11315,10922,1628,12550,178
2021-02-25,Calaveras,009,45235,1898,1868,11,1879,46
2021-02-25,Colusa,011,21464,1872,1863,262,2125,11
2021-02-25,Contra Costa,013,1133247,63147,61910,1055,62965,686
2021-02-25,Del Norte,015,27424,1005,966,5,971,5
2021-02-25,El Dorado,017,186661,9152,9012,604,9616,98
2021-02-25,Fresno,019,978130,96312,95015,7602,102617,1377
2021-02-25,Glenn,021,27897,2250,2219,488,2707,15
2021-02-25,Humboldt,023,135768,3169,3129,22,3151,30
2021-02-25,Imperial,025,180216,27232,26855,2431,29286,628
2021-02-25,Inyo,027,18085,1300,1264,9,1273,33
2021-02-25,Kern,029,883053,93375,91735,9689,101424,992
2021-02-25,Kings,031,150075,22250,21900,953,22853,216
2021-02-25,Lake,033,64148,3185,3141,6,3147,40
2021-02-25,Lassen,035,31185,5122,5097,94,5191,1
2021-02-25,Los Angeles,037,10098052,1172828,1151846,38025,1189871,20931
2021-02-25,Madera,039,155013,15608,15414,811,16225,194
2021-02-25,Marin,041,260295,13214,13067,159,13226,214
2021-02-25,Mariposa,043,17540,377,375,5,380,4
2021-02-25,Mendocino,045,87422,3634,3542,72,3614,41
2021-02-25,Merced,047,269075,28400,28383,909,29292,382
2021-02-25,Modoc,049,8938,338,329,113,442,3
2021-02-25,Mono,051,14174,1181,1190,16,1206,3
2021-02-25,Monterey,053,433212,41933,41564,1653,43217,321
2021-02-25,Napa,055,140530,9026,8998,31,9029,70
2021-02-25,Nevada,057,99092,4004,3940,159,4099,66
2021-02-25,Orange,059,3164182,247200,245000,10110,255110,3882
2021-02-25,Placer,061,380077,20554,19661,1098,20759,239
2021-02-25,Plumas,063,18699,643,626,10,636,4
2021-02-25,Riverside,065,2383286,285486,278544,13239,291783,3646
2021-02-25,Sacramento,067,1510023,94461,92961,1225,94186,1386
2021-02-25,San Benito,069,59416,5734,5752,88,5840,58
2021-02-25,San Bernardino,071,2135413,285941,280946,8466,289412,3409
2021-02-25,San Diego,073,3302833,263987,258979,12844,271823,3260
2021-02-25,San Francisco,075,870044,34175,34138,1050,35188,408
2021-02-25,San Joaquin,077,732212,66795,65389,2701,68090,1047
2021-02-25,San Luis Obispo,079,281455,19704,19335,547,19882,234
2021-02-25,San Mateo,081,765935,39474,38872,404,39276,300
2021-02-25,Santa Barbara,083,443738,32242,31631,1026,32657,408
2021-02-25,Santa Clara,085,1922200,110339,109923,571,110494,1677
2021-02-25,Santa Cruz,087,273765,15416,14492,765,15257,185
2021-02-25,Shasta,089,179085,10942,10947,1209,12156,148
2021-02-25,Sierra,091,2930,51,47,12,59,0
2021-02-25,Siskiyou,093,43540,1497,1390,226,1616,4
2021-02-25,Solano,095,438530,29822,29616,355,29971,161
2021-02-25,Sonoma,097,501317,28010,28004,206,28210,278
2021-02-25,Stanislaus,099,539301,50637,49964,5277,55241,738
2021-02-25,Sutter,101,95872,8817,8789,78,8867,99
2021-02-25,Tehama,103,63373,4600,4578,482,5060,32
2021-02-25,Trinity,105,12862,467,297,76,373,3
2021-02-25,Tulare,107,460477,48232,47052,7853,54905,765
2021-02-25,Tuolumne,109,53932,3845,3894,36,3930,53
2021-02-25,Ventura,111,848112,77836,77395,2739,80134,751
2021-02-25,Yolo,113,214977,12872,12787,149,12936,188
2021-02-25,Yuba,115,75493,5497,5429,86,5515,39
2021-02-24,Alameda,001,1643700,80753,80070,1686,81756,1082
2021-02-24,Alpine,003,1148,79,77,0,77,0
2021-02-24,Amador,005,37829,3460,3444,29,3473,41
2021-02-24,Butte,007,227075,11302,10915,1624,12539,178
2021-02-24,Calaveras,009,45235,1894,1864,11,1875,31
2021-02-24,Colusa,011,21464,1870,1863,262,2125,11
2021-02-24,Contra Costa,013,1133247,63039,61776,1055,62831,663
2021-02-24,Del Norte,015,27424,1004,960,4,964,5
2021-02-24,El Dorado,017,186661,9139,8993,604,9597,98
2021-02-24,Fresno,019,978130,96163,94794,7586,102380,1369
2021-02-24,Glenn,021,27897,2249,2210,488,2698,14
2021-02-24,Humboldt,023,135768,3157,3123,22,3145,29
2021-02-24,Imperial,025,180216,27219,26843,2426,29269,596
2021-02-24,Inyo,027,18085,1295,1253,9,1262,32
2021-02-24,Kern,029,883053,93242,91525,9673,101198,992
2021-02-24,Kings,031,150075,22225,21871,951,22822,216
2021-02-24,Lake,033,64148,3178,3134,6,3140,40
2021-02-24,Lassen,035,31185,5118,5095,93,5188,1
2021-02-24,Los Angeles,037,10098052,1172066,1150322,37986,1188308,20817
2021-02-24,Madera,039,155013,15581,15390,811,16201,194
2021-02-24,Marin,041,260295,13191,13044,158,13202,214
2021-02-24,Mariposa,043,17540,377,374,5,379,4
2021-02-24,Mendocino,045,87422,3627,3540,72,3612,41
2021-02-24,Merced,047,269075,28362,28295,905,29200,383
2021-02-24,Modoc,049,8938,337,329,113,442,3
2021-02-24,Mono,051,14174,1179,1189,16,1205,3
2021-02-24,Monterey,053,433212,41908,41495,1651,43146,320
2021-02-24,Napa,055,140530,9009,8976,31,9007,70
2021-02-24,Nevada,057,99092,3994,3927,159,4086,66
2021-02-24,Orange,059,3164182,246981,244743,10097,254840,3835
2021-02-24,Placer,061,380077,20515,19648,1092,20740,239
2021-02-24,Plumas,063,18699,641,626,10,636,4
2021-02-24,Riverside,065,2383286,285258,278293,13230,291523,3603
2021-02-24,Sacramento,067,1510023,94307,92742,1220,93962,1375
2021-02-24,San Benito,069,59416,5733,5743,88,5831,57
2021-02-24,San Bernardino,071,2135413,285789,280583,8462,289045,3360
2021-02-24,San Diego,073,3302833,263691,258460,12828,271288,3230
2021-02-24,San Francisco,075,870044,34129,34061,1047,35108,406
2021-02-24,San Joaquin,077,732212,66685,65274,2699,67973,1019
2021-02-24,San Luis Obispo,079,281455,19681,19309,545,19854,233
2021-02-24,San Mateo,081,765935,39437,38763,404,39167,300
2021-02-24,Santa Barbara,083,443738,32190,31563,1023,32586,405
2021-02-24,Santa Clara,085,1922200,110190,109671,570,110241,1674
2021-02-24,Santa Cruz,087,273765,15395,14458,765,15223,185
2021-02-24,Shasta,089,179085,10929,10922,1206,12128,148
2021-02-24,Sierra,091,2930,51,47,12,59,0
2021-02-24,Siskiyou,093,43540,1490,1385,222,1607,4
2021-02-24,Solano,095,438530,29783,29577,353,29930,158
2021-02-24,Sonoma,097,501317,27946,27954,202,28156,278
2021-02-24,Stanislaus,099,539301,50566,49851,5270,55121,732
2021-02-24,Sutter,101,95872,8807,8778,78,8856,99
2021-02-24,Tehama,103,63373,4597,4566,482,5048,31
2021-02-24,Trinity,105,12862,467,294,75,369,3
2021-02-24,Tulare,107,460477,48176,46976,7825,54801,759
2021-02-24,Tuolumne,109,53932,3842,3887,36,3923,53
2021-02-24,Ventura,111,848112,77728,77238,2738,79976,718
2021-02-24,Yolo,113,214977,12859,12760,149,12909,188
2021-02-24,Yuba,115,75493,5486,5425,84,5509,39
2021-02-23,Alameda,001,1643700,80615,79948,1684,81632,1070
2021-02-23,Alpine,003,1148,78,77,0,77,0
2021-02-23,Amador,005,37829,3458,3440,29,3469,41
2021-02-23,Butte,007,227075,11286,10887,1621,12508,176
2021-02-23,Calaveras,009,45235,1893,1863,11,1874,21
2021-02-23,Colusa,011,21464,1867,1862,262,2124,11
2021-02-23,Contra Costa,013,1133247,62905,61613,1052,62665,661
2021-02-23,Del Norte,015,27424,1002,953,4,957,3
2021-02-23,El Dorado,017,186661,9126,8969,604,9573,96
2021-02-23,Fresno,019,978130,96002,94741,7572,102313,1356
2021-02-23,Glenn,021,27897,2247,2209,488,2697,14
2021-02-23,Humboldt,023,135768,3140,3108,22,3130,29
2021-02-23,Imperial,025,180216,27199,26816,2421,29237,591
2021-02-23,Inyo,027,18085,1291,1250,9,1259,32
2021-02-23,Kern,029,883053,93103,91390,9645,101035,982
2021-02-23,Kings,031,150075,22210,21839,947,22786,216
2021-02-23,Lake,033,64148,3170,3121,6,3127,40
2021-02-23,Lassen,035,31185,5115,5092,93,5185,1
2021-02-23,Los Angeles,037,10098052,1171193,1148965,37934,1186899,19887
2021-02-23,Madera,039,155013,15567,15352,805,16157,193
2021-02-23,Marin,041,260295,13171,13015,157,13172,214
2021-02-23,Mariposa,043,17540,377,374,5,379,4
2021-02-23,Mendocino,045,87422,3625,3540,71,3611,41
2021-02-23,Merced,047,269075,28282,28209,898,29107,381
2021-02-23,Modoc,049,8938,336,328,112,440,3
2021-02-23,Mono,051,14174,1179,1189,16,1205,3
2021-02-23,Monterey,053,433212,41869,41439,1646,43085,317
2021-02-23,Napa,055,140530,8997,8967,31,8998,70
2021-02-23,Nevada,057,99092,3986,3912,159,4071,66
2021-02-23,Orange,059,3164182,246783,244566,10079,254645,3843
2021-02-23,Placer,061,380077,20490,19608,1088,20696,238
2021-02-23,Plumas,063,18699,640,626,10,636,4
2021-02-23,Riverside,065,2383286,285021,278075,13216,291291,3599
2021-02-23,Sacramento,067,1510023,94150,92632,1214,93846,1370
2021-02-23,San Benito,069,59416,5727,5731,87,5818,57
2021-02-23,San Bernardino,071,2135413,285601,280279,8457,288736,3283
2021-02-23,San Diego,073,3302833,263314,257802,12798,270600,3218
2021-02-23,San Francisco,075,870044,34080,33994,1046,35040,405
2021-02-23,San Joaquin,077,732212,66585,65141,2692,67833,1004
2021-02-23,San Luis Obispo,079,281455,19652,19233,544,19777,230
2021-02-23,San Mateo,081,765935,39376,38662,404,39066,299
2021-02-23,Santa Barbara,083,443738,32135,31483,1022,32505,402
2021-02-23,Santa Clara,085,1922200,109993,109449,567,110016,1661
2021-02-23,Santa Cruz,087,273765,15366,14435,763,15198,178
2021-02-23,Shasta,089,179085,10917,10903,1202,12105,146
2021-02-23,Sierra,091,2930,51,47,12,59,0
2021-02-23,Siskiyou,093,43540,1485,1380,220,1600,4
2021-02-23,Solano,095,438530,29743,29545,350,29895,154
2021-02-23,Sonoma,097,501317,27903,27882,199,28081,278
2021-02-23,Stanislaus,099,539301,50488,49749,5254,55003,722
2021-02-23,Sutter,101,95872,8794,8766,78,8844,98
2021-02-23,Tehama,103,63373,4591,4556,481,5037,30
2021-02-23,Trinity,105,12862,467,292,74,366,3
2021-02-23,Tulare,107,460477,48098,46937,7792,54729,757
2021-02-23,Tuolumne,109,53932,3838,3864,36,3900,53
2021-02-23,Ventura,111,848112,77612,77093,2729,79822,689
2021-02-23,Yolo,113,214977,12830,12729,149,12878,188
2021-02-23,Yuba,115,75493,5473,5417,83,5500,38
2021-02-22,Alameda,001,1643700,80464,79796,1680,81476,1062
2021-02-22,Alpine,003,1148,78,77,0,77,0
2021-02-22,Amador,005,37829,3453,3438,29,3467,39
2021-02-22,Butte,007,227075,11273,10855,1616,12471,176
2021-02-22,Calaveras,009,45235,1891,1862,11,1873,21
2021-02-22,Colusa,011,21464,1867,1860,262,2122,11
2021-02-22,Contra Costa,013,1133247,62777,61478,1051,62529,661
2021-02-22,Del Norte,015,27424,1001,948,4,952,3
2021-02-22,El Dorado,017,186661,9109,8940,604,9544,96
2021-02-22,Fresno,019,978130,95840,94584,7555,102139,1351
2021-02-22,Glenn,021,27897,2242,2207,486,2693,14
2021-02-22,Humboldt,023,135768,3128,3095,22,3117,29
2021-02-22,Imperial,025,180216,27177,26778,2414,29192,590
2021-02-22,Inyo,027,18085,1286,1248,9,1257,32
2021-02-22,Kern,029,883053,92986,91201,9623,100824,982
2021-02-22,Kings,031,150075,22187,21801,944,22745,214
2021-02-22,Lake,033,64148,3164,3107,6,3113,40
2021-02-22,Lassen,035,31185,5115,5088,92,5180,1
2021-02-22,Los Angeles,037,10098052,1170333,1147541,37878,1185419,19730
2021-02-22,Madera,039,155013,15542,15325,801,16126,193
2021-02-22,Marin,041,260295,13146,12991,154,13145,213
2021-02-22,Mariposa,043,17540,376,374,5,379,4
2021-02-22,Mendocino,045,87422,3619,3535,71,3606,41
2021-02-22,Merced,047,269075,28219,28166,895,29061,379
2021-02-22,Modoc,049,8938,336,329,112,441,3
2021-02-22,Mono,051,14174,1175,1189,16,1205,3
2021-02-22,Monterey,053,433212,41824,41397,1640,43037,311
2021-02-22,Napa,055,140530,8970,8950,31,8981,69
2021-02-22,Nevada,057,99092,3977,3900,157,4057,66
2021-02-22,Orange,059,3164182,246547,244118,10061,254179,3843
2021-02-22,Placer,061,380077,20453,19587,1080,20667,238
2021-02-22,Plumas,063,18699,640,625,10,635,4
2021-02-22,Riverside,065,2383286,284759,277730,13208,290938,3567
2021-02-22,Sacramento,067,1510023,93983,92476,1204,93680,1359
2021-02-22,San Benito,069,59416,5725,5723,87,5810,57
2021-02-22,San Bernardino,071,2135413,285424,279984,8444,288428,3259
2021-02-22,San Diego,073,3302833,262904,257348,12765,270113,3189
2021-02-22,San Francisco,075,870044,34020,33947,1041,34988,405
2021-02-22,San Joaquin,077,732212,66489,65060,2679,67739,1001
2021-02-22,San Luis Obispo,079,281455,19615,19198,542,19740,229
2021-02-22,San Mateo,081,765935,39319,38542,401,38943,282
2021-02-22,Santa Barbara,083,443738,32069,31421,1019,32440,399
2021-02-22,Santa Clara,085,1922200,109784,109213,556,109769,1655
2021-02-22,Santa Cruz,087,273765,15340,14417,763,15180,176
2021-02-22,Shasta,089,179085,10902,10872,1197,12069,145
2021-02-22,Sierra,091,2930,51,47,12,59,0
2021-02-22,Siskiyou,093,43540,1479,1373,219,1592,4
2021-02-22,Solano,095,438530,29704,29508,349,29857,150
2021-02-22,Sonoma,097,501317,27858,27845,198,28043,278
2021-02-22,Stanislaus,099,539301,50386,49630,5236,54866,722
2021-02-22,Sutter,101,95872,8786,8698,78,8776,98
2021-02-22,Tehama,103,63373,4588,4550,480,5030,30
2021-02-22,Trinity,105,12862,467,287,73,360,3
2021-02-22,Tulare,107,460477,48036,46879,7760,54639,751
2021-02-22,Tuolumne,109,53932,3834,3856,36,3892,53
2021-02-22,Ventura,111,848112,77484,76947,2724,79671,677
2021-02-22,Yolo,113,214977,12803,12689,149,12838,183
2021-02-22,Yuba,115,75493,5470,5404,82,5486,38
2021-02-21,Alameda,001,1643700,80270,79649,1676,81325,1061
2021-02-21,Alpine,003,1148,78,77,0,77,0
2021-02-21,Amador,005,37829,3445,3435,29,3464,39
2021-02-21,Butte,007,227075,11255,10855,1614,12469,176
2021-02-21,Calaveras,009,45235,1890,1860,11,1871,21
2021-02-21,Colusa,011,21464,1866,1860,258,2118,11
2021-02-21,Contra Costa,013,1133247,62622,61364,1048,62412,661
2021-02-21,Del Norte,015,27424,995,942,4,946,3
2021-02-21,El Dorado,017,186661,9091,8927,603,9530,96
2021-02-21,Fresno,019,978130,95697,94374,7539,101913,1349
2021-02-21,Glenn,021,27897,2240,2201,484,2685,14
2021-02-21,Humboldt,023,135768,3116,3096,22,3118,29
2021-02-21,Imperial,025,180216,27163,26779,2412,29191,590
2021-02-21,Inyo,027,18085,1280,1232,9,1241,32
2021-02-21,Kern,029,883053,92861,91141,9585,100726,980
2021-02-21,Kings,031,150075,22151,21784,942,22726,213
2021-02-21,Lake,033,64148,3156,3100,6,3106,40
2021-02-21,Lassen,035,31185,5107,5077,92,5169,1
2021-02-21,Los Angeles,037,10098052,1169291,1146756,37834,1184590,19711
2021-02-21,Madera,039,155013,15509,15298,798,16096,192
2021-02-21,Marin,041,260295,13117,12968,154,13122,212
2021-02-21,Mariposa,043,17540,376,373,5,378,4
2021-02-21,Mendocino,045,87422,3614,3535,71,3606,41
2021-02-21,Merced,047,269075,28145,28106,880,28986,379
2021-02-21,Modoc,049,8938,333,329,112,441,3
2021-02-21,Mono,051,14174,1175,1189,16,1205,3
2021-02-21,Monterey,053,433212,41768,41373,1633,43006,309
2021-02-21,Napa,055,140530,8956,8929,31,8960,69
2021-02-21,Nevada,057,99092,3964,3895,157,4052,66
2021-02-21,Orange,059,3164182,246250,243985,10044,254029,3801
2021-02-21,Placer,061,380077,20417,19553,1076,20629,238
2021-02-21,Plumas,063,18699,640,625,10,635,4
2021-02-21,Riverside,065,2383286,284526,277555,13195,290750,3564
2021-02-21,Sacramento,067,1510023,93773,92288,1194,93482,1354
2021-02-21,San Benito,069,59416,5715,5716,84,5800,57
2021-02-21,San Bernardino,071,2135413,285200,279870,8430,288300,3247
2021-02-21,San Diego,073,3302833,262470,257027,12719,269746,3190
2021-02-21,San Francisco,075,870044,33956,33891,1037,34928,405
2021-02-21,San Joaquin,077,732212,66350,64997,2667,67664,1001
2021-02-21,San Luis Obispo,079,281455,19582,19178,540,19718,229
2021-02-21,San Mateo,081,765935,39257,38448,397,38845,282
2021-02-21,Santa Barbara,083,443738,32007,31374,1016,32390,399
2021-02-21,Santa Clara,085,1922200,109560,108992,548,109540,1654
2021-02-21,Santa Cruz,087,273765,15317,14401,762,15163,176
2021-02-21,Shasta,089,179085,10888,10867,1192,12059,145
2021-02-21,Sierra,091,2930,51,47,12,59,0
2021-02-21,Siskiyou,093,43540,1473,1371,219,1590,4
2021-02-21,Solano,095,438530,29649,29471,348,29819,150
2021-02-21,Sonoma,097,501317,27794,27793,191,27984,278
2021-02-21,Stanislaus,099,539301,50273,49527,5222,54749,726
2021-02-21,Sutter,101,95872,8769,8687,77,8764,97
2021-02-21,Tehama,103,63373,4579,4547,480,5027,30
2021-02-21,Trinity,105,12862,465,286,73,359,3
2021-02-21,Tulare,107,460477,47968,46830,7725,54555,749
2021-02-21,Tuolumne,109,53932,3820,3828,36,3864,53
2021-02-21,Ventura,111,848112,77335,76862,2711,79573,677
2021-02-21,Yolo,113,214977,12772,12670,148,12818,183
2021-02-21,Yuba,115,75493,5462,5396,81,5477,38
2021-02-20,Alameda,001,1643700,80179,79496,1671,81167,1055
2021-02-20,Alpine,003,1148,78,77,0,77,0
2021-02-20,Amador,005,37829,3443,3432,29,3461,39
2021-02-20,Butte,007,227075,11247,10838,1613,12451,176
2021-02-20,Calaveras,009,45235,1889,1858,11,1869,21
2021-02-20,Colusa,011,21464,1865,1858,258,2116,11
2021-02-20,Contra Costa,013,1133247,62538,61205,1046,62251,663
2021-02-20,Del Norte,015,27424,991,937,4,941,3
2021-02-20,El Dorado,017,186661,9081,8911,602,9513,96
2021-02-20,Fresno,019,978130,95614,94234,7519,101753,1341
2021-02-20,Glenn,021,27897,2236,2199,483,2682,14
2021-02-20,Humboldt,023,135768,3108,3073,22,3095,29
2021-02-20,Imperial,025,180216,27153,26771,2412,29183,590
2021-02-20,Inyo,027,18085,1276,1226,9,1235,32
2021-02-20,Kern,029,883053,92790,91025,9553,100578,968
2021-02-20,Kings,031,150075,22133,21773,941,22714,212
2021-02-20,Lake,033,64148,3149,3089,6,3095,40
2021-02-20,Lassen,035,31185,5105,5067,92,5159,1
2021-02-20,Los Angeles,037,10098052,1168721,1145594,37794,1183388,19630
2021-02-20,Madera,039,155013,15489,15274,797,16071,191
2021-02-20,Marin,041,260295,13096,12945,152,13097,211
2021-02-20,Mariposa,043,17540,376,372,5,377,4
2021-02-20,Mendocino,045,87422,3612,3533,71,3604,40
2021-02-20,Merced,047,269075,28102,28066,877,28943,379
2021-02-20,Modoc,049,8938,333,328,112,440,3
2021-02-20,Mono,051,14174,1174,1187,16,1203,3
2021-02-20,Monterey,053,433212,41746,41313,1631,42944,309
2021-02-20,Napa,055,140530,8947,8910,31,8941,69
2021-02-20,Nevada,057,99092,3954,3887,156,4043,66
2021-02-20,Orange,059,3164182,246081,243761,10030,253791,3755
2021-02-20,Placer,061,380077,20376,19509,1072,20581,236
2021-02-20,Plumas,063,18699,640,626,10,636,4
2021-02-20,Riverside,065,2383286,284372,277267,13186,290453,3559
2021-02-20,Sacramento,067,1510023,93650,92057,1192,93249,1352
2021-02-20,San Benito,069,59416,5704,5709,84,5793,57
2021-02-20,San Bernardino,071,2135413,285098,279608,8425,288033,3203
2021-02-20,San Diego,073,3302833,262228,256510,12690,269200,3188
2021-02-20,San Francisco,075,870044,33914,33820,1029,34849,399
2021-02-20,San Joaquin,077,732212,66280,64916,2662,67578,1001
2021-02-20,San Luis Obispo,079,281455,19558,19138,539,19677,229
2021-02-20,San Mateo,081,765935,39213,38371,396,38767,282
2021-02-20,Santa Barbara,083,443738,31973,31289,1015,32304,396
2021-02-20,Santa Clara,085,1922200,109382,108728,545,109273,1649
2021-02-20,Santa Cruz,087,273765,15306,14378,760,15138,176
2021-02-20,Shasta,089,179085,10874,10850,1187,12037,146
2021-02-20,Sierra,091,2930,51,47,12,59,0
2021-02-20,Siskiyou,093,43540,1470,1366,219,1585,4
2021-02-20,Solano,095,438530,29635,29440,346,29786,150
2021-02-20,Sonoma,097,501317,27765,27703,189,27892,278
2021-02-20,Stanislaus,099,539301,50222,49445,5208,54653,733
2021-02-20,Sutter,101,95872,8763,8681,77,8758,97
2021-02-20,Tehama,103,63373,4574,4545,480,5025,30
2021-02-20,Trinity,105,12862,464,285,72,357,3
2021-02-20,Tulare,107,460477,47932,46769,7703,54472,739
2021-02-20,Tuolumne,109,53932,3815,3823,36,3859,53
2021-02-20,Ventura,111,848112,77240,76757,2708,79465,671
2021-02-20,Yolo,113,214977,12758,12639,148,12787,183
2021-02-20,Yuba,115,75493,5459,5386,81,5467,38
2021-02-19,Alameda,001,1643700,80079,79318,1667,80985,1047
2021-02-19,Alpine,003,1148,78,77,0,77,0
2021-02-19,Amador,005,37829,3439,3427,29,3456,39
2021-02-19,Butte,007,227075,11233,10823,1606,12429,176
2021-02-19,Calaveras,009,45235,1888,1856,11,1867,21
2021-02-19,Colusa,011,21464,1865,1858,258,2116,11
2021-02-19,Contra Costa,013,1133247,62426,61017,1043,62060,651
2021-02-19,Del Norte,015,27424,986,932,4,936,2
2021-02-19,El Dorado,017,186661,9072,8882,601,9483,96
2021-02-19,Fresno,019,978130,95484,93973,7503,101476,1330
2021-02-19,Glenn,021,27897,2231,2199,482,2681,14
2021-02-19,Humboldt,023,135768,3096,3037,22,3059,29
2021-02-19,Imperial,025,180216,27147,26751,2409,29160,589
2021-02-19,Inyo,027,18085,1271,1212,9,1221,32
2021-02-19,Kern,029,883053,92721,90807,9513,100320,963
2021-02-19,Kings,031,150075,22119,21724,939,22663,211
2021-02-19,Lake,033,64148,3143,3078,6,3084,40
2021-02-19,Lassen,035,31185,5104,5057,92,5149,1
2021-02-19,Los Angeles,037,10098052,1167970,1143828,37754,1181582,19498
2021-02-19,Madera,039,155013,15472,15222,795,16017,188
2021-02-19,Marin,041,260295,13078,12919,151,13070,210
2021-02-19,Mariposa,043,17540,376,371,5,376,4
2021-02-19,Mendocino,045,87422,3610,3526,71,3597,39
2021-02-19,Merced,047,269075,28072,27985,874,28859,376
2021-02-19,Modoc,049,8938,333,328,112,440,3
2021-02-19,Mono,051,14174,1174,1186,16,1202,3
2021-02-19,Monterey,053,433212,41719,41209,1627,42836,309
2021-02-19,Napa,055,140530,8934,8899,31,8930,69
2021-02-19,Nevada,057,99092,3948,3863,156,4019,66
2021-02-19,Orange,059,3164182,245905,243397,10018,253415,3715
2021-02-19,Placer,061,380077,20354,19457,1072,20529,236
2021-02-19,Plumas,063,18699,638,624,10,634,4
2021-02-19,Riverside,065,2383286,284203,276941,13169,290110,3541
2021-02-19,Sacramento,067,1510023,93530,91815,1188,93003,1351
2021-02-19,San Benito,069,59416,5699,5699,84,5783,57
2021-02-19,San Bernardino,071,2135413,284962,279209,8420,287629,3117
2021-02-19,San Diego,073,3302833,261937,255799,12667,268466,3169
2021-02-19,San Francisco,075,870044,33866,33746,1023,34769,387
2021-02-19,San Joaquin,077,732212,66204,64774,2654,67428,988
2021-02-19,San Luis Obispo,079,281455,19527,19061,537,19598,230
2021-02-19,San Mateo,081,765935,39155,38256,394,38650,282
2021-02-19,Santa Barbara,083,443738,31909,31204,1014,32218,392
2021-02-19,Santa Clara,085,1922200,109170,108400,543,108943,1634
2021-02-19,Santa Cruz,087,273765,15291,14354,760,15114,176
2021-02-19,Shasta,089,179085,10863,10833,1184,12017,140
2021-02-19,Sierra,091,2930,51,47,12,59,0
2021-02-19,Siskiyou,093,43540,1466,1363,217,1580,4
2021-02-19,Solano,095,438530,29610,29383,345,29728,150
2021-02-19,Sonoma,097,501317,27718,27595,187,27782,280
2021-02-19,Stanislaus,099,539301,50160,49282,5192,54474,739
2021-02-19,Sutter,101,95872,8753,8665,77,8742,96
2021-02-19,Tehama,103,63373,4572,4535,480,5015,30
2021-02-19,Trinity,105,12862,462,282,70,352,3
2021-02-19,Tulare,107,460477,47887,46662,7678,54340,736
2021-02-19,Tuolumne,109,53932,3808,3817,36,3853,52
2021-02-19,Ventura,111,848112,77161,76582,2705,79287,667
2021-02-19,Yolo,113,214977,12742,12606,148,12754,183
2021-02-19,Yuba,115,75493,5449,5376,81,5457,38
2021-02-18,Alameda,001,1643700,79945,79111,1660,80771,1012
2021-02-18,Alpine,003,1148,78,77,0,77,0
2021-02-18,Amador,005,37829,3435,3417,28,3445,38
2021-02-18,Butte,007,227075,11216,10791,1604,12395,175
2021-02-18,Calaveras,009,45235,1883,1873,11,1884,21
2021-02-18,Colusa,011,21464,1863,1856,256,2112,11
2021-02-18,Contra Costa,013,1133247,62312,60868,1041,61909,640
2021-02-18,Del Norte,015,27424,981,929,4,933,2
2021-02-18,El Dorado,017,186661,9057,8850,600,9450,94
2021-02-18,Fresno,019,978130,95315,93734,7478,101212,1323
2021-02-18,Glenn,021,27897,2225,2195,482,2677,14
2021-02-18,Humboldt,023,135768,3084,3023,22,3045,29
2021-02-18,Imperial,025,180216,27121,26731,2402,29133,591
2021-02-18,Inyo,027,18085,1267,1213,8,1221,32
2021-02-18,Kern,029,883053,92567,90655,9483,100138,961
2021-02-18,Kings,031,150075,22095,21648,938,22586,211
2021-02-18,Lake,033,64148,3138,3066,6,3072,40
2021-02-18,Lassen,035,31185,5095,5052,92,5144,1
2021-02-18,Los Angeles,037,10098052,1167018,1141930,37691,1179621,19358
2021-02-18,Madera,039,155013,15450,15175,790,15965,188
2021-02-18,Marin,041,260295,13065,12895,150,13045,209
2021-02-18,Mariposa,043,17540,375,369,5,374,4
2021-02-18,Mendocino,045,87422,3607,3519,70,3589,39
2021-02-18,Merced,047,269075,28023,27870,868,28738,372
2021-02-18,Modoc,049,8938,331,327,111,438,3
2021-02-18,Mono,051,14174,1174,1182,16,1198,3
2021-02-18,Monterey,053,433212,41661,41091,1618,42709,307
2021-02-18,Napa,055,140530,8917,8877,31,8908,68
2021-02-18,Nevada,057,99092,3939,3836,155,3991,66
2021-02-18,Orange,059,3164182,245682,243098,10001,253099,3673
2021-02-18,Placer,061,380077,20327,19429,1071,20500,232
2021-02-18,Plumas,063,18699,638,624,10,634,4
2021-02-18,Riverside,065,2383286,283915,276595,13148,289743,3510
2021-02-18,Sacramento,067,1510023,93368,91476,1182,92658,1334
2021-02-18,San Benito,069,59416,5696,5697,83,5780,58
2021-02-18,San Bernardino,071,2135413,284753,278887,8406,287293,3066
2021-02-18,San Diego,073,3302833,261582,254987,12644,267631,3135
2021-02-18,San Francisco,075,870044,33808,33650,1020,34670,386
2021-02-18,San Joaquin,077,732212,66121,64634,2644,67278,982
2021-02-18,San Luis Obispo,079,281455,19485,18987,534,19521,230
2021-02-18,San Mateo,081,765935,39093,38185,390,38575,282
2021-02-18,Santa Barbara,083,443738,31831,31054,1007,32061,387
2021-02-18,Santa Clara,085,1922200,108945,108210,540,108750,1605
2021-02-18,Santa Cruz,087,273765,15265,14314,760,15074,176
2021-02-18,Shasta,089,179085,10845,10811,1181,11992,139
2021-02-18,Sierra,091,2930,50,47,12,59,0
2021-02-18,Siskiyou,093,43540,1461,1359,216,1575,4
2021-02-18,Solano,095,438530,29584,29349,344,29693,150
2021-02-18,Sonoma,097,501317,27651,27512,186,27698,281
2021-02-18,Stanislaus,099,539301,50060,49150,5175,54325,738
2021-02-18,Sutter,101,95872,8745,8654,77,8731,96
2021-02-18,Tehama,103,63373,4569,4528,480,5008,30
2021-02-18,Trinity,105,12862,461,282,70,352,3
2021-02-18,Tulare,107,460477,47824,46591,7639,54230,728
2021-02-18,Tuolumne,109,53932,3771,3811,36,3847,52
2021-02-18,Ventura,111,848112,77029,76442,2697,79139,659
2021-02-18,Yolo,113,214977,12716,12549,148,12697,183
2021-02-18,Yuba,115,75493,5432,5358,81,5439,38
2021-02-17,Alameda,001,1643700,79783,78895,1658,80553,1002
2021-02-17,Alpine,003,1148,78,77,0,77,0
2021-02-17,Amador,005,37829,3431,3415,28,3443,38
2021-02-17,Butte,007,227075,11198,10770,1600,12370,174
2021-02-17,Calaveras,009,45235,1883,1876,11,1887,21
2021-02-17,Colusa,011,21464,1860,1854,256,2110,10
2021-02-17,Contra Costa,013,1133247,62174,60723,1038,61761,635
2021-02-17,Del Norte,015,27424,974,920,4,924,2
2021-02-17,El Dorado,017,186661,9046,8847,600,9447,94
2021-02-17,Fresno,019,978130,95176,93555,7451,101006,1307
2021-02-17,Glenn,021,27897,2224,2189,481,2670,14
2021-02-17,Humboldt,023,135768,3069,3006,22,3028,29
2021-02-17,Imperial,025,180216,27107,26726,2398,29124,580
2021-02-17,Inyo,027,18085,1259,1197,8,1205,32
2021-02-17,Kern,029,883053,92449,90454,9439,99893,962
2021-02-17,Kings,031,150075,22057,21617,934,22551,211
2021-02-17,Lake,033,64148,3128,3057,2,3059,38
2021-02-17,Lassen,035,31185,5090,5052,91,5143,1
2021-02-17,Los Angeles,037,10098052,1165963,1139786,37629,1177415,19213
2021-02-17,Madera,039,155013,15425,15135,781,15916,177
2021-02-17,Marin,041,260295,13040,12881,150,13031,207
2021-02-17,Mariposa,043,17540,375,368,4,372,4
2021-02-17,Mendocino,045,87422,3605,3494,69,3563,39
2021-02-17,Merced,047,269075,27968,27824,859,28683,372
2021-02-17,Modoc,049,8938,331,327,111,438,3
2021-02-17,Mono,051,14174,1174,1180,16,1196,3
2021-02-17,Monterey,053,433212,41606,41014,1607,42621,304
2021-02-17,Napa,055,140530,8903,8865,31,8896,68
2021-02-17,Nevada,057,99092,3920,3822,152,3974,52
2021-02-17,Orange,059,3164182,245421,242716,9968,252684,3626
2021-02-17,Placer,061,380077,20293,19405,1067,20472,230
2021-02-17,Plumas,063,18699,637,623,10,633,4
2021-02-17,Riverside,065,2383286,283627,276289,13127,289416,3491
2021-02-17,Sacramento,067,1510023,93209,91309,1175,92484,1326
2021-02-17,San Benito,069,59416,5690,5661,83,5744,57
2021-02-17,San Bernardino,071,2135413,284550,278461,8386,286847,3020
2021-02-17,San Diego,073,3302833,261204,254177,12623,266800,3099
2021-02-17,San Francisco,075,870044,33732,33558,1015,34573,379
2021-02-17,San Joaquin,077,732212,66015,64556,2638,67194,979
2021-02-17,San Luis Obispo,079,281455,19440,18964,534,19498,230
2021-02-17,San Mateo,081,765935,39029,38124,390,38514,282
2021-02-17,Santa Barbara,083,443738,31763,30927,1006,31933,384
2021-02-17,Santa Clara,085,1922200,108713,107949,538,108487,1592
2021-02-17,Santa Cruz,087,273765,15232,14268,757,15025,174
2021-02-17,Shasta,089,179085,10825,10770,1180,11950,139
2021-02-17,Sierra,091,2930,50,47,12,59,0
2021-02-17,Siskiyou,093,43540,1455,1352,213,1565,4
2021-02-17,Solano,095,438530,29527,29288,344,29632,149
2021-02-17,Sonoma,097,501317,27579,27408,181,27589,281
2021-02-17,Stanislaus,099,539301,49947,49050,5159,54209,730
2021-02-17,Sutter,101,95872,8735,8681,77,8758,95
2021-02-17,Tehama,103,63373,4566,4511,480,4991,30
2021-02-17,Trinity,105,12862,461,277,68,345,3
2021-02-17,Tulare,107,460477,47759,46495,7614,54109,726
2021-02-17,Tuolumne,109,53932,3762,3806,36,3842,49
2021-02-17,Ventura,111,848112,76907,76234,2691,78925,646
2021-02-17,Yolo,113,214977,12697,12506,146,12652,182
2021-02-17,Yuba,115,75493,5423,5345,81,5426,38
2021-02-16,Alameda,001,1643700,79614,78756,1655,80411,997
2021-02-16,Alpine,003,1148,78,76,0,76,0
2021-02-16,Amador,005,37829,3424,3413,28,3441,39
2021-02-16,Butte,007,227075,11173,10748,1597,12345,164
2021-02-16,Calaveras,009,45235,1881,1872,11,1883,21
2021-02-16,Colusa,011,21464,1857,1852,254,2106,10
2021-02-16,Contra Costa,013,1133247,62023,60564,1033,61597,631
2021-02-16,Del Norte,015,27424,966,913,4,917,2
2021-02-16,El Dorado,017,186661,9036,8836,598,9434,94
2021-02-16,Fresno,019,978130,95011,93363,7421,100784,1293
2021-02-16,Glenn,021,27897,2220,2189,477,2666,14
2021-02-16,Humboldt,023,135768,3046,2994,21,3015,29
2021-02-16,Imperial,025,180216,27094,26711,2394,29105,580
2021-02-16,Inyo,027,18085,1251,1191,8,1199,32
2021-02-16,Kern,029,883053,92317,90267,9409,99676,959
2021-02-16,Kings,031,150075,22011,21583,930,22513,206
2021-02-16,Lake,033,64148,3121,3041,2,3043,38
2021-02-16,Lassen,035,31185,5078,5047,91,5138,1
2021-02-16,Los Angeles,037,10098052,1164709,1138262,37569,1175831,19044
2021-02-16,Madera,039,155013,15387,15120,776,15896,172
2021-02-16,Marin,041,260295,13012,12832,150,12982,205
2021-02-16,Mariposa,043,17540,375,367,4,371,4
2021-02-16,Mendocino,045,87422,3601,3489,69,3558,39
2021-02-16,Merced,047,269075,27887,27724,853,28577,368
2021-02-16,Modoc,049,8938,331,326,111,437,3
2021-02-16,Mono,051,14174,1174,1180,16,1196,3
2021-02-16,Monterey,053,433212,41530,40962,1598,42560,303
2021-02-16,Napa,055,140530,8890,8854,31,8885,66
2021-02-16,Nevada,057,99092,3907,3774,151,3925,47
2021-02-16,Orange,059,3164182,245100,242382,9952,252334,3612
2021-02-16,Placer,061,380077,20260,19367,1064,20431,230
2021-02-16,Plumas,063,18699,637,619,10,629,4
2021-02-16,Riverside,065,2383286,283320,275954,13105,289059,3471
2021-02-16,Sacramento,067,1510023,92955,91246,1169,92415,1305
2021-02-16,San Benito,069,59416,5682,5659,82,5741,56
2021-02-16,San Bernardino,071,2135413,284327,277947,8377,286324,2978
2021-02-16,San Diego,073,3302833,260739,253638,12584,266222,3042
2021-02-16,San Francisco,075,870044,33660,33491,1010,34501,373
2021-02-16,San Joaquin,077,732212,65885,64448,2635,67083,979
2021-02-16,San Luis Obispo,079,281455,19395,18925,531,19456,229
2021-02-16,San Mateo,081,765935,38970,38041,388,38429,277
2021-02-16,Santa Barbara,083,443738,31689,30865,1003,31868,378
2021-02-16,Santa Clara,085,1922200,108461,107754,535,108289,1591
2021-02-16,Santa Cruz,087,273765,15212,14256,756,15012,174
2021-02-16,Shasta,089,179085,10810,10736,1178,11914,139
2021-02-16,Sierra,091,2930,50,47,12,59,0
2021-02-16,Siskiyou,093,43540,1451,1351,213,1564,4
2021-02-16,Solano,095,438530,29489,29246,343,29589,148
2021-02-16,Sonoma,097,501317,27520,27380,175,27555,279
2021-02-16,Stanislaus,099,539301,49823,48927,5145,54072,716
2021-02-16,Sutter,101,95872,8712,8671,77,8748,95
2021-02-16,Tehama,103,63373,4557,4501,478,4979,30
2021-02-16,Trinity,105,12862,457,275,68,343,3
2021-02-16,Tulare,107,460477,47695,46444,7571,54015,716
2021-02-16,Tuolumne,109,53932,3760,3796,36,3832,49
2021-02-16,Ventura,111,848112,76765,76043,2688,78731,631
2021-02-16,Yolo,113,214977,12668,12457,146,12603,175
2021-02-16,Yuba,115,75493,5416,5332,80,5412,38
2021-02-15,Alameda,001,1643700,79417,78647,1644,80291,996
2021-02-15,Alpine,003,1148,78,76,0,76,0
2021-02-15,Amador,005,37829,3420,3409,28,3437,39
2021-02-15,Butte,007,227075,11155,10723,1593,12316,155
2021-02-15,Calaveras,009,45235,1877,1871,11,1882,21
2021-02-15,Colusa,011,21464,1857,1849,250,2099,10
2021-02-15,Contra Costa,013,1133247,61852,60444,1028,61472,631
2021-02-15,Del Norte,015,27424,962,913,4,917,2
2021-02-15,El Dorado,017,186661,9019,8816,598,9414,94
2021-02-15,Fresno,019,978130,94812,93231,7382,100613,1288
2021-02-15,Glenn,021,27897,2218,2185,476,2661,14
2021-02-15,Humboldt,023,135768,3039,2997,21,3018,29
2021-02-15,Imperial,025,180216,27074,26700,2391,29091,580
2021-02-15,Inyo,027,18085,1232,1184,8,1192,32
2021-02-15,Kern,029,883053,92173,90181,9378,99559,959
2021-02-15,Kings,031,150075,21966,21574,925,22499,205
2021-02-15,Lake,033,64148,3107,3030,1,3031,38
2021-02-15,Lassen,035,31185,5076,5047,90,5137,1
2021-02-15,Los Angeles,037,10098052,1163322,1137164,37508,1174672,18925
2021-02-15,Madera,039,155013,15356,15108,774,15882,106
2021-02-15,Marin,041,260295,12991,12810,147,12957,203
2021-02-15,Mariposa,043,17540,373,367,4,371,4
2021-02-15,Mendocino,045,87422,3589,3481,69,3550,39
2021-02-15,Merced,047,269075,27813,27656,846,28502,368
2021-02-15,Modoc,049,8938,331,326,111,437,3
2021-02-15,Mono,051,14174,1171,1178,16,1194,3
2021-02-15,Monterey,053,433212,41466,40911,1586,42497,302
2021-02-15,Napa,055,140530,8876,8837,31,8868,57
2021-02-15,Nevada,057,99092,3890,3767,150,3917,47
2021-02-15,Orange,059,3164182,244781,242176,9924,252100,3586
2021-02-15,Placer,061,380077,20234,19361,1063,20424,230
2021-02-15,Plumas,063,18699,637,620,10,630,4
2021-02-15,Riverside,065,2383286,282967,275771,13086,288857,3468
2021-02-15,Sacramento,067,1510023,92628,91091,1164,92255,1304
2021-02-15,San Benito,069,59416,5676,5649,82,5731,56
2021-02-15,San Bernardino,071,2135413,284076,277869,8369,286238,2945
2021-02-15,San Diego,073,3302833,260226,252940,12553,265493,3037
2021-02-15,San Francisco,075,870044,33587,33454,1004,34458,373
2021-02-15,San Joaquin,077,732212,65720,64382,2628,67010,979
2021-02-15,San Luis Obispo,079,281455,19342,18891,529,19420,227
2021-02-15,San Mateo,081,765935,38891,37969,385,38354,277
2021-02-15,Santa Barbara,083,443738,31586,30810,1000,31810,378
2021-02-15,Santa Clara,085,1922200,108231,107630,533,108163,1588
2021-02-15,Santa Cruz,087,273765,15180,14239,753,14992,175
2021-02-15,Shasta,089,179085,10790,10730,1173,11903,139
2021-02-15,Sierra,091,2930,50,47,12,59,0
2021-02-15,Siskiyou,093,43540,1443,1345,212,1557,4
2021-02-15,Solano,095,438530,29434,29225,343,29568,148
2021-02-15,Sonoma,097,501317,27436,27359,171,27530,276
2021-02-15,Stanislaus,099,539301,49696,48808,5132,53940,716
2021-02-15,Sutter,101,95872,8697,8652,77,8729,95
2021-02-15,Tehama,103,63373,4548,4492,477,4969,30
2021-02-15,Trinity,105,12862,456,274,68,342,3
2021-02-15,Tulare,107,460477,47624,46344,7532,53876,715
2021-02-15,Tuolumne,109,53932,3750,3794,36,3830,49
2021-02-15,Ventura,111,848112,76610,75889,2685,78574,629
2021-02-15,Yolo,113,214977,12632,12412,145,12557,175
2021-02-15,Yuba,115,75493,5399,5320,79,5399,38
2021-02-14,Alameda,001,1643700,79265,78442,1643,80085,995
2021-02-14,Alpine,003,1148,78,76,0,76,0
2021-02-14,Amador,005,37829,3415,3398,28,3426,39
2021-02-14,Butte,007,227075,11131,10717,1590,12307,155
2021-02-14,Calaveras,009,45235,1873,1866,11,1877,21
2021-02-14,Colusa,011,21464,1853,1845,247,2092,10
2021-02-14,Contra Costa,013,1133247,61702,60272,1025,61297,631
2021-02-14,Del Norte,015,27424,958,911,4,915,2
2021-02-14,El Dorado,017,186661,8987,8790,597,9387,94
2021-02-14,Fresno,019,978130,94641,93065,7359,100424,1287
2021-02-14,Glenn,021,27897,2215,2184,476,2660,14
2021-02-14,Humboldt,023,135768,3026,2992,21,3013,29
2021-02-14,Imperial,025,180216,27067,26696,2390,29086,580
2021-02-14,Inyo,027,18085,1226,1177,8,1185,32
2021-02-14,Kern,029,883053,92013,90038,9325,99363,959
2021-02-14,Kings,031,150075,21940,21538,923,22461,205
2021-02-14,Lake,033,64148,3096,3030,1,3031,38
2021-02-14,Lassen,035,31185,5072,5037,90,5127,1
2021-02-14,Los Angeles,037,10098052,1161976,1135450,37428,1172878,18898
2021-02-14,Madera,039,155013,15324,15089,770,15859,106
2021-02-14,Marin,041,260295,12967,12784,147,12931,201
2021-02-14,Mariposa,043,17540,373,365,4,369,4
2021-02-14,Mendocino,045,87422,3583,3475,69,3544,39
2021-02-14,Merced,047,269075,27731,27601,841,28442,368
2021-02-14,Modoc,049,8938,331,326,111,437,3
2021-02-14,Mono,051,14174,1170,1180,16,1196,3
2021-02-14,Monterey,053,433212,41415,40842,1581,42423,302
2021-02-14,Napa,055,140530,8856,8826,31,8857,57
2021-02-14,Nevada,057,99092,3874,3761,150,3911,47
2021-02-14,Orange,059,3164182,244472,241859,9906,251765,3564
2021-02-14,Placer,061,380077,20195,19313,1058,20371,230
2021-02-14,Plumas,063,18699,636,620,10,630,4
2021-02-14,Riverside,065,2383286,282636,275518,13067,288585,3471
2021-02-14,Sacramento,067,1510023,92421,90856,1160,92016,1304
2021-02-14,San Benito,069,59416,5667,5641,81,5722,56
2021-02-14,San Bernardino,071,2135413,283770,277664,8349,286013,2929
2021-02-14,San Diego,073,3302833,259734,252247,12506,264753,3037
2021-02-14,San Francisco,075,870044,33513,33374,996,34370,372
2021-02-14,San Joaquin,077,732212,65622,64243,2614,66857,979
2021-02-14,San Luis Obispo,079,281455,19304,18868,526,19394,225
2021-02-14,San Mateo,081,765935,38806,37859,385,38244,277
2021-02-14,Santa Barbara,083,443738,31494,30744,996,31740,377
2021-02-14,Santa Clara,085,1922200,108032,107412,529,107941,1582
2021-02-14,Santa Cruz,087,273765,15152,14225,748,14973,175
2021-02-14,Shasta,089,179085,10758,10720,1169,11889,139
2021-02-14,Sierra,091,2930,50,47,12,59,0
2021-02-14,Siskiyou,093,43540,1439,1340,212,1552,4
2021-02-14,Solano,095,438530,29392,29150,340,29490,148
2021-02-14,Sonoma,097,501317,27361,27266,169,27435,276
2021-02-14,Stanislaus,099,539301,49586,48672,5117,53789,716
2021-02-14,Sutter,101,95872,8674,8642,77,8719,95
2021-02-14,Tehama,103,63373,4542,4490,474,4964,30
2021-02-14,Trinity,105,12862,456,272,68,340,3
2021-02-14,Tulare,107,460477,47539,46263,7482,53745,715
2021-02-14,Tuolumne,109,53932,3749,3764,36,3800,49
2021-02-14,Ventura,111,848112,76441,75742,2674,78416,629
2021-02-14,Yolo,113,214977,12603,12399,144,12543,175
2021-02-14,Yuba,115,75493,5389,5314,79,5393,38
2021-02-13,Alameda,001,1643700,79143,78246,1640,79886,995
2021-02-13,Alpine,003,1148,78,76,0,76,0
2021-02-13,Amador,005,37829,3412,3387,28,3415,38
2021-02-13,Butte,007,227075,11115,10699,1588,12287,155
2021-02-13,Calaveras,009,45235,1870,1863,11,1874,21
2021-02-13,Colusa,011,21464,1853,1837,247,2084,10
2021-02-13,Contra Costa,013,1133247,61581,60100,1025,61125,629
2021-02-13,Del Norte,015,27424,956,908,4,912,2
2021-02-13,El Dorado,017,186661,8975,8758,596,9354,93
2021-02-13,Fresno,019,978130,94527,92807,7337,100144,1287
2021-02-13,Glenn,021,27897,2214,2182,474,2656,14
2021-02-13,Humboldt,023,135768,3013,2974,20,2994,29
2021-02-13,Imperial,025,180216,27060,26680,2388,29068,580
2021-02-13,Inyo,027,18085,1222,1168,8,1176,32
2021-02-13,Kern,029,883053,91924,89915,9299,99214,957
2021-02-13,Kings,031,150075,21925,21513,921,22434,205
2021-02-13,Lake,033,64148,3087,3025,1,3026,37
2021-02-13,Lassen,035,31185,5069,5028,90,5118,1
2021-02-13,Los Angeles,037,10098052,1161117,1133752,37382,1171134,18822
2021-02-13,Madera,039,155013,15315,15053,766,15819,106
2021-02-13,Marin,041,260295,12943,12757,147,12904,201
2021-02-13,Mariposa,043,17540,373,365,4,369,4
2021-02-13,Mendocino,045,87422,3573,3466,69,3535,38
2021-02-13,Merced,047,269075,27687,27541,838,28379,368
2021-02-13,Modoc,049,8938,331,325,111,436,3
2021-02-13,Mono,051,14174,1170,1176,16,1192,3
2021-02-13,Monterey,053,433212,41383,40731,1580,42311,301
2021-02-13,Napa,055,140530,8847,8809,31,8840,57
2021-02-13,Nevada,057,99092,3865,3742,149,3891,47
2021-02-13,Orange,059,3164182,244266,241545,9887,251432,3520
2021-02-13,Placer,061,380077,20175,19214,1058,20272,230
2021-02-13,Plumas,063,18699,636,616,10,626,4
2021-02-13,Riverside,065,2383286,282407,275276,13058,288334,3462
2021-02-13,Sacramento,067,1510023,92254,90401,1157,91558,1302
2021-02-13,San Benito,069,59416,5650,5633,81,5714,56
2021-02-13,San Bernardino,071,2135413,283618,277405,8336,285741,2899
2021-02-13,San Diego,073,3302833,259402,251679,12494,264173,3009
2021-02-13,San Francisco,075,870044,33463,33291,986,34277,364
2021-02-13,San Joaquin,077,732212,65553,64105,2604,66709,977
2021-02-13,San Luis Obispo,079,281455,19276,18803,520,19323,225
2021-02-13,San Mateo,081,765935,38753,37745,385,38130,277
2021-02-13,Santa Barbara,083,443738,31442,30594,995,31589,374
2021-02-13,Santa Clara,085,1922200,107843,107125,526,107651,1570
2021-02-13,Santa Cruz,087,273765,15125,14198,747,14945,173
2021-02-13,Shasta,089,179085,10745,10713,1164,11877,139
2021-02-13,Sierra,091,2930,50,47,12,59,0
2021-02-13,Siskiyou,093,43540,1436,1336,212,1548,4
2021-02-13,Solano,095,438530,29356,29084,340,29424,148
2021-02-13,Sonoma,097,501317,27313,27157,167,27324,276
2021-02-13,Stanislaus,099,539301,49515,48568,5111,53679,697
2021-02-13,Sutter,101,95872,8662,8626,77,8703,94
2021-02-13,Tehama,103,63373,4532,4484,473,4957,30
2021-02-13,Trinity,105,12862,455,272,67,339,3
2021-02-13,Tulare,107,460477,47488,46162,7451,53613,709
2021-02-13,Tuolumne,109,53932,3748,3752,36,3788,49
2021-02-13,Ventura,111,848112,76301,75481,2668,78149,618
2021-02-13,Yolo,113,214977,12590,12374,143,12517,175
2021-02-13,Yuba,115,75493,5381,5289,79,5368,38
2021-02-12,Alameda,001,1643700,78994,77958,1634,79592,974
2021-02-12,Alpine,003,1148,78,76,0,76,0
2021-02-12,Amador,005,37829,3408,3381,28,3409,38
2021-02-12,Butte,007,227075,11102,10655,1581,12236,155
2021-02-12,Calaveras,009,45235,1867,1860,11,1871,21
2021-02-12,Colusa,011,21464,1853,1836,247,2083,10
2021-02-12,Contra Costa,013,1133247,61431,59878,1021,60899,620
2021-02-12,Del Norte,015,27424,946,901,4,905,2
2021-02-12,El Dorado,017,186661,8960,8725,593,9318,92
2021-02-12,Fresno,019,978130,94373,92520,7317,99837,1273
2021-02-12,Glenn,021,27897,2211,2175,474,2649,14
2021-02-12,Humboldt,023,135768,3005,2961,20,2981,29
2021-02-12,Imperial,025,180216,27053,26646,2385,29031,585
2021-02-12,Inyo,027,18085,1216,1156,8,1164,32
2021-02-12,Kern,029,883053,91810,89532,9267,98799,949
2021-02-12,Kings,031,150075,21893,21462,916,22378,202
2021-02-12,Lake,033,64148,3082,3012,1,3013,36
2021-02-12,Lassen,035,31185,5067,5015,90,5105,1
2021-02-12,Los Angeles,037,10098052,1159905,1131185,37315,1168500,18637
2021-02-12,Madera,039,155013,15288,15022,763,15785,106
2021-02-12,Marin,041,260295,12917,12720,147,12867,200
2021-02-12,Mariposa,043,17540,372,365,4,369,4
2021-02-12,Mendocino,045,87422,3571,3447,69,3516,38
2021-02-12,Merced,047,269075,27636,27453,835,28288,367
2021-02-12,Modoc,049,8938,331,324,111,435,3
2021-02-12,Mono,051,14174,1169,1172,16,1188,3
2021-02-12,Monterey,053,433212,41335,40633,1571,42204,297
2021-02-12,Napa,055,140530,8835,8785,31,8816,55
2021-02-12,Nevada,057,99092,3860,3728,149,3877,47
2021-02-12,Orange,059,3164182,244027,241075,9872,250947,3505
2021-02-12,Placer,061,380077,20133,19174,1053,20227,230
2021-02-12,Plumas,063,18699,635,614,10,624,4
2021-02-12,Riverside,065,2383286,282129,274792,13043,287835,3438
2021-02-12,Sacramento,067,1510023,92052,90252,1156,91408,1295
2021-02-12,San Benito,069,59416,5634,5622,80,5702,56
2021-02-12,San Bernardino,071,2135413,283428,276890,8325,285215,2827
2021-02-12,San Diego,073,3302833,259014,250788,12468,263256,2979
2021-02-12,San Francisco,075,870044,33403,33179,982,34161,359
2021-02-12,San Joaquin,077,732212,65457,63966,2596,66562,975
2021-02-12,San Luis Obispo,079,281455,19235,18687,519,19206,224
2021-02-12,San Mateo,081,765935,38681,37560,385,37945,254
2021-02-12,Santa Barbara,083,443738,31371,30454,990,31444,372
2021-02-12,Santa Clara,085,1922200,107671,106759,523,107282,1543
2021-02-12,Santa Cruz,087,273765,15105,14147,747,14894,170
2021-02-12,Shasta,089,179085,10727,10693,1154,11847,142
2021-02-12,Sierra,091,2930,49,45,12,57,0
2021-02-12,Siskiyou,093,43540,1432,1324,209,1533,4
2021-02-12,Solano,095,438530,29324,28996,337,29333,147
2021-02-12,Sonoma,097,501317,27258,27064,163,27227,275
2021-02-12,Stanislaus,099,539301,49427,48418,5089,53507,697
2021-02-12,Sutter,101,95872,8649,8609,77,8686,93
2021-02-12,Tehama,103,63373,4525,4470,472,4942,27
2021-02-12,Trinity,105,12862,455,269,67,336,3
2021-02-12,Tulare,107,460477,47410,46016,7425,53441,710
2021-02-12,Tuolumne,109,53932,3745,3736,35,3771,49
2021-02-12,Ventura,111,848112,76131,75210,2662,77872,605
2021-02-12,Yolo,113,214977,12569,12340,143,12483,175
2021-02-12,Yuba,115,75493,5373,5274,79,5353,38
2021-02-11,Alameda,001,1643700,78768,77564,1629,79193,960
2021-02-11,Alpine,003,1148,77,76,0,76,0
2021-02-11,Amador,005,37829,3404,3368,28,3396,35
2021-02-11,Butte,007,227075,11079,10624,1580,12204,155
2021-02-11,Calaveras,009,45235,1864,1856,11,1867,21
2021-02-11,Colusa,011,21464,1848,1823,245,2068,10
2021-02-11,Contra Costa,013,1133247,61263,59633,1017,60650,605
2021-02-11,Del Norte,015,27424,941,894,4,898,2
2021-02-11,El Dorado,017,186661,8939,8698,593,9291,92
2021-02-11,Fresno,019,978130,94220,92168,7294,99462,1255
2021-02-11,Glenn,021,27897,2206,2166,473,2639,14
2021-02-11,Humboldt,023,135768,2992,2954,19,2973,29
2021-02-11,Imperial,025,180216,27029,26545,2383,28928,578
2021-02-11,Inyo,027,18085,1207,1144,8,1152,32
2021-02-11,Kern,029,883053,91619,89224,9224,98448,941
2021-02-11,Kings,031,150075,21863,21373,913,22286,202
2021-02-11,Lake,033,64148,3072,3002,1,3003,36
2021-02-11,Lassen,035,31185,5056,5004,87,5091,1
2021-02-11,Los Angeles,037,10098052,1158277,1128437,37245,1165682,18500
2021-02-11,Madera,039,155013,15267,14984,761,15745,106
2021-02-11,Marin,041,260295,12880,12682,147,12829,200
2021-02-11,Mariposa,043,17540,372,361,4,365,4
2021-02-11,Mendocino,045,87422,3564,3420,69,3489,38
2021-02-11,Merced,047,269075,27570,27325,831,28156,363
2021-02-11,Modoc,049,8938,330,317,111,428,3
2021-02-11,Mono,051,14174,1165,1173,16,1189,3
2021-02-11,Monterey,053,433212,41229,40469,1565,42034,295
2021-02-11,Napa,055,140530,8814,8777,31,8808,55
2021-02-11,Nevada,057,99092,3844,3720,149,3869,47
2021-02-11,Orange,059,3164182,243660,240590,9848,250438,3476
2021-02-11,Placer,061,380077,20093,19118,1052,20170,224
2021-02-11,Plumas,063,18699,634,592,10,602,4
2021-02-11,Riverside,065,2383286,281762,274313,13028,287341,3394
2021-02-11,Sacramento,067,1510023,91809,89988,1150,91138,1286
2021-02-11,San Benito,069,59416,5625,5609,80,5689,56
2021-02-11,San Bernardino,071,2135413,283130,276349,8311,284660,2774
2021-02-11,San Diego,073,3302833,258461,249971,12434,262405,2955
2021-02-11,San Francisco,075,870044,33320,33076,973,34049,356
2021-02-11,San Joaquin,077,732212,65289,63719,2586,66305,971
2021-02-11,San Luis Obispo,079,281455,19170,18615,515,19130,219
2021-02-11,San Mateo,081,765935,38589,37439,383,37822,253
2021-02-11,Santa Barbara,083,443738,31273,30375,985,31360,370
2021-02-11,Santa Clara,085,1922200,107411,106392,518,106910,1507
2021-02-11,Santa Cruz,087,273765,15082,14088,742,14830,165
2021-02-11,Shasta,089,179085,10703,10672,1150,11822,140
2021-02-11,Sierra,091,2930,49,45,12,57,0
2021-02-11,Siskiyou,093,43540,1417,1320,209,1529,4
2021-02-11,Solano,095,438530,29271,28885,337,29222,138
2021-02-11,Sonoma,097,501317,27173,26971,160,27131,272
2021-02-11,Stanislaus,099,539301,49282,48205,5077,53282,697
2021-02-11,Sutter,101,95872,8635,8590,76,8666,93
2021-02-11,Tehama,103,63373,4519,4463,472,4935,26
2021-02-11,Trinity,105,12862,455,269,67,336,3
2021-02-11,Tulare,107,460477,47315,45897,7386,53283,706
2021-02-11,Tuolumne,109,53932,3708,3716,35,3751,48
2021-02-11,Ventura,111,848112,75929,74959,2653,77612,590
2021-02-11,Yolo,113,214977,12545,12303,143,12446,173
2021-02-11,Yuba,115,75493,5359,5261,78,5339,38
2021-02-10,Alameda,001,1643700,78567,77344,1628,78972,944
2021-02-10,Alpine,003,1148,77,76,0,76,0
2021-02-10,Amador,005,37829,3392,3348,28,3376,35
2021-02-10,Butte,007,227075,11051,10594,1579,12173,155
2021-02-10,Calaveras,009,45235,1862,1850,11,1861,21
2021-02-10,Colusa,011,21464,1841,1815,243,2058,10
2021-02-10,Contra Costa,013,1133247,61088,59488,1015,60503,590
2021-02-10,Del Norte,015,27424,935,888,4,892,2
2021-02-10,El Dorado,017,186661,8908,8682,589,9271,87
2021-02-10,Fresno,019,978130,94045,91876,7269,99145,1247
2021-02-10,Glenn,021,27897,2202,2160,471,2631,14
2021-02-10,Humboldt,023,135768,2984,2924,19,2943,29
2021-02-10,Imperial,025,180216,26991,26522,2380,28902,578
2021-02-10,Inyo,027,18085,1195,1138,8,1146,30
2021-02-10,Kern,029,883053,91412,88933,9170,98103,926
2021-02-10,Kings,031,150075,21820,21294,911,22205,197
2021-02-10,Lake,033,64148,3059,2975,1,2976,36
2021-02-10,Lassen,035,31185,5052,4993,87,5080,1
2021-02-10,Los Angeles,037,10098052,1156528,1125437,37118,1162555,18338
2021-02-10,Madera,039,155013,15228,14925,759,15684,105
2021-02-10,Marin,041,260295,12843,12651,147,12798,199
2021-02-10,Mariposa,043,17540,370,360,4,364,4
2021-02-10,Mendocino,045,87422,3549,3395,69,3464,38
2021-02-10,Merced,047,269075,27487,27246,820,28066,359
2021-02-10,Modoc,049,8938,329,315,109,424,3
2021-02-10,Mono,051,14174,1160,1170,16,1186,3
2021-02-10,Monterey,053,433212,41152,40366,1551,41917,288
2021-02-10,Napa,055,140530,8795,8769,31,8800,55
2021-02-10,Nevada,057,99092,3829,3693,147,3840,47
2021-02-10,Orange,059,3164182,243242,239974,9817,249791,3439
2021-02-10,Placer,061,380077,20053,19062,1047,20109,220
2021-02-10,Plumas,063,18699,631,589,10,599,2
2021-02-10,Riverside,065,2383286,281334,273721,13018,286739,3374
2021-02-10,Sacramento,067,1510023,91558,89653,1146,90799,1275
2021-02-10,San Benito,069,59416,5611,5591,80,5671,55
2021-02-10,San Bernardino,071,2135413,282776,275616,8295,283911,2696
2021-02-10,San Diego,073,3302833,257879,248858,12396,261254,2904
2021-02-10,San Francisco,075,870044,33237,32955,970,33925,351
2021-02-10,San Joaquin,077,732212,65147,63484,2572,66056,954
2021-02-10,San Luis Obispo,079,281455,19091,18549,513,19062,216
2021-02-10,San Mateo,081,765935,38498,37323,383,37706,245
2021-02-10,Santa Barbara,083,443738,31182,30216,980,31196,359
2021-02-10,Santa Clara,085,1922200,107171,106048,515,106563,1489
2021-02-10,Santa Cruz,087,273765,15046,14007,740,14747,165
2021-02-10,Shasta,089,179085,10680,10645,1147,11792,142
2021-02-10,Sierra,091,2930,49,45,12,57,0
2021-02-10,Siskiyou,093,43540,1412,1314,208,1522,4
2021-02-10,Solano,095,438530,29196,28835,335,29170,137
2021-02-10,Sonoma,097,501317,27077,26881,158,27039,271
2021-02-10,Stanislaus,099,539301,49165,48016,5061,53077,696
2021-02-10,Sutter,101,95872,8618,8571,76,8647,93
2021-02-10,Tehama,103,63373,4511,4445,472,4917,23
2021-02-10,Trinity,105,12862,452,268,67,335,3
2021-02-10,Tulare,107,460477,47197,45782,7348,53130,696
2021-02-10,Tuolumne,109,53932,3700,3691,35,3726,48
2021-02-10,Ventura,111,848112,75701,74651,2636,77287,580
2021-02-10,Yolo,113,214977,12521,12276,143,12419,174
2021-02-10,Yuba,115,75493,5341,5241,78,5319,38
2021-02-09,Alameda,001,1643700,78305,77018,1624,78642,936
2021-02-09,Alpine,003,1148,77,76,0,76,0
2021-02-09,Amador,005,37829,3384,3347,28,3375,35
2021-02-09,Butte,007,227075,11025,10563,1576,12139,153
2021-02-09,Calaveras,009,45235,1858,1847,11,1858,21
2021-02-09,Colusa,011,21464,1832,1812,238,2050,10
2021-02-09,Contra Costa,013,1133247,60898,59307,1009,60316,583
2021-02-09,Del Norte,015,27424,929,886,4,890,2
2021-02-09,El Dorado,017,186661,8880,8663,587,9250,87
2021-02-09,Fresno,019,978130,93803,91730,7241,98971,1211
2021-02-09,Glenn,021,27897,2198,2156,471,2627,14
2021-02-09,Humboldt,023,135768,2976,2904,19,2923,29
2021-02-09,Imperial,025,180216,26961,26509,2377,28886,568
2021-02-09,Inyo,027,18085,1187,1137,8,1145,30
2021-02-09,Kern,029,883053,91160,88684,9124,97808,920
2021-02-09,Kings,031,150075,21778,21275,909,22184,196
2021-02-09,Lake,033,64148,3048,2955,1,2956,36
2021-02-09,Lassen,035,31185,5045,4983,87,5070,1
2021-02-09,Los Angeles,037,10098052,1154549,1122745,37037,1159782,18198
2021-02-09,Madera,039,155013,15208,14912,756,15668,105
2021-02-09,Marin,041,260295,12811,12623,146,12769,197
2021-02-09,Mariposa,043,17540,368,355,4,359,4
2021-02-09,Mendocino,045,87422,3531,3369,69,3438,38
2021-02-09,Merced,047,269075,27389,27166,815,27981,354
2021-02-09,Modoc,049,8938,328,316,109,425,3
2021-02-09,Mono,051,14174,1159,1167,16,1183,3
2021-02-09,Monterey,053,433212,41044,40279,1538,41817,285
2021-02-09,Napa,055,140530,8782,8749,31,8780,55
2021-02-09,Nevada,057,99092,3812,3687,147,3834,44
2021-02-09,Orange,059,3164182,242831,239169,9786,248955,3406
2021-02-09,Placer,061,380077,19988,19008,1040,20048,220
2021-02-09,Plumas,063,18699,631,584,10,594,2
2021-02-09,Riverside,065,2383286,280840,273465,13001,286466,3334
2021-02-09,Sacramento,067,1510023,91248,89378,1145,90523,1265
2021-02-09,San Benito,069,59416,5599,5566,79,5645,54
2021-02-09,San Bernardino,071,2135413,282405,274998,8282,283280,2613
2021-02-09,San Diego,073,3302833,257221,248048,12353,260401,2853
2021-02-09,San Francisco,075,870044,33157,32782,960,33742,349
2021-02-09,San Joaquin,077,732212,64972,63341,2567,65908,937
2021-02-09,San Luis Obispo,079,281455,19032,18489,512,19001,216
2021-02-09,San Mateo,081,765935,38367,37227,382,37609,235
2021-02-09,Santa Barbara,083,443738,31070,30118,974,31092,351
2021-02-09,Santa Clara,085,1922200,106865,105762,512,106274,1463
2021-02-09,Santa Cruz,087,273765,14995,13958,735,14693,162
2021-02-09,Shasta,089,179085,10652,10595,1145,11740,139
2021-02-09,Sierra,091,2930,49,44,12,56,0
2021-02-09,Siskiyou,093,43540,1404,1306,206,1512,4
2021-02-09,Solano,095,438530,29117,28769,332,29101,131
2021-02-09,Sonoma,097,501317,26987,26826,156,26982,267
2021-02-09,Stanislaus,099,539301,49005,47906,5046,52952,679
2021-02-09,Sutter,101,95872,8602,8541,76,8617,92
2021-02-09,Tehama,103,63373,4504,4416,471,4887,22
2021-02-09,Trinity,105,12862,452,266,67,333,3
2021-02-09,Tulare,107,460477,47063,45704,7296,53000,686
2021-02-09,Tuolumne,109,53932,3681,3673,35,3708,48
2021-02-09,Ventura,111,848112,75450,74333,2628,76961,567
2021-02-09,Yolo,113,214977,12479,12220,143,12363,174
2021-02-09,Yuba,115,75493,5332,5235,78,5313,35
2021-02-08,Alameda,001,1643700,78044,76735,1619,78354,924
2021-02-08,Alpine,003,1148,77,73,0,73,0
2021-02-08,Amador,005,37829,3377,3344,27,3371,33
2021-02-08,Butte,007,227075,11003,10524,1572,12096,152
2021-02-08,Calaveras,009,45235,1857,1840,11,1851,21
2021-02-08,Colusa,011,21464,1824,1802,234,2036,10
2021-02-08,Contra Costa,013,1133247,60687,59039,1007,60046,567
2021-02-08,Del Norte,015,27424,926,885,4,889,2
2021-02-08,El Dorado,017,186661,8848,8627,584,9211,86
2021-02-08,Fresno,019,978130,93591,91430,7216,98646,1207
2021-02-08,Glenn,021,27897,2194,2148,469,2617,14
2021-02-08,Humboldt,023,135768,2968,2902,19,2921,29
2021-02-08,Imperial,025,180216,26939,26526,2375,28901,567
2021-02-08,Inyo,027,18085,1174,1126,8,1134,30
2021-02-08,Kern,029,883053,90943,88380,9063,97443,920
2021-02-08,Kings,031,150075,21716,21232,906,22138,195
2021-02-08,Lake,033,64148,3029,2949,1,2950,36
2021-02-08,Lassen,035,31185,5032,4976,87,5063,1
2021-02-08,Los Angeles,037,10098052,1152452,1120179,36916,1157095,17977
2021-02-08,Madera,039,155013,15172,14887,749,15636,93
2021-02-08,Marin,041,260295,12781,12591,146,12737,194
2021-02-08,Mariposa,043,17540,368,355,4,359,4
2021-02-08,Mendocino,045,87422,3517,3355,69,3424,38
2021-02-08,Merced,047,269075,27306,27082,810,27892,346
2021-02-08,Modoc,049,8938,326,318,109,427,3
2021-02-08,Mono,051,14174,1159,1165,16,1181,3
2021-02-08,Monterey,053,433212,40924,40186,1519,41705,283
2021-02-08,Napa,055,140530,8767,8719,31,8750,55
2021-02-08,Nevada,057,99092,3800,3671,147,3818,44
2021-02-08,Orange,059,3164182,242364,238715,9763,248478,3361
2021-02-08,Placer,061,380077,19947,18944,1034,19978,211
2021-02-08,Plumas,063,18699,630,584,10,594,2
2021-02-08,Riverside,065,2383286,280272,272904,12975,285879,3301
2021-02-08,Sacramento,067,1510023,90962,89267,1142,90409,1247
2021-02-08,San Benito,069,59416,5594,5553,78,5631,52
2021-02-08,San Bernardino,071,2135413,282002,274661,8276,282937,2587
2021-02-08,San Diego,073,3302833,256478,247259,12312,259571,2821
2021-02-08,San Francisco,075,870044,33063,32679,952,33631,348
2021-02-08,San Joaquin,077,732212,64811,63148,2557,65705,929
2021-02-08,San Luis Obispo,079,281455,18975,18421,507,18928,214
2021-02-08,San Mateo,081,765935,38258,37084,382,37466,232
2021-02-08,Santa Barbara,083,443738,30955,29978,967,30945,340
2021-02-08,Santa Clara,085,1922200,106542,105413,504,105917,1456
2021-02-08,Santa Cruz,087,273765,14956,13921,729,14650,161
2021-02-08,Shasta,089,179085,10625,10574,1139,11713,137
2021-02-08,Sierra,091,2930,49,44,12,56,0
2021-02-08,Siskiyou,093,43540,1401,1303,206,1509,4
2021-02-08,Solano,095,438530,29051,28644,330,28974,130
2021-02-08,Sonoma,097,501317,26896,26760,155,26915,259
2021-02-08,Stanislaus,099,539301,48850,47704,5018,52722,679
2021-02-08,Sutter,101,95872,8583,8526,76,8602,92
2021-02-08,Tehama,103,63373,4494,4403,468,4871,22
2021-02-08,Trinity,105,12862,450,266,67,333,3
2021-02-08,Tulare,107,460477,46955,45617,7256,52873,673
2021-02-08,Tuolumne,109,53932,3673,3647,35,3682,48
2021-02-08,Ventura,111,848112,75193,74068,2623,76691,565
2021-02-08,Yolo,113,214977,12447,12169,142,12311,162
2021-02-08,Yuba,115,75493,5316,5215,78,5293,35
2021-02-07,Alameda,001,1643700,77743,76500,1611,78111,924
2021-02-07,Alpine,003,1148,74,72,0,72,0
2021-02-07,Amador,005,37829,3356,3343,27,3370,33
2021-02-07,Butte,007,227075,10971,10513,1564,12077,152
2021-02-07,Calaveras,009,45235,1853,1837,11,1848,21
2021-02-07,Colusa,011,21464,1813,1795,232,2027,10
2021-02-07,Contra Costa,013,1133247,60443,58836,1002,59838,566
2021-02-07,Del Norte,015,27424,922,881,4,885,2
2021-02-07,El Dorado,017,186661,8819,8596,582,9178,86
2021-02-07,Fresno,019,978130,93360,91184,7178,98362,1207
2021-02-07,Glenn,021,27897,2190,2141,464,2605,14
2021-02-07,Humboldt,023,135768,2947,2895,19,2914,28
2021-02-07,Imperial,025,180216,26910,26518,2370,28888,567
2021-02-07,Inyo,027,18085,1163,1124,8,1132,27
2021-02-07,Kern,029,883053,90695,88146,9005,97151,920
2021-02-07,Kings,031,150075,21655,21180,903,22083,192
2021-02-07,Lake,033,64148,3014,2940,1,2941,36
2021-02-07,Lassen,035,31185,5021,4973,87,5060,1
2021-02-07,Los Angeles,037,10098052,1149692,1117551,36791,1154342,17889
2021-02-07,Madera,039,155013,15138,14850,745,15595,93
2021-02-07,Marin,041,260295,12748,12571,144,12715,194
2021-02-07,Mariposa,043,17540,367,355,4,359,4
2021-02-07,Mendocino,045,87422,3500,3348,69,3417,38
2021-02-07,Merced,047,269075,27194,26977,798,27775,346
2021-02-07,Modoc,049,8938,326,317,105,422,3
2021-02-07,Mono,051,14174,1156,1165,16,1181,3
2021-02-07,Monterey,053,433212,40788,40113,1500,41613,283
2021-02-07,Napa,055,140530,8744,8701,31,8732,55
2021-02-07,Nevada,057,99092,3789,3643,147,3790,44
2021-02-07,Orange,059,3164182,241766,238155,9730,247885,3336
2021-02-07,Placer,061,380077,19900,18903,1021,19924,211
2021-02-07,Plumas,063,18699,630,584,10,594,2
2021-02-07,Riverside,065,2383286,279743,272301,12954,285255,3267
2021-02-07,Sacramento,067,1510023,90629,88919,1135,90054,1246
2021-02-07,San Benito,069,59416,5575,5548,77,5625,52
2021-02-07,San Bernardino,071,2135413,281409,274316,8251,282567,2587
2021-02-07,San Diego,073,3302833,255692,246561,12248,258809,2821
2021-02-07,San Francisco,075,870044,32943,32609,940,33549,348
2021-02-07,San Joaquin,077,732212,64537,63051,2543,65594,929
2021-02-07,San Luis Obispo,079,281455,18903,18349,500,18849,214
2021-02-07,San Mateo,081,765935,38124,36984,380,37364,232
2021-02-07,Santa Barbara,083,443738,30815,29815,955,30770,340
2021-02-07,Santa Clara,085,1922200,106203,105118,494,105612,1450
2021-02-07,Santa Cruz,087,273765,14902,13887,724,14611,161
2021-02-07,Shasta,089,179085,10605,10570,1131,11701,137
2021-02-07,Sierra,091,2930,49,43,12,55,0
2021-02-07,Siskiyou,093,43540,1394,1295,204,1499,4
2021-02-07,Solano,095,438530,28940,28567,329,28896,130
2021-02-07,Sonoma,097,501317,26789,26684,151,26835,257
2021-02-07,Stanislaus,099,539301,48660,47551,4986,52537,679
2021-02-07,Sutter,101,95872,8555,8515,76,8591,92
2021-02-07,Tehama,103,63373,4478,4396,467,4863,22
2021-02-07,Trinity,105,12862,447,264,65,329,3
2021-02-07,Tulare,107,460477,46833,45520,7178,52698,671
2021-02-07,Tuolumne,109,53932,3649,3619,34,3653,48
2021-02-07,Ventura,111,848112,74882,73759,2611,76370,561
2021-02-07,Yolo,113,214977,12402,12135,142,12277,162
2021-02-07,Yuba,115,75493,5301,5198,76,5274,35
2021-02-06,Alameda,001,1643700,77590,76170,1600,77770,922
2021-02-06,Alpine,003,1148,74,72,0,72,0
2021-02-06,Amador,005,37829,3350,3306,27,3333,33
2021-02-06,Butte,007,227075,10954,10480,1560,12040,150
2021-02-06,Calaveras,009,45235,1851,1832,11,1843,21
2021-02-06,Colusa,011,21464,1811,1791,231,2022,10
2021-02-06,Contra Costa,013,1133247,60296,58567,996,59563,566
2021-02-06,Del Norte,015,27424,918,879,4,883,2
2021-02-06,El Dorado,017,186661,8812,8575,578,9153,86
2021-02-06,Fresno,019,978130,93247,90944,7157,98101,1207
2021-02-06,Glenn,021,27897,2188,2136,463,2599,14
2021-02-06,Humboldt,023,135768,2936,2880,19,2899,28
2021-02-06,Imperial,025,180216,26898,26514,2369,28883,567
2021-02-06,Inyo,027,18085,1160,1113,8,1121,27
2021-02-06,Kern,029,883053,90541,87919,8959,96878,912
2021-02-06,Kings,031,150075,21624,21156,903,22059,190
2021-02-06,Lake,033,64148,3009,2920,1,2921,34
2021-02-06,Lassen,035,31185,5017,4964,86,5050,1
2021-02-06,Los Angeles,037,10098052,1148336,1114718,36694,1151412,17793
2021-02-06,Madera,039,155013,15117,14807,743,15550,93
2021-02-06,Marin,041,260295,12728,12531,144,12675,194
2021-02-06,Mariposa,043,17540,366,355,3,358,4
2021-02-06,Mendocino,045,87422,3482,3316,68,3384,38
2021-02-06,Merced,047,269075,27108,26881,790,27671,346
2021-02-06,Modoc,049,8938,326,313,105,418,3
2021-02-06,Mono,051,14174,1155,1159,16,1175,3
2021-02-06,Monterey,053,433212,40730,39995,1492,41487,282
2021-02-06,Napa,055,140530,8731,8639,31,8670,55
2021-02-06,Nevada,057,99092,3777,3624,147,3771,43
2021-02-06,Orange,059,3164182,241402,237391,9696,247087,3293
2021-02-06,Placer,061,380077,19863,18836,1018,19854,211
2021-02-06,Plumas,063,18699,630,584,10,594,2
2021-02-06,Riverside,065,2383286,279375,271741,12935,284676,3243
2021-02-06,Sacramento,067,1510023,90412,88532,1125,89657,1237
2021-02-06,San Benito,069,59416,5557,5516,77,5593,52
2021-02-06,San Bernardino,071,2135413,281100,273718,8229,281947,2564
2021-02-06,San Diego,073,3302833,255196,245331,12213,257544,2812
2021-02-06,San Francisco,075,870044,32869,32437,930,33367,346
2021-02-06,San Joaquin,077,732212,64458,62840,2532,65372,906
2021-02-06,San Luis Obispo,079,281455,18861,18284,496,18780,214
2021-02-06,San Mateo,081,765935,38056,36824,377,37201,232
2021-02-06,Santa Barbara,083,443738,30739,29645,953,30598,337
2021-02-06,Santa Clara,085,1922200,105981,104639,489,105128,1439
2021-02-06,Santa Cruz,087,273765,14871,13845,720,14565,161
2021-02-06,Shasta,089,179085,10594,10561,1129,11690,137
2021-02-06,Sierra,091,2930,49,43,12,55,0
2021-02-06,Siskiyou,093,43540,1391,1289,203,1492,4
2021-02-06,Solano,095,438530,28904,28446,328,28774,129
2021-02-06,Sonoma,097,501317,26752,26564,149,26713,257
2021-02-06,Stanislaus,099,539301,48564,47325,4971,52296,679
2021-02-06,Sutter,101,95872,8547,8485,76,8561,92
2021-02-06,Tehama,103,63373,4468,4380,466,4846,22
2021-02-06,Trinity,105,12862,447,263,65,328,3
2021-02-06,Tulare,107,460477,46765,45349,7133,52482,664
2021-02-06,Tuolumne,109,53932,3642,3612,34,3646,48
2021-02-06,Ventura,111,848112,74702,73431,2605,76036,552
2021-02-06,Yolo,113,214977,12379,12061,142,12203,161
2021-02-06,Yuba,115,75493,5291,5177,75,5252,35
2021-02-05,Alameda,001,1643700,77361,75716,1598,77314,916
2021-02-05,Alpine,003,1148,74,72,0,72,0
2021-02-05,Amador,005,37829,3345,3299,26,3325,33
2021-02-05,Butte,007,227075,10935,10421,1553,11974,150
2021-02-05,Calaveras,009,45235,1847,1818,11,1829,21
2021-02-05,Colusa,011,21464,1807,1785,231,2016,10
2021-02-05,Contra Costa,013,1133247,60135,58195,994,59189,560
2021-02-05,Del Norte,015,27424,917,874,4,878,2
2021-02-05,El Dorado,017,186661,8793,8527,576,9103,86
2021-02-05,Fresno,019,978130,93045,90513,7136,97649,1194
2021-02-05,Glenn,021,27897,2185,2122,458,2580,14
2021-02-05,Humboldt,023,135768,2926,2857,19,2876,28
2021-02-05,Imperial,025,180216,26879,26474,2368,28842,557
2021-02-05,Inyo,027,18085,1156,1104,8,1112,27
2021-02-05,Kern,029,883053,90372,87470,8893,96363,906
2021-02-05,Kings,031,150075,21586,21021,900,21921,190
2021-02-05,Lake,033,64148,2997,2906,1,2907,33
2021-02-05,Lassen,035,31185,5013,4936,86,5022,1
2021-02-05,Los Angeles,037,10098052,1146236,1110384,36563,1146947,17608
2021-02-05,Madera,039,155013,15083,14752,738,15490,95
2021-02-05,Marin,041,260295,12693,12479,144,12623,193
2021-02-05,Mariposa,043,17540,366,352,3,355,4
2021-02-05,Mendocino,045,87422,3468,3272,68,3340,38
2021-02-05,Merced,047,269075,27048,26760,789,27549,345
2021-02-05,Modoc,049,8938,326,312,105,417,3
2021-02-05,Mono,051,14174,1154,1157,16,1173,3
2021-02-05,Monterey,053,433212,40663,39840,1481,41321,281
2021-02-05,Napa,055,140530,8717,8598,31,8629,55
2021-02-05,Nevada,057,99092,3774,3607,147,3754,43
2021-02-05,Orange,059,3164182,240975,236335,9669,246004,3260
2021-02-05,Placer,061,380077,19827,18756,1016,19772,211
2021-02-05,Plumas,063,18699,628,578,10,588,2
2021-02-05,Riverside,065,2383286,278959,270666,12916,283582,3235
2021-02-05,Sacramento,067,1510023,90231,87992,1118,89110,1231
2021-02-05,San Benito,069,59416,5546,5502,77,5579,51
2021-02-05,San Bernardino,071,2135413,280755,272938,8213,281151,2495
2021-02-05,San Diego,073,3302833,254620,244066,12178,256244,2777
2021-02-05,San Francisco,075,870044,32779,32229,919,33148,337
2021-02-05,San Joaquin,077,732212,64309,62565,2524,65089,902
2021-02-05,San Luis Obispo,079,281455,18800,18152,492,18644,213
2021-02-05,San Mateo,081,765935,37973,36582,376,36958,227
2021-02-05,Santa Barbara,083,443738,30642,29455,940,30395,334
2021-02-05,Santa Clara,085,1922200,105733,104112,487,104599,1421
2021-02-05,Santa Cruz,087,273765,14850,13776,718,14494,161
2021-02-05,Shasta,089,179085,10578,10507,1122,11629,136
2021-02-05,Sierra,091,2930,49,42,12,54,0
2021-02-05,Siskiyou,093,43540,1384,1276,201,1477,4
2021-02-05,Solano,095,438530,28854,28283,328,28611,127
2021-02-05,Sonoma,097,501317,26683,26423,146,26569,252
2021-02-05,Stanislaus,099,539301,48419,47024,4953,51977,678
2021-02-05,Sutter,101,95872,8527,8443,76,8519,92
2021-02-05,Tehama,103,63373,4459,4355,465,4820,22
2021-02-05,Trinity,105,12862,446,260,65,325,3
2021-02-05,Tulare,107,460477,46688,45138,7085,52223,663
2021-02-05,Tuolumne,109,53932,3616,3595,34,3629,45
2021-02-05,Ventura,111,848112,74457,72953,2593,75546,546
2021-02-05,Yolo,113,214977,12361,12025,139,12164,162
2021-02-05,Yuba,115,75493,5274,5145,75,5220,35
2021-02-04,Alameda,001,1643700,77076,75422,1592,77014,899
2021-02-04,Alpine,003,1148,73,72,0,72,0
2021-02-04,Amador,005,37829,3342,3288,26,3314,33
2021-02-04,Butte,007,227075,10902,10386,1545,11931,147
2021-02-04,Calaveras,009,45235,1845,1808,11,1819,21
2021-02-04,Colusa,011,21464,1803,1777,229,2006,10
2021-02-04,Contra Costa,013,1133247,59947,57991,990,58981,550
2021-02-04,Del Norte,015,27424,911,870,4,874,2
2021-02-04,El Dorado,017,186661,8767,8490,573,9063,86
2021-02-04,Fresno,019,978130,92830,90126,7109,97235,1114
2021-02-04,Glenn,021,27897,2180,2102,457,2559,14
2021-02-04,Humboldt,023,135768,2916,2827,19,2846,28
2021-02-04,Imperial,025,180216,26834,26411,2366,28777,556
2021-02-04,Inyo,027,18085,1144,1084,8,1092,27
2021-02-04,Kern,029,883053,90098,87156,8817,95973,898
2021-02-04,Kings,031,150075,21536,20918,894,21812,187
2021-02-04,Lake,033,64148,2985,2882,1,2883,34
2021-02-04,Lassen,035,31185,5010,4927,86,5013,1
2021-02-04,Los Angeles,037,10098052,1143437,1106323,36438,1142761,17396
2021-02-04,Madera,039,155013,15053,14706,735,15441,95
2021-02-04,Marin,041,260295,12658,12431,144,12575,192
2021-02-04,Mariposa,043,17540,366,348,3,351,4
2021-02-04,Mendocino,045,87422,3450,3240,66,3306,38
2021-02-04,Merced,047,269075,26953,26629,786,27415,345
2021-02-04,Modoc,049,8938,326,309,105,414,3
2021-02-04,Mono,051,14174,1152,1153,16,1169,3
2021-02-04,Monterey,053,433212,40552,39619,1464,41083,279
2021-02-04,Napa,055,140530,8688,8573,31,8604,55
2021-02-04,Nevada,057,99092,3754,3590,146,3736,37
2021-02-04,Orange,059,3164182,240333,235677,9627,245304,3238
2021-02-04,Placer,061,380077,19767,18711,1007,19718,210
2021-02-04,Plumas,063,18699,625,562,10,572,2
2021-02-04,Riverside,065,2383286,278196,269851,12877,282728,3230
2021-02-04,Sacramento,067,1510023,89930,87658,1108,88766,1222
2021-02-04,San Benito,069,59416,5532,5488,76,5564,51
2021-02-04,San Bernardino,071,2135413,280206,272223,8193,280416,2409
2021-02-04,San Diego,073,3302833,253832,242613,12112,254725,2738
2021-02-04,San Francisco,075,870044,32665,32116,910,33026,326
2021-02-04,San Joaquin,077,732212,64084,62374,2516,64890,883
2021-02-04,San Luis Obispo,079,281455,18733,18058,490,18548,211
2021-02-04,San Mateo,081,765935,37852,36437,373,36810,226
2021-02-04,Santa Barbara,083,443738,30507,29344,923,30267,322
2021-02-04,Santa Clara,085,1922200,105390,103781,484,104265,1404
2021-02-04,Santa Cruz,087,273765,14817,13713,710,14423,156
2021-02-04,Shasta,089,179085,10552,10466,1117,11583,131
2021-02-04,Sierra,091,2930,49,42,12,54,0
2021-02-04,Siskiyou,093,43540,1375,1273,201,1474,4
2021-02-04,Solano,095,438530,28751,28192,327,28519,120
2021-02-04,Sonoma,097,501317,26601,26276,143,26419,249
2021-02-04,Stanislaus,099,539301,48258,46822,4934,51756,678
2021-02-04,Sutter,101,95872,8507,8401,76,8477,92
2021-02-04,Tehama,103,63373,4442,4327,464,4791,21
2021-02-04,Trinity,105,12862,445,260,64,324,3
2021-02-04,Tulare,107,460477,46561,44983,7027,52010,656
2021-02-04,Tuolumne,109,53932,3576,3585,34,3619,45
2021-02-04,Ventura,111,848112,74125,72595,2580,75175,537
2021-02-04,Yolo,113,214977,12327,11982,138,12120,161
2021-02-04,Yuba,115,75493,5248,5135,75,5210,34
2021-02-03,Alameda,001,1643700,76752,74968,1589,76557,880
2021-02-03,Alpine,003,1148,73,72,0,72,0
2021-02-03,Amador,005,37829,3338,3281,26,3307,33
2021-02-03,Butte,007,227075,10870,10355,1538,11893,144
2021-02-03,Calaveras,009,45235,1830,1799,11,1810,21
2021-02-03,Colusa,011,21464,1798,1773,228,2001,10
2021-02-03,Contra Costa,013,1133247,59706,57762,978,58740,537
2021-02-03,Del Norte,015,27424,906,869,4,873,2
2021-02-03,El Dorado,017,186661,8746,8428,572,9000,86
2021-02-03,Fresno,019,978130,92608,89748,7070,96818,1015
2021-02-03,Glenn,021,27897,2170,2098,456,2554,14
2021-02-03,Humboldt,023,135768,2906,2800,19,2819,27
2021-02-03,Imperial,025,180216,26798,26363,2360,28723,547
2021-02-03,Inyo,027,18085,1134,1071,8,1079,27
2021-02-03,Kern,029,883053,89855,86771,8776,95547,877
2021-02-03,Kings,031,150075,21475,20831,892,21723,172
2021-02-03,Lake,033,64148,2967,2869,1,2870,33
2021-02-03,Lassen,035,31185,4998,4910,86,4996,1
2021-02-03,Los Angeles,037,10098052,1140352,1101890,36319,1138209,17163
2021-02-03,Madera,039,155013,15013,14605,733,15338,94
2021-02-03,Marin,041,260295,12623,12406,144,12550,190
2021-02-03,Mariposa,043,17540,365,347,3,350,4
2021-02-03,Mendocino,045,87422,3424,3236,65,3301,38
2021-02-03,Merced,047,269075,26838,26520,782,27302,343
2021-02-03,Modoc,049,8938,325,308,105,413,3
2021-02-03,Mono,051,14174,1145,1146,16,1162,3
2021-02-03,Monterey,053,433212,40425,39500,1447,40947,279
2021-02-03,Napa,055,140530,8653,8534,31,8565,54
2021-02-03,Nevada,057,99092,3740,3572,146,3718,35
2021-02-03,Orange,059,3164182,239589,234738,9595,244333,3189
2021-02-03,Placer,061,380077,19712,18646,1005,19651,210
2021-02-03,Plumas,063,18699,625,559,10,569,2
2021-02-03,Riverside,065,2383286,277453,269019,12847,281866,3195
2021-02-03,Sacramento,067,1510023,89607,87415,1104,88519,1212
2021-02-03,San Benito,069,59416,5514,5463,73,5536,51
2021-02-03,San Bernardino,071,2135413,279720,271477,8170,279647,2308
2021-02-03,San Diego,073,3302833,252930,241015,12066,253081,2683
2021-02-03,San Francisco,075,870044,32535,31983,905,32888,325
2021-02-03,San Joaquin,077,732212,63856,61976,2506,64482,880
2021-02-03,San Luis Obispo,079,281455,18655,17922,487,18409,206
2021-02-03,San Mateo,081,765935,37714,36227,369,36596,225
2021-02-03,Santa Barbara,083,443738,30358,29121,914,30035,315
2021-02-03,Santa Clara,085,1922200,105074,103278,482,103760,1364
2021-02-03,Santa Cruz,087,273765,14762,13611,704,14315,154
2021-02-03,Shasta,089,179085,10509,10422,1112,11534,130
2021-02-03,Sierra,091,2930,49,42,12,54,0
2021-02-03,Siskiyou,093,43540,1364,1268,200,1468,4
2021-02-03,Solano,095,438530,28629,28057,327,28384,119
2021-02-03,Sonoma,097,501317,26517,26155,142,26297,248
2021-02-03,Stanislaus,099,539301,48082,46598,4915,51513,662
2021-02-03,Sutter,101,95872,8482,8379,76,8455,90
2021-02-03,Tehama,103,63373,4424,4309,461,4770,21
2021-02-03,Trinity,105,12862,445,260,63,323,3
2021-02-03,Tulare,107,460477,46390,44838,6971,51809,640
2021-02-03,Tuolumne,109,53932,3565,3568,34,3602,45
2021-02-03,Ventura,111,848112,73788,72124,2570,74694,526
2021-02-03,Yolo,113,214977,12302,11933,138,12071,161
2021-02-03,Yuba,115,75493,5230,5124,75,5199,34
2021-02-02,Alameda,001,1643700,76409,74642,1577,76219,869
2021-02-02,Alpine,003,1148,73,72,0,72,0
2021-02-02,Amador,005,37829,3307,3275,26,3301,33
2021-02-02,Butte,007,227075,10844,10307,1529,11836,141
2021-02-02,Calaveras,009,45235,1820,1786,11,1797,21
2021-02-02,Colusa,011,21464,1790,1769,223,1992,9
2021-02-02,Contra Costa,013,1133247,59426,57551,975,58526,536
2021-02-02,Del Norte,015,27424,900,868,4,872,2
2021-02-02,El Dorado,017,186661,8706,8405,572,8977,84
2021-02-02,Fresno,019,978130,92307,89542,7035,96577,1009
2021-02-02,Glenn,021,27897,2158,2090,453,2543,14
2021-02-02,Humboldt,023,135768,2894,2784,19,2803,25
2021-02-02,Imperial,025,180216,26745,26317,2354,28671,535
2021-02-02,Inyo,027,18085,1131,1074,8,1082,27
2021-02-02,Kern,029,883053,89552,86485,8700,95185,867
2021-02-02,Kings,031,150075,21397,20785,884,21669,172
2021-02-02,Lake,033,64148,2947,2857,1,2858,33
2021-02-02,Lassen,035,31185,4991,4908,86,4994,1
2021-02-02,Los Angeles,037,10098052,1136970,1097573,36159,1133732,16913
2021-02-02,Madera,039,155013,14962,14595,728,15323,94
2021-02-02,Marin,041,260295,12593,12367,144,12511,189
2021-02-02,Mariposa,043,17540,362,345,3,348,4
2021-02-02,Mendocino,045,87422,3391,3210,65,3275,38
2021-02-02,Merced,047,269075,26741,26427,776,27203,340
2021-02-02,Modoc,049,8938,320,306,105,411,3
2021-02-02,Mono,051,14174,1143,1147,16,1163,3
2021-02-02,Monterey,053,433212,40290,39371,1433,40804,278
2021-02-02,Napa,055,140530,8624,8505,31,8536,53
2021-02-02,Nevada,057,99092,3725,3548,146,3694,20
2021-02-02,Orange,059,3164182,238786,233783,9560,243343,3152
2021-02-02,Placer,061,380077,19653,18615,1001,19616,205
2021-02-02,Plumas,063,18699,625,560,10,570,2
2021-02-02,Riverside,065,2383286,276596,267901,12813,280714,3169
2021-02-02,Sacramento,067,1510023,89317,87107,1093,88200,1202
2021-02-02,San Benito,069,59416,5500,5444,72,5516,50
2021-02-02,San Bernardino,071,2135413,279043,270486,8141,278627,2244
2021-02-02,San Diego,073,3302833,251891,240047,11979,252026,2629
2021-02-02,San Francisco,075,870044,32381,31788,895,32683,324
2021-02-02,San Joaquin,077,732212,63635,61708,2493,64201,878
2021-02-02,San Luis Obispo,079,281455,18561,17811,485,18296,201
2021-02-02,San Mateo,081,765935,37550,36004,363,36367,225
2021-02-02,Santa Barbara,083,443738,30187,28951,907,29858,304
2021-02-02,Santa Clara,085,1922200,104609,102872,477,103349,1349
2021-02-02,Santa Cruz,087,273765,14703,13572,700,14272,150
2021-02-02,Shasta,089,179085,10483,10371,1102,11473,128
2021-02-02,Sierra,091,2930,49,42,12,54,0
2021-02-02,Siskiyou,093,43540,1357,1252,197,1449,4
2021-02-02,Solano,095,438530,28533,27963,323,28286,118
2021-02-02,Sonoma,097,501317,26401,26054,142,26196,247
2021-02-02,Stanislaus,099,539301,47863,46306,4883,51189,641
2021-02-02,Sutter,101,95872,8459,8340,76,8416,89
2021-02-02,Tehama,103,63373,4410,4289,460,4749,21
2021-02-02,Trinity,105,12862,445,260,63,323,3
2021-02-02,Tulare,107,460477,46234,44720,6906,51626,625
2021-02-02,Tuolumne,109,53932,3553,3548,34,3582,39
2021-02-02,Ventura,111,848112,73372,71557,2560,74117,514
2021-02-02,Yolo,113,214977,12257,11886,136,12022,158
2021-02-02,Yuba,115,75493,5212,5111,74,5185,34
2021-02-01,Alameda,001,1643700,76053,74374,1572,75946,858
2021-02-01,Alpine,003,1148,73,72,0,72,0
2021-02-01,Amador,005,37829,3296,3234,26,3260,32
2021-02-01,Butte,007,227075,10800,10263,1525,11788,141
2021-02-01,Calaveras,009,45235,1813,1785,11,1796,21
2021-02-01,Colusa,011,21464,1785,1763,214,1977,9
2021-02-01,Contra Costa,013,1133247,59184,57324,974,58298,531
2021-02-01,Del Norte,015,27424,896,865,4,869,2
2021-02-01,El Dorado,017,186661,8667,8337,572,8909,83
2021-02-01,Fresno,019,978130,91975,89272,7000,96272,994
2021-02-01,Glenn,021,27897,2142,2086,445,2531,14
2021-02-01,Humboldt,023,135768,2873,2773,18,2791,25
2021-02-01,Imperial,025,180216,26702,26224,2352,28576,530
2021-02-01,Inyo,027,18085,1121,1072,8,1080,27
2021-02-01,Kern,029,883053,89155,86170,8632,94802,862
2021-02-01,Kings,031,150075,21306,20746,876,21622,172
2021-02-01,Lake,033,64148,2931,2843,1,2844,33
2021-02-01,Lassen,035,31185,4971,4907,86,4993,1
2021-02-01,Los Angeles,037,10098052,1133141,1094341,35995,1130336,16695
2021-02-01,Madera,039,155013,14927,14572,725,15297,94
2021-02-01,Marin,041,260295,12554,12341,143,12484,188
2021-02-01,Mariposa,043,17540,360,344,3,347,4
2021-02-01,Mendocino,045,87422,3358,3192,65,3257,37
2021-02-01,Merced,047,269075,26617,26282,767,27049,337
2021-02-01,Modoc,049,8938,314,303,101,404,1
2021-02-01,Mono,051,14174,1140,1145,16,1161,3
2021-02-01,Monterey,053,433212,40106,39196,1412,40608,278
2021-02-01,Napa,055,140530,8591,8449,31,8480,52
2021-02-01,Nevada,057,99092,3708,3535,145,3680,20
2021-02-01,Orange,059,3164182,237872,233155,9515,242670,3100
2021-02-01,Placer,061,380077,19586,18574,994,19568,204
2021-02-01,Plumas,063,18699,623,554,10,564,2
2021-02-01,Riverside,065,2383286,275656,267025,12778,279803,3092
2021-02-01,Sacramento,067,1510023,88914,86856,1082,87938,1193
2021-02-01,San Benito,069,59416,5482,5432,72,5504,48
2021-02-01,San Bernardino,071,2135413,278348,270012,8102,278114,2172
2021-02-01,San Diego,073,3302833,250666,239121,11903,251024,2619
2021-02-01,San Francisco,075,870044,32246,31703,883,32586,324
2021-02-01,San Joaquin,077,732212,63429,61542,2482,64024,877
2021-02-01,San Luis Obispo,079,281455,18441,17690,478,18168,199
2021-02-01,San Mateo,081,765935,37401,35843,363,36206,220
2021-02-01,Santa Barbara,083,443738,30018,28837,899,29736,297
2021-02-01,Santa Clara,085,1922200,104192,102462,476,102938,1343
2021-02-01,Santa Cruz,087,273765,14650,13524,698,14222,149
2021-02-01,Shasta,089,179085,10458,10329,1096,11425,112
2021-02-01,Sierra,091,2930,49,42,12,54,0
2021-02-01,Siskiyou,093,43540,1350,1238,194,1432,4
2021-02-01,Solano,095,438530,28428,27844,322,28166,117
2021-02-01,Sonoma,097,501317,26313,26011,141,26152,243
2021-02-01,Stanislaus,099,539301,47606,46112,4855,50967,642
2021-02-01,Sutter,101,95872,8420,8313,76,8389,89
2021-02-01,Tehama,103,63373,4384,4263,460,4723,21
2021-02-01,Trinity,105,12862,443,260,63,323,3
2021-02-01,Tulare,107,460477,46089,44569,6826,51395,618
2021-02-01,Tuolumne,109,53932,3545,3534,34,3568,39
2021-02-01,Ventura,111,848112,72967,71104,2543,73647,502
2021-02-01,Yolo,113,214977,12210,11824,135,11959,151
2021-02-01,Yuba,115,75493,5198,5084,73,5157,33
2021-01-31,Alameda,001,1643700,75628,73979,1564,75543,857
2021-01-31,Alpine,003,1148,73,72,0,72,0
2021-01-31,Amador,005,37829,3286,3212,25,3237,32
2021-01-31,Butte,007,227075,10755,10215,1515,11730,140
2021-01-31,Calaveras,009,45235,1793,1778,11,1789,21
2021-01-31,Colusa,011,21464,1779,1754,209,1963,9
2021-01-31,Contra Costa,013,1133247,58853,57079,974,58053,531
2021-01-31,Del Norte,015,27424,894,865,4,869,2
2021-01-31,El Dorado,017,186661,8629,8317,570,8887,83
2021-01-31,Fresno,019,978130,91663,88852,6946,95798,994
2021-01-31,Glenn,021,27897,2132,2083,444,2527,14
2021-01-31,Humboldt,023,135768,2857,2767,18,2785,25
2021-01-31,Imperial,025,180216,26629,26206,2343,28549,530
2021-01-31,Inyo,027,18085,1108,1072,8,1080,27
2021-01-31,Kern,029,883053,88658,85872,8548,94420,861
2021-01-31,Kings,031,150075,21222,20709,864,21573,172
2021-01-31,Lake,033,64148,2910,2826,1,2827,33
2021-01-31,Lassen,035,31185,4955,4900,86,4986,1
2021-01-31,Los Angeles,037,10098052,1128509,1090304,35795,1126099,16609
2021-01-31,Madera,039,155013,14873,14496,717,15213,94
2021-01-31,Marin,041,260295,12507,12297,139,12436,185
2021-01-31,Mariposa,043,17540,358,344,3,347,4
2021-01-31,Mendocino,045,87422,3335,3181,64,3245,37
2021-01-31,Merced,047,269075,26475,26222,762,26984,337
2021-01-31,Modoc,049,8938,311,304,99,403,1
2021-01-31,Mono,051,14174,1137,1146,16,1162,3
2021-01-31,Monterey,053,433212,39927,39035,1385,40420,278
2021-01-31,Napa,055,140530,8550,8404,31,8435,52
2021-01-31,Nevada,057,99092,3686,3518,143,3661,20
2021-01-31,Orange,059,3164182,236855,232347,9475,241822,3053
2021-01-31,Placer,061,380077,19509,18506,983,19489,204
2021-01-31,Plumas,063,18699,622,554,10,564,2
2021-01-31,Riverside,065,2383286,274639,266145,12731,278876,3074
2021-01-31,Sacramento,067,1510023,88473,86560,1068,87628,1186
2021-01-31,San Benito,069,59416,5460,5425,70,5495,48
2021-01-31,San Bernardino,071,2135413,277346,269533,8073,277606,2156
2021-01-31,San Diego,073,3302833,249353,238039,11789,249828,2619
2021-01-31,San Francisco,075,870044,32057,31563,872,32435,323
2021-01-31,San Joaquin,077,732212,63028,61379,2473,63852,877
2021-01-31,San Luis Obispo,079,281455,18308,17615,473,18088,199
2021-01-31,San Mateo,081,765935,37211,35659,360,36019,219
2021-01-31,Santa Barbara,083,443738,29774,28570,890,29460,297
2021-01-31,Santa Clara,085,1922200,103657,101986,467,102453,1330
2021-01-31,Santa Cruz,087,273765,14555,13469,684,14153,149
2021-01-31,Shasta,089,179085,10413,10313,1088,11401,112
2021-01-31,Sierra,091,2930,48,43,12,55,0
2021-01-31,Siskiyou,093,43540,1340,1238,194,1432,4
2021-01-31,Solano,095,438530,28298,27678,322,28000,118
2021-01-31,Sonoma,097,501317,26210,25925,140,26065,243
2021-01-31,Stanislaus,099,539301,47322,45971,4825,50796,642
2021-01-31,Sutter,101,95872,8375,8289,76,8365,89
2021-01-31,Tehama,103,63373,4362,4256,459,4715,21
2021-01-31,Trinity,105,12862,441,260,63,323,3
2021-01-31,Tulare,107,460477,45921,44440,6747,51187,618
2021-01-31,Tuolumne,109,53932,3507,3519,34,3553,39
2021-01-31,Ventura,111,848112,72372,70635,2530,73165,502
2021-01-31,Yolo,113,214977,12150,11771,135,11906,151
2021-01-31,Yuba,115,75493,5178,5071,73,5144,33
2021-01-30,Alameda,001,1643700,75425,73622,1559,75181,850
2021-01-30,Alpine,003,1148,73,72,0,72,0
2021-01-30,Amador,005,37829,3282,3181,25,3206,32
2021-01-30,Butte,007,227075,10721,10177,1506,11683,139
2021-01-30,Calaveras,009,45235,1780,1763,11,1774,21
2021-01-30,Colusa,011,21464,1777,1748,209,1957,9
2021-01-30,Contra Costa,013,1133247,58674,56763,970,57733,531
2021-01-30,Del Norte,015,27424,893,865,4,869,2
2021-01-30,El Dorado,017,186661,8609,8299,569,8868,83
2021-01-30,Fresno,019,978130,91483,88476,6926,95402,964
2021-01-30,Glenn,021,27897,2129,2074,442,2516,14
2021-01-30,Humboldt,023,135768,2846,2742,18,2760,24
2021-01-30,Imperial,025,180216,26605,26160,2341,28501,530
2021-01-30,Inyo,027,18085,1104,1068,8,1076,27
2021-01-30,Kern,029,883053,88457,85572,8483,94055,848
2021-01-30,Kings,031,150075,21151,20605,859,21464,169
2021-01-30,Lake,033,64148,2904,2809,1,2810,33
2021-01-30,Lassen,035,31185,4951,4890,86,4976,1
2021-01-30,Los Angeles,037,10098052,1126109,1084763,35652,1120415,16484
2021-01-30,Madera,039,155013,14831,14443,712,15155,94
2021-01-30,Marin,041,260295,12480,12225,138,12363,185
2021-01-30,Mariposa,043,17540,356,344,3,347,4
2021-01-30,Mendocino,045,87422,3321,3153,63,3216,36
2021-01-30,Merced,047,269075,26401,26078,760,26838,335
2021-01-30,Modoc,049,8938,311,303,99,402,1
2021-01-30,Mono,051,14174,1137,1143,16,1159,3
2021-01-30,Monterey,053,433212,39867,38847,1383,40230,277
2021-01-30,Napa,055,140530,8534,8342,31,8373,52
2021-01-30,Nevada,057,99092,3667,3499,143,3642,20
2021-01-30,Orange,059,3164182,236310,231358,9438,240796,3013
2021-01-30,Placer,061,380077,19456,18430,977,19407,205
2021-01-30,Plumas,063,18699,620,554,10,564,2
2021-01-30,Riverside,065,2383286,274043,265137,12700,277837,3061
2021-01-30,Sacramento,067,1510023,88282,86388,1063,87451,1184
2021-01-30,San Benito,069,59416,5442,5401,69,5470,48
2021-01-30,San Bernardino,071,2135413,276918,268660,8053,276713,2122
2021-01-30,San Diego,073,3302833,248588,236765,11744,248509,2603
2021-01-30,San Francisco,075,870044,31956,31427,869,32296,316
2021-01-30,San Joaquin,077,732212,62896,61120,2464,63584,864
2021-01-30,San Luis Obispo,079,281455,18228,17522,472,17994,198
2021-01-30,San Mateo,081,765935,37072,35451,359,35810,219
2021-01-30,Santa Barbara,083,443738,29632,28342,888,29230,296
2021-01-30,Santa Clara,085,1922200,103328,101471,465,101936,1307
2021-01-30,Santa Cruz,087,273765,14515,13383,683,14066,149
2021-01-30,Shasta,089,179085,10394,10283,1085,11368,112
2021-01-30,Sierra,091,2930,48,43,12,55,0
2021-01-30,Siskiyou,093,43540,1337,1236,193,1429,4
2021-01-30,Solano,095,438530,28215,27511,321,27832,118
2021-01-30,Sonoma,097,501317,26162,25810,137,25947,243
2021-01-30,Stanislaus,099,539301,47192,45697,4798,50495,642
2021-01-30,Sutter,101,95872,8359,8226,76,8302,87
2021-01-30,Tehama,103,63373,4349,4229,458,4687,21
2021-01-30,Trinity,105,12862,441,259,63,322,3
2021-01-30,Tulare,107,460477,45785,44203,6711,50914,615
2021-01-30,Tuolumne,109,53932,3503,3508,34,3542,36
2021-01-30,Ventura,111,848112,72060,69931,2516,72447,493
2021-01-30,Yolo,113,214977,12136,11698,134,11832,151
2021-01-30,Yuba,115,75493,5168,5042,72,5114,33
2021-01-29,Alameda,001,1643700,75158,73210,1552,74762,841
2021-01-29,Alpine,003,1148,73,72,0,72,0
2021-01-29,Amador,005,37829,3270,3134,24,3158,32
2021-01-29,Butte,007,227075,10689,10122,1497,11619,138
2021-01-29,Calaveras,009,45235,1769,1757,11,1768,21
2021-01-29,Colusa,011,21464,1773,1734,208,1942,8
2021-01-29,Contra Costa,013,1133247,58507,56318,968,57286,529
2021-01-29,Del Norte,015,27424,892,865,4,869,2
2021-01-29,El Dorado,017,186661,8592,8231,568,8799,83
2021-01-29,Fresno,019,978130,91269,87936,6889,94825,962
2021-01-29,Glenn,021,27897,2124,2061,441,2502,14
2021-01-29,Humboldt,023,135768,2833,2707,18,2725,24
2021-01-29,Imperial,025,180216,26590,26045,2338,28383,521
2021-01-29,Inyo,027,18085,1092,1048,8,1056,27
2021-01-29,Kern,029,883053,88230,85044,8432,93476,836
2021-01-29,Kings,031,150075,21112,20466,854,21320,169
2021-01-29,Lake,033,64148,2894,2792,1,2793,32
2021-01-29,Lassen,035,31185,4948,4874,86,4960,1
2021-01-29,Los Angeles,037,10098052,1122613,1078329,35503,1113832,16190
2021-01-29,Madera,039,155013,14784,14377,712,15089,94
2021-01-29,Marin,041,260295,12435,12145,137,12282,185
2021-01-29,Mariposa,043,17540,355,342,3,345,4
2021-01-29,Mendocino,045,87422,3312,3131,62,3193,36
2021-01-29,Merced,047,269075,26327,25865,755,26620,334
2021-01-29,Modoc,049,8938,310,297,99,396,1
2021-01-29,Mono,051,14174,1135,1139,16,1155,3
2021-01-29,Monterey,053,433212,39754,38539,1375,39914,277
2021-01-29,Napa,055,140530,8503,8276,31,8307,52
2021-01-29,Nevada,057,99092,3658,3487,142,3629,20
2021-01-29,Orange,059,3164182,235634,229917,9401,239318,2967
2021-01-29,Placer,061,380077,19403,18367,973,19340,203
2021-01-29,Plumas,063,18699,619,548,10,558,2
2021-01-29,Riverside,065,2383286,273242,263504,12668,276172,3008
2021-01-29,Sacramento,067,1510023,88028,86320,1058,87378,1169
2021-01-29,San Benito,069,59416,5434,5386,69,5455,48
2021-01-29,San Bernardino,071,2135413,276400,267490,8015,275505,2095
2021-01-29,San Diego,073,3302833,247646,234637,11666,246303,2571
2021-01-29,San Francisco,075,870044,31817,31294,861,32155,307
2021-01-29,San Joaquin,077,732212,62752,60899,2450,63349,858
2021-01-29,San Luis Obispo,079,281455,18168,17440,467,17907,193
2021-01-29,San Mateo,081,765935,36939,35223,356,35579,218
2021-01-29,Santa Barbara,083,443738,29499,28105,882,28987,291
2021-01-29,Santa Clara,085,1922200,102973,101010,463,101473,1273
2021-01-29,Santa Cruz,087,273765,14462,13311,680,13991,148
2021-01-29,Shasta,089,179085,10378,10220,1081,11301,112
2021-01-29,Sierra,091,2930,48,43,12,55,0
2021-01-29,Siskiyou,093,43540,1336,1227,193,1420,4
2021-01-29,Solano,095,438530,28132,27352,319,27671,116
2021-01-29,Sonoma,097,501317,26106,25710,136,25846,243
2021-01-29,Stanislaus,099,539301,47049,45466,4776,50242,642
2021-01-29,Sutter,101,95872,8340,8181,76,8257,87
2021-01-29,Tehama,103,63373,4337,4191,456,4647,20
2021-01-29,Trinity,105,12862,441,260,63,323,3
2021-01-29,Tulare,107,460477,45678,43925,6672,50597,606
2021-01-29,Tuolumne,109,53932,3493,3483,34,3517,36
2021-01-29,Ventura,111,848112,71638,69511,2503,72014,484
2021-01-29,Yolo,113,214977,12098,11612,134,11746,151
2021-01-29,Yuba,115,75493,5152,5018,72,5090,32
2021-01-28,Alameda,001,1643700,74735,72758,1544,74302,833
2021-01-28,Alpine,003,1148,73,72,0,72,0
2021-01-28,Amador,005,37829,3233,3124,24,3148,31
2021-01-28,Butte,007,227075,10648,10037,1487,11524,138
2021-01-28,Calaveras,009,45235,1756,1747,10,1757,21
2021-01-28,Colusa,011,21464,1766,1731,204,1935,8
2021-01-28,Contra Costa,013,1133247,58264,55999,958,56957,525
2021-01-28,Del Norte,015,27424,891,862,4,866,2
2021-01-28,El Dorado,017,186661,8577,8198,563,8761,79
2021-01-28,Fresno,019,978130,90983,87401,6842,94243,949
2021-01-28,Glenn,021,27897,2119,2043,434,2477,14
2021-01-28,Humboldt,023,135768,2816,2686,18,2704,24
2021-01-28,Imperial,025,180216,26547,25984,2331,28315,517
2021-01-28,Inyo,027,18085,1087,1039,8,1047,27
2021-01-28,Kern,029,883053,87901,84708,8349,93057,817
2021-01-28,Kings,031,150075,21052,20328,851,21179,167
2021-01-28,Lake,033,64148,2879,2772,1,2773,32
2021-01-28,Lassen,035,31185,4942,4865,86,4951,1
2021-01-28,Los Angeles,037,10098052,1118701,1072412,35315,1107727,15967
2021-01-28,Madera,039,155013,14729,14301,708,15009,94
2021-01-28,Marin,041,260295,12386,12079,136,12215,183
2021-01-28,Mariposa,043,17540,355,334,3,337,4
2021-01-28,Mendocino,045,87422,3295,3110,62,3172,36
2021-01-28,Merced,047,269075,26205,25620,743,26363,328
2021-01-28,Modoc,049,8938,309,297,99,396,0
2021-01-28,Mono,051,14174,1133,1131,16,1147,3
2021-01-28,Monterey,053,433212,39560,38312,1356,39668,274
2021-01-28,Napa,055,140530,8456,8233,31,8264,50
2021-01-28,Nevada,057,99092,3643,3452,141,3593,19
2021-01-28,Orange,059,3164182,234659,228636,9371,238007,2860
2021-01-28,Placer,061,380077,19343,18246,970,19216,198
2021-01-28,Plumas,063,18699,618,547,10,557,2
2021-01-28,Riverside,065,2383286,272462,262342,12620,274962,2981
2021-01-28,Sacramento,067,1510023,87663,85698,1047,86745,1149
2021-01-28,San Benito,069,59416,5416,5344,68,5412,47
2021-01-28,San Bernardino,071,2135413,275698,266456,7994,274450,2057
2021-01-28,San Diego,073,3302833,246493,232967,11577,244544,2534
2021-01-28,San Francisco,075,870044,31680,31193,845,32038,290
2021-01-28,San Joaquin,077,732212,62490,60627,2436,63063,854
2021-01-28,San Luis Obispo,079,281455,18068,17279,465,17744,189
2021-01-28,San Mateo,081,765935,36770,34931,340,35271,218
2021-01-28,Santa Barbara,083,443738,29276,27674,869,28543,284
2021-01-28,Santa Clara,085,1922200,102517,100470,461,100931,1219
2021-01-28,Santa Cruz,087,273765,14373,13188,674,13862,145
2021-01-28,Shasta,089,179085,10344,10176,1073,11249,110
2021-01-28,Sierra,091,2930,48,43,12,55,0
2021-01-28,Siskiyou,093,43540,1329,1218,191,1409,4
2021-01-28,Solano,095,438530,27972,27163,318,27481,114
2021-01-28,Sonoma,097,501317,26015,25564,136,25700,236
2021-01-28,Stanislaus,099,539301,46841,45162,4757,49919,640
2021-01-28,Sutter,101,95872,8293,8136,76,8212,85
2021-01-28,Tehama,103,63373,4314,4163,453,4616,20
2021-01-28,Trinity,105,12862,439,260,63,323,3
2021-01-28,Tulare,107,460477,45523,43742,6597,50339,595
2021-01-28,Tuolumne,109,53932,3479,3472,34,3506,32
2021-01-28,Ventura,111,848112,71126,68896,2487,71383,475
2021-01-28,Yolo,113,214977,12056,11500,130,11630,151
2021-01-28,Yuba,115,75493,5136,4994,71,5065,32
2021-01-27,Alameda,001,1643700,74316,72188,1537,73725,815
2021-01-27,Alpine,003,1148,73,72,0,72,0
2021-01-27,Amador,005,37829,3217,3116,24,3140,31
2021-01-27,Butte,007,227075,10609,9988,1476,11464,138
2021-01-27,Calaveras,009,45235,1747,1737,10,1747,21
2021-01-27,Colusa,011,21464,1760,1724,202,1926,8
2021-01-27,Contra Costa,013,1133247,57970,55578,955,56533,507
2021-01-27,Del Norte,015,27424,890,859,4,863,2
2021-01-27,El Dorado,017,186661,8551,8141,562,8703,76
2021-01-27,Fresno,019,978130,90691,86886,6800,93686,938
2021-01-27,Glenn,021,27897,2115,2042,433,2475,14
2021-01-27,Humboldt,023,135768,2794,2630,18,2648,24
2021-01-27,Imperial,025,180216,26493,25861,2319,28180,504
2021-01-27,Inyo,027,18085,1083,1023,8,1031,27
2021-01-27,Kern,029,883053,87591,84244,8278,92522,809
2021-01-27,Kings,031,150075,20946,20211,843,21054,167
2021-01-27,Lake,033,64148,2859,2750,1,2751,32
2021-01-27,Lassen,035,31185,4936,4851,86,4937,1
2021-01-27,Los Angeles,037,10098052,1113890,1066569,35112,1101681,15757
2021-01-27,Madera,039,155013,14687,14194,703,14897,86
2021-01-27,Marin,041,260295,12348,12028,135,12163,180
2021-01-27,Mariposa,043,17540,355,333,3,336,4
2021-01-27,Mendocino,045,87422,3275,3095,62,3157,36
2021-01-27,Merced,047,269075,26046,25439,732,26171,315
2021-01-27,Modoc,049,8938,309,297,96,393,0
2021-01-27,Mono,051,14174,1131,1131,16,1147,3
2021-01-27,Monterey,053,433212,39353,38139,1337,39476,268
2021-01-27,Napa,055,140530,8383,8187,31,8218,46
2021-01-27,Nevada,057,99092,3621,3431,141,3572,18
2021-01-27,Orange,059,3164182,233542,227110,9319,236429,2832
2021-01-27,Placer,061,380077,19273,18106,959,19065,198
2021-01-27,Plumas,063,18699,618,544,10,554,2
2021-01-27,Riverside,065,2383286,271267,260796,12569,273365,2931
2021-01-27,Sacramento,067,1510023,87303,85428,1035,86463,1142
2021-01-27,San Benito,069,59416,5401,5284,68,5352,47
2021-01-27,San Bernardino,071,2135413,274844,265153,7961,273114,2019
2021-01-27,San Diego,073,3302833,245164,231478,11472,242950,2465
2021-01-27,San Francisco,075,870044,31535,31082,838,31920,287
2021-01-27,San Joaquin,077,732212,62220,60131,2417,62548,853
2021-01-27,San Luis Obispo,079,281455,17960,17119,461,17580,188
2021-01-27,San Mateo,081,765935,36615,34619,337,34956,216
2021-01-27,Santa Barbara,083,443738,29099,27435,863,28298,282
2021-01-27,Santa Clara,085,1922200,102102,99732,457,100189,1184
2021-01-27,Santa Cruz,087,273765,14303,13111,671,13782,143
2021-01-27,Shasta,089,179085,10310,10106,1067,11173,105
2021-01-27,Sierra,091,2930,48,44,12,56,0
2021-01-27,Siskiyou,093,43540,1324,1214,188,1402,4
2021-01-27,Solano,095,438530,27795,26982,311,27293,112
2021-01-27,Sonoma,097,501317,25917,25361,132,25493,237
2021-01-27,Stanislaus,099,539301,46657,44874,4732,49606,624
2021-01-27,Sutter,101,95872,8250,8093,76,8169,83
2021-01-27,Tehama,103,63373,4294,4133,449,4582,20
2021-01-27,Trinity,105,12862,439,260,63,323,3
2021-01-27,Tulare,107,460477,45336,43462,6527,49989,583
2021-01-27,Tuolumne,109,53932,3469,3464,34,3498,32
2021-01-27,Ventura,111,848112,70652,68291,2462,70753,468
2021-01-27,Yolo,113,214977,12009,11427,128,11555,151
2021-01-27,Yuba,115,75493,5120,4968,71,5039,32
2021-01-26,Alameda,001,1643700,73940,71851,1520,73371,789
2021-01-26,Alpine,003,1148,73,72,0,72,0
2021-01-26,Amador,005,37829,3206,3113,24,3137,31
2021-01-26,Butte,007,227075,10567,9943,1470,11413,136
2021-01-26,Calaveras,009,45235,1737,1723,10,1733,21
2021-01-26,Colusa,011,21464,1753,1719,199,1918,8
2021-01-26,Contra Costa,013,1133247,57697,55337,947,56284,491
2021-01-26,Del Norte,015,27424,889,856,4,860,2
2021-01-26,El Dorado,017,186661,8527,8115,560,8675,71
2021-01-26,Fresno,019,978130,90332,86673,6757,93430,923
2021-01-26,Glenn,021,27897,2105,2034,428,2462,13
2021-01-26,Humboldt,023,135768,2773,2612,17,2629,24
2021-01-26,Imperial,025,180216,26421,25812,2307,28119,498
2021-01-26,Inyo,027,18085,1077,1018,8,1026,27
2021-01-26,Kern,029,883053,87168,83868,8203,92071,790
2021-01-26,Kings,031,150075,20888,20156,838,20994,159
2021-01-26,Lake,033,64148,2851,2748,1,2749,32
2021-01-26,Lassen,035,31185,4930,4844,86,4930,1
2021-01-26,Los Angeles,037,10098052,1108600,1060492,34914,1095406,15458
2021-01-26,Madera,039,155013,14630,14130,697,14827,86
2021-01-26,Marin,041,260295,12304,11993,133,12126,179
2021-01-26,Mariposa,043,17540,353,332,3,335,3
2021-01-26,Mendocino,045,87422,3249,3076,61,3137,36
2021-01-26,Merced,047,269075,25906,25359,724,26083,309
2021-01-26,Modoc,049,8938,302,291,95,386,0
2021-01-26,Mono,051,14174,1129,1120,16,1136,3
2021-01-26,Monterey,053,433212,39159,37963,1317,39280,255
2021-01-26,Napa,055,140530,8326,8145,31,8176,43
2021-01-26,Nevada,057,99092,3614,3410,140,3550,18
2021-01-26,Orange,059,3164182,232419,225987,9273,235260,2760
2021-01-26,Placer,061,380077,19197,18016,957,18973,193
2021-01-26,Plumas,063,18699,616,536,10,546,2
2021-01-26,Riverside,065,2383286,269898,259399,12506,271905,2898
2021-01-26,Sacramento,067,1510023,86943,85062,1028,86090,1127
2021-01-26,San Benito,069,59416,5387,5251,67,5318,45
2021-01-26,San Bernardino,071,2135413,273849,263736,7919,271655,1970
2021-01-26,San Diego,073,3302833,243668,230063,11370,241433,2421
2021-01-26,San Francisco,075,870044,31403,30874,819,31693,286
2021-01-26,San Joaquin,077,732212,61968,59889,2401,62290,847
2021-01-26,San Luis Obispo,079,281455,17879,17016,458,17474,186
2021-01-26,San Mateo,081,765935,36421,34441,326,34767,213
2021-01-26,Santa Barbara,083,443738,28923,27321,851,28172,273
2021-01-26,Santa Clara,085,1922200,101623,99215,454,99669,1171
2021-01-26,Santa Cruz,087,273765,14237,13045,665,13710,134
2021-01-26,Shasta,089,179085,10275,10036,1059,11095,103
2021-01-26,Sierra,091,2930,48,43,12,55,0
2021-01-26,Siskiyou,093,43540,1309,1208,186,1394,4
2021-01-26,Solano,095,438530,27639,26858,304,27162,110
2021-01-26,Sonoma,097,501317,25798,25273,130,25403,236
2021-01-26,Stanislaus,099,539301,46475,44703,4692,49395,599
2021-01-26,Sutter,101,95872,8207,8067,76,8143,83
2021-01-26,Tehama,103,63373,4261,4115,449,4564,20
2021-01-26,Trinity,105,12862,439,260,63,323,3
2021-01-26,Tulare,107,460477,45133,43394,6459,49853,579
2021-01-26,Tuolumne,109,53932,3459,3451,34,3485,30
2021-01-26,Ventura,111,848112,70120,67526,2436,69962,448
2021-01-26,Yolo,113,214977,11965,11361,125,11486,148
2021-01-26,Yuba,115,75493,5095,4944,69,5013,31
2021-01-25,Alameda,001,1643700,73515,71255,1510,72765,780
2021-01-25,Alpine,003,1148,73,72,0,72,0
2021-01-25,Amador,005,37829,3166,3074,24,3098,30
2021-01-25,Butte,007,227075,10502,9865,1462,11327,133
2021-01-25,Calaveras,009,45235,1722,1713,10,1723,21
2021-01-25,Colusa,011,21464,1741,1709,195,1904,8
2021-01-25,Contra Costa,013,1133247,57345,54989,940,55929,488
2021-01-25,Del Norte,015,27424,889,855,4,859,2
2021-01-25,El Dorado,017,186661,8502,8060,559,8619,66
2021-01-25,Fresno,019,978130,89962,86336,6725,93061,913
2021-01-25,Glenn,021,27897,2096,2028,428,2456,13
2021-01-25,Humboldt,023,135768,2739,2587,17,2604,24
2021-01-25,Imperial,025,180216,26373,25745,2300,28045,491
2021-01-25,Inyo,027,18085,1071,1015,8,1023,27
2021-01-25,Kern,029,883053,86783,83401,8118,91519,787
2021-01-25,Kings,031,150075,20768,20067,834,20901,159
2021-01-25,Lake,033,64148,2833,2729,1,2730,32
2021-01-25,Lassen,035,31185,4903,4835,86,4921,1
2021-01-25,Los Angeles,037,10098052,1102635,1055181,34694,1089875,15163
2021-01-25,Madera,039,155013,14575,14068,692,14760,86
2021-01-25,Marin,041,260295,12255,11923,129,12052,177
2021-01-25,Mariposa,043,17540,350,331,3,334,3
2021-01-25,Mendocino,045,87422,3238,3054,61,3115,35
2021-01-25,Merced,047,269075,25767,25181,715,25896,305
2021-01-25,Modoc,049,8938,301,288,91,379,0
2021-01-25,Mono,051,14174,1126,1114,15,1129,3
2021-01-25,Monterey,053,433212,38907,37726,1298,39024,255
2021-01-25,Napa,055,140530,8292,8057,30,8087,43
2021-01-25,Nevada,057,99092,3600,3365,140,3505,18
2021-01-25,Orange,059,3164182,231210,225105,9228,234333,2696
2021-01-25,Placer,061,380077,19107,17936,942,18878,193
2021-01-25,Plumas,063,18699,613,533,10,543,2
2021-01-25,Riverside,065,2383286,268161,258082,12453,270535,2789
2021-01-25,Sacramento,067,1510023,86501,84653,1020,85673,1118
2021-01-25,San Benito,069,59416,5352,5238,66,5304,43
2021-01-25,San Bernardino,071,2135413,272923,263174,7883,271057,1947
2021-01-25,San Diego,073,3302833,242055,228630,11298,239928,2375
2021-01-25,San Francisco,075,870044,31257,30734,796,31530,288
2021-01-25,San Joaquin,077,732212,61677,59291,2376,61667,838
2021-01-25,San Luis Obispo,079,281455,17745,16868,453,17321,179
2021-01-25,San Mateo,081,765935,36188,34187,320,34507,213
2021-01-25,Santa Barbara,083,443738,28689,27065,841,27906,269
2021-01-25,Santa Clara,085,1922200,101099,98647,446,99093,1143
2021-01-25,Santa Cruz,087,273765,14150,12973,661,13634,133
2021-01-25,Shasta,089,179085,10234,9991,1048,11039,103
2021-01-25,Sierra,091,2930,48,42,12,54,0
2021-01-25,Siskiyou,093,43540,1301,1205,183,1388,4
2021-01-25,Solano,095,438530,27471,26648,303,26951,109
2021-01-25,Sonoma,097,501317,25691,25160,128,25288,233
2021-01-25,Stanislaus,099,539301,46229,44293,4650,48943,599
2021-01-25,Sutter,101,95872,8164,8023,76,8099,83
2021-01-25,Tehama,103,63373,4234,4082,445,4527,20
2021-01-25,Trinity,105,12862,439,262,63,325,3
2021-01-25,Tulare,107,460477,44916,43124,6357,49481,578
2021-01-25,Tuolumne,109,53932,3450,3422,34,3456,29
2021-01-25,Ventura,111,848112,69499,66910,2420,69330,439
2021-01-25,Yolo,113,214977,11881,11276,124,11400,140
2021-01-25,Yuba,115,75493,5074,4900,67,4967,31
2021-01-24,Alameda,001,1643700,73013,70823,1499,72322,780
2021-01-24,Alpine,003,1148,73,72,0,72,0
2021-01-24,Amador,005,37829,3133,3054,24,3078,30
2021-01-24,Butte,007,227075,10418,9820,1446,11266,133
2021-01-24,Calaveras,009,45235,1709,1704,10,1714,21
2021-01-24,Colusa,011,21464,1730,1689,189,1878,8
2021-01-24,Contra Costa,013,1133247,56959,54694,928,55622,488
2021-01-24,Del Norte,015,27424,885,855,4,859,2
2021-01-24,El Dorado,017,186661,8467,8003,555,8558,66
2021-01-24,Fresno,019,978130,89523,85808,6686,92494,911
2021-01-24,Glenn,021,27897,2088,2026,427,2453,13
2021-01-24,Humboldt,023,135768,2700,2562,17,2579,24
2021-01-24,Imperial,025,180216,26278,25707,2279,27986,488
2021-01-24,Inyo,027,18085,1055,1007,8,1015,27
2021-01-24,Kern,029,883053,86348,83125,8011,91136,785
2021-01-24,Kings,031,150075,20640,19988,818,20806,159
2021-01-24,Lake,033,64148,2816,2724,0,2724,32
2021-01-24,Lassen,035,31185,4892,4828,83,4911,1
2021-01-24,Los Angeles,037,10098052,1096216,1048757,34390,1083147,15119
2021-01-24,Madera,039,155013,14492,14000,686,14686,86
2021-01-24,Marin,041,260295,12191,11872,128,12000,177
2021-01-24,Mariposa,043,17540,346,322,3,325,3
2021-01-24,Mendocino,045,87422,3217,3037,60,3097,33
2021-01-24,Merced,047,269075,25556,25047,706,25753,305
2021-01-24,Modoc,049,8938,301,285,91,376,0
2021-01-24,Mono,051,14174,1119,1113,15,1128,3
2021-01-24,Monterey,053,433212,38635,37527,1264,38791,254
2021-01-24,Napa,055,140530,8250,8005,30,8035,43
2021-01-24,Nevada,057,99092,3558,3349,138,3487,18
2021-01-24,Orange,059,3164182,229777,223853,9159,233012,2632
2021-01-24,Placer,061,380077,18994,17839,922,18761,193
2021-01-24,Plumas,063,18699,610,532,10,542,2
2021-01-24,Riverside,065,2383286,266521,256767,12377,269144,2761
2021-01-24,Sacramento,067,1510023,85948,84110,1012,85122,1112
2021-01-24,San Benito,069,59416,5310,5223,63,5286,43
2021-01-24,San Bernardino,071,2135413,271610,262370,7831,270201,1935
2021-01-24,San Diego,073,3302833,240361,227193,11167,238360,2375
2021-01-24,San Francisco,075,870044,31067,30559,775,31334,275
2021-01-24,San Joaquin,077,732212,61252,59021,2362,61383,838
2021-01-24,San Luis Obispo,079,281455,17621,16758,451,17209,179
2021-01-24,San Mateo,081,765935,35943,33956,314,34270,213
2021-01-24,Santa Barbara,083,443738,28374,26735,831,27566,269
2021-01-24,Santa Clara,085,1922200,100464,98103,441,98544,1109
2021-01-24,Santa Cruz,087,273765,14064,12905,653,13558,133
2021-01-24,Shasta,089,179085,10163,9978,1039,11017,103
2021-01-24,Sierra,091,2930,47,42,12,54,0
2021-01-24,Siskiyou,093,43540,1294,1195,183,1378,4
2021-01-24,Solano,095,438530,27286,26515,299,26814,109
2021-01-24,Sonoma,097,501317,25529,25045,127,25172,233
2021-01-24,Stanislaus,099,539301,45920,44031,4591,48622,599
2021-01-24,Sutter,101,95872,8100,7980,76,8056,83
2021-01-24,Tehama,103,63373,4194,4062,442,4504,20
2021-01-24,Trinity,105,12862,439,262,63,325,3
2021-01-24,Tulare,107,460477,44696,43006,6268,49274,577
2021-01-24,Tuolumne,109,53932,3439,3416,34,3450,29
2021-01-24,Ventura,111,848112,68809,66347,2398,68745,439
2021-01-24,Yolo,113,214977,11798,11210,120,11330,140
2021-01-24,Yuba,115,75493,5034,4875,66,4941,31
2021-01-23,Alameda,001,1643700,72765,70080,1493,71573,780
2021-01-23,Alpine,003,1148,73,72,0,72,0
2021-01-23,Amador,005,37829,3130,3049,24,3073,30
2021-01-23,Butte,007,227075,10389,9757,1443,11200,133
2021-01-23,Calaveras,009,45235,1706,1695,10,1705,21
2021-01-23,Colusa,011,21464,1726,1672,188,1860,8
2021-01-23,Contra Costa,013,1133247,56745,54162,922,55084,487
2021-01-23,Del Norte,015,27424,883,855,4,859,2
2021-01-23,El Dorado,017,186661,8451,7984,553,8537,66
2021-01-23,Fresno,019,978130,89336,85274,6658,91932,910
2021-01-23,Glenn,021,27897,2085,2015,423,2438,13
2021-01-23,Humboldt,023,135768,2681,2493,16,2509,23
2021-01-23,Imperial,025,180216,26244,25581,2267,27848,487
2021-01-23,Inyo,027,18085,1046,987,8,995,27
2021-01-23,Kern,029,883053,86105,82602,7943,90545,783
2021-01-23,Kings,031,150075,20596,19904,816,20720,159
2021-01-23,Lake,033,64148,2807,2673,0,2673,32
2021-01-23,Lassen,035,31185,4891,4816,80,4896,1
2021-01-23,Los Angeles,037,10098052,1092977,1040961,34232,1075193,15034
2021-01-23,Madera,039,155013,14455,13858,683,14541,86
2021-01-23,Marin,041,260295,12135,11796,126,11922,177
2021-01-23,Mariposa,043,17540,346,323,3,326,3
2021-01-23,Mendocino,045,87422,3203,2991,60,3051,32
2021-01-23,Merced,047,269075,25464,24787,692,25479,303
2021-01-23,Modoc,049,8938,301,285,91,376,0
2021-01-23,Mono,051,14174,1117,1111,15,1126,3
2021-01-23,Monterey,053,433212,38552,37165,1259,38424,253
2021-01-23,Napa,055,140530,8225,7893,30,7923,43
2021-01-23,Nevada,057,99092,3547,3332,137,3469,18
2021-01-23,Orange,059,3164182,229008,221722,9119,230841,2618
2021-01-23,Placer,061,380077,18944,17617,917,18534,193
2021-01-23,Plumas,063,18699,609,528,10,538,2
2021-01-23,Riverside,065,2383286,265622,253636,12327,265963,2733
2021-01-23,Sacramento,067,1510023,85720,83408,1009,84417,1108
2021-01-23,San Benito,069,59416,5286,5166,62,5228,43
2021-01-23,San Bernardino,071,2135413,271053,260381,7801,268182,1922
2021-01-23,San Diego,073,3302833,239300,225556,11095,236651,2344
2021-01-23,San Francisco,075,870044,30962,30308,745,31053,268
2021-01-23,San Joaquin,077,732212,61124,58164,2352,60516,836
2021-01-23,San Luis Obispo,079,281455,17557,16652,448,17100,176
2021-01-23,San Mateo,081,765935,35767,33696,303,33999,213
2021-01-23,Santa Barbara,083,443738,28189,26234,822,27056,264
2021-01-23,Santa Clara,085,1922200,100105,97189,440,97629,1086
2021-01-23,Santa Cruz,087,273765,14006,12771,650,13421,127
2021-01-23,Shasta,089,179085,10134,9951,1038,10989,103
2021-01-23,Sierra,091,2930,47,41,12,53,0
2021-01-23,Siskiyou,093,43540,1285,1190,182,1372,4
2021-01-23,Solano,095,438530,27193,26261,297,26558,107
2021-01-23,Sonoma,097,501317,25449,24790,127,24917,232
2021-01-23,Stanislaus,099,539301,45753,43723,4560,48283,599
2021-01-23,Sutter,101,95872,8082,7943,75,8018,80
2021-01-23,Tehama,103,63373,4175,4006,441,4447,20
2021-01-23,Trinity,105,12862,439,262,63,325,3
2021-01-23,Tulare,107,460477,44543,42661,6208,48869,575
2021-01-23,Tuolumne,109,53932,3432,3407,34,3441,29
2021-01-23,Ventura,111,848112,68353,65581,2375,67956,438
2021-01-23,Yolo,113,214977,11757,11087,118,11205,141
2021-01-23,Yuba,115,75493,5022,4831,65,4896,30
2021-01-22,Alameda,001,1643700,72447,69693,1486,71179,751
2021-01-22,Alpine,003,1148,73,71,0,71,0
2021-01-22,Amador,005,37829,3125,3042,24,3066,30
2021-01-22,Butte,007,227075,10345,9711,1430,11141,133
2021-01-22,Calaveras,009,45235,1697,1672,10,1682,21
2021-01-22,Colusa,011,21464,1724,1668,188,1856,7
2021-01-22,Contra Costa,013,1133247,56507,53887,916,54803,485
2021-01-22,Del Norte,015,27424,882,852,4,856,2
2021-01-22,El Dorado,017,186661,8418,7877,550,8427,64
2021-01-22,Fresno,019,978130,88995,84744,6630,91374,892
2021-01-22,Glenn,021,27897,2080,1985,417,2402,13
2021-01-22,Humboldt,023,135768,2657,2452,16,2468,23
2021-01-22,Imperial,025,180216,26210,25562,2252,27814,474
2021-01-22,Inyo,027,18085,1035,961,8,969,26
2021-01-22,Kern,029,883053,85808,82101,7867,89968,771
2021-01-22,Kings,031,150075,20520,19760,812,20572,159
2021-01-22,Lake,033,64148,2795,2681,0,2681,32
2021-01-22,Lassen,035,31185,4882,4765,79,4844,1
2021-01-22,Los Angeles,037,10098052,1088507,1031177,34045,1065222,14777
2021-01-22,Madera,039,155013,14395,13781,682,14463,86
2021-01-22,Marin,041,260295,12098,11769,124,11893,177
2021-01-22,Mariposa,043,17540,346,323,3,326,3
2021-01-22,Mendocino,045,87422,3178,2994,59,3053,32
2021-01-22,Merced,047,269075,25341,24616,685,25301,290
2021-01-22,Modoc,049,8938,301,285,91,376,0
2021-01-22,Mono,051,14174,1117,1108,15,1123,3
2021-01-22,Monterey,053,433212,38399,36909,1254,38163,253
2021-01-22,Napa,055,140530,8180,7828,30,7858,40
2021-01-22,Nevada,057,99092,3522,3296,136,3432,18
2021-01-22,Orange,059,3164182,228055,220384,9072,229456,2542
2021-01-22,Placer,061,380077,18887,17636,902,18538,193
2021-01-22,Plumas,063,18699,607,522,10,532,2
2021-01-22,Riverside,065,2383286,264478,252440,12261,264701,2710
2021-01-22,Sacramento,067,1510023,85389,82861,1001,83862,1094
2021-01-22,San Benito,069,59416,5260,5143,62,5205,43
2021-01-22,San Bernardino,071,2135413,270250,259121,7771,266892,1849
2021-01-22,San Diego,073,3302833,238060,222576,11030,233606,2301
2021-01-22,San Francisco,075,870044,30848,30027,728,30755,266
2021-01-22,San Joaquin,077,732212,60940,58485,2340,60825,812
2021-01-22,San Luis Obispo,079,281455,17467,16336,445,16781,172
2021-01-22,San Mateo,081,765935,35545,33401,300,33701,211
2021-01-22,Santa Barbara,083,443738,27989,25989,811,26800,256
2021-01-22,Santa Clara,085,1922200,99659,96435,437,96872,1062
2021-01-22,Santa Cruz,087,273765,13948,12687,646,13333,123
2021-01-22,Shasta,089,179085,10114,9866,1036,10902,103
2021-01-22,Sierra,091,2930,47,40,12,52,0
2021-01-22,Siskiyou,093,43540,1281,1182,180,1362,4
2021-01-22,Solano,095,438530,27102,26048,295,26343,107
2021-01-22,Sonoma,097,501317,25364,24659,127,24786,232
2021-01-22,Stanislaus,099,539301,45587,43489,4534,48023,599
2021-01-22,Sutter,101,95872,8057,7878,75,7953,80
2021-01-22,Tehama,103,63373,4161,3993,439,4432,19
2021-01-22,Trinity,105,12862,438,263,63,326,3
2021-01-22,Tulare,107,460477,44364,42307,6141,48448,573
2021-01-22,Tuolumne,109,53932,3404,3379,34,3413,29
2021-01-22,Ventura,111,848112,67840,64404,2356,66760,426
2021-01-22,Yolo,113,214977,11724,11014,116,11130,141
2021-01-22,Yuba,115,75493,4998,4789,63,4852,29
2021-01-21,Alameda,001,1643700,72013,69314,1469,70783,739
2021-01-21,Alpine,003,1148,73,71,0,71,0
2021-01-21,Amador,005,37829,3103,3038,24,3062,29
2021-01-21,Butte,007,227075,10281,9643,1423,11066,130
2021-01-21,Calaveras,009,45235,1689,1647,10,1657,21
2021-01-21,Colusa,011,21464,1717,1662,186,1848,7
2021-01-21,Contra Costa,013,1133247,56117,53595,904,54499,478
2021-01-21,Del Norte,015,27424,880,850,3,853,2
2021-01-21,El Dorado,017,186661,8369,7823,547,8370,58
2021-01-21,Fresno,019,978130,88590,84137,6590,90727,889
2021-01-21,Glenn,021,27897,2072,1964,412,2376,13
2021-01-21,Humboldt,023,135768,2634,2423,16,2439,23
2021-01-21,Imperial,025,180216,26125,25509,2240,27749,463
2021-01-21,Inyo,027,18085,1026,946,8,954,26
2021-01-21,Kern,029,883053,85395,81328,7752,89080,769
2021-01-21,Kings,031,150075,20449,19633,795,20428,158
2021-01-21,Lake,033,64148,2781,2669,0,2669,32
2021-01-21,Lassen,035,31185,4875,4763,79,4842,1
2021-01-21,Los Angeles,037,10098052,1081839,1023055,33733,1056788,14537
2021-01-21,Madera,039,155013,14331,13664,674,14338,86
2021-01-21,Marin,041,260295,12044,11732,122,11854,173
2021-01-21,Mariposa,043,17540,342,322,3,325,3
2021-01-21,Mendocino,045,87422,3155,2967,57,3024,32
2021-01-21,Merced,047,269075,25186,24426,678,25104,245
2021-01-21,Modoc,049,8938,298,284,90,374,0
2021-01-21,Mono,051,14174,1112,1104,15,1119,3
2021-01-21,Monterey,053,433212,38118,36149,1245,37394,253
2021-01-21,Napa,055,140530,8116,7774,30,7804,40
2021-01-21,Nevada,057,99092,3493,3274,135,3409,18
2021-01-21,Orange,059,3164182,226679,218867,9018,227885,2540
2021-01-21,Placer,061,380077,18809,17553,898,18451,190
2021-01-21,Plumas,063,18699,603,518,10,528,2
2021-01-21,Riverside,065,2383286,262762,251007,12183,263190,2676
2021-01-21,Sacramento,067,1510023,84910,82303,981,83284,1084
2021-01-21,San Benito,069,59416,5230,5100,57,5157,43
2021-01-21,San Bernardino,071,2135413,268932,257754,7706,265460,1832
2021-01-21,San Diego,073,3302833,236285,219729,10923,230652,2222
2021-01-21,San Francisco,075,870044,30675,29801,694,30495,266
2021-01-21,San Joaquin,077,732212,60634,58270,2322,60592,806
2021-01-21,San Luis Obispo,079,281455,17381,16153,437,16590,169
2021-01-21,San Mateo,081,765935,35299,33156,287,33443,210
2021-01-21,Santa Barbara,083,443738,27701,25654,798,26452,253
2021-01-21,Santa Clara,085,1922200,99072,96028,432,96460,1062
2021-01-21,Santa Cruz,087,273765,13864,12548,636,13184,119
2021-01-21,Shasta,089,179085,10071,9795,1021,10816,98
2021-01-21,Sierra,091,2930,47,40,12,52,0
2021-01-21,Siskiyou,093,43540,1278,1178,178,1356,4
2021-01-21,Solano,095,438530,26924,25885,291,26176,106
2021-01-21,Sonoma,097,501317,25224,24440,125,24565,230
2021-01-21,Stanislaus,099,539301,45289,43223,4490,47713,599
2021-01-21,Sutter,101,95872,8023,7822,75,7897,80
2021-01-21,Tehama,103,63373,4122,3938,438,4376,19
2021-01-21,Trinity,105,12862,438,261,63,324,3
2021-01-21,Tulare,107,460477,44153,42082,6067,48149,569
2021-01-21,Tuolumne,109,53932,3394,3365,33,3398,29
2021-01-21,Ventura,111,848112,67141,63995,2336,66331,420
2021-01-21,Yolo,113,214977,11633,10940,108,11048,141
2021-01-21,Yuba,115,75493,4966,4757,62,4819,29
2021-01-20,Alameda,001,1643700,71540,68785,1453,70238,702
2021-01-20,Alpine,003,1148,73,71,0,71,0
2021-01-20,Amador,005,37829,3072,3036,24,3060,29
2021-01-20,Butte,007,227075,10225,9582,1413,10995,130
2021-01-20,Calaveras,009,45235,1667,1637,9,1646,21
2021-01-20,Colusa,011,21464,1700,1630,181,1811,7
2021-01-20,Contra Costa,013,1133247,55691,53108,895,54003,461
2021-01-20,Del Norte,015,27424,879,848,3,851,2
2021-01-20,El Dorado,017,186661,8319,7785,544,8329,53
2021-01-20,Fresno,019,978130,88171,83591,6536,90127,872
2021-01-20,Glenn,021,27897,2053,1955,410,2365,13
2021-01-20,Humboldt,023,135768,2591,2390,16,2406,22
2021-01-20,Imperial,025,180216,26053,25380,2206,27586,461
2021-01-20,Inyo,027,18085,1016,901,8,909,26
2021-01-20,Kern,029,883053,84945,80701,7646,88347,754
2021-01-20,Kings,031,150075,20359,19522,787,20309,146
2021-01-20,Lake,033,64148,2761,2646,0,2646,31
2021-01-20,Lassen,035,31185,4867,4758,77,4835,1
2021-01-20,Los Angeles,037,10098052,1074337,1015608,33455,1049063,14299
2021-01-20,Madera,039,155013,14266,13585,670,14255,86
2021-01-20,Marin,041,260295,11988,11684,120,11804,171
2021-01-20,Mariposa,043,17540,340,322,3,325,3
2021-01-20,Mendocino,045,87422,3140,2957,57,3014,32
2021-01-20,Merced,047,269075,25013,24220,656,24876,243
2021-01-20,Modoc,049,8938,297,282,90,372,0
2021-01-20,Mono,051,14174,1105,1105,14,1119,3
2021-01-20,Monterey,053,433212,37806,35960,1225,37185,249
2021-01-20,Napa,055,140530,8047,7731,30,7761,40
2021-01-20,Nevada,057,99092,3461,3238,135,3373,18
2021-01-20,Orange,059,3164182,225143,216893,8957,225850,2500
2021-01-20,Placer,061,380077,18715,17455,880,18335,186
2021-01-20,Plumas,063,18699,601,512,10,522,2
2021-01-20,Riverside,065,2383286,260718,248686,12100,260786,2615
2021-01-20,Sacramento,067,1510023,84350,81687,971,82658,1072
2021-01-20,San Benito,069,59416,5199,5036,56,5092,35
2021-01-20,San Bernardino,071,2135413,267610,255921,7659,263580,1801
2021-01-20,San Diego,073,3302833,234430,218553,10819,229372,2174
2021-01-20,San Francisco,075,870044,30488,29665,673,30338,262
2021-01-20,San Joaquin,077,732212,60230,58025,2313,60338,783
2021-01-20,San Luis Obispo,079,281455,17199,15936,428,16364,164
2021-01-20,San Mateo,081,765935,35072,32929,286,33215,210
2021-01-20,Santa Barbara,083,443738,27383,25312,786,26098,248
2021-01-20,Santa Clara,085,1922200,98427,94995,430,95425,1040
2021-01-20,Santa Cruz,087,273765,13757,12460,623,13083,107
2021-01-20,Shasta,089,179085,10019,9697,1011,10708,98
2021-01-20,Sierra,091,2930,47,40,12,52,0
2021-01-20,Siskiyou,093,43540,1271,1163,177,1340,4
2021-01-20,Solano,095,438530,26731,25659,287,25946,106
2021-01-20,Sonoma,097,501317,25087,24262,123,24385,223
2021-01-20,Stanislaus,099,539301,45009,42955,4452,47407,585
2021-01-20,Sutter,101,95872,7972,7772,73,7845,80
2021-01-20,Tehama,103,63373,4096,3892,435,4327,19
2021-01-20,Trinity,105,12862,438,260,63,323,3
2021-01-20,Tulare,107,460477,43896,41799,5977,47776,559
2021-01-20,Tuolumne,109,53932,3380,3355,32,3387,29
2021-01-20,Ventura,111,848112,66180,63413,2307,65720,395
2021-01-20,Yolo,113,214977,11568,10852,105,10957,141
2021-01-20,Yuba,115,75493,4939,4729,62,4791,29
2021-01-19,Alameda,001,1643700,70899,68434,1444,69878,680
2021-01-19,Alpine,003,1148,73,71,0,71,0
2021-01-19,Amador,005,37829,3063,3024,24,3048,28
2021-01-19,Butte,007,227075,10162,9528,1399,10927,129
2021-01-19,Calaveras,009,45235,1652,1621,8,1629,21
2021-01-19,Colusa,011,21464,1678,1617,178,1795,7
2021-01-19,Contra Costa,013,1133247,55228,52730,885,53615,448
2021-01-19,Del Norte,015,27424,877,843,3,846,2
2021-01-19,El Dorado,017,186661,8258,7743,536,8279,47
2021-01-19,Fresno,019,978130,87649,83200,6486,89686,857
2021-01-19,Glenn,021,27897,2041,1948,405,2353,13
2021-01-19,Humboldt,023,135768,2567,2359,13,2372,22
2021-01-19,Imperial,025,180216,25973,25333,2189,27522,452
2021-01-19,Inyo,027,18085,1008,891,8,899,26
2021-01-19,Kern,029,883053,84357,80272,7541,87813,742
2021-01-19,Kings,031,150075,20220,19375,777,20152,143
2021-01-19,Lake,033,64148,2748,2625,0,2625,31
2021-01-19,Lassen,035,31185,4860,4753,77,4830,1
2021-01-19,Los Angeles,037,10098052,1065663,1010375,33190,1043565,14014
2021-01-19,Madera,039,155013,14155,13528,665,14193,86
2021-01-19,Marin,041,260295,11933,11654,116,11770,169
2021-01-19,Mariposa,043,17540,340,322,3,325,3
2021-01-19,Mendocino,045,87422,3123,2930,57,2987,32
2021-01-19,Merced,047,269075,24801,24108,647,24755,242
2021-01-19,Modoc,049,8938,296,281,90,371,0
2021-01-19,Mono,051,14174,1104,1106,14,1120,3
2021-01-19,Monterey,053,433212,37505,35840,1204,37044,248
2021-01-19,Napa,055,140530,7989,7672,30,7702,38
2021-01-19,Nevada,057,99092,3443,3216,133,3349,18
2021-01-19,Orange,059,3164182,223410,215244,8890,224134,2468
2021-01-19,Placer,061,380077,18618,17348,870,18218,182
2021-01-19,Plumas,063,18699,594,509,10,519,2
2021-01-19,Riverside,065,2383286,258631,246248,12022,258270,2585
2021-01-19,Sacramento,067,1510023,83813,81183,951,82134,1053
2021-01-19,San Benito,069,59416,5153,4988,55,5043,35
2021-01-19,San Bernardino,071,2135413,265906,253651,7605,261256,1777
2021-01-19,San Diego,073,3302833,232007,216833,10721,227554,2109
2021-01-19,San Francisco,075,870044,30269,29502,642,30144,261
2021-01-19,San Joaquin,077,732212,59850,57655,2302,59957,782
2021-01-19,San Luis Obispo,079,281455,16936,15855,425,16280,161
2021-01-19,San Mateo,081,765935,34787,32730,275,33005,208
2021-01-19,Santa Barbara,083,443738,26999,24991,770,25761,236
2021-01-19,Santa Clara,085,1922200,97692,94483,429,94912,1010
2021-01-19,Santa Cruz,087,273765,13640,12410,615,13025,106
2021-01-19,Shasta,089,179085,9983,9614,1001,10615,93
2021-01-19,Sierra,091,2930,47,40,10,50,0
2021-01-19,Siskiyou,093,43540,1263,1149,175,1324,4
2021-01-19,Solano,095,438530,26483,25520,286,25806,106
2021-01-19,Sonoma,097,501317,24907,24133,121,24254,223
2021-01-19,Stanislaus,099,539301,44661,42723,4407,47130,561
2021-01-19,Sutter,101,95872,7922,7709,67,7776,80
2021-01-19,Tehama,103,63373,4066,3876,433,4309,19
2021-01-19,Trinity,105,12862,437,260,63,323,3
2021-01-19,Tulare,107,460477,43617,41559,5882,47441,549
2021-01-19,Tuolumne,109,53932,3353,3328,32,3360,29
2021-01-19,Ventura,111,848112,65496,62656,2280,64936,383
2021-01-19,Yolo,113,214977,11483,10789,105,10894,134
2021-01-19,Yuba,115,75493,4906,4695,61,4756,29
2021-01-18,Alameda,001,1643700,70267,67938,1427,69365,680
2021-01-18,Alpine,003,1148,73,71,0,71,0
2021-01-18,Amador,005,37829,3049,3016,24,3040,28
2021-01-18,Butte,007,227075,10076,9474,1387,10861,129
2021-01-18,Calaveras,009,45235,1631,1617,7,1624,21
2021-01-18,Colusa,011,21464,1662,1608,176,1784,7
2021-01-18,Contra Costa,013,1133247,54719,52323,877,53200,448
2021-01-18,Del Norte,015,27424,876,840,3,843,2
2021-01-18,El Dorado,017,186661,8192,7707,534,8241,47
2021-01-18,Fresno,019,978130,87038,82485,6420,88905,857
2021-01-18,Glenn,021,27897,2024,1935,401,2336,13
2021-01-18,Humboldt,023,135768,2529,2343,13,2356,22
2021-01-18,Imperial,025,180216,25905,25317,2165,27482,452
2021-01-18,Inyo,027,18085,996,872,8,880,26
2021-01-18,Kern,029,883053,83720,79930,7450,87380,740
2021-01-18,Kings,031,150075,20050,19267,765,20032,141
2021-01-18,Lake,033,64148,2731,2591,0,2591,30
2021-01-18,Lassen,035,31185,4824,4749,76,4825,1
2021-01-18,Los Angeles,037,10098052,1056151,1002614,32907,1035521,13828
2021-01-18,Madera,039,155013,14053,13443,656,14099,85
2021-01-18,Marin,041,260295,11887,11607,114,11721,165
2021-01-18,Mariposa,043,17540,337,320,2,322,3
2021-01-18,Mendocino,045,87422,3100,2919,57,2976,31
2021-01-18,Merced,047,269075,24556,23927,631,24558,242
2021-01-18,Modoc,049,8938,293,281,87,368,0
2021-01-18,Mono,051,14174,1101,1101,14,1115,3
2021-01-18,Monterey,053,433212,37063,35549,1190,36739,247
2021-01-18,Napa,055,140530,7916,7601,30,7631,38
2021-01-18,Nevada,057,99092,3405,3199,133,3332,17
2021-01-18,Orange,059,3164182,221522,213866,8836,222702,2405
2021-01-18,Placer,061,380077,18502,17263,861,18124,182
2021-01-18,Plumas,063,18699,591,506,10,516,2
2021-01-18,Riverside,065,2383286,256320,244151,11929,256080,2568
2021-01-18,Sacramento,067,1510023,83143,80546,935,81481,1046
2021-01-18,San Benito,069,59416,5105,4963,53,5016,35
2021-01-18,San Bernardino,071,2135413,264188,252808,7550,260358,1775
2021-01-18,San Diego,073,3302833,229359,214335,10592,224927,2103
2021-01-18,San Francisco,075,870044,30062,29321,618,29939,259
2021-01-18,San Joaquin,077,732212,59338,57405,2281,59686,782
2021-01-18,San Luis Obispo,079,281455,16749,15742,415,16157,158
2021-01-18,San Mateo,081,765935,34475,32515,256,32771,208
2021-01-18,Santa Barbara,083,443738,26620,24638,757,25395,235
2021-01-18,Santa Clara,085,1922200,96905,93688,425,94113,992
2021-01-18,Santa Cruz,087,273765,13507,12298,602,12900,106
2021-01-18,Shasta,089,179085,9944,9600,991,10591,92
2021-01-18,Sierra,091,2930,46,40,10,50,0
2021-01-18,Siskiyou,093,43540,1250,1144,174,1318,4
2021-01-18,Solano,095,438530,26205,25344,282,25626,105
2021-01-18,Sonoma,097,501317,24639,24068,120,24188,223
2021-01-18,Stanislaus,099,539301,44304,42413,4351,46764,562
2021-01-18,Sutter,101,95872,7865,7680,65,7745,78
2021-01-18,Tehama,103,63373,4021,3854,426,4280,19
2021-01-18,Trinity,105,12862,437,260,63,323,3
2021-01-18,Tulare,107,460477,43327,41196,5776,46972,549
2021-01-18,Tuolumne,109,53932,3329,3318,31,3349,28
2021-01-18,Ventura,111,848112,65063,61859,2258,64117,379
2021-01-18,Yolo,113,214977,11361,10620,102,10722,134
2021-01-18,Yuba,115,75493,4879,4671,59,4730,29
2021-01-17,Alameda,001,1643700,69703,67375,1409,68784,676
2021-01-17,Alpine,003,1148,73,71,0,71,0
2021-01-17,Amador,005,37829,3042,3001,24,3025,28
2021-01-17,Butte,007,227075,10001,9411,1363,10774,129
2021-01-17,Calaveras,009,45235,1618,1608,7,1615,21
2021-01-17,Colusa,011,21464,1649,1588,172,1760,7
2021-01-17,Contra Costa,013,1133247,54212,51932,866,52798,447
2021-01-17,Del Norte,015,27424,876,838,3,841,2
2021-01-17,El Dorado,017,186661,8137,7659,523,8182,47
2021-01-17,Fresno,019,978130,86484,82039,6345,88384,857
2021-01-17,Glenn,021,27897,2013,1924,396,2320,9
2021-01-17,Humboldt,023,135768,2493,2322,11,2333,22
2021-01-17,Imperial,025,180216,25835,25253,2124,27377,451
2021-01-17,Inyo,027,18085,990,864,8,872,26
2021-01-17,Kern,029,883053,83171,79489,7364,86853,738
2021-01-17,Kings,031,150075,19914,19201,751,19952,131
2021-01-17,Lake,033,64148,2717,2572,0,2572,30
2021-01-17,Lassen,035,31185,4816,4740,75,4815,1
2021-01-17,Los Angeles,037,10098052,1049490,993028,32519,1025547,13741
2021-01-17,Madera,039,155013,13963,13328,652,13980,85
2021-01-17,Marin,041,260295,11838,11552,112,11664,164
2021-01-17,Mariposa,043,17540,337,319,2,321,3
2021-01-17,Mendocino,045,87422,3072,2912,56,2968,31
2021-01-17,Merced,047,269075,24344,23800,613,24413,242
2021-01-17,Modoc,049,8938,292,279,87,366,0
2021-01-17,Mono,051,14174,1094,1091,13,1104,3
2021-01-17,Monterey,053,433212,36819,35340,1164,36504,244
2021-01-17,Napa,055,140530,7860,7521,30,7551,38
2021-01-17,Nevada,057,99092,3380,3176,131,3307,17
2021-01-17,Orange,059,3164182,219528,212389,8763,221152,2359
2021-01-17,Placer,061,380077,18396,17194,846,18040,181
2021-01-17,Plumas,063,18699,589,505,9,514,2
2021-01-17,Riverside,065,2383286,254210,242206,11813,254019,2534
2021-01-17,Sacramento,067,1510023,82543,80154,923,81077,1045
2021-01-17,San Benito,069,59416,5067,4941,53,4994,35
2021-01-17,San Bernardino,071,2135413,262090,251487,7463,258950,1775
2021-01-17,San Diego,073,3302833,227165,211785,10485,222270,2103
2021-01-17,San Francisco,075,870044,29873,29139,581,29720,255
2021-01-17,San Joaquin,077,732212,58981,57094,2267,59361,780
2021-01-17,San Luis Obispo,079,281455,16627,15658,406,16064,157
2021-01-17,San Mateo,081,765935,34223,32186,233,32419,208
2021-01-17,Santa Barbara,083,443738,26159,24401,745,25146,235
2021-01-17,Santa Clara,085,1922200,96145,92752,422,93174,976
2021-01-17,Santa Cruz,087,273765,13395,12196,599,12795,106
2021-01-17,Shasta,089,179085,9886,9588,983,10571,92
2021-01-17,Sierra,091,2930,46,38,9,47,0
2021-01-17,Siskiyou,093,43540,1243,1136,171,1307,4
2021-01-17,Solano,095,438530,25979,25216,280,25496,105
2021-01-17,Sonoma,097,501317,24465,23871,120,23991,223
2021-01-17,Stanislaus,099,539301,43984,42221,4288,46509,562
2021-01-17,Sutter,101,95872,7802,7604,64,7668,77
2021-01-17,Tehama,103,63373,3990,3837,422,4259,18
2021-01-17,Trinity,105,12862,437,261,63,324,3
2021-01-17,Tulare,107,460477,43040,41016,5660,46676,549
2021-01-17,Tuolumne,109,53932,3312,3287,31,3318,27
2021-01-17,Ventura,111,848112,64212,61257,2211,63468,376
2021-01-17,Yolo,113,214977,11262,10519,100,10619,134
2021-01-17,Yuba,115,75493,4832,4640,56,4696,28
2021-01-16,Alameda,001,1643700,69381,66583,1397,67980,673
2021-01-16,Alpine,003,1148,73,71,0,71,0
2021-01-16,Amador,005,37829,3039,2986,24,3010,28
2021-01-16,Butte,007,227075,9970,9359,1343,10702,129
2021-01-16,Calaveras,009,45235,1605,1596,7,1603,21
2021-01-16,Colusa,011,21464,1638,1578,172,1750,7
2021-01-16,Contra Costa,013,1133247,53933,51363,859,52222,443
2021-01-16,Del Norte,015,27424,871,833,3,836,2
2021-01-16,El Dorado,017,186661,8115,7575,522,8097,47
2021-01-16,Fresno,019,978130,86208,81294,6291,87585,846
2021-01-16,Glenn,021,27897,2009,1894,393,2287,9
2021-01-16,Humboldt,023,135768,2473,2294,9,2303,22
2021-01-16,Imperial,025,180216,25797,25140,2117,27257,451
2021-01-16,Inyo,027,18085,986,845,8,853,25
2021-01-16,Kern,029,883053,82804,78865,7310,86175,733
2021-01-16,Kings,031,150075,19858,19072,748,19820,131
2021-01-16,Lake,033,64148,2705,2504,0,2504,30
2021-01-16,Lassen,035,31185,4804,4719,75,4794,1
2021-01-16,Los Angeles,037,10098052,1045404,982684,32285,1014969,13654
2021-01-16,Madera,039,155013,13897,13193,647,13840,85
2021-01-16,Marin,041,260295,11796,11482,112,11594,164
2021-01-16,Mariposa,043,17540,336,317,2,319,3
2021-01-16,Mendocino,045,87422,3058,2890,53,2943,31
2021-01-16,Merced,047,269075,24257,23478,599,24077,242
2021-01-16,Modoc,049,8938,292,278,87,365,0
2021-01-16,Mono,051,14174,1092,1079,13,1092,3
2021-01-16,Monterey,053,433212,36708,34972,1148,36120,243
2021-01-16,Napa,055,140530,7821,7356,30,7386,39
2021-01-16,Nevada,057,99092,3347,3144,131,3275,17
2021-01-16,Orange,059,3164182,218495,210111,8707,218818,2312
2021-01-16,Placer,061,380077,18332,16995,844,17839,177
2021-01-16,Plumas,063,18699,587,502,9,511,2
2021-01-16,Riverside,065,2383286,252852,239412,11698,251110,2506
2021-01-16,Sacramento,067,1510023,82168,79122,906,80028,1033
2021-01-16,San Benito,069,59416,5034,4875,53,4928,35
2021-01-16,San Bernardino,071,2135413,261262,249401,7396,256797,1755
2021-01-16,San Diego,073,3302833,225867,209895,10388,220283,2065
2021-01-16,San Francisco,075,870044,29744,28853,550,29403,244
2021-01-16,San Joaquin,077,732212,58738,56642,2234,58876,776
2021-01-16,San Luis Obispo,079,281455,16526,15466,404,15870,152
2021-01-16,San Mateo,081,765935,34058,31805,227,32032,208
2021-01-16,Santa Barbara,083,443738,25958,24088,741,24829,229
2021-01-16,Santa Clara,085,1922200,95650,91584,415,91999,954
2021-01-16,Santa Cruz,087,273765,13336,12026,597,12623,106
2021-01-16,Shasta,089,179085,9853,9547,979,10526,92
2021-01-16,Sierra,091,2930,45,38,9,47,0
2021-01-16,Siskiyou,093,43540,1238,1124,171,1295,4
2021-01-16,Solano,095,438530,25870,24732,276,25008,103
2021-01-16,Sonoma,097,501317,24374,23607,119,23726,223
2021-01-16,Stanislaus,099,539301,43796,41809,4238,46047,562
2021-01-16,Sutter,101,95872,7770,7560,64,7624,76
2021-01-16,Tehama,103,63373,3976,3783,422,4205,18
2021-01-16,Trinity,105,12862,437,261,63,324,3
2021-01-16,Tulare,107,460477,42861,40655,5587,46242,542
2021-01-16,Tuolumne,109,53932,3304,3269,31,3300,27
2021-01-16,Ventura,111,848112,63659,60368,2181,62549,369
2021-01-16,Yolo,113,214977,11211,10406,99,10505,134
2021-01-16,Yuba,115,75493,4804,4602,56,4658,27
2021-01-15,Alameda,001,1643700,68954,65416,1386,66802,672
2021-01-15,Alpine,003,1148,73,71,0,71,0
2021-01-15,Amador,005,37829,3032,2953,24,2977,28
2021-01-15,Butte,007,227075,9928,9233,1329,10562,129
2021-01-15,Calaveras,009,45235,1598,1538,7,1545,21
2021-01-15,Colusa,011,21464,1627,1541,167,1708,7
2021-01-15,Contra Costa,013,1133247,53597,50408,852,51260,428
2021-01-15,Del Norte,015,27424,867,828,2,830,2
2021-01-15,El Dorado,017,186661,8065,7439,514,7953,47
2021-01-15,Fresno,019,978130,85670,79950,6255,86205,832
2021-01-15,Glenn,021,27897,2005,1824,390,2214,9
2021-01-15,Humboldt,023,135768,2446,2218,8,2226,22
2021-01-15,Imperial,025,180216,25761,24944,2111,27055,446
2021-01-15,Inyo,027,18085,969,814,8,822,25
2021-01-15,Kern,029,883053,82388,77873,7245,85118,719
2021-01-15,Kings,031,150075,19749,18661,742,19403,131
2021-01-15,Lake,033,64148,2679,2434,0,2434,28
2021-01-15,Lassen,035,31185,4793,4693,73,4766,1
2021-01-15,Los Angeles,037,10098052,1038351,968979,32003,1000982,13404
2021-01-15,Madera,039,155013,13807,12883,643,13526,85
2021-01-15,Marin,041,260295,11740,11310,112,11422,160
2021-01-15,Mariposa,043,17540,334,307,2,309,3
2021-01-15,Mendocino,045,87422,3047,2835,53,2888,31
2021-01-15,Merced,047,269075,24144,23060,595,23655,239
2021-01-15,Modoc,049,8938,292,278,85,363,0
2021-01-15,Mono,051,14174,1089,1057,13,1070,3
2021-01-15,Monterey,053,433212,36491,34460,1091,35551,243
2021-01-15,Napa,055,140530,7759,7231,30,7261,38
2021-01-15,Nevada,057,99092,3334,3099,128,3227,17
2021-01-15,Orange,059,3164182,217140,207129,8655,215784,2254
2021-01-15,Placer,061,380077,18227,16712,835,17547,173
2021-01-15,Plumas,063,18699,584,499,9,508,2
2021-01-15,Riverside,065,2383286,250990,235235,11619,246854,2458
2021-01-15,Sacramento,067,1510023,81745,80279,898,81177,1023
2021-01-15,San Benito,069,59416,4995,4766,51,4817,35
2021-01-15,San Bernardino,071,2135413,260079,246182,7335,253517,1726
2021-01-15,San Diego,073,3302833,224118,206868,10323,217191,2037
2021-01-15,San Francisco,075,870044,29570,28574,530,29104,242
2021-01-15,San Joaquin,077,732212,58510,55885,2220,58105,748
2021-01-15,San Luis Obispo,079,281455,16392,15129,399,15528,148
2021-01-15,San Mateo,081,765935,33813,31291,223,31514,208
2021-01-15,Santa Barbara,083,443738,25675,23487,737,24224,226
2021-01-15,Santa Clara,085,1922200,94989,90103,410,90513,942
2021-01-15,Santa Cruz,087,273765,13227,11776,584,12360,105
2021-01-15,Shasta,089,179085,9814,9459,972,10431,91
2021-01-15,Sierra,091,2930,44,36,7,43,0
2021-01-15,Siskiyou,093,43540,1234,1119,171,1290,4
2021-01-15,Solano,095,438530,25722,24222,274,24496,103
2021-01-15,Sonoma,097,501317,24243,23204,118,23322,222
2021-01-15,Stanislaus,099,539301,43546,41178,4196,45374,562
2021-01-15,Sutter,101,95872,7723,7484,63,7547,75
2021-01-15,Tehama,103,63373,3954,3714,421,4135,17
2021-01-15,Trinity,105,12862,437,262,63,325,3
2021-01-15,Tulare,107,460477,42619,39951,5504,45455,535
2021-01-15,Tuolumne,109,53932,3288,3231,31,3262,27
2021-01-15,Ventura,111,848112,62916,59061,2148,61209,353
2021-01-15,Yolo,113,214977,11153,10240,98,10338,134
2021-01-15,Yuba,115,75493,4784,4549,56,4605,27
2021-01-14,Alameda,001,1643700,68327,64364,1371,65735,686
2021-01-14,Alpine,003,1148,73,71,0,71,0
2021-01-14,Amador,005,37829,3026,2940,24,2964,28
2021-01-14,Butte,007,227075,9840,9127,1308,10435,129
2021-01-14,Calaveras,009,45235,1581,1513,7,1520,21
2021-01-14,Colusa,011,21464,1612,1535,161,1696,7
2021-01-14,Contra Costa,013,1133247,53054,49545,840,50385,415
2021-01-14,Del Norte,015,27424,861,821,2,823,2
2021-01-14,El Dorado,017,186661,7991,7321,507,7828,45
2021-01-14,Fresno,019,978130,85037,79033,6175,85208,814
2021-01-14,Glenn,021,27897,1993,1798,385,2183,9
2021-01-14,Humboldt,023,135768,2403,2169,8,2177,22
2021-01-14,Imperial,025,180216,25655,24882,2081,26963,447
2021-01-14,Inyo,027,18085,962,790,8,798,25
2021-01-14,Kern,029,883053,81716,77070,7144,84214,705
2021-01-14,Kings,031,150075,19619,18405,738,19143,108
2021-01-14,Lake,033,64148,2640,2378,0,2378,27
2021-01-14,Lassen,035,31185,4783,4673,71,4744,1
2021-01-14,Los Angeles,037,10098052,1028322,954652,31638,986290,13147
2021-01-14,Madera,039,155013,13692,12742,634,13376,85
2021-01-14,Marin,041,260295,11664,11155,111,11266,159
2021-01-14,Mariposa,043,17540,331,302,2,304,3
2021-01-14,Mendocino,045,87422,3033,2801,51,2852,31
2021-01-14,Merced,047,269075,23917,22780,585,23365,239
2021-01-14,Modoc,049,8938,292,273,85,358,0
2021-01-14,Mono,051,14174,1081,1020,13,1033,3
2021-01-14,Monterey,053,433212,36070,34105,1069,35174,242
2021-01-14,Napa,055,140530,7673,7117,30,7147,38
2021-01-14,Nevada,057,99092,3307,3075,126,3201,17
2021-01-14,Orange,059,3164182,215234,204442,8571,213013,2162
2021-01-14,Placer,061,380077,18066,16488,828,17316,169
2021-01-14,Plumas,063,18699,576,496,9,505,2
2021-01-14,Riverside,065,2383286,248343,231684,11518,243202,2357
2021-01-14,Sacramento,067,1510023,81106,79137,875,80012,1007
2021-01-14,San Benito,069,59416,4959,4678,50,4728,35
2021-01-14,San Bernardino,071,2135413,258095,243379,7264,250643,1750
2021-01-14,San Diego,073,3302833,221723,204173,10203,214376,2005
2021-01-14,San Francisco,075,870044,29323,28200,484,28684,238
2021-01-14,San Joaquin,077,732212,57992,55058,2207,57265,739
2021-01-14,San Luis Obispo,079,281455,16230,14851,390,15241,146
2021-01-14,San Mateo,081,765935,33444,30694,214,30908,208
2021-01-14,Santa Barbara,083,443738,25254,23126,720,23846,219
2021-01-14,Santa Clara,085,1922200,94078,88505,404,88909,910
2021-01-14,Santa Cruz,087,273765,13080,11583,569,12152,109
2021-01-14,Shasta,089,179085,9765,9334,956,10290,90
2021-01-14,Sierra,091,2930,44,35,6,41,0
2021-01-14,Siskiyou,093,43540,1222,1108,168,1276,3
2021-01-14,Solano,095,438530,25461,23782,270,24052,103
2021-01-14,Sonoma,097,501317,24003,22910,118,23028,202
2021-01-14,Stanislaus,099,539301,43219,40597,4155,44752,574
2021-01-14,Sutter,101,95872,7664,7416,60,7476,74
2021-01-14,Tehama,103,63373,3925,3664,417,4081,17
2021-01-14,Trinity,105,12862,437,261,62,323,3
2021-01-14,Tulare,107,460477,42235,39565,5395,44960,533
2021-01-14,Tuolumne,109,53932,3267,3215,31,3246,28
2021-01-14,Ventura,111,848112,62042,57941,2111,60052,347
2021-01-14,Yolo,113,214977,11050,10097,92,10189,135
2021-01-14,Yuba,115,75493,4752,4496,56,4552,27
2021-01-13,Alameda,001,1643700,67577,63568,1353,64921,690
2021-01-13,Alpine,003,1148,73,71,0,71,0
2021-01-13,Amador,005,37829,3012,2914,24,2938,26
2021-01-13,Butte,007,227075,9759,9013,1293,10306,126
2021-01-13,Calaveras,009,45235,1559,1493,7,1500,21
2021-01-13,Colusa,011,21464,1602,1524,153,1677,7
2021-01-13,Contra Costa,013,1133247,52481,48877,829,49706,403
2021-01-13,Del Norte,015,27424,857,820,2,822,2
2021-01-13,El Dorado,017,186661,7897,7247,499,7746,43
2021-01-13,Fresno,019,978130,84318,78278,6134,84412,804
2021-01-13,Glenn,021,27897,1977,1792,376,2168,9
2021-01-13,Humboldt,023,135768,2370,2114,8,2122,22
2021-01-13,Imperial,025,180216,25531,24717,2049,26766,463
2021-01-13,Inyo,027,18085,950,785,8,793,25
2021-01-13,Kern,029,883053,81059,76049,7054,83103,704
2021-01-13,Kings,031,150075,19452,18121,717,18838,108
2021-01-13,Lake,033,64148,2599,2305,0,2305,27
2021-01-13,Lassen,035,31185,4776,4663,70,4733,1
2021-01-13,Los Angeles,037,10098052,1017528,937985,31241,969226,12873
2021-01-13,Madera,039,155013,13576,12570,629,13199,85
2021-01-13,Marin,041,260295,11612,11039,111,11150,161
2021-01-13,Mariposa,043,17540,329,304,2,306,3
2021-01-13,Mendocino,045,87422,3013,2790,51,2841,31
2021-01-13,Merced,047,269075,23678,22497,571,23068,241
2021-01-13,Modoc,049,8938,291,274,82,356,0
2021-01-13,Mono,051,14174,1077,1017,13,1030,3
2021-01-13,Monterey,053,433212,35645,33748,1045,34793,241
2021-01-13,Napa,055,140530,7559,7028,30,7058,36
2021-01-13,Nevada,057,99092,3283,3037,123,3160,17
2021-01-13,Orange,059,3164182,213162,201158,8501,209659,2172
2021-01-13,Placer,061,380077,17941,16272,814,17086,172
2021-01-13,Plumas,063,18699,574,490,9,499,2
2021-01-13,Riverside,065,2383286,245196,228192,11405,239597,2278
2021-01-13,Sacramento,067,1510023,80445,78268,868,79136,996
2021-01-13,San Benito,069,59416,4903,4583,49,4632,35
2021-01-13,San Bernardino,071,2135413,255708,240191,7189,247380,1759
2021-01-13,San Diego,073,3302833,219109,201578,10100,211678,1952
2021-01-13,San Francisco,075,870044,29084,27863,464,28327,238
2021-01-13,San Joaquin,077,732212,57370,54373,2179,56552,738
2021-01-13,San Luis Obispo,079,281455,16075,14625,379,15004,140
2021-01-13,San Mateo,081,765935,33105,30195,212,30407,207
2021-01-13,Santa Barbara,083,443738,24812,22714,704,23418,216
2021-01-13,Santa Clara,085,1922200,93105,87187,400,87587,911
2021-01-13,Santa Cruz,087,273765,12907,11423,555,11978,110
2021-01-13,Shasta,089,179085,9701,9180,942,10122,93
2021-01-13,Sierra,091,2930,44,33,6,39,0
2021-01-13,Siskiyou,093,43540,1216,1102,164,1266,3
2021-01-13,Solano,095,438530,25183,23503,267,23770,105
2021-01-13,Sonoma,097,501317,23752,22610,117,22727,206
2021-01-13,Stanislaus,099,539301,42827,40167,4102,44269,574
2021-01-13,Sutter,101,95872,7618,7350,59,7409,73
2021-01-13,Tehama,103,63373,3874,3589,412,4001,17
2021-01-13,Trinity,105,12862,437,260,62,322,3
2021-01-13,Tulare,107,460477,41832,39129,5295,44424,522
2021-01-13,Tuolumne,109,53932,3253,3196,31,3227,28
2021-01-13,Ventura,111,848112,61030,56453,2071,58524,338
2021-01-13,Yolo,113,214977,10951,9933,89,10022,135
2021-01-13,Yuba,115,75493,4707,4448,53,4501,27
2021-01-12,Alameda,001,1643700,66753,62642,1335,63977,677
2021-01-12,Alpine,003,1148,73,71,0,71,0
2021-01-12,Amador,005,37829,2995,2897,24,2921,26
2021-01-12,Butte,007,227075,9671,8883,1279,10162,124
2021-01-12,Calaveras,009,45235,1523,1475,7,1482,21
2021-01-12,Colusa,011,21464,1590,1510,149,1659,7
2021-01-12,Contra Costa,013,1133247,51839,48242,815,49057,399
2021-01-12,Del Norte,015,27424,852,816,2,818,2
2021-01-12,El Dorado,017,186661,7813,7156,488,7644,41
2021-01-12,Fresno,019,978130,83446,77651,6066,83717,796
2021-01-12,Glenn,021,27897,1952,1781,372,2153,9
2021-01-12,Humboldt,023,135768,2316,2077,7,2084,22
2021-01-12,Imperial,025,180216,25439,24566,2008,26574,457
2021-01-12,Inyo,027,18085,932,773,8,781,25
2021-01-12,Kern,029,883053,80351,75320,6959,82279,689
2021-01-12,Kings,031,150075,19241,18072,707,18779,108
2021-01-12,Lake,033,64148,2551,2260,0,2260,27
2021-01-12,Lassen,035,31185,4754,4659,68,4727,1
2021-01-12,Los Angeles,037,10098052,1005866,926295,30845,957140,12610
2021-01-12,Madera,039,155013,13428,12485,620,13105,85
2021-01-12,Marin,041,260295,11505,10960,111,11071,157
2021-01-12,Mariposa,043,17540,326,302,2,304,3
2021-01-12,Mendocino,045,87422,2993,2762,47,2809,31
2021-01-12,Merced,047,269075,23427,22172,549,22721,239
2021-01-12,Modoc,049,8938,289,274,82,356,0
2021-01-12,Mono,051,14174,1067,1008,13,1021,3
2021-01-12,Monterey,053,433212,35154,33381,1028,34409,240
2021-01-12,Napa,055,140530,7476,6936,30,6966,36
2021-01-12,Nevada,057,99092,3255,3014,121,3135,17
2021-01-12,Orange,059,3164182,210891,198260,8415,206675,2142
2021-01-12,Placer,061,380077,17771,16087,808,16895,163
2021-01-12,Plumas,063,18699,568,483,9,492,2
2021-01-12,Riverside,065,2383286,242065,225580,11266,236846,2266
2021-01-12,Sacramento,067,1510023,79717,77201,860,78061,985
2021-01-12,San Benito,069,59416,4834,4515,49,4564,35
2021-01-12,San Bernardino,071,2135413,253123,237008,7120,244128,1739
2021-01-12,San Diego,073,3302833,216195,198317,9983,208300,1898
2021-01-12,San Francisco,075,870044,28807,27531,431,27962,238
2021-01-12,San Joaquin,077,732212,56729,53630,2151,55781,725
2021-01-12,San Luis Obispo,079,281455,15830,14367,371,14738,132
2021-01-12,San Mateo,081,765935,32714,29747,200,29947,206
2021-01-12,Santa Barbara,083,443738,24390,22182,684,22866,209
2021-01-12,Santa Clara,085,1922200,91991,86075,392,86467,904
2021-01-12,Santa Cruz,087,273765,12692,11267,540,11807,110
2021-01-12,Shasta,089,179085,9628,9086,929,10015,84
2021-01-12,Sierra,091,2930,43,33,6,39,0
2021-01-12,Siskiyou,093,43540,1206,1091,157,1248,3
2021-01-12,Solano,095,438530,24881,23160,263,23423,102
2021-01-12,Sonoma,097,501317,23447,22403,117,22520,205
2021-01-12,Stanislaus,099,539301,42388,39615,4067,43682,571
2021-01-12,Sutter,101,95872,7555,7276,58,7334,73
2021-01-12,Tehama,103,63373,3836,3567,407,3974,17
2021-01-12,Trinity,105,12862,437,258,62,320,3
2021-01-12,Tulare,107,460477,41372,38797,5179,43976,509
2021-01-12,Tuolumne,109,53932,3220,3178,31,3209,28
2021-01-12,Ventura,111,848112,60056,55342,2039,57381,324
2021-01-12,Yolo,113,214977,10815,9857,85,9942,133
2021-01-12,Yuba,115,75493,4662,4389,53,4442,27
2021-01-11,Alameda,001,1643700,65901,61949,1317,63266,652
2021-01-11,Alpine,003,1148,73,70,0,70,0
2021-01-11,Amador,005,37829,2981,2867,24,2891,24
2021-01-11,Butte,007,227075,9558,8757,1261,10018,119
2021-01-11,Calaveras,009,45235,1504,1460,7,1467,21
2021-01-11,Colusa,011,21464,1571,1494,144,1638,7
2021-01-11,Contra Costa,013,1133247,51158,47728,804,48532,398
2021-01-11,Del Norte,015,27424,848,810,2,812,2
2021-01-11,El Dorado,017,186661,7719,6987,481,7468,36
2021-01-11,Fresno,019,978130,82566,76581,5990,82571,775
2021-01-11,Glenn,021,27897,1925,1763,366,2129,9
2021-01-11,Humboldt,023,135768,2277,2069,7,2076,22
2021-01-11,Imperial,025,180216,25328,24418,1971,26389,453
2021-01-11,Inyo,027,18085,913,763,8,771,25
2021-01-11,Kern,029,883053,79491,74489,6860,81349,682
2021-01-11,Kings,031,150075,18978,17909,698,18607,108
2021-01-11,Lake,033,64148,2500,2205,0,2205,26
2021-01-11,Lassen,035,31185,4731,4647,68,4715,1
2021-01-11,Los Angeles,037,10098052,992637,914434,30389,944823,12304
2021-01-11,Madera,039,155013,13291,12366,609,12975,85
2021-01-11,Marin,041,260295,11406,10814,110,10924,156
2021-01-11,Mariposa,043,17540,319,296,2,298,3
2021-01-11,Mendocino,045,87422,2965,2728,47,2775,31
2021-01-11,Merced,047,269075,23104,21884,535,22419,238
2021-01-11,Modoc,049,8938,288,271,81,352,0
2021-01-11,Mono,051,14174,1061,1006,13,1019,3
2021-01-11,Monterey,053,433212,34615,32858,966,33824,239
2021-01-11,Napa,055,140530,7374,6822,30,6852,36
2021-01-11,Nevada,057,99092,3227,2980,121,3101,17
2021-01-11,Orange,059,3164182,208307,196340,8316,204656,2113
2021-01-11,Placer,061,380077,17592,15919,799,16718,163
2021-01-11,Plumas,063,18699,564,477,9,486,2
2021-01-11,Riverside,065,2383286,238561,222907,11122,234029,2222
2021-01-11,Sacramento,067,1510023,78784,76009,844,76853,974
2021-01-11,San Benito,069,59416,4762,4482,42,4524,34
2021-01-11,San Bernardino,071,2135413,250325,235543,7023,242566,1739
2021-01-11,San Diego,073,3302833,212926,194793,9823,204616,1857
2021-01-11,San Francisco,075,870044,28528,27264,411,27675,238
2021-01-11,San Joaquin,077,732212,56120,53002,2122,55124,725
2021-01-11,San Luis Obispo,079,281455,15459,14213,364,14577,126
2021-01-11,San Mateo,081,765935,32270,29355,188,29543,206
2021-01-11,Santa Barbara,083,443738,23939,21740,672,22412,200
2021-01-11,Santa Clara,085,1922200,90747,84851,384,85235,877
2021-01-11,Santa Cruz,087,273765,12512,11093,517,11610,106
2021-01-11,Shasta,089,179085,9530,8977,916,9893,81
2021-01-11,Sierra,091,2930,41,33,6,39,0
2021-01-11,Siskiyou,093,43540,1197,1087,155,1242,3
2021-01-11,Solano,095,438530,24560,22893,257,23150,101
2021-01-11,Sonoma,097,501317,23199,22191,117,22308,205
2021-01-11,Stanislaus,099,539301,41897,39149,4018,43167,571
2021-01-11,Sutter,101,95872,7496,7204,57,7261,71
2021-01-11,Tehama,103,63373,3774,3524,386,3910,17
2021-01-11,Trinity,105,12862,437,256,62,318,2
2021-01-11,Tulare,107,460477,40957,38380,5099,43479,497
2021-01-11,Tuolumne,109,53932,3209,3165,31,3196,27
2021-01-11,Ventura,111,848112,58919,54202,2015,56217,320
2021-01-11,Yolo,113,214977,10609,9699,84,9783,129
2021-01-11,Yuba,115,75493,4624,4349,46,4395,27
2021-01-10,Alameda,001,1643700,64922,61111,1289,62400,650
2021-01-10,Alpine,003,1148,73,70,0,70,0
2021-01-10,Amador,005,37829,2957,2861,24,2885,24
2021-01-10,Butte,007,227075,9438,8665,1235,9900,119
2021-01-10,Calaveras,009,45235,1481,1449,7,1456,21
2021-01-10,Colusa,011,21464,1549,1478,142,1620,7
2021-01-10,Contra Costa,013,1133247,50361,47109,785,47894,398
2021-01-10,Del Norte,015,27424,846,809,2,811,2
2021-01-10,El Dorado,017,186661,7630,6904,464,7368,36
2021-01-10,Fresno,019,978130,81755,75621,5868,81489,775
2021-01-10,Glenn,021,27897,1906,1746,358,2104,9
2021-01-10,Humboldt,023,135768,2216,2049,7,2056,22
2021-01-10,Imperial,025,180216,25169,24233,1921,26154,453
2021-01-10,Inyo,027,18085,886,748,8,756,25
2021-01-10,Kern,029,883053,78659,73712,6730,80442,679
2021-01-10,Kings,031,150075,18759,17812,691,18503,108
2021-01-10,Lake,033,64148,2445,2174,0,2174,26
2021-01-10,Lassen,035,31185,4709,4642,68,4710,1
2021-01-10,Los Angeles,037,10098052,978018,901783,29778,931561,12170
2021-01-10,Madera,039,155013,13100,12179,592,12771,85
2021-01-10,Marin,041,260295,11282,10737,109,10846,155
2021-01-10,Mariposa,043,17540,319,291,2,293,3
2021-01-10,Mendocino,045,87422,2934,2706,43,2749,31
2021-01-10,Merced,047,269075,22833,21691,524,22215,238
2021-01-10,Modoc,049,8938,288,271,79,350,0
2021-01-10,Mono,051,14174,1043,965,13,978,3
2021-01-10,Monterey,053,433212,34175,32571,934,33505,237
2021-01-10,Napa,055,140530,7272,6687,28,6715,36
2021-01-10,Nevada,057,99092,3208,2959,117,3076,17
2021-01-10,Orange,059,3164182,205522,193766,8194,201960,2104
2021-01-10,Placer,061,380077,17403,15779,779,16558,163
2021-01-10,Plumas,063,18699,554,477,9,486,2
2021-01-10,Riverside,065,2383286,235201,219486,10933,230419,2216
2021-01-10,Sacramento,067,1510023,77822,75394,817,76211,965
2021-01-10,San Benito,069,59416,4660,4434,41,4475,34
2021-01-10,San Bernardino,071,2135413,246915,232171,6920,239091,1736
2021-01-10,San Diego,073,3302833,209258,191886,9656,201542,1857
2021-01-10,San Francisco,075,870044,28147,27054,380,27434,238
2021-01-10,San Joaquin,077,732212,55309,52535,2089,54624,725
2021-01-10,San Luis Obispo,079,281455,15130,13968,352,14320,122
2021-01-10,San Mateo,081,765935,31780,28972,174,29146,206
2021-01-10,Santa Barbara,083,443738,23380,21290,657,21947,200
2021-01-10,Santa Clara,085,1922200,89563,83779,375,84154,858
2021-01-10,Santa Cruz,087,273765,12299,10951,499,11450,106
2021-01-10,Shasta,089,179085,9418,8936,901,9837,81
2021-01-10,Sierra,091,2930,40,32,6,38,0
2021-01-10,Siskiyou,093,43540,1191,1075,152,1227,3
2021-01-10,Solano,095,438530,24158,22621,254,22875,101
2021-01-10,Sonoma,097,501317,22923,21925,116,22041,204
2021-01-10,Stanislaus,099,539301,41323,38809,3941,42750,571
2021-01-10,Sutter,101,95872,7435,7133,54,7187,71
2021-01-10,Tehama,103,63373,3701,3504,374,3878,17
2021-01-10,Trinity,105,12862,437,253,60,313,2
2021-01-10,Tulare,107,460477,40542,38012,4981,42993,497
2021-01-10,Tuolumne,109,53932,3175,3143,30,3173,27
2021-01-10,Ventura,111,848112,57650,53095,1972,55067,319
2021-01-10,Yolo,113,214977,10457,9610,84,9694,129
2021-01-10,Yuba,115,75493,4571,4300,43,4343,27
2021-01-09,Alameda,001,1643700,64378,60125,1274,61399,649
2021-01-09,Alpine,003,1148,73,70,0,70,0
2021-01-09,Amador,005,37829,2950,2809,24,2833,24
2021-01-09,Butte,007,227075,9359,8552,1211,9763,118
2021-01-09,Calaveras,009,45235,1471,1425,7,1432,21
2021-01-09,Colusa,011,21464,1542,1468,141,1609,7
2021-01-09,Contra Costa,013,1133247,50007,46406,770,47176,393
2021-01-09,Del Norte,015,27424,844,802,2,804,2
2021-01-09,El Dorado,017,186661,7596,6800,461,7261,36
2021-01-09,Fresno,019,978130,81345,74816,5828,80644,773
2021-01-09,Glenn,021,27897,1891,1707,355,2062,9
2021-01-09,Humboldt,023,135768,2198,2026,7,2033,22
2021-01-09,Imperial,025,180216,25100,24028,1908,25936,448
2021-01-09,Inyo,027,18085,877,734,8,742,25
2021-01-09,Kern,029,883053,78190,73015,6653,79668,677
2021-01-09,Kings,031,150075,18664,17679,687,18366,108
2021-01-09,Lake,033,64148,2409,2144,0,2144,26
2021-01-09,Lassen,035,31185,4697,4613,68,4681,1
2021-01-09,Los Angeles,037,10098052,972436,887949,29350,917299,12011
2021-01-09,Madera,039,155013,13005,12063,586,12649,85
2021-01-09,Marin,041,260295,11221,10634,108,10742,154
2021-01-09,Mariposa,043,17540,316,287,2,289,3
2021-01-09,Mendocino,045,87422,2916,2664,43,2707,31
2021-01-09,Merced,047,269075,22691,21357,515,21872,237
2021-01-09,Modoc,049,8938,288,271,78,349,0
2021-01-09,Mono,051,14174,1038,964,13,977,3
2021-01-09,Monterey,053,433212,34025,31948,924,32872,235
2021-01-09,Napa,055,140530,7202,6594,25,6619,36
2021-01-09,Nevada,057,99092,3186,2932,114,3046,17
2021-01-09,Orange,059,3164182,204003,191004,8102,199106,2034
2021-01-09,Placer,061,380077,17296,15609,777,16386,162
2021-01-09,Plumas,063,18699,552,477,9,486,2
2021-01-09,Riverside,065,2383286,233446,216076,10797,226873,2201
2021-01-09,Sacramento,067,1510023,77289,74482,812,75294,953
2021-01-09,San Benito,069,59416,4608,4335,41,4376,34
2021-01-09,San Bernardino,071,2135413,245691,228857,6853,235710,1714
2021-01-09,San Diego,073,3302833,207564,188598,9536,198134,1824
2021-01-09,San Francisco,075,870044,27977,26708,339,27047,235
2021-01-09,San Joaquin,077,732212,54981,51927,2070,53997,724
2021-01-09,San Luis Obispo,079,281455,15006,13647,341,13988,121
2021-01-09,San Mateo,081,765935,31481,28512,167,28679,205
2021-01-09,Santa Barbara,083,443738,23168,20971,652,21623,197
2021-01-09,Santa Clara,085,1922200,88723,82269,363,82632,808
2021-01-09,Santa Cruz,087,273765,12204,10717,493,11210,107
2021-01-09,Shasta,089,179085,9385,8893,897,9790,81
2021-01-09,Sierra,091,2930,38,32,6,38,0
2021-01-09,Siskiyou,093,43540,1187,1062,147,1209,3
2021-01-09,Solano,095,438530,23999,22226,252,22478,101
2021-01-09,Sonoma,097,501317,22801,21393,116,21509,202
2021-01-09,Stanislaus,099,539301,41032,38403,3907,42310,567
2021-01-09,Sutter,101,95872,7399,7072,53,7125,69
2021-01-09,Tehama,103,63373,3669,3451,363,3814,15
2021-01-09,Trinity,105,12862,437,252,60,312,2
2021-01-09,Tulare,107,460477,40291,37684,4917,42601,496
2021-01-09,Tuolumne,109,53932,3167,3117,29,3146,26
2021-01-09,Ventura,111,848112,56822,51988,1946,53934,306
2021-01-09,Yolo,113,214977,10386,9524,83,9607,129
2021-01-09,Yuba,115,75493,4540,4265,43,4308,27
2021-01-08,Alameda,001,1643700,63816,59172,1265,60437,646
2021-01-08,Alpine,003,1148,73,70,0,70,0
2021-01-08,Amador,005,37829,2943,2792,24,2816,24
2021-01-08,Butte,007,227075,9299,8430,1196,9626,115
2021-01-08,Calaveras,009,45235,1457,1385,7,1392,21
2021-01-08,Colusa,011,21464,1530,1448,140,1588,7
2021-01-08,Contra Costa,013,1133247,49471,45667,766,46433,381
2021-01-08,Del Norte,015,27424,842,795,2,797,2
2021-01-08,El Dorado,017,186661,7526,6690,449,7139,36
2021-01-08,Fresno,019,978130,80533,73689,5770,79459,771
2021-01-08,Glenn,021,27897,1876,1680,350,2030,9
2021-01-08,Humboldt,023,135768,2174,1988,7,1995,22
2021-01-08,Imperial,025,180216,25035,23751,1893,25644,446
2021-01-08,Inyo,027,18085,862,682,8,690,24
2021-01-08,Kern,029,883053,77626,71978,6580,78558,674
2021-01-08,Kings,031,150075,18536,17441,682,18123,108
2021-01-08,Lake,033,64148,2381,2098,0,2098,26
2021-01-08,Lassen,035,31185,4689,4598,66,4664,1
2021-01-08,Los Angeles,037,10098052,961622,871188,28934,900122,11796
2021-01-08,Madera,039,155013,12855,11846,577,12423,85
2021-01-08,Marin,041,260295,11129,10531,108,10639,153
2021-01-08,Mariposa,043,17540,315,273,2,275,3
2021-01-08,Mendocino,045,87422,2897,2634,40,2674,31
2021-01-08,Merced,047,269075,22496,20862,510,21372,236
2021-01-08,Modoc,049,8938,288,266,78,344,0
2021-01-08,Mono,051,14174,1028,951,13,964,3
2021-01-08,Monterey,053,433212,33773,31543,914,32457,224
2021-01-08,Napa,055,140530,7132,6544,25,6569,32
2021-01-08,Nevada,057,99092,3164,2888,114,3002,17
2021-01-08,Orange,059,3164182,202003,186608,8016,194624,1991
2021-01-08,Placer,061,380077,17163,15401,770,16171,161
2021-01-08,Plumas,063,18699,546,465,9,474,2
2021-01-08,Riverside,065,2383286,231039,212122,10674,222796,2184
2021-01-08,Sacramento,067,1510023,76716,73245,806,74051,939
2021-01-08,San Benito,069,59416,4571,4225,40,4265,33
2021-01-08,San Bernardino,071,2135413,243811,224267,6782,231049,1703
2021-01-08,San Diego,073,3302833,205026,185060,9442,194502,1771
2021-01-08,San Francisco,075,870044,27726,26378,317,26695,207
2021-01-08,San Joaquin,077,732212,54656,50990,2042,53032,710
2021-01-08,San Luis Obispo,079,281455,14873,13286,329,13615,119
2021-01-08,San Mateo,081,765935,31132,28072,165,28237,204
2021-01-08,Santa Barbara,083,443738,22882,20461,647,21108,189
2021-01-08,Santa Clara,085,1922200,87779,80561,360,80921,789
2021-01-08,Santa Cruz,087,273765,12062,10486,485,10971,106
2021-01-08,Shasta,089,179085,9335,8772,882,9654,81
2021-01-08,Sierra,091,2930,38,31,6,37,0
2021-01-08,Siskiyou,093,43540,1184,1027,146,1173,3
2021-01-08,Solano,095,438530,23828,21832,249,22081,100
2021-01-08,Sonoma,097,501317,22659,21178,116,21294,201
2021-01-08,Stanislaus,099,539301,40733,37858,3873,41731,566
2021-01-08,Sutter,101,95872,7349,6982,53,7035,68
2021-01-08,Tehama,103,63373,3645,3406,360,3766,15
2021-01-08,Trinity,105,12862,437,247,60,307,2
2021-01-08,Tulare,107,460477,40023,36946,4822,41768,491
2021-01-08,Tuolumne,109,53932,3159,3099,29,3128,19
2021-01-08,Ventura,111,848112,55956,50553,1922,52475,294
2021-01-08,Yolo,113,214977,10297,9391,83,9474,129
2021-01-08,Yuba,115,75493,4498,4195,42,4237,26
2021-01-07,Alameda,001,1643700,62955,57921,1238,59159,632
2021-01-07,Alpine,003,1148,71,70,0,70,0
2021-01-07,Amador,005,37829,2930,2740,23,2763,24
2021-01-07,Butte,007,227075,9202,8278,1175,9453,112
2021-01-07,Calaveras,009,45235,1440,1342,6,1348,21
2021-01-07,Colusa,011,21464,1518,1420,133,1553,7
2021-01-07,Contra Costa,013,1133247,48694,44756,752,45508,376
2021-01-07,Del Norte,015,27424,840,791,2,793,2
2021-01-07,El Dorado,017,186661,7425,6545,439,6984,36
2021-01-07,Fresno,019,978130,79578,72557,5670,78227,765
2021-01-07,Glenn,021,27897,1858,1639,340,1979,9
2021-01-07,Humboldt,023,135768,2147,1954,7,1961,22
2021-01-07,Imperial,025,180216,24855,23608,1842,25450,431
2021-01-07,Inyo,027,18085,850,656,8,664,20
2021-01-07,Kern,029,883053,76764,70953,6432,77385,660
2021-01-07,Kings,031,150075,18410,17238,672,17910,108
2021-01-07,Lake,033,64148,2328,2054,0,2054,26
2021-01-07,Lassen,035,31185,4684,4581,64,4645,1
2021-01-07,Los Angeles,037,10098052,946696,853187,28409,881596,11480
2021-01-07,Madera,039,155013,12700,11644,567,12211,76
2021-01-07,Marin,041,260295,11040,10364,106,10470,153
2021-01-07,Mariposa,043,17540,313,264,2,266,3
2021-01-07,Mendocino,045,87422,2843,2585,35,2620,30
2021-01-07,Merced,047,269075,22174,20510,494,21004,234
2021-01-07,Modoc,049,8938,288,265,78,343,0
2021-01-07,Mono,051,14174,1017,905,13,918,3
2021-01-07,Monterey,053,433212,33268,30903,891,31794,222
2021-01-07,Napa,055,140530,7023,6408,25,6433,32
2021-01-07,Nevada,057,99092,3130,2847,109,2956,17
2021-01-07,Orange,059,3164182,199177,181922,7916,189838,1974
2021-01-07,Placer,061,380077,16984,15155,742,15897,144
2021-01-07,Plumas,063,18699,544,454,9,463,2
2021-01-07,Riverside,065,2383286,227581,208177,10524,218701,2156
2021-01-07,Sacramento,067,1510023,75811,72342,785,73127,919
2021-01-07,San Benito,069,59416,4510,4112,38,4150,33
2021-01-07,San Bernardino,071,2135413,240372,219691,6698,226389,1666
2021-01-07,San Diego,073,3302833,201720,180510,9264,189774,1738
2021-01-07,San Francisco,075,870044,27401,25885,304,26189,202
2021-01-07,San Joaquin,077,732212,53986,50156,2013,52169,689
2021-01-07,San Luis Obispo,079,281455,14634,12810,316,13126,118
2021-01-07,San Mateo,081,765935,30622,27494,162,27656,201
2021-01-07,Santa Barbara,083,443738,22455,19931,636,20567,187
2021-01-07,Santa Clara,085,1922200,86660,78808,356,79164,775
2021-01-07,Santa Cruz,087,273765,11853,10228,477,10705,104
2021-01-07,Shasta,089,179085,9247,8612,874,9486,81
2021-01-07,Sierra,091,2930,38,31,6,37,0
2021-01-07,Siskiyou,093,43540,1179,1010,145,1155,3
2021-01-07,Solano,095,438530,23438,21384,245,21629,100
2021-01-07,Sonoma,097,501317,22398,20857,115,20972,200
2021-01-07,Stanislaus,099,539301,40316,37296,3821,41117,553
2021-01-07,Sutter,101,95872,7290,6890,52,6942,65
2021-01-07,Tehama,103,63373,3621,3330,352,3682,15
2021-01-07,Trinity,105,12862,437,247,60,307,2
2021-01-07,Tulare,107,460477,39636,36397,4692,41089,482
2021-01-07,Tuolumne,109,53932,3139,3068,28,3096,14
2021-01-07,Ventura,111,848112,54795,49083,1894,50977,288
2021-01-07,Yolo,113,214977,10155,9207,81,9288,128
2021-01-07,Yuba,115,75493,4458,4128,42,4170,25
2021-01-06,Alameda,001,1643700,62101,57081,1211,58292,616
2021-01-06,Alpine,003,1148,71,70,0,70,0
2021-01-06,Amador,005,37829,2909,2717,22,2739,24
2021-01-06,Butte,007,227075,9090,8147,1156,9303,110
2021-01-06,Calaveras,009,45235,1417,1321,6,1327,21
2021-01-06,Colusa,011,21464,1498,1385,128,1513,7
2021-01-06,Contra Costa,013,1133247,47898,44054,736,44790,358
2021-01-06,Del Norte,015,27424,834,780,2,782,2
2021-01-06,El Dorado,017,186661,7313,6397,425,6822,35
2021-01-06,Fresno,019,978130,78732,71404,5568,76972,752
2021-01-06,Glenn,021,27897,1832,1622,336,1958,9
2021-01-06,Humboldt,023,135768,2121,1912,7,1919,22
2021-01-06,Imperial,025,180216,24608,23400,1799,25199,431
2021-01-06,Inyo,027,18085,834,630,8,638,20
2021-01-06,Kern,029,883053,75821,69893,6306,76199,646
2021-01-06,Kings,031,150075,18212,17019,653,17672,108
2021-01-06,Lake,033,64148,2294,2033,0,2033,26
2021-01-06,Lassen,035,31185,4672,4560,60,4620,1
2021-01-06,Los Angeles,037,10098052,930732,835052,27728,862780,11285
2021-01-06,Madera,039,155013,12566,11407,560,11967,67
2021-01-06,Marin,041,260295,10917,10282,105,10387,153
2021-01-06,Mariposa,043,17540,310,259,2,261,3
2021-01-06,Mendocino,045,87422,2813,2561,35,2596,30
2021-01-06,Merced,047,269075,21839,20258,479,20737,232
2021-01-06,Modoc,049,8938,288,263,78,341,0
2021-01-06,Mono,051,14174,986,905,13,918,3
2021-01-06,Monterey,053,433212,32667,30387,860,31247,222
2021-01-06,Napa,055,140530,6893,6342,25,6367,32
2021-01-06,Nevada,057,99092,3110,2805,108,2913,15
2021-01-06,Orange,059,3164182,195739,177686,7775,185461,1935
2021-01-06,Placer,061,380077,16797,14940,724,15664,134
2021-01-06,Plumas,063,18699,536,445,9,454,2
2021-01-06,Riverside,065,2383286,223568,203714,10338,214052,2121
2021-01-06,Sacramento,067,1510023,74787,71572,768,72340,909
2021-01-06,San Benito,069,59416,4434,4031,37,4068,32
2021-01-06,San Bernardino,071,2135413,236686,215286,6595,221881,1634
2021-01-06,San Diego,073,3302833,198219,176660,9093,185753,1691
2021-01-06,San Francisco,075,870044,27035,25424,296,25720,199
2021-01-06,San Joaquin,077,732212,53253,49286,1971,51257,673
2021-01-06,San Luis Obispo,079,281455,14240,12305,309,12614,115
2021-01-06,San Mateo,081,765935,30197,27050,159,27209,200
2021-01-06,Santa Barbara,083,443738,21966,19453,627,20080,177
2021-01-06,Santa Clara,085,1922200,85339,77485,349,77834,746
2021-01-06,Santa Cruz,087,273765,11634,9954,459,10413,97
2021-01-06,Shasta,089,179085,9177,8482,867,9349,78
2021-01-06,Sierra,091,2930,37,31,6,37,0
2021-01-06,Siskiyou,093,43540,1167,998,141,1139,3
2021-01-06,Solano,095,438530,23060,21102,242,21344,99
2021-01-06,Sonoma,097,501317,22090,20558,115,20673,196
2021-01-06,Stanislaus,099,539301,39749,36751,3761,40512,553
2021-01-06,Sutter,101,95872,7209,6839,51,6890,59
2021-01-06,Tehama,103,63373,3592,3306,346,3652,15
2021-01-06,Trinity,105,12862,437,246,60,306,2
2021-01-06,Tulare,107,460477,39143,35882,4597,40479,465
2021-01-06,Tuolumne,109,53932,3118,3008,28,3036,14
2021-01-06,Ventura,111,848112,53551,47428,1870,49298,280
2021-01-06,Yolo,113,214977,9990,9083,78,9161,127
2021-01-06,Yuba,115,75493,4408,4097,42,4139,25
2021-01-05,Alameda,001,1643700,60984,56432,1181,57613,602
2021-01-05,Alpine,003,1148,71,70,0,70,0
2021-01-05,Amador,005,37829,2869,2695,22,2717,24
2021-01-05,Butte,007,227075,8950,8008,1129,9137,107
2021-01-05,Calaveras,009,45235,1370,1292,6,1298,21
2021-01-05,Colusa,011,21464,1476,1376,122,1498,7
2021-01-05,Contra Costa,013,1133247,47038,43442,724,44166,353
2021-01-05,Del Norte,015,27424,828,770,2,772,2
2021-01-05,El Dorado,017,186661,7195,6270,404,6674,32
2021-01-05,Fresno,019,978130,77512,70971,5478,76449,741
2021-01-05,Glenn,021,27897,1809,1608,320,1928,9
2021-01-05,Humboldt,023,135768,2085,1884,7,1891,22
2021-01-05,Imperial,025,180216,24437,23165,1758,24923,421
2021-01-05,Inyo,027,18085,820,627,8,635,20
2021-01-05,Kern,029,883053,74743,68257,6171,74428,624
2021-01-05,Kings,031,150075,18014,16860,631,17491,108
2021-01-05,Lake,033,64148,2248,2015,0,2015,25
2021-01-05,Lassen,035,31185,4657,4554,56,4610,1
2021-01-05,Los Angeles,037,10098052,911992,823783,27073,850856,11028
2021-01-05,Madera,039,155013,12396,11359,548,11907,67
2021-01-05,Marin,041,260295,10769,10214,104,10318,151
2021-01-05,Mariposa,043,17540,304,257,2,259,3
2021-01-05,Mendocino,045,87422,2777,2501,35,2536,30
2021-01-05,Merced,047,269075,21487,20051,467,20518,230
2021-01-05,Modoc,049,8938,288,254,78,332,0
2021-01-05,Mono,051,14174,980,896,13,909,3
2021-01-05,Monterey,053,433212,32120,30045,827,30872,213
2021-01-05,Napa,055,140530,6807,6264,25,6289,29
2021-01-05,Nevada,057,99092,3082,2781,106,2887,15
2021-01-05,Orange,059,3164182,192112,174869,7585,182454,1918
2021-01-05,Placer,061,380077,16574,14723,701,15424,133
2021-01-05,Plumas,063,18699,529,428,9,437,2
2021-01-05,Riverside,065,2383286,219442,200439,10169,210608,2069
2021-01-05,Sacramento,067,1510023,73858,70677,742,71419,888
2021-01-05,San Benito,069,59416,4332,3961,35,3996,28
2021-01-05,San Bernardino,071,2135413,232722,212522,6479,219001,1615
2021-01-05,San Diego,073,3302833,194079,172845,8879,181724,1654
2021-01-05,San Francisco,075,870044,26664,24989,280,25269,196
2021-01-05,San Joaquin,077,732212,52395,48969,1927,50896,663
2021-01-05,San Luis Obispo,079,281455,13842,12027,299,12326,106
2021-01-05,San Mateo,081,765935,29716,26486,157,26643,198
2021-01-05,Santa Barbara,083,443738,21519,19063,619,19682,172
2021-01-05,Santa Clara,085,1922200,83791,76355,337,76692,729
2021-01-05,Santa Cruz,087,273765,11361,9753,435,10188,93
2021-01-05,Shasta,089,179085,9070,8345,849,9194,73
2021-01-05,Sierra,091,2930,37,31,6,37,0
2021-01-05,Siskiyou,093,43540,1155,985,139,1124,3
2021-01-05,Solano,095,438530,22651,20860,237,21097,97
2021-01-05,Sonoma,097,501317,21732,20247,114,20361,194
2021-01-05,Stanislaus,099,539301,39205,36363,3710,40073,553
2021-01-05,Sutter,101,95872,7112,6769,50,6819,59
2021-01-05,Tehama,103,63373,3540,3255,342,3597,9
2021-01-05,Trinity,105,12862,437,246,60,306,2
2021-01-05,Tulare,107,460477,38568,35585,4456,40041,455
2021-01-05,Tuolumne,109,53932,3095,2996,23,3019,13
2021-01-05,Ventura,111,848112,52307,46456,1848,48304,264
2021-01-05,Yolo,113,214977,9812,8980,76,9056,127
2021-01-05,Yuba,115,75493,4349,4053,41,4094,21
2021-01-04,Alameda,001,1643700,59763,55899,1147,57046,583
2021-01-04,Alpine,003,1148,71,68,0,68,0
2021-01-04,Amador,005,37829,2829,2596,22,2618,24
2021-01-04,Butte,007,227075,8791,7893,1108,9001,105
2021-01-04,Calaveras,009,45235,1329,1276,5,1281,21
2021-01-04,Colusa,011,21464,1451,1368,108,1476,7
2021-01-04,Contra Costa,013,1133247,46179,43019,700,43719,353
2021-01-04,Del Norte,015,27424,817,770,2,772,2
2021-01-04,El Dorado,017,186661,7061,6152,390,6542,27
2021-01-04,Fresno,019,978130,76245,69871,5380,75251,726
2021-01-04,Glenn,021,27897,1776,1590,315,1905,9
2021-01-04,Humboldt,023,135768,2048,1845,7,1852,22
2021-01-04,Imperial,025,180216,24290,23035,1707,24742,420
2021-01-04,Inyo,027,18085,794,623,8,631,20
2021-01-04,Kern,029,883053,73660,67418,5977,73395,623
2021-01-04,Kings,031,150075,17738,16801,607,17408,108
2021-01-04,Lake,033,64148,2212,1984,0,1984,25
2021-01-04,Lassen,035,31185,4635,4550,55,4605,1
2021-01-04,Los Angeles,037,10098052,891847,813022,26234,839256,10790
2021-01-04,Madera,039,155013,12180,11204,527,11731,67
2021-01-04,Marin,041,260295,10629,10115,102,10217,151
2021-01-04,Mariposa,043,17540,298,253,2,255,3
2021-01-04,Mendocino,045,87422,2737,2460,31,2491,28
2021-01-04,Merced,047,269075,21074,19804,448,20252,230
2021-01-04,Modoc,049,8938,272,250,76,326,0
2021-01-04,Mono,051,14174,969,895,13,908,3
2021-01-04,Monterey,053,433212,31506,29659,806,30465,212
2021-01-04,Napa,055,140530,6666,6187,25,6212,29
2021-01-04,Nevada,057,99092,3044,2765,103,2868,15
2021-01-04,Orange,059,3164182,188227,172458,7463,179921,1918
2021-01-04,Placer,061,380077,16315,14622,688,15310,133
2021-01-04,Plumas,063,18699,519,419,9,428,1
2021-01-04,Riverside,065,2383286,214894,196809,9983,206792,2066
2021-01-04,Sacramento,067,1510023,72804,70164,733,70897,870
2021-01-04,San Benito,069,59416,4219,3914,35,3949,28
2021-01-04,San Bernardino,071,2135413,228454,210868,6331,217199,1615
2021-01-04,San Diego,073,3302833,189505,171031,8683,179714,1598
2021-01-04,San Francisco,075,870044,26278,24753,274,25027,191
2021-01-04,San Joaquin,077,732212,51504,48644,1886,50530,661
2021-01-04,San Luis Obispo,079,281455,13355,11945,292,12237,96
2021-01-04,San Mateo,081,765935,29152,26150,152,26302,198
2021-01-04,Santa Barbara,083,443738,20996,18735,590,19325,165
2021-01-04,Santa Clara,085,1922200,82035,75297,330,75627,727
2021-01-04,Santa Cruz,087,273765,11073,9680,418,10098,85
2021-01-04,Shasta,089,179085,8965,8224,832,9056,72
2021-01-04,Sierra,091,2930,36,30,6,36,0
2021-01-04,Siskiyou,093,43540,1139,980,136,1116,3
2021-01-04,Solano,095,438530,22149,20588,229,20817,97
2021-01-04,Sonoma,097,501317,21394,20210,113,20323,194
2021-01-04,Stanislaus,099,539301,38642,36141,3655,39796,553
2021-01-04,Sutter,101,95872,7016,6712,49,6761,56
2021-01-04,Tehama,103,63373,3471,3190,337,3527,9
2021-01-04,Trinity,105,12862,434,245,60,305,2
2021-01-04,Tulare,107,460477,38029,35060,4357,39417,455
2021-01-04,Tuolumne,109,53932,3070,2987,23,3010,13
2021-01-04,Ventura,111,848112,50804,45014,1828,46842,255
2021-01-04,Yolo,113,214977,9617,8834,75,8909,121
2021-01-04,Yuba,115,75493,4294,4023,41,4064,21
2021-01-03,Alameda,001,1643700,58515,55082,1120,56202,580
2021-01-03,Alpine,003,1148,69,68,0,68,0
2021-01-03,Amador,005,37829,2772,2565,22,2587,24
2021-01-03,Butte,007,227075,8597,7837,1062,8899,105
2021-01-03,Calaveras,009,45235,1292,1249,3,1252,21
2021-01-03,Colusa,011,21464,1423,1337,102,1439,7
2021-01-03,Contra Costa,013,1133247,45293,42432,679,43111,352
2021-01-03,Del Norte,015,27424,806,768,2,770,2
2021-01-03,El Dorado,017,186661,6933,6034,373,6407,27
2021-01-03,Fresno,019,978130,75096,69326,5264,74590,719
2021-01-03,Glenn,021,27897,1751,1581,309,1890,9
2021-01-03,Humboldt,023,135768,2011,1833,7,1840,21
2021-01-03,Imperial,025,180216,24049,22951,1629,24580,419
2021-01-03,Inyo,027,18085,775,615,8,623,20
2021-01-03,Kern,029,883053,72399,66895,5802,72697,609
2021-01-03,Kings,031,150075,17462,16593,578,17171,108
2021-01-03,Lake,033,64148,2166,1976,0,1976,24
2021-01-03,Lassen,035,31185,4602,4531,54,4585,1
2021-01-03,Los Angeles,037,10098052,869783,792168,25199,817367,10633
2021-01-03,Madera,039,155013,11952,11152,504,11656,67
2021-01-03,Marin,041,260295,10479,10034,98,10132,150
2021-01-03,Mariposa,043,17540,291,248,2,250,3
2021-01-03,Mendocino,045,87422,2697,2445,29,2474,24
2021-01-03,Merced,047,269075,20607,19600,422,20022,230
2021-01-03,Modoc,049,8938,268,245,75,320,0
2021-01-03,Mono,051,14174,944,893,13,906,3
2021-01-03,Monterey,053,433212,30916,29357,771,30128,191
2021-01-03,Napa,055,140530,6565,6094,25,6119,29
2021-01-03,Nevada,057,99092,2983,2742,100,2842,15
2021-01-03,Orange,059,3164182,184037,169881,7274,177155,1919
2021-01-03,Placer,061,380077,16064,14319,665,14984,133
2021-01-03,Plumas,063,18699,506,416,9,425,1
2021-01-03,Riverside,065,2383286,210019,195048,9736,204784,2005
2021-01-03,Sacramento,067,1510023,71598,68558,712,69270,859
2021-01-03,San Benito,069,59416,4123,3882,34,3916,28
2021-01-03,San Bernardino,071,2135413,223178,208294,6160,214454,1592
2021-01-03,San Diego,073,3302833,184245,168018,8454,176472,1592
2021-01-03,San Francisco,075,870044,25787,24588,255,24843,193
2021-01-03,San Joaquin,077,732212,50395,47899,1831,49730,661
2021-01-03,San Luis Obispo,079,281455,12887,11636,284,11920,95
2021-01-03,San Mateo,081,765935,28558,25770,145,25915,196
2021-01-03,Santa Barbara,083,443738,20263,18267,576,18843,164
2021-01-03,Santa Clara,085,1922200,80445,74534,324,74858,720
2021-01-03,Santa Cruz,087,273765,10768,9528,403,9931,84
2021-01-03,Shasta,089,179085,8838,8192,792,8984,72
2021-01-03,Sierra,091,2930,36,30,6,36,0
2021-01-03,Siskiyou,093,43540,1106,976,127,1103,3
2021-01-03,Solano,095,438530,21616,20105,223,20328,97
2021-01-03,Sonoma,097,501317,21008,19982,111,20093,193
2021-01-03,Stanislaus,099,539301,37935,35762,3572,39334,553
2021-01-03,Sutter,101,95872,6919,6664,48,6712,53
2021-01-03,Tehama,103,63373,3417,3176,329,3505,9
2021-01-03,Trinity,105,12862,429,243,58,301,2
2021-01-03,Tulare,107,460477,37452,34747,4212,38959,455
2021-01-03,Tuolumne,109,53932,3009,2978,20,2998,13
2021-01-03,Ventura,111,848112,48978,43748,1811,45559,254
2021-01-03,Yolo,113,214977,9456,8674,74,8748,121
2021-01-03,Yuba,115,75493,4243,3966,40,4006,20
2021-01-02,Alameda,001,1643700,57893,54518,1089,55607,581
2021-01-02,Alpine,003,1148,69,68,0,68,0
2021-01-02,Amador,005,37829,2753,2540,22,2562,24
2021-01-02,Butte,007,227075,8491,7750,1041,8791,105
2021-01-02,Calaveras,009,45235,1272,1230,3,1233,21
2021-01-02,Colusa,011,21464,1412,1332,101,1433,7
2021-01-02,Contra Costa,013,1133247,44747,41993,671,42664,352
2021-01-02,Del Norte,015,27424,804,764,2,766,2
2021-01-02,El Dorado,017,186661,6878,5959,369,6328,27
2021-01-02,Fresno,019,978130,74553,68740,5153,73893,717
2021-01-02,Glenn,021,27897,1734,1546,308,1854,9
2021-01-02,Humboldt,023,135768,1984,1815,7,1822,21
2021-01-02,Imperial,025,180216,23961,22867,1597,24464,420
2021-01-02,Inyo,027,18085,764,609,8,617,20
2021-01-02,Kern,029,883053,71679,66457,5690,72147,610
2021-01-02,Kings,031,150075,17368,16515,574,17089,108
2021-01-02,Lake,033,64148,2129,1925,0,1925,24
2021-01-02,Lassen,035,31185,4591,4457,53,4510,1
2021-01-02,Los Angeles,037,10098052,861413,791892,24520,816412,10633
2021-01-02,Madera,039,155013,11837,11039,492,11531,67
2021-01-02,Marin,041,260295,10431,9924,95,10019,151
2021-01-02,Mariposa,043,17540,284,243,2,245,3
2021-01-02,Mendocino,045,87422,2654,2428,28,2456,24
2021-01-02,Merced,047,269075,20465,19395,405,19800,230
2021-01-02,Modoc,049,8938,267,245,75,320,0
2021-01-02,Mono,051,14174,933,884,13,897,3
2021-01-02,Monterey,053,433212,30700,28991,759,29750,191
2021-01-02,Napa,055,140530,6506,5994,25,6019,29
2021-01-02,Nevada,057,99092,2954,2706,96,2802,15
2021-01-02,Orange,059,3164182,181814,168457,7126,175583,1918
2021-01-02,Placer,061,380077,15891,14182,656,14838,133
2021-01-02,Plumas,063,18699,503,413,9,422,1
2021-01-02,Riverside,065,2383286,207373,192069,9510,201579,2008
2021-01-02,Sacramento,067,1510023,70962,67810,694,68504,858
2021-01-02,San Benito,069,59416,4041,3829,34,3863,28
2021-01-02,San Bernardino,071,2135413,221516,206939,6038,212977,1597
2021-01-02,San Diego,073,3302833,181646,164498,8257,172755,1592
2021-01-02,San Francisco,075,870044,25534,24414,247,24661,194
2021-01-02,San Joaquin,077,732212,49992,47310,1803,49113,662
2021-01-02,San Luis Obispo,079,281455,12753,11467,278,11745,95
2021-01-02,San Mateo,081,765935,28221,25483,137,25620,196
2021-01-02,Santa Barbara,083,443738,19974,18135,573,18708,164
2021-01-02,Santa Clara,085,1922200,79269,73662,318,73980,720
2021-01-02,Santa Cruz,087,273765,10613,9340,395,9735,85
2021-01-02,Shasta,089,179085,8772,8154,781,8935,72
2021-01-02,Sierra,091,2930,36,28,6,34,0
2021-01-02,Siskiyou,093,43540,1095,949,125,1074,3
2021-01-02,Solano,095,438530,21414,19805,214,20019,97
2021-01-02,Sonoma,097,501317,20839,19761,111,19872,194
2021-01-02,Stanislaus,099,539301,37602,35431,3508,38939,553
2021-01-02,Sutter,101,95872,6867,6621,48,6669,53
2021-01-02,Tehama,103,63373,3389,3146,325,3471,9
2021-01-02,Trinity,105,12862,426,243,58,301,2
2021-01-02,Tulare,107,460477,37124,34479,4138,38617,455
2021-01-02,Tuolumne,109,53932,2995,2942,18,2960,13
2021-01-02,Ventura,111,848112,47823,43397,1778,45175,254
2021-01-02,Yolo,113,214977,9359,8571,72,8643,122
2021-01-02,Yuba,115,75493,4205,3930,40,3970,21
2021-01-01,Alameda,001,1643700,57245,53518,1075,54593,579
2021-01-01,Alpine,003,1148,69,68,0,68,0
2021-01-01,Amador,005,37829,2727,2513,20,2533,24
2021-01-01,Butte,007,227075,8389,7589,1019,8608,105
2021-01-01,Calaveras,009,45235,1257,1186,3,1189,21
2021-01-01,Colusa,011,21464,1402,1314,99,1413,7
2021-01-01,Contra Costa,013,1133247,44272,41412,651,42063,351
2021-01-01,Del Norte,015,27424,799,758,2,760,2
2021-01-01,El Dorado,017,186661,6785,5832,361,6193,27
2021-01-01,Fresno,019,978130,73481,67484,5069,72553,717
2021-01-01,Glenn,021,27897,1717,1520,299,1819,9
2021-01-01,Humboldt,023,135768,1945,1783,7,1790,21
2021-01-01,Imperial,025,180216,23865,22715,1546,24261,418
2021-01-01,Inyo,027,18085,739,606,8,614,20
2021-01-01,Kern,029,883053,70853,65571,5583,71154,609
2021-01-01,Kings,031,150075,17185,16358,567,16925,108
2021-01-01,Lake,033,64148,2091,1888,0,1888,24
2021-01-01,Lassen,035,31185,4585,4377,53,4430,1
2021-01-01,Los Angeles,037,10098052,847192,775578,23850,799428,10515
2021-01-01,Madera,039,155013,11682,10752,483,11235,66
2021-01-01,Marin,041,260295,10333,9821,94,9915,148
2021-01-01,Mariposa,043,17540,276,236,2,238,3
2021-01-01,Mendocino,045,87422,2600,2400,28,2428,24
2021-01-01,Merced,047,269075,20281,19118,389,19507,229
2021-01-01,Modoc,049,8938,267,241,75,316,0
2021-01-01,Mono,051,14174,915,884,12,896,3
2021-01-01,Monterey,053,433212,30462,28465,750,29215,191
2021-01-01,Napa,055,140530,6421,5899,25,5924,28
2021-01-01,Nevada,057,99092,2930,2663,96,2759,15
2021-01-01,Orange,059,3164182,179020,165440,6983,172423,1893
2021-01-01,Placer,061,380077,15701,13987,641,14628,133
2021-01-01,Plumas,063,18699,498,412,9,421,1
2021-01-01,Riverside,065,2383286,204183,188674,9257,197931,1990
2021-01-01,Sacramento,067,1510023,70364,66956,677,67633,848
2021-01-01,San Benito,069,59416,4004,3773,34,3807,28
2021-01-01,San Bernardino,071,2135413,218752,203651,5908,209559,1590
2021-01-01,San Diego,073,3302833,178573,160071,8078,168149,1592
2021-01-01,San Francisco,075,870044,25256,24145,236,24381,187
2021-01-01,San Joaquin,077,732212,49668,46640,1759,48399,657
2021-01-01,San Luis Obispo,079,281455,12524,11160,270,11430,94
2021-01-01,San Mateo,081,765935,27772,25041,133,25174,194
2021-01-01,Santa Barbara,083,443738,19654,17759,563,18322,164
2021-01-01,Santa Clara,085,1922200,78048,71904,314,72218,680
2021-01-01,Santa Cruz,087,273765,10433,9146,385,9531,84
2021-01-01,Shasta,089,179085,8691,8102,764,8866,72
2021-01-01,Sierra,091,2930,36,26,6,32,0
2021-01-01,Siskiyou,093,43540,1081,944,120,1064,3
2021-01-01,Solano,095,438530,21200,19393,212,19605,97
2021-01-01,Sonoma,097,501317,20643,19513,111,19624,189
2021-01-01,Stanislaus,099,539301,37314,34978,3446,38424,553
2021-01-01,Sutter,101,95872,6810,6553,47,6600,52
2021-01-01,Tehama,103,63373,3331,3079,318,3397,9
2021-01-01,Trinity,105,12862,426,243,58,301,2
2021-01-01,Tulare,107,460477,36715,33994,4050,38044,454
2021-01-01,Tuolumne,109,53932,2978,2909,18,2927,13
2021-01-01,Ventura,111,848112,46330,42026,1752,43778,253
2021-01-01,Yolo,113,214977,9249,8461,69,8530,120
2021-01-01,Yuba,115,75493,4151,3845,39,3884,19
2020-12-31,Alameda,001,1643700,56697,52475,1043,53518,579
2020-12-31,Alpine,003,1148,69,66,0,66,0
2020-12-31,Amador,005,37829,2713,2493,20,2513,24
2020-12-31,Butte,007,227075,8314,7405,998,8403,105
2020-12-31,Calaveras,009,45235,1246,1161,3,1164,21
2020-12-31,Colusa,011,21464,1390,1301,96,1397,7
2020-12-31,Contra Costa,013,1133247,43868,40512,635,41147,336
2020-12-31,Del Norte,015,27424,798,748,2,750,2
2020-12-31,El Dorado,017,186661,6733,5662,352,6014,26
2020-12-31,Fresno,019,978130,73050,66442,5007,71449,711
2020-12-31,Glenn,021,27897,1689,1484,291,1775,9
2020-12-31,Humboldt,023,135768,1928,1713,7,1720,21
2020-12-31,Imperial,025,180216,23795,22494,1529,24023,417
2020-12-31,Inyo,027,18085,731,591,8,599,20
2020-12-31,Kern,029,883053,70379,64904,5495,70399,609
2020-12-31,Kings,031,150075,17110,16077,558,16635,108
2020-12-31,Lake,033,64148,2070,1848,0,1848,23
2020-12-31,Lassen,035,31185,4579,4340,52,4392,1
2020-12-31,Los Angeles,037,10098052,841845,755844,23399,779243,10320
2020-12-31,Madera,039,155013,11597,10609,475,11084,64
2020-12-31,Marin,041,260295,10281,9731,92,9823,148
2020-12-31,Mariposa,043,17540,274,217,2,219,3
2020-12-31,Mendocino,045,87422,2585,2367,24,2391,24
2020-12-31,Merced,047,269075,20191,18808,379,19187,226
2020-12-31,Modoc,049,8938,267,238,75,313,0
2020-12-31,Mono,051,14174,907,868,12,880,3
2020-12-31,Monterey,053,433212,30232,27720,738,28458,188
2020-12-31,Napa,055,140530,6358,5801,25,5826,28
2020-12-31,Nevada,057,99092,2907,2619,95,2714,15
2020-12-31,Orange,059,3164182,177119,161586,6854,168440,1866
2020-12-31,Placer,061,380077,15545,13708,638,14346,126
2020-12-31,Plumas,063,18699,494,401,8,409,1
2020-12-31,Riverside,065,2383286,202501,184193,9128,193321,1958
2020-12-31,Sacramento,067,1510023,69834,65817,667,66484,830
2020-12-31,San Benito,069,59416,3980,3673,34,3707,28
2020-12-31,San Bernardino,071,2135413,217058,199115,5835,204950,1586
2020-12-31,San Diego,073,3302833,176810,155593,7979,163572,1534
2020-12-31,San Francisco,075,870044,25021,23740,229,23969,183
2020-12-31,San Joaquin,077,732212,49316,45764,1721,47485,646
2020-12-31,San Luis Obispo,079,281455,12409,10846,270,11116,89
2020-12-31,San Mateo,081,765935,27442,24570,127,24697,192
2020-12-31,Santa Barbara,083,443738,19410,17434,556,17990,161
2020-12-31,Santa Clara,085,1922200,77171,70032,309,70341,665
2020-12-31,Santa Cruz,087,273765,10315,8909,373,9282,84
2020-12-31,Shasta,089,179085,8625,7996,754,8750,69
2020-12-31,Sierra,091,2930,36,26,6,32,0
2020-12-31,Siskiyou,093,43540,1065,940,117,1057,3
2020-12-31,Solano,095,438530,20970,18942,211,19153,97
2020-12-31,Sonoma,097,501317,20522,19129,110,19239,188
2020-12-31,Stanislaus,099,539301,37006,34398,3399,37797,552
2020-12-31,Sutter,101,95872,6779,6432,47,6479,51
2020-12-31,Tehama,103,63373,3293,3036,317,3353,9
2020-12-31,Trinity,105,12862,425,241,58,299,2
2020-12-31,Tulare,107,460477,36511,33412,3989,37401,446
2020-12-31,Tuolumne,109,53932,2969,2902,18,2920,12
2020-12-31,Ventura,111,848112,45820,40854,1735,42589,251
2020-12-31,Yolo,113,214977,9160,8295,68,8363,117
2020-12-31,Yuba,115,75493,4114,3799,38,3837,18
2020-12-30,Alameda,001,1643700,55915,50158,990,51148,573
2020-12-30,Alpine,003,1148,69,66,0,66,0
2020-12-30,Amador,005,37829,2693,2418,19,2437,24
2020-12-30,Butte,007,227075,8153,7140,978,8118,103
2020-12-30,Calaveras,009,45235,1221,1135,3,1138,21
2020-12-30,Colusa,011,21464,1372,1289,90,1379,7
2020-12-30,Contra Costa,013,1133247,43319,39601,622,40223,337
2020-12-30,Del Norte,015,27424,793,726,2,728,2
2020-12-30,El Dorado,017,186661,6632,5595,342,5937,27
2020-12-30,Fresno,019,978130,72205,65566,4857,70423,711
2020-12-30,Glenn,021,27897,1658,1471,279,1750,9
2020-12-30,Humboldt,023,135768,1894,1654,7,1661,22
2020-12-30,Imperial,025,180216,23629,22098,1453,23551,412
2020-12-30,Inyo,027,18085,725,572,8,580,20
2020-12-30,Kern,029,883053,69651,63292,5350,68642,604
2020-12-30,Kings,031,150075,16991,15862,549,16411,108
2020-12-30,Lake,033,64148,2051,1731,0,1731,23
2020-12-30,Lassen,035,31185,4570,4300,52,4352,1
2020-12-30,Los Angeles,037,10098052,830923,741907,22729,764636,10046
2020-12-30,Madera,039,155013,11487,10249,464,10713,65
2020-12-30,Marin,041,260295,10187,9569,85,9654,148
2020-12-30,Mariposa,043,17540,270,214,2,216,3
2020-12-30,Mendocino,045,87422,2567,2291,21,2312,24
2020-12-30,Merced,047,269075,19901,18519,369,18888,225
2020-12-30,Modoc,049,8938,264,234,75,309,0
2020-12-30,Mono,051,14174,904,868,12,880,3
2020-12-30,Monterey,053,433212,29602,26977,716,27693,186
2020-12-30,Napa,055,140530,6253,5754,25,5779,28
2020-12-30,Nevada,057,99092,2872,2595,93,2688,15
2020-12-30,Orange,059,3164182,174461,153951,6667,160618,1863
2020-12-30,Placer,061,380077,15313,13540,626,14166,127
2020-12-30,Plumas,063,18699,489,397,8,405,1
2020-12-30,Riverside,065,2383286,199553,176402,8945,185347,1919
2020-12-30,Sacramento,067,1510023,68961,64119,650,64769,847
2020-12-30,San Benito,069,59416,3898,3464,30,3494,29
2020-12-30,San Bernardino,071,2135413,214490,192648,5750,198398,1591
2020-12-30,San Diego,073,3302833,173177,152510,7804,160314,1472
2020-12-30,San Francisco,075,870044,24745,23099,224,23323,182
2020-12-30,San Joaquin,077,732212,48595,44465,1680,46145,634
2020-12-30,San Luis Obispo,079,281455,12140,10542,262,10804,89
2020-12-30,San Mateo,081,765935,27013,24150,123,24273,190
2020-12-30,Santa Barbara,083,443738,19008,16895,535,17430,161
2020-12-30,Santa Clara,085,1922200,75962,67218,305,67523,661
2020-12-30,Santa Cruz,087,273765,10141,8787,364,9151,86
2020-12-30,Shasta,089,179085,8511,7818,740,8558,69
2020-12-30,Sierra,091,2930,36,25,6,31,0
2020-12-30,Siskiyou,093,43540,1058,913,109,1022,3
2020-12-30,Solano,095,438530,20581,18300,208,18508,96
2020-12-30,Sonoma,097,501317,20266,18947,110,19057,191
2020-12-30,Stanislaus,099,539301,36543,33730,3324,37054,526
2020-12-30,Sutter,101,95872,6719,6328,45,6373,51
2020-12-30,Tehama,103,63373,3249,2969,313,3282,9
2020-12-30,Trinity,105,12862,424,231,57,288,2
2020-12-30,Tulare,107,460477,35981,32413,3929,36342,430
2020-12-30,Tuolumne,109,53932,2959,2772,16,2788,12
2020-12-30,Ventura,111,848112,44533,39039,1711,40750,251
2020-12-30,Yolo,113,214977,9052,8067,66,8133,117
2020-12-30,Yuba,115,75493,4046,3612,38,3650,18
2020-12-29,Alameda,001,1643700,54845,50946,955,51901,552
2020-12-29,Alpine,003,1148,69,65,0,65,0
2020-12-29,Amador,005,37829,2641,2388,18,2406,23
2020-12-29,Butte,007,227075,7981,7178,954,8132,98
2020-12-29,Calaveras,009,45235,1177,1111,2,1113,21
2020-12-29,Colusa,011,21464,1351,1272,85,1357,7
2020-12-29,Contra Costa,013,1133247,42549,39225,596,39821,325
2020-12-29,Del Norte,015,27424,786,724,2,726,2
2020-12-29,El Dorado,017,186661,6502,5551,329,5880,22
2020-12-29,Fresno,019,978130,70832,65149,4708,69857,688
2020-12-29,Glenn,021,27897,1624,1454,272,1726,9
2020-12-29,Humboldt,023,135768,1846,1616,7,1623,19
2020-12-29,Imperial,025,180216,23414,22105,1371,23476,407
2020-12-29,Inyo,027,18085,707,571,8,579,19
2020-12-29,Kern,029,883053,68486,63096,5182,68278,589
2020-12-29,Kings,031,150075,16822,15777,537,16314,108
2020-12-29,Lake,033,64148,2020,1805,0,1805,22
2020-12-29,Lassen,035,31185,4555,4288,52,4340,1
2020-12-29,Los Angeles,037,10098052,810711,731907,21905,753812,9786
2020-12-29,Madera,039,155013,11185,10251,451,10702,64
2020-12-29,Marin,041,260295,10044,9595,81,9676,146
2020-12-29,Mariposa,043,17540,262,212,2,214,3
2020-12-29,Mendocino,045,87422,2524,2249,20,2269,24
2020-12-29,Merced,047,269075,19551,18464,353,18817,221
2020-12-29,Modoc,049,8938,261,232,75,307,0
2020-12-29,Mono,051,14174,895,868,12,880,3
2020-12-29,Monterey,053,433212,28951,26894,691,27585,185
2020-12-29,Napa,055,140530,6135,5663,25,5688,28
2020-12-29,Nevada,057,99092,2824,2550,92,2642,15
2020-12-29,Orange,059,3164182,170688,154411,6504,160915,1839
2020-12-29,Placer,061,380077,15100,13392,605,13997,126
2020-12-29,Plumas,063,18699,480,395,8,403,1
2020-12-29,Riverside,065,2383286,194955,177624,8696,186320,1904
2020-12-29,Sacramento,067,1510023,67910,65078,638,65716,820
2020-12-29,San Benito,069,59416,3779,3474,29,3503,25
2020-12-29,San Bernardino,071,2135413,209654,190476,5614,196090,1557
2020-12-29,San Diego,073,3302833,168954,150062,7573,157635,1435
2020-12-29,San Francisco,075,870044,24405,22996,217,23213,178
2020-12-29,San Joaquin,077,732212,47655,44699,1627,46326,622
2020-12-29,San Luis Obispo,079,281455,11844,10387,254,10641,80
2020-12-29,San Mateo,081,765935,26471,23773,111,23884,189
2020-12-29,Santa Barbara,083,443738,18539,16797,509,17306,155
2020-12-29,Santa Clara,085,1922200,74462,67581,301,67882,621
2020-12-29,Santa Cruz,087,273765,9875,8492,355,8847,84
2020-12-29,Shasta,089,179085,8407,7782,725,8507,65
2020-12-29,Sierra,091,2930,34,24,5,29,0
2020-12-29,Siskiyou,093,43540,1043,926,107,1033,3
2020-12-29,Solano,095,438530,20205,18412,203,18615,96
2020-12-29,Sonoma,097,501317,19934,18790,108,18898,187
2020-12-29,Stanislaus,099,539301,36066,33775,3254,37029,508
2020-12-29,Sutter,101,95872,6652,6302,45,6347,50
2020-12-29,Tehama,103,63373,3179,2962,301,3263,9
2020-12-29,Trinity,105,12862,423,241,57,298,2
2020-12-29,Tulare,107,460477,35353,32545,3806,36351,419
2020-12-29,Tuolumne,109,53932,2917,2797,16,2813,12
2020-12-29,Ventura,111,848112,43278,38669,1685,40354,235
2020-12-29,Yolo,113,214977,8922,8124,64,8188,111
2020-12-29,Yuba,115,75493,3967,3723,38,3761,18
2020-12-28,Alameda,001,1643700,53802,50405,935,51340,551
2020-12-28,Alpine,003,1148,68,65,0,65,0
2020-12-28,Amador,005,37829,2571,2255,18,2273,23
2020-12-28,Butte,007,227075,7815,7053,924,7977,86
2020-12-28,Calaveras,009,45235,1154,1102,2,1104,21
2020-12-28,Colusa,011,21464,1325,1255,74,1329,7
2020-12-28,Contra Costa,013,1133247,41607,38872,567,39439,324
2020-12-28,Del Norte,015,27424,777,718,2,720,2
2020-12-28,El Dorado,017,186661,6346,5441,317,5758,18
2020-12-28,Fresno,019,978130,69567,64274,4558,68832,679
2020-12-28,Glenn,021,27897,1590,1435,260,1695,9
2020-12-28,Humboldt,023,135768,1811,1579,7,1586,19
2020-12-28,Imperial,025,180216,23158,22003,1297,23300,405
2020-12-28,Inyo,027,18085,701,569,8,577,19
2020-12-28,Kern,029,883053,67420,62392,4982,67374,579
2020-12-28,Kings,031,150075,16605,15733,520,16253,108
2020-12-28,Lake,033,64148,1980,1785,0,1785,22
2020-12-28,Lassen,035,31185,4448,4284,51,4335,1
2020-12-28,Los Angeles,037,10098052,788351,720699,21121,741820,9544
2020-12-28,Madera,039,155013,11012,10123,431,10554,64
2020-12-28,Marin,041,260295,9937,9546,75,9621,145
2020-12-28,Mariposa,043,17540,238,211,2,213,3
2020-12-28,Mendocino,045,87422,2489,2214,20,2234,23
2020-12-28,Merced,047,269075,19231,18245,335,18580,213
2020-12-28,Modoc,049,8938,256,220,73,293,0
2020-12-28,Mono,051,14174,891,848,12,860,3
2020-12-28,Monterey,053,433212,28103,26529,682,27211,182
2020-12-28,Napa,055,140530,6025,5576,25,5601,26
2020-12-28,Nevada,057,99092,2776,2532,88,2620,15
2020-12-28,Orange,059,3164182,166587,152089,6329,158418,1839
2020-12-28,Placer,061,380077,14760,13234,578,13812,126
2020-12-28,Plumas,063,18699,476,391,8,399,0
2020-12-28,Riverside,065,2383286,190059,174029,8409,182438,1855
2020-12-28,Sacramento,067,1510023,66675,64322,614,64936,813
2020-12-28,San Benito,069,59416,3710,3429,29,3458,24
2020-12-28,San Bernardino,071,2135413,204561,188919,5501,194420,1552
2020-12-28,San Diego,073,3302833,164210,147528,7391,154919,1404
2020-12-28,San Francisco,075,870044,24045,22726,212,22938,178
2020-12-28,San Joaquin,077,732212,46716,44172,1595,45767,618
2020-12-28,San Luis Obispo,079,281455,11494,10260,250,10510,76
2020-12-28,San Mateo,081,765935,25997,23467,107,23574,189
2020-12-28,Santa Barbara,083,443738,18071,16579,497,17076,155
2020-12-28,Santa Clara,085,1922200,72981,66418,294,66712,619
2020-12-28,Santa Cruz,087,273765,9617,8310,345,8655,81
2020-12-28,Shasta,089,179085,8290,7688,712,8400,65
2020-12-28,Sierra,091,2930,32,24,4,28,0
2020-12-28,Siskiyou,093,43540,1027,915,102,1017,3
2020-12-28,Solano,095,438530,19645,18171,196,18367,96
2020-12-28,Sonoma,097,501317,19587,18667,106,18773,185
2020-12-28,Stanislaus,099,539301,35520,33473,3195,36668,507
2020-12-28,Sutter,101,95872,6572,6253,45,6298,49
2020-12-28,Tehama,103,63373,3126,2934,294,3228,9
2020-12-28,Trinity,105,12862,421,240,57,297,2
2020-12-28,Tulare,107,460477,34704,32010,3705,35715,404
2020-12-28,Tuolumne,109,53932,2900,2777,16,2793,12
2020-12-28,Ventura,111,848112,41608,37151,1640,38791,230
2020-12-28,Yolo,113,214977,8769,8031,63,8094,111
2020-12-28,Yuba,115,75493,3912,3679,37,3716,18
2020-12-27,Alameda,001,1643700,52561,49764,909,50673,551
2020-12-27,Alpine,003,1148,66,65,0,65,0
2020-12-27,Amador,005,37829,2451,2218,18,2236,23
2020-12-27,Butte,007,227075,7660,7016,886,7902,86
2020-12-27,Calaveras,009,45235,1108,1097,2,1099,21
2020-12-27,Colusa,011,21464,1300,1253,71,1324,7
2020-12-27,Contra Costa,013,1133247,40662,38428,543,38971,324
2020-12-27,Del Norte,015,27424,753,712,2,714,2
2020-12-27,El Dorado,017,186661,6132,5388,294,5682,18
2020-12-27,Fresno,019,978130,68321,63811,4353,68164,679
2020-12-27,Glenn,021,27897,1562,1434,246,1680,9
2020-12-27,Humboldt,023,135768,1767,1575,7,1582,17
2020-12-27,Imperial,025,180216,22879,21934,1190,23124,405
2020-12-27,Inyo,027,18085,682,565,7,572,18
2020-12-27,Kern,029,883053,66139,61914,4817,66731,568
2020-12-27,Kings,031,150075,16369,15593,486,16079,108
2020-12-27,Lake,033,64148,1931,1769,0,1769,22
2020-12-27,Lassen,035,31185,4371,4230,44,4274,1
2020-12-27,Los Angeles,037,10098052,766821,707260,20257,727517,9476
2020-12-27,Madera,039,155013,10755,10005,421,10426,64
2020-12-27,Marin,041,260295,9818,9477,73,9550,144
2020-12-27,Mariposa,043,17540,231,208,2,210,3
2020-12-27,Mendocino,045,87422,2442,2209,20,2229,23
2020-12-27,Merced,047,269075,18864,18075,319,18394,213
2020-12-27,Modoc,049,8938,247,221,69,290,0
2020-12-27,Mono,051,14174,879,849,12,861,3
2020-12-27,Monterey,053,433212,27540,26322,665,26987,181
2020-12-27,Napa,055,140530,5891,5496,25,5521,26
2020-12-27,Nevada,057,99092,2740,2519,88,2607,15
2020-12-27,Orange,059,3164182,162185,149276,6141,155417,1839
2020-12-27,Placer,061,380077,14465,13017,546,13563,126
2020-12-27,Plumas,063,18699,470,390,8,398,0
2020-12-27,Riverside,065,2383286,185143,171995,8109,180104,1836
2020-12-27,Sacramento,067,1510023,65464,63416,592,64008,811
2020-12-27,San Benito,069,59416,3625,3394,29,3423,24
2020-12-27,San Bernardino,071,2135413,199470,186776,5364,192140,1551
2020-12-27,San Diego,073,3302833,159803,145777,7204,152981,1402
2020-12-27,San Francisco,075,870044,23691,22514,204,22718,178
2020-12-27,San Joaquin,077,732212,45666,43529,1546,45075,618
2020-12-27,San Luis Obispo,079,281455,11086,10154,245,10399,76
2020-12-27,San Mateo,081,765935,25433,23136,104,23240,187
2020-12-27,Santa Barbara,083,443738,17542,16364,470,16834,155
2020-12-27,Santa Clara,085,1922200,71286,65288,288,65576,619
2020-12-27,Santa Cruz,087,273765,9359,8234,337,8571,81
2020-12-27,Shasta,089,179085,8163,7671,690,8361,65
2020-12-27,Sierra,091,2930,32,24,3,27,0
2020-12-27,Siskiyou,093,43540,1017,914,97,1011,3
2020-12-27,Solano,095,438530,19163,17840,191,18031,96
2020-12-27,Sonoma,097,501317,19296,18487,105,18592,185
2020-12-27,Stanislaus,099,539301,34908,33076,3112,36188,506
2020-12-27,Sutter,101,95872,6491,6218,43,6261,48
2020-12-27,Tehama,103,63373,3054,2922,278,3200,9
2020-12-27,Trinity,105,12862,414,240,55,295,2
2020-12-27,Tulare,107,460477,34102,31864,3587,35451,400
2020-12-27,Tuolumne,109,53932,2794,2750,14,2764,12
2020-12-27,Ventura,111,848112,40546,36661,1589,38250,230
2020-12-27,Yolo,113,214977,8580,7919,59,7978,111
2020-12-27,Yuba,115,75493,3849,3665,35,3700,18
2020-12-26,Alameda,001,1643700,51938,49084,896,49980,551
2020-12-26,Alpine,003,1148,66,65,0,65,0
2020-12-26,Amador,005,37829,2437,2189,18,2207,23
2020-12-26,Butte,007,227075,7566,6968,862,7830,86
2020-12-26,Calaveras,009,45235,1102,1084,2,1086,21
2020-12-26,Colusa,011,21464,1290,1240,71,1311,7
2020-12-26,Contra Costa,013,1133247,40184,38008,526,38534,324
2020-12-26,Del Norte,015,27424,748,709,2,711,2
2020-12-26,El Dorado,017,186661,6077,5279,290,5569,18
2020-12-26,Fresno,019,978130,67852,63080,4290,67370,679
2020-12-26,Glenn,021,27897,1541,1413,241,1654,9
2020-12-26,Humboldt,023,135768,1729,1545,7,1552,17
2020-12-26,Imperial,025,180216,22784,21734,1137,22871,405
2020-12-26,Inyo,027,18085,667,554,7,561,18
2020-12-26,Kern,029,883053,65468,61174,4670,65844,564
2020-12-26,Kings,031,150075,16251,15517,482,15999,108
2020-12-26,Lake,033,64148,1891,1710,0,1710,22
2020-12-26,Lassen,035,31185,4350,3981,44,4025,1
2020-12-26,Los Angeles,037,10098052,758244,694149,19771,713920,9424
2020-12-26,Madera,039,155013,10679,9908,409,10317,64
2020-12-26,Marin,041,260295,9778,9413,70,9483,143
2020-12-26,Mariposa,043,17540,230,206,2,208,3
2020-12-26,Mendocino,045,87422,2396,2194,20,2214,23
2020-12-26,Merced,047,269075,18706,17890,314,18204,213
2020-12-26,Modoc,049,8938,244,222,69,291,0
2020-12-26,Mono,051,14174,873,850,12,862,3
2020-12-26,Monterey,053,433212,27402,26010,656,26666,182
2020-12-26,Napa,055,140530,5833,5427,25,5452,26
2020-12-26,Nevada,057,99092,2712,2480,88,2568,15
2020-12-26,Orange,059,3164182,159962,147304,6050,153354,1838
2020-12-26,Placer,061,380077,14293,12816,531,13347,122
2020-12-26,Plumas,063,18699,467,381,8,389,0
2020-12-26,Riverside,065,2383286,182657,169360,7951,177311,1834
2020-12-26,Sacramento,067,1510023,64839,62435,582,63017,807
2020-12-26,San Benito,069,59416,3552,3330,29,3359,24
2020-12-26,San Bernardino,071,2135413,197790,185111,5282,190393,1551
2020-12-26,San Diego,073,3302833,157278,142644,7057,149701,1402
2020-12-26,San Francisco,075,870044,23450,22319,204,22523,177
2020-12-26,San Joaquin,077,732212,45278,42887,1500,44387,618
2020-12-26,San Luis Obispo,079,281455,10999,9945,240,10185,76
2020-12-26,San Mateo,081,765935,25095,22908,99,23007,187
2020-12-26,Santa Barbara,083,443738,17303,16159,464,16623,155
2020-12-26,Santa Clara,085,1922200,70171,64185,286,64471,618
2020-12-26,Santa Cruz,087,273765,9228,8113,328,8441,81
2020-12-26,Shasta,089,179085,8103,7641,678,8319,65
2020-12-26,Sierra,091,2930,32,24,3,27,0
2020-12-26,Siskiyou,093,43540,1010,909,94,1003,2
2020-12-26,Solano,095,438530,18923,17528,191,17719,96
2020-12-26,Sonoma,097,501317,19093,18261,103,18364,184
2020-12-26,Stanislaus,099,539301,34609,32678,3059,35737,505
2020-12-26,Sutter,101,95872,6433,6121,43,6164,48
2020-12-26,Tehama,103,63373,3025,2884,272,3156,9
2020-12-26,Trinity,105,12862,412,237,54,291,2
2020-12-26,Tulare,107,460477,33792,31665,3524,35189,398
2020-12-26,Tuolumne,109,53932,2783,2703,14,2717,12
2020-12-26,Ventura,111,848112,39581,36064,1559,37623,230
2020-12-26,Yolo,113,214977,8478,7785,57,7842,111
2020-12-26,Yuba,115,75493,3817,3599,35,3634,18
2020-12-25,Alameda,001,1643700,51367,48365,881,49246,542
2020-12-25,Alpine,003,1148,66,64,0,64,0
2020-12-25,Amador,005,37829,2394,2172,18,2190,23
2020-12-25,Butte,007,227075,7467,6873,843,7716,85
2020-12-25,Calaveras,009,45235,1099,1062,2,1064,21
2020-12-25,Colusa,011,21464,1277,1219,70,1289,7
2020-12-25,Contra Costa,013,1133247,39697,37480,502,37982,324
2020-12-25,Del Norte,015,27424,746,692,2,694,2
2020-12-25,El Dorado,017,186661,6012,5170,277,5447,16
2020-12-25,Fresno,019,978130,66990,62251,4209,66460,679
2020-12-25,Glenn,021,27897,1525,1390,234,1624,9
2020-12-25,Humboldt,023,135768,1689,1532,7,1539,16
2020-12-25,Imperial,025,180216,22681,21646,1125,22771,405
2020-12-25,Inyo,027,18085,657,546,7,553,18
2020-12-25,Kern,029,883053,64738,60417,4524,64941,562
2020-12-25,Kings,031,150075,16140,15460,478,15938,108
2020-12-25,Lake,033,64148,1872,1669,0,1669,20
2020-12-25,Lassen,035,31185,4335,3926,44,3970,1
2020-12-25,Los Angeles,037,10098052,744575,665600,19117,684717,9292
2020-12-25,Madera,039,155013,10515,9770,403,10173,64
2020-12-25,Marin,041,260295,9725,9375,68,9443,143
2020-12-25,Mariposa,043,17540,224,203,2,205,3
2020-12-25,Mendocino,045,87422,2353,2176,20,2196,23
2020-12-25,Merced,047,269075,18545,17726,306,18032,213
2020-12-25,Modoc,049,8938,243,221,69,290,0
2020-12-25,Mono,051,14174,871,843,12,855,3
2020-12-25,Monterey,053,433212,27125,25788,647,26435,182
2020-12-25,Napa,055,140530,5756,5351,25,5376,26
2020-12-25,Nevada,057,99092,2686,2458,86,2544,15
2020-12-25,Orange,059,3164182,157270,144542,5859,150401,1814
2020-12-25,Placer,061,380077,14108,12660,509,13169,122
2020-12-25,Plumas,063,18699,460,381,8,389,0
2020-12-25,Riverside,065,2383286,179376,166690,7640,174330,1825
2020-12-25,Sacramento,067,1510023,64148,61630,557,62187,796
2020-12-25,San Benito,069,59416,3511,3281,27,3308,24
2020-12-25,San Bernardino,071,2135413,195192,181812,5167,186979,1546
2020-12-25,San Diego,073,3302833,154798,139958,6879,146837,1402
2020-12-25,San Francisco,075,870044,23168,22130,199,22329,175
2020-12-25,San Joaquin,077,732212,44978,42089,1447,43536,614
2020-12-25,San Luis Obispo,079,281455,10816,9749,233,9982,76
2020-12-25,San Mateo,081,765935,24773,22568,97,22665,187
2020-12-25,Santa Barbara,083,443738,17079,15936,457,16393,155
2020-12-25,Santa Clara,085,1922200,69034,63173,277,63450,612
2020-12-25,Santa Cruz,087,273765,9078,8018,307,8325,81
2020-12-25,Shasta,089,179085,8029,7612,655,8267,65
2020-12-25,Sierra,091,2930,32,24,3,27,0
2020-12-25,Siskiyou,093,43540,1004,905,92,997,2
2020-12-25,Solano,095,438530,18744,17280,189,17469,96
2020-12-25,Sonoma,097,501317,18918,18035,101,18136,184
2020-12-25,Stanislaus,099,539301,34327,32290,3004,35294,498
2020-12-25,Sutter,101,95872,6374,6051,42,6093,47
2020-12-25,Tehama,103,63373,2977,2839,259,3098,9
2020-12-25,Trinity,105,12862,408,236,54,290,2
2020-12-25,Tulare,107,460477,33381,31323,3456,34779,398
2020-12-25,Tuolumne,109,53932,2764,2674,14,2688,12
2020-12-25,Ventura,111,848112,38425,35514,1511,37025,230
2020-12-25,Yolo,113,214977,8386,7700,55,7755,111
2020-12-25,Yuba,115,75493,3777,3549,34,3583,17
2020-12-24,Alameda,001,1643700,51011,47527,863,48390,541
2020-12-24,Alpine,003,1148,66,64,0,64,0
2020-12-24,Amador,005,37829,2381,2145,18,2163,23
2020-12-24,Butte,007,227075,7429,6716,827,7543,84
2020-12-24,Calaveras,009,45235,1096,1032,2,1034,21
2020-12-24,Colusa,011,21464,1272,1188,68,1256,7
2020-12-24,Contra Costa,013,1133247,39445,36623,489,37112,311
2020-12-24,Del Norte,015,27424,745,678,2,680,2
2020-12-24,El Dorado,017,186661,5986,5042,269,5311,16
2020-12-24,Fresno,019,978130,66768,61435,4195,65630,663
2020-12-24,Glenn,021,27897,1514,1363,226,1589,9
2020-12-24,Humboldt,023,135768,1666,1516,7,1523,16
2020-12-24,Imperial,025,180216,22618,21545,1115,22660,402
2020-12-24,Inyo,027,18085,655,532,7,539,17
2020-12-24,Kern,029,883053,64450,59601,4511,64112,556
2020-12-24,Kings,031,150075,16100,15211,477,15688,108
2020-12-24,Lake,033,64148,1850,1629,0,1629,20
2020-12-24,Lassen,035,31185,4322,3894,44,3938,1
2020-12-24,Los Angeles,037,10098052,740381,664840,18875,683715,9288
2020-12-24,Madera,039,155013,10466,9547,395,9942,63
2020-12-24,Marin,041,260295,9686,9287,68,9355,143
2020-12-24,Mariposa,043,17540,220,197,2,199,3
2020-12-24,Mendocino,045,87422,2342,2150,20,2170,23
2020-12-24,Merced,047,269075,18475,17485,302,17787,212
2020-12-24,Modoc,049,8938,243,220,68,288,0
2020-12-24,Mono,051,14174,869,817,12,829,3
2020-12-24,Monterey,053,433212,27012,25131,640,25771,180
2020-12-24,Napa,055,140530,5701,5265,25,5290,26
2020-12-24,Nevada,057,99092,2662,2429,86,2515,15
2020-12-24,Orange,059,3164182,155776,141205,5808,147013,1775
2020-12-24,Placer,061,380077,14018,12457,502,12959,121
2020-12-24,Plumas,063,18699,457,376,8,384,0
2020-12-24,Riverside,065,2383286,178440,162435,7600,170035,1816
2020-12-24,Sacramento,067,1510023,63873,60596,555,61151,788
2020-12-24,San Benito,069,59416,3480,3183,27,3210,24
2020-12-24,San Bernardino,071,2135413,194102,176866,5134,182000,1533
2020-12-24,San Diego,073,3302833,153714,136952,6847,143799,1382
2020-12-24,San Francisco,075,870044,22995,21830,196,22026,175
2020-12-24,San Joaquin,077,732212,44811,41324,1429,42753,611
2020-12-24,San Luis Obispo,079,281455,10747,9504,231,9735,77
2020-12-24,San Mateo,081,765935,24578,22093,97,22190,186
2020-12-24,Santa Barbara,083,443738,16974,15644,449,16093,153
2020-12-24,Santa Clara,085,1922200,68345,61742,270,62012,591
2020-12-24,Santa Cruz,087,273765,8999,7856,295,8151,82
2020-12-24,Shasta,089,179085,7988,7540,638,8178,65
2020-12-24,Sierra,091,2930,29,23,1,24,0
2020-12-24,Siskiyou,093,43540,999,900,86,986,2
2020-12-24,Solano,095,438530,18603,16872,184,17056,96
2020-12-24,Sonoma,097,501317,18817,17710,101,17811,183
2020-12-24,Stanislaus,099,539301,34125,31848,2977,34825,498
2020-12-24,Sutter,101,95872,6333,5960,41,6001,47
2020-12-24,Tehama,103,63373,2959,2779,257,3036,9
2020-12-24,Trinity,105,12862,407,235,54,289,2
2020-12-24,Tulare,107,460477,33233,30827,3430,34257,390
2020-12-24,Tuolumne,109,53932,2756,2653,14,2667,12
2020-12-24,Ventura,111,848112,38145,34400,1504,35904,224
2020-12-24,Yolo,113,214977,8344,7566,54,7620,113
2020-12-24,Yuba,115,75493,3746,3483,34,3517,16
2020-12-23,Alameda,001,1643700,50433,46753,835,47588,537
2020-12-23,Alpine,003,1148,66,64,0,64,0
2020-12-23,Amador,005,37829,2312,2108,17,2125,23
2020-12-23,Butte,007,227075,7340,6588,800,7388,84
2020-12-23,Calaveras,009,45235,1088,1002,1,1003,21
2020-12-23,Colusa,011,21464,1261,1167,67,1234,7
2020-12-23,Contra Costa,013,1133247,39048,36190,475,36665,311
2020-12-23,Del Norte,015,27424,737,670,2,672,2
2020-12-23,El Dorado,017,186661,5911,4967,261,5228,14
2020-12-23,Fresno,019,978130,66157,60488,4130,64618,654
2020-12-23,Glenn,021,27897,1500,1349,222,1571,9
2020-12-23,Humboldt,023,135768,1641,1458,7,1465,16
2020-12-23,Imperial,025,180216,22523,21323,1086,22409,399
2020-12-23,Inyo,027,18085,642,517,7,524,17
2020-12-23,Kern,029,883053,63931,58656,4420,63076,549
2020-12-23,Kings,031,150075,16023,14923,474,15397,105
2020-12-23,Lake,033,64148,1833,1595,0,1595,20
2020-12-23,Lassen,035,31185,4312,3865,41,3906,1
2020-12-23,Los Angeles,037,10098052,731307,651958,18358,670316,9146
2020-12-23,Madera,039,155013,10309,9371,380,9751,63
2020-12-23,Marin,041,260295,9626,9199,65,9264,142
2020-12-23,Mariposa,043,17540,218,194,2,196,3
2020-12-23,Mendocino,045,87422,2330,2121,20,2141,23
2020-12-23,Merced,047,269075,18319,17250,294,17544,203
2020-12-23,Modoc,049,8938,239,197,67,264,0
2020-12-23,Mono,051,14174,866,814,12,826,3
2020-12-23,Monterey,053,433212,26712,24856,635,25491,176
2020-12-23,Napa,055,140530,5634,5172,25,5197,25
2020-12-23,Nevada,057,99092,2617,2406,85,2491,15
2020-12-23,Orange,059,3164182,153321,138050,5647,143697,1771
2020-12-23,Placer,061,380077,13808,12213,494,12707,111
2020-12-23,Plumas,063,18699,450,369,8,377,0
2020-12-23,Riverside,065,2383286,176169,158110,7446,165556,1790
2020-12-23,Sacramento,067,1510023,63224,59661,542,60203,779
2020-12-23,San Benito,069,59416,3426,3073,25,3098,24
2020-12-23,San Bernardino,071,2135413,192036,172888,5066,177954,1509
2020-12-23,San Diego,073,3302833,151288,134695,6710,141405,1350
2020-12-23,San Francisco,075,870044,22774,21498,193,21691,174
2020-12-23,San Joaquin,077,732212,44285,35664,1387,37051,602
2020-12-23,San Luis Obispo,079,281455,10605,9267,226,9493,74
2020-12-23,San Mateo,081,765935,24276,21780,95,21875,186
2020-12-23,Santa Barbara,083,443738,16766,15399,424,15823,152
2020-12-23,Santa Clara,085,1922200,67398,60455,265,60720,579
2020-12-23,Santa Cruz,087,273765,8840,7637,277,7914,75
2020-12-23,Shasta,089,179085,7916,7487,632,8119,66
2020-12-23,Sierra,091,2930,27,23,1,24,0
2020-12-23,Siskiyou,093,43540,978,891,85,976,2
2020-12-23,Solano,095,438530,18389,16626,179,16805,95
2020-12-23,Sonoma,097,501317,18612,17397,101,17498,182
2020-12-23,Stanislaus,099,539301,33773,31492,2925,34417,499
2020-12-23,Sutter,101,95872,6266,5871,41,5912,46
2020-12-23,Tehama,103,63373,2941,2737,250,2987,9
2020-12-23,Trinity,105,12862,407,234,53,287,2
2020-12-23,Tulare,107,460477,32921,30315,3390,33705,385
2020-12-23,Tuolumne,109,53932,2717,2540,14,2554,12
2020-12-23,Ventura,111,848112,37747,33377,1475,34852,216
2020-12-23,Yolo,113,214977,8265,7508,54,7562,112
2020-12-23,Yuba,115,75493,3686,3438,34,3472,14
2020-12-22,Alameda,001,1643700,49548,45751,805,46556,534
2020-12-22,Alpine,003,1148,66,64,0,64,0
2020-12-22,Amador,005,37829,2301,1839,17,1856,23
2020-12-22,Butte,007,227075,7211,6467,785,7252,85
2020-12-22,Calaveras,009,45235,1061,988,0,988,21
2020-12-22,Colusa,011,21464,1238,1150,64,1214,7
2020-12-22,Contra Costa,013,1133247,38423,35681,461,36142,301
2020-12-22,Del Norte,015,27424,727,666,2,668,2
2020-12-22,El Dorado,017,186661,5788,4885,249,5134,12
2020-12-22,Fresno,019,978130,65125,59640,4028,63668,640
2020-12-22,Glenn,021,27897,1477,1337,211,1548,9
2020-12-22,Humboldt,023,135768,1608,1440,7,1447,16
2020-12-22,Imperial,025,180216,22334,21128,1045,22173,398
2020-12-22,Inyo,027,18085,621,506,7,513,17
2020-12-22,Kern,029,883053,62978,57816,4285,62101,547
2020-12-22,Kings,031,150075,15881,14855,468,15323,102
2020-12-22,Lake,033,64148,1809,1569,0,1569,20
2020-12-22,Lassen,035,31185,4170,3848,39,3887,1
2020-12-22,Los Angeles,037,10098052,714035,635931,17701,653632,9013
2020-12-22,Madera,039,155013,10195,9187,365,9552,63
2020-12-22,Marin,041,260295,9560,9115,64,9179,142
2020-12-22,Mariposa,043,17540,215,194,2,196,3
2020-12-22,Mendocino,045,87422,2297,2092,19,2111,23
2020-12-22,Merced,047,269075,18073,17012,289,17301,201
2020-12-22,Modoc,049,8938,231,182,66,248,0
2020-12-22,Mono,051,14174,860,786,12,798,3
2020-12-22,Monterey,053,433212,26041,24152,614,24766,176
2020-12-22,Napa,055,140530,5545,5059,25,5084,23
2020-12-22,Nevada,057,99092,2589,2367,84,2451,14
2020-12-22,Orange,059,3164182,149985,134850,5479,140329,1774
2020-12-22,Placer,061,380077,13564,11943,474,12417,105
2020-12-22,Plumas,063,18699,444,360,8,368,0
2020-12-22,Riverside,065,2383286,172361,155059,7180,162239,1777
2020-12-22,Sacramento,067,1510023,62296,57966,523,58489,772
2020-12-22,San Benito,069,59416,3348,2998,25,3023,24
2020-12-22,San Bernardino,071,2135413,187426,169266,4922,174188,1500
2020-12-22,San Diego,073,3302833,147929,132097,6548,138645,1311
2020-12-22,San Francisco,075,870044,22502,21232,189,21421,174
2020-12-22,San Joaquin,077,732212,43522,39423,1339,40762,592
2020-12-22,San Luis Obispo,079,281455,10259,9174,221,9395,69
2020-12-22,San Mateo,081,765935,23950,21382,79,21461,186
2020-12-22,Santa Barbara,083,443738,16500,15189,414,15603,150
2020-12-22,Santa Clara,085,1922200,66220,59192,258,59450,569
2020-12-22,Santa Cruz,087,273765,8657,7471,251,7722,72
2020-12-22,Shasta,089,179085,7837,7371,615,7986,64
2020-12-22,Sierra,091,2930,27,23,0,23,0
2020-12-22,Siskiyou,093,43540,972,880,84,964,2
2020-12-22,Solano,095,438530,17987,16229,176,16405,95
2020-12-22,Sonoma,097,501317,18291,17216,101,17317,180
2020-12-22,Stanislaus,099,539301,33389,30914,2851,33765,499
2020-12-22,Sutter,101,95872,6207,5791,40,5831,46
2020-12-22,Tehama,103,63373,2892,2688,244,2932,9
2020-12-22,Trinity,105,12862,406,231,53,284,2
2020-12-22,Tulare,107,460477,32455,30025,3326,33351,377
2020-12-22,Tuolumne,109,53932,2666,2526,14,2540,12
2020-12-22,Ventura,111,848112,36981,32488,1432,33920,213
2020-12-22,Yolo,113,214977,8153,7388,53,7441,113
2020-12-22,Yuba,115,75493,3638,3379,34,3413,14
2020-12-21,Alameda,001,1643700,48646,44756,779,45535,518
2020-12-21,Alpine,003,1148,65,64,0,64,0
2020-12-21,Amador,005,37829,2224,1815,17,1832,23
2020-12-21,Butte,007,227075,7056,6335,762,7097,81
2020-12-21,Calaveras,009,45235,1031,963,0,963,21
2020-12-21,Colusa,011,21464,1211,1135,59,1194,7
2020-12-21,Contra Costa,013,1133247,37674,35207,425,35632,300
2020-12-21,Del Norte,015,27424,712,660,2,662,2
2020-12-21,El Dorado,017,186661,5643,4805,237,5042,10
2020-12-21,Fresno,019,978130,63975,58568,3887,62455,634
2020-12-21,Glenn,021,27897,1445,1323,203,1526,9
2020-12-21,Humboldt,023,135768,1585,1419,7,1426,16
2020-12-21,Imperial,025,180216,22068,20994,1004,21998,395
2020-12-21,Inyo,027,18085,600,482,7,489,17
2020-12-21,Kern,029,883053,62089,56836,4151,60987,541
2020-12-21,Kings,031,150075,15631,14760,453,15213,100
2020-12-21,Lake,033,64148,1761,1538,0,1538,20
2020-12-21,Lassen,035,31185,4010,3798,37,3835,1
2020-12-21,Los Angeles,037,10098052,694937,624129,17038,641167,8918
2020-12-21,Madera,039,155013,10005,9069,344,9413,63
2020-12-21,Marin,041,260295,9490,9035,64,9099,142
2020-12-21,Mariposa,043,17540,210,186,2,188,3
2020-12-21,Mendocino,045,87422,2266,2066,19,2085,23
2020-12-21,Merced,047,269075,17823,16710,274,16984,198
2020-12-21,Modoc,049,8938,217,181,65,246,0
2020-12-21,Mono,051,14174,848,781,12,793,3
2020-12-21,Monterey,053,433212,25509,23673,600,24273,174
2020-12-21,Napa,055,140530,5459,4952,25,4977,23
2020-12-21,Nevada,057,99092,2556,2337,84,2421,13
2020-12-21,Orange,059,3164182,146582,130444,5327,135771,1772
2020-12-21,Placer,061,380077,13332,11715,455,12170,105
2020-12-21,Plumas,063,18699,440,353,8,361,0
2020-12-21,Riverside,065,2383286,168140,151713,6861,158574,1743
2020-12-21,Sacramento,067,1510023,61277,57064,506,57570,759
2020-12-21,San Benito,069,59416,3279,2921,25,2946,22
2020-12-21,San Bernardino,071,2135413,182613,165086,4756,169842,1476
2020-12-21,San Diego,073,3302833,144478,129716,6384,136100,1284
2020-12-21,San Francisco,075,870044,22210,21086,187,21273,174
2020-12-21,San Joaquin,077,732212,42724,38811,1289,40100,586
2020-12-21,San Luis Obispo,079,281455,10070,9006,216,9222,64
2020-12-21,San Mateo,081,765935,23546,21035,76,21111,185
2020-12-21,Santa Barbara,083,443738,16226,14988,409,15397,149
2020-12-21,Santa Clara,085,1922200,65027,57699,246,57945,570
2020-12-21,Santa Cruz,087,273765,8450,7315,238,7553,69
2020-12-21,Shasta,089,179085,7772,7299,605,7904,64
2020-12-21,Sierra,091,2930,24,23,0,23,0
2020-12-21,Siskiyou,093,43540,965,878,83,961,2
2020-12-21,Solano,095,438530,17528,15878,171,16049,95
2020-12-21,Sonoma,097,501317,18018,17075,98,17173,176
2020-12-21,Stanislaus,099,539301,32932,30437,2775,33212,499
2020-12-21,Sutter,101,95872,6112,5708,40,5748,46
2020-12-21,Tehama,103,63373,2827,2656,235,2891,9
2020-12-21,Trinity,105,12862,404,226,51,277,2
2020-12-21,Tulare,107,460477,31969,29482,3235,32717,373
2020-12-21,Tuolumne,109,53932,2641,2423,12,2435,12
2020-12-21,Ventura,111,848112,35901,31759,1395,33154,212
2020-12-21,Yolo,113,214977,8016,7266,49,7315,109
2020-12-21,Yuba,115,75493,3580,3329,34,3363,14
2020-12-20,Alameda,001,1643700,47763,44004,758,44762,516
2020-12-20,Alpine,003,1148,65,64,0,64,0
2020-12-20,Amador,005,37829,2166,1771,17,1788,23
2020-12-20,Butte,007,227075,6909,6228,726,6954,81
2020-12-20,Calaveras,009,45235,1007,926,0,926,21
2020-12-20,Colusa,011,21464,1183,1121,53,1174,7
2020-12-20,Contra Costa,013,1133247,37073,34798,407,35205,301
2020-12-20,Del Norte,015,27424,690,652,2,654,2
2020-12-20,El Dorado,017,186661,5518,4697,228,4925,10
2020-12-20,Fresno,019,978130,62988,57616,3752,61368,634
2020-12-20,Glenn,021,27897,1436,1295,196,1491,9
2020-12-20,Humboldt,023,135768,1548,1386,6,1392,15
2020-12-20,Imperial,025,180216,21828,20882,902,21784,395
2020-12-20,Inyo,027,18085,584,476,7,483,17
2020-12-20,Kern,029,883053,60991,55983,3997,59980,540
2020-12-20,Kings,031,150075,15411,14629,437,15066,100
2020-12-20,Lake,033,64148,1718,1463,0,1463,20
2020-12-20,Lassen,035,31185,3956,3669,35,3704,1
2020-12-20,Los Angeles,037,10098052,676831,612975,16321,629296,8862
2020-12-20,Madera,039,155013,9795,8871,337,9208,63
2020-12-20,Marin,041,260295,9389,8948,61,9009,142
2020-12-20,Mariposa,043,17540,209,179,2,181,3
2020-12-20,Mendocino,045,87422,2241,2033,19,2052,23
2020-12-20,Merced,047,269075,17506,16435,267,16702,198
2020-12-20,Modoc,049,8938,217,181,63,244,0
2020-12-20,Mono,051,14174,830,774,12,786,3
2020-12-20,Monterey,053,433212,25026,23250,562,23812,173
2020-12-20,Napa,055,140530,5338,4865,24,4889,23
2020-12-20,Nevada,057,99092,2510,2289,78,2367,13
2020-12-20,Orange,059,3164182,143092,128780,5179,133959,1763
2020-12-20,Placer,061,380077,13107,11496,437,11933,105
2020-12-20,Plumas,063,18699,432,347,8,355,0
2020-12-20,Riverside,065,2383286,163935,148714,6574,155288,1742
2020-12-20,Sacramento,067,1510023,60278,56017,486,56503,755
2020-12-20,San Benito,069,59416,3208,2885,24,2909,21
2020-12-20,San Bernardino,071,2135413,177605,162810,4599,167409,1458
2020-12-20,San Diego,073,3302833,140760,126465,6214,132679,1280
2020-12-20,San Francisco,075,870044,21892,20937,184,21121,174
2020-12-20,San Joaquin,077,732212,41876,38268,1229,39497,587
2020-12-20,San Luis Obispo,079,281455,9779,8881,210,9091,63
2020-12-20,San Mateo,081,765935,23112,20764,72,20836,185
2020-12-20,Santa Barbara,083,443738,15904,14817,391,15208,148
2020-12-20,Santa Clara,085,1922200,63630,56860,240,57100,566
2020-12-20,Santa Cruz,087,273765,8240,7178,225,7403,69
2020-12-20,Shasta,089,179085,7658,7256,591,7847,64
2020-12-20,Sierra,091,2930,24,22,0,22,0
2020-12-20,Siskiyou,093,43540,956,870,82,952,2
2020-12-20,Solano,095,438530,17145,15533,160,15693,95
2020-12-20,Sonoma,097,501317,17742,16802,97,16899,175
2020-12-20,Stanislaus,099,539301,32401,29995,2676,32671,498
2020-12-20,Sutter,101,95872,6025,5601,40,5641,43
2020-12-20,Tehama,103,63373,2779,2602,216,2818,9
2020-12-20,Trinity,105,12862,396,221,50,271,2
2020-12-20,Tulare,107,460477,31452,29078,3143,32221,373
2020-12-20,Tuolumne,109,53932,2533,2152,11,2163,12
2020-12-20,Ventura,111,848112,35200,31335,1363,32698,210
2020-12-20,Yolo,113,214977,7864,7121,46,7167,109
2020-12-20,Yuba,115,75493,3530,3254,32,3286,12
2020-12-19,Alameda,001,1643700,47315,43109,751,43860,516
2020-12-19,Alpine,003,1148,65,64,0,64,0
2020-12-19,Amador,005,37829,2142,1754,17,1771,23
2020-12-19,Butte,007,227075,6809,6118,704,6822,81
2020-12-19,Calaveras,009,45235,990,900,0,900,21
2020-12-19,Colusa,011,21464,1175,1096,50,1146,7
2020-12-19,Contra Costa,013,1133247,36745,34321,393,34714,301
2020-12-19,Del Norte,015,27424,688,641,1,642,2
2020-12-19,El Dorado,017,186661,5451,4588,220,4808,10
2020-12-19,Fresno,019,978130,62662,55428,3686,59114,634
2020-12-19,Glenn,021,27897,1401,1286,195,1481,9
2020-12-19,Humboldt,023,135768,1531,1357,6,1363,15
2020-12-19,Imperial,025,180216,21735,20711,856,21567,395
2020-12-19,Inyo,027,18085,577,475,7,482,17
2020-12-19,Kern,029,883053,60507,55118,3891,59009,540
2020-12-19,Kings,031,150075,15332,14474,435,14909,100
2020-12-19,Lake,033,64148,1678,1438,0,1438,20
2020-12-19,Lassen,035,31185,3928,3595,35,3630,1
2020-12-19,Los Angeles,037,10098052,669706,599888,15800,615688,8804
2020-12-19,Madera,039,155013,9694,8717,325,9042,63
2020-12-19,Marin,041,260295,9349,8864,61,8925,142
2020-12-19,Mariposa,043,17540,207,177,2,179,3
2020-12-19,Mendocino,045,87422,2216,2008,19,2027,23
2020-12-19,Merced,047,269075,17367,16230,259,16489,198
2020-12-19,Modoc,049,8938,214,181,63,244,0
2020-12-19,Mono,051,14174,823,766,12,778,3
2020-12-19,Monterey,053,433212,24912,22799,557,23356,172
2020-12-19,Napa,055,140530,5276,4772,24,4796,23
2020-12-19,Nevada,057,99092,2488,2260,78,2338,13
2020-12-19,Orange,059,3164182,141165,125574,5031,130605,1733
2020-12-19,Placer,061,380077,12952,11246,431,11677,105
2020-12-19,Plumas,063,18699,429,343,8,351,0
2020-12-19,Riverside,065,2383286,161947,146703,6343,153046,1737
2020-12-19,Sacramento,067,1510023,59743,55169,472,55641,746
2020-12-19,San Benito,069,59416,3160,2820,23,2843,21
2020-12-19,San Bernardino,071,2135413,176021,159883,4491,164374,1433
2020-12-19,San Diego,073,3302833,138993,122972,6075,129047,1280
2020-12-19,San Francisco,075,870044,21737,20643,184,20827,174
2020-12-19,San Joaquin,077,732212,41472,37340,1181,38521,586
2020-12-19,San Luis Obispo,079,281455,9708,8788,207,8995,63
2020-12-19,San Mateo,081,765935,22903,20393,65,20458,182
2020-12-19,Santa Barbara,083,443738,15748,14667,385,15052,148
2020-12-19,Santa Clara,085,1922200,62780,55540,236,55776,558
2020-12-19,Santa Cruz,087,273765,8134,7054,221,7275,68
2020-12-19,Shasta,089,179085,7606,7221,579,7800,63
2020-12-19,Sierra,091,2930,24,23,0,23,0
2020-12-19,Siskiyou,093,43540,952,853,81,934,2
2020-12-19,Solano,095,438530,16967,15204,157,15361,95
2020-12-19,Sonoma,097,501317,17633,16553,97,16650,175
2020-12-19,Stanislaus,099,539301,32074,29555,2604,32159,498
2020-12-19,Sutter,101,95872,5969,5506,40,5546,41
2020-12-19,Tehama,103,63373,2730,2574,214,2788,9
2020-12-19,Trinity,105,12862,395,219,50,269,2
2020-12-19,Tulare,107,460477,31214,28734,3077,31811,375
2020-12-19,Tuolumne,109,53932,2519,2107,11,2118,12
2020-12-19,Ventura,111,848112,34919,30843,1333,32176,209
2020-12-19,Yolo,113,214977,7789,7025,45,7070,109
2020-12-19,Yuba,115,75493,3500,3168,32,3200,11
2020-12-18,Alameda,001,1643700,46780,42196,735,42931,515
2020-12-18,Alpine,003,1148,65,64,0,64,0
2020-12-18,Amador,005,37829,2125,1727,15,1742,20
2020-12-18,Butte,007,227075,6724,5891,679,6570,81
2020-12-18,Calaveras,009,45235,980,870,0,870,21
2020-12-18,Colusa,011,21464,1166,1068,50,1118,7
2020-12-18,Contra Costa,013,1133247,36453,33610,382,33992,300
2020-12-18,Del Norte,015,27424,683,627,0,627,2
2020-12-18,El Dorado,017,186661,5389,4494,211,4705,10
2020-12-18,Fresno,019,978130,61835,52643,3625,56268,613
2020-12-18,Glenn,021,27897,1384,1264,190,1454,9
2020-12-18,Humboldt,023,135768,1516,1331,6,1337,15
2020-12-18,Imperial,025,180216,21652,20430,810,21240,393
2020-12-18,Inyo,027,18085,558,454,7,461,17
2020-12-18,Kern,029,883053,59847,54220,3806,58026,533
2020-12-18,Kings,031,150075,15206,14284,429,14713,98
2020-12-18,Lake,033,64148,1662,1397,0,1397,20
2020-12-18,Lassen,035,31185,3920,3486,35,3521,1
2020-12-18,Los Angeles,037,10098052,657559,586413,15320,601733,8744
2020-12-18,Madera,039,155013,9591,8609,319,8928,63
2020-12-18,Marin,041,260295,9265,8799,61,8860,142
2020-12-18,Mariposa,043,17540,204,176,2,178,3
2020-12-18,Mendocino,045,87422,2198,1977,19,1996,24
2020-12-18,Merced,047,269075,17286,15956,257,16213,195
2020-12-18,Modoc,049,8938,214,179,63,242,0
2020-12-18,Mono,051,14174,815,731,12,743,3
2020-12-18,Monterey,053,433212,24619,22336,552,22888,165
2020-12-18,Napa,055,140530,5227,4688,24,4712,23
2020-12-18,Nevada,057,99092,2471,2220,77,2297,13
2020-12-18,Orange,059,3164182,138734,121681,4882,126563,1725
2020-12-18,Placer,061,380077,12781,10995,423,11418,104
2020-12-18,Plumas,063,18699,423,336,8,344,0
2020-12-18,Riverside,065,2383286,159105,142375,6081,148456,1733
2020-12-18,Sacramento,067,1510023,59117,53980,456,54436,736
2020-12-18,San Benito,069,59416,3111,2744,23,2767,21
2020-12-18,San Bernardino,071,2135413,173722,154272,4356,158628,1430
2020-12-18,San Diego,073,3302833,136815,120463,5936,126399,1253
2020-12-18,San Francisco,075,870044,21570,20315,178,20493,173
2020-12-18,San Joaquin,077,732212,41115,36484,1152,37636,559
2020-12-18,San Luis Obispo,079,281455,9610,8598,202,8800,62
2020-12-18,San Mateo,081,765935,22590,19971,61,20032,182
2020-12-18,Santa Barbara,083,443738,15607,14361,372,14733,148
2020-12-18,Santa Clara,085,1922200,61883,53992,227,54219,539
2020-12-18,Santa Cruz,087,273765,8015,6838,213,7051,68
2020-12-18,Shasta,089,179085,7568,7114,568,7682,62
2020-12-18,Sierra,091,2930,24,23,0,23,0
2020-12-18,Siskiyou,093,43540,950,840,81,921,2
2020-12-18,Solano,095,438530,16810,14667,153,14820,95
2020-12-18,Sonoma,097,501317,17513,16261,97,16358,173
2020-12-18,Stanislaus,099,539301,31798,28967,2567,31534,490
2020-12-18,Sutter,101,95872,5885,5399,40,5439,39
2020-12-18,Tehama,103,63373,2715,2523,204,2727,9
2020-12-18,Trinity,105,12862,394,215,50,265,2
2020-12-18,Tulare,107,460477,30923,28322,2999,31321,370
2020-12-18,Tuolumne,109,53932,2508,2067,11,2078,12
2020-12-18,Ventura,111,848112,34415,29907,1290,31197,209
2020-12-18,Yolo,113,214977,7720,6901,44,6945,109
2020-12-18,Yuba,115,75493,3440,3097,32,3129,11
2020-12-17,Alameda,001,1643700,45975,41548,710,42258,508
2020-12-17,Alpine,003,1148,65,64,0,64,0
2020-12-17,Amador,005,37829,2077,1703,13,1716,19
2020-12-17,Butte,007,227075,6599,5746,660,6406,78
2020-12-17,Calaveras,009,45235,957,848,0,848,21
2020-12-17,Colusa,011,21464,1155,1053,48,1101,7
2020-12-17,Contra Costa,013,1133247,35920,33006,352,33358,293
2020-12-17,Del Norte,015,27424,678,583,0,583,1
2020-12-17,El Dorado,017,186661,5243,4327,198,4525,9
2020-12-17,Fresno,019,978130,60973,49918,3498,53416,597
2020-12-17,Glenn,021,27897,1360,1244,183,1427,9
2020-12-17,Humboldt,023,135768,1483,1322,6,1328,14
2020-12-17,Imperial,025,180216,21491,20208,745,20953,391
2020-12-17,Inyo,027,18085,540,450,6,456,16
2020-12-17,Kern,029,883053,58890,53683,3671,57354,526
2020-12-17,Kings,031,150075,15103,14057,414,14471,98
2020-12-17,Lake,033,64148,1633,1374,0,1374,20
2020-12-17,Lassen,035,31185,3884,3417,35,3452,1
2020-12-17,Los Angeles,037,10098052,641880,571093,14784,585877,8657
2020-12-17,Madera,039,155013,9470,8465,315,8780,62
2020-12-17,Marin,041,260295,9203,8721,59,8780,142
2020-12-17,Mariposa,043,17540,200,172,2,174,3
2020-12-17,Mendocino,045,87422,2164,1942,19,1961,23
2020-12-17,Merced,047,269075,17024,15648,249,15897,192
2020-12-17,Modoc,049,8938,211,179,63,242,0
2020-12-17,Mono,051,14174,801,718,12,730,3
2020-12-17,Monterey,053,433212,24100,21951,537,22488,163
2020-12-17,Napa,055,140530,5115,4612,24,4636,23
2020-12-17,Nevada,057,99092,2430,2173,74,2247,13
2020-12-17,Orange,059,3164182,135367,118367,4750,123117,1725
2020-12-17,Placer,061,380077,12507,10756,409,11165,99
2020-12-17,Plumas,063,18699,414,324,8,332,0
2020-12-17,Riverside,065,2383286,155232,139325,5867,145192,1696
2020-12-17,Sacramento,067,1510023,58210,53189,434,53623,721
2020-12-17,San Benito,069,59416,3042,2645,22,2667,20
2020-12-17,San Bernardino,071,2135413,169777,149838,4240,154078,1425
2020-12-17,San Diego,073,3302833,134014,116852,5780,122632,1239
2020-12-17,San Francisco,075,870044,21280,19939,173,20112,170
2020-12-17,San Joaquin,077,732212,40387,35894,1118,37012,554
2020-12-17,San Luis Obispo,079,281455,9491,8365,201,8566,59
2020-12-17,San Mateo,081,765935,22220,19647,61,19708,181
2020-12-17,Santa Barbara,083,443738,15374,14207,365,14572,147
2020-12-17,Santa Clara,085,1922200,60693,52559,221,52780,527
2020-12-17,Santa Cruz,087,273765,7859,6687,200,6887,64
2020-12-17,Shasta,089,179085,7492,7000,549,7549,62
2020-12-17,Sierra,091,2930,23,23,0,23,0
2020-12-17,Siskiyou,093,43540,942,827,80,907,2
2020-12-17,Solano,095,438530,16496,14361,150,14511,96
2020-12-17,Sonoma,097,501317,17241,15993,96,16089,171
2020-12-17,Stanislaus,099,539301,31379,28582,2507,31089,489
2020-12-17,Sutter,101,95872,5787,5309,38,5347,39
2020-12-17,Tehama,103,63373,2666,2480,198,2678,9
2020-12-17,Trinity,105,12862,389,213,50,263,2
2020-12-17,Tulare,107,460477,30522,27852,2920,30772,358
2020-12-17,Tuolumne,109,53932,2215,1992,11,2003,11
2020-12-17,Ventura,111,848112,33805,29404,1254,30658,208
2020-12-17,Yolo,113,214977,7599,6800,43,6843,105
2020-12-17,Yuba,115,75493,3380,3035,31,3066,12
2020-12-16,Alameda,001,1643700,45119,40751,686,41437,497
2020-12-16,Alpine,003,1148,65,64,0,64,0
2020-12-16,Amador,005,37829,2030,1693,12,1705,19
2020-12-16,Butte,007,227075,6410,5659,632,6291,76
2020-12-16,Calaveras,009,45235,922,821,0,821,21
2020-12-16,Colusa,011,21464,1142,1038,45,1083,7
2020-12-16,Contra Costa,013,1133247,35362,32429,333,32762,293
2020-12-16,Del Norte,015,27424,676,575,0,575,1
2020-12-16,El Dorado,017,186661,5122,4237,189,4426,9
2020-12-16,Fresno,019,978130,60017,49173,3402,52575,584
2020-12-16,Glenn,021,27897,1342,1236,172,1408,9
2020-12-16,Humboldt,023,135768,1451,1308,5,1313,12
2020-12-16,Imperial,025,180216,21309,19980,681,20661,388
2020-12-16,Inyo,027,18085,527,444,6,450,16
2020-12-16,Kern,029,883053,58013,52896,3542,56438,522
2020-12-16,Kings,031,150075,14923,13734,398,14132,99
2020-12-16,Lake,033,64148,1594,1363,0,1363,20
2020-12-16,Lassen,035,31185,3851,3396,34,3430,1
2020-12-16,Los Angeles,037,10098052,625341,557907,14119,572026,8561
2020-12-16,Madera,039,155013,9344,8278,307,8585,62
2020-12-16,Marin,041,260295,9132,8641,59,8700,142
2020-12-16,Mariposa,043,17540,197,175,2,177,3
2020-12-16,Mendocino,045,87422,2129,1929,19,1948,23
2020-12-16,Merced,047,269075,16739,15443,246,15689,190
2020-12-16,Modoc,049,8938,208,178,63,241,0
2020-12-16,Mono,051,14174,782,702,12,714,3
2020-12-16,Monterey,053,433212,23540,21107,526,21633,163
2020-12-16,Napa,055,140530,5017,4544,24,4568,23
2020-12-16,Nevada,057,99092,2394,2149,72,2221,13
2020-12-16,Orange,059,3164182,131886,115260,4585,119845,1712
2020-12-16,Placer,061,380077,12270,10554,388,10942,96
2020-12-16,Plumas,063,18699,405,319,8,327,0
2020-12-16,Riverside,065,2383286,151116,135751,5622,141373,1664
2020-12-16,Sacramento,067,1510023,57238,52166,409,52575,715
2020-12-16,San Benito,069,59416,2952,2582,22,2604,20
2020-12-16,San Bernardino,071,2135413,165170,143565,4106,147671,1403
2020-12-16,San Diego,073,3302833,130909,114248,5626,119874,1217
2020-12-16,San Francisco,075,870044,21021,19624,173,19797,170
2020-12-16,San Joaquin,077,732212,39564,35010,1078,36088,547
2020-12-16,San Luis Obispo,079,281455,9296,8252,192,8444,58
2020-12-16,San Mateo,081,765935,21895,19292,57,19349,179
2020-12-16,Santa Barbara,083,443738,15122,13966,353,14319,144
2020-12-16,Santa Clara,085,1922200,59441,51502,218,51720,523
2020-12-16,Santa Cruz,087,273765,7671,6536,189,6725,63
2020-12-16,Shasta,089,179085,7419,6914,526,7440,62
2020-12-16,Sierra,091,2930,23,23,0,23,0
2020-12-16,Siskiyou,093,43540,934,818,80,898,2
2020-12-16,Solano,095,438530,16025,14157,146,14303,96
2020-12-16,Sonoma,097,501317,16986,15768,96,15864,170
2020-12-16,Stanislaus,099,539301,30886,28279,2436,30715,489
2020-12-16,Sutter,101,95872,5708,5223,38,5261,39
2020-12-16,Tehama,103,63373,2631,2441,174,2615,9
2020-12-16,Trinity,105,12862,383,212,50,262,2
2020-12-16,Tulare,107,460477,30095,27500,2830,30330,352
2020-12-16,Tuolumne,109,53932,2172,1941,11,1952,11
2020-12-16,Ventura,111,848112,33032,28566,1212,29778,203
2020-12-16,Yolo,113,214977,7472,6649,42,6691,103
2020-12-16,Yuba,115,75493,3294,2980,30,3010,11
2020-12-15,Alameda,001,1643700,44262,40026,665,40691,492
2020-12-15,Alpine,003,1148,65,64,0,64,0
2020-12-15,Amador,005,37829,1917,1669,10,1679,19
2020-12-15,Butte,007,227075,6271,5565,604,6169,75
2020-12-15,Calaveras,009,45235,890,799,0,799,21
2020-12-15,Colusa,011,21464,1129,1026,44,1070,7
2020-12-15,Contra Costa,013,1133247,34708,31423,319,31742,281
2020-12-15,Del Norte,015,27424,669,564,0,564,1
2020-12-15,El Dorado,017,186661,5014,4113,175,4288,9
2020-12-15,Fresno,019,978130,58644,47316,3268,50584,574
2020-12-15,Glenn,021,27897,1329,1207,156,1363,9
2020-12-15,Humboldt,023,135768,1431,1276,5,1281,12
2020-12-15,Imperial,025,180216,21084,19756,603,20359,380
2020-12-15,Inyo,027,18085,515,394,6,400,16
2020-12-15,Kern,029,883053,57002,52002,3436,55438,511
2020-12-15,Kings,031,150075,14759,13652,379,14031,97
2020-12-15,Lake,033,64148,1568,1341,0,1341,21
2020-12-15,Lassen,035,31185,3679,3378,33,3411,1
2020-12-15,Los Angeles,037,10098052,608938,536258,13492,549750,8429
2020-12-15,Madera,039,155013,9187,8118,300,8418,60
2020-12-15,Marin,041,260295,9027,8528,58,8586,141
2020-12-15,Mariposa,043,17540,193,171,2,173,3
2020-12-15,Mendocino,045,87422,2102,1883,19,1902,24
2020-12-15,Merced,047,269075,16443,15120,242,15362,190
2020-12-15,Modoc,049,8938,206,179,63,242,0
2020-12-15,Mono,051,14174,766,702,12,714,3
2020-12-15,Monterey,053,433212,22943,19905,465,20370,161
2020-12-15,Napa,055,140530,4914,4440,24,4464,23
2020-12-15,Nevada,057,99092,2361,2117,70,2187,11
2020-12-15,Orange,059,3164182,128255,112893,4436,117329,1689
2020-12-15,Placer,061,380077,12036,10301,366,10667,95
2020-12-15,Plumas,063,18699,400,313,8,321,0
2020-12-15,Riverside,065,2383286,147064,131822,5347,137169,1624
2020-12-15,Sacramento,067,1510023,56220,51076,396,51472,703
2020-12-15,San Benito,069,59416,2873,2520,21,2541,19
2020-12-15,San Bernardino,071,2135413,160707,137548,3957,141505,1351
2020-12-15,San Diego,073,3302833,127342,111441,5463,116904,1194
2020-12-15,San Francisco,075,870044,20714,19283,170,19453,171
2020-12-15,San Joaquin,077,732212,38642,33849,1044,34893,537
2020-12-15,San Luis Obispo,079,281455,9187,8074,189,8263,55
2020-12-15,San Mateo,081,765935,21486,18907,55,18962,178
2020-12-15,Santa Barbara,083,443738,14895,13782,345,14127,144
2020-12-15,Santa Clara,085,1922200,58013,50311,215,50526,505
2020-12-15,Santa Cruz,087,273765,7484,6361,176,6537,59
2020-12-15,Shasta,089,179085,7360,6794,501,7295,54
2020-12-15,Sierra,091,2930,23,23,0,23,0
2020-12-15,Siskiyou,093,43540,926,812,79,891,2
2020-12-15,Solano,095,438530,15671,13796,146,13942,95
2020-12-15,Sonoma,097,501317,16765,15406,96,15502,167
2020-12-15,Stanislaus,099,539301,30389,27823,2357,30180,485
2020-12-15,Sutter,101,95872,5609,5080,37,5117,36
2020-12-15,Tehama,103,63373,2593,2392,168,2560,9
2020-12-15,Trinity,105,12862,375,213,48,261,1
2020-12-15,Tulare,107,460477,29596,27026,2742,29768,342
2020-12-15,Tuolumne,109,53932,2142,1874,11,1885,8
2020-12-15,Ventura,111,848112,32410,27936,1165,29101,201
2020-12-15,Yolo,113,214977,7347,6531,40,6571,104
2020-12-15,Yuba,115,75493,3199,2891,29,2920,11
2020-12-14,Alameda,001,1643700,43363,39252,646,39898,487
2020-12-14,Alpine,003,1148,65,63,0,63,0
2020-12-14,Amador,005,37829,1845,1609,10,1619,19
2020-12-14,Butte,007,227075,6103,5202,587,5789,75
2020-12-14,Calaveras,009,45235,852,718,0,718,21
2020-12-14,Colusa,011,21464,1105,949,43,992,7
2020-12-14,Contra Costa,013,1133247,34017,30594,305,30899,281
2020-12-14,Del Norte,015,27424,663,560,0,560,1
2020-12-14,El Dorado,017,186661,4858,4018,159,4177,9
2020-12-14,Fresno,019,978130,57619,44726,3094,47820,560
2020-12-14,Glenn,021,27897,1303,1186,148,1334,9
2020-12-14,Humboldt,023,135768,1418,1256,5,1261,9
2020-12-14,Imperial,025,180216,20845,19608,529,20137,379
2020-12-14,Inyo,027,18085,502,382,6,388,16
2020-12-14,Kern,029,883053,55965,50538,3315,53853,510
2020-12-14,Kings,031,150075,14574,13491,352,13843,97
2020-12-14,Lake,033,64148,1517,1301,0,1301,21
2020-12-14,Lassen,035,31185,3581,2905,30,2935,1
2020-12-14,Los Angeles,037,10098052,591292,524668,12869,537537,8340
2020-12-14,Madera,039,155013,8923,8011,291,8302,60
2020-12-14,Marin,041,260295,8942,8475,57,8532,141
2020-12-14,Mariposa,043,17540,192,171,2,173,3
2020-12-14,Mendocino,045,87422,2081,1845,19,1864,24
2020-12-14,Merced,047,269075,16038,14572,228,14800,189
2020-12-14,Modoc,049,8938,200,180,61,241,0
2020-12-14,Mono,051,14174,758,685,12,697,3
2020-12-14,Monterey,053,433212,22420,19154,459,19613,155
2020-12-14,Napa,055,140530,4821,4289,24,4313,22
2020-12-14,Nevada,057,99092,2324,2070,67,2137,11
2020-12-14,Orange,059,3164182,124374,108602,4300,112902,1688
2020-12-14,Placer,061,380077,11755,9551,355,9906,95
2020-12-14,Plumas,063,18699,388,309,8,317,0
2020-12-14,Riverside,065,2383286,142942,123715,5085,128800,1588
2020-12-14,Sacramento,067,1510023,55113,50304,371,50675,691
2020-12-14,San Benito,069,59416,2807,2467,20,2487,19
2020-12-14,San Bernardino,071,2135413,156258,129151,3831,132982,1347
2020-12-14,San Diego,073,3302833,123606,109578,5278,114856,1162
2020-12-14,San Francisco,075,870044,20344,18904,168,19072,171
2020-12-14,San Joaquin,077,732212,37807,32522,998,33520,534
2020-12-14,San Luis Obispo,079,281455,8942,7791,185,7976,52
2020-12-14,San Mateo,081,765935,20989,18361,52,18413,178
2020-12-14,Santa Barbara,083,443738,14623,13587,337,13924,144
2020-12-14,Santa Clara,085,1922200,56500,49180,204,49384,502
2020-12-14,Santa Cruz,087,273765,7302,6049,161,6210,54
2020-12-14,Shasta,089,179085,7271,6665,483,7148,54
2020-12-14,Sierra,091,2930,23,21,0,21,0
2020-12-14,Siskiyou,093,43540,903,764,73,837,2
2020-12-14,Solano,095,438530,15316,13352,145,13497,93
2020-12-14,Sonoma,097,501317,16458,14807,95,14902,167
2020-12-14,Stanislaus,099,539301,29861,27311,2311,29622,485
2020-12-14,Sutter,101,95872,5506,5001,30,5031,35
2020-12-14,Tehama,103,63373,2551,2344,165,2509,9
2020-12-14,Trinity,105,12862,371,205,46,251,1
2020-12-14,Tulare,107,460477,29117,25735,2653,28388,341
2020-12-14,Tuolumne,109,53932,2089,1647,11,1658,8
2020-12-14,Ventura,111,848112,31487,27436,1107,28543,202
2020-12-14,Yolo,113,214977,7189,6389,39,6428,95
2020-12-14,Yuba,115,75493,3136,2851,29,2880,11
2020-12-13,Alameda,001,1643700,42162,38064,622,38686,486
2020-12-13,Alpine,003,1148,65,63,0,63,0
2020-12-13,Amador,005,37829,1789,1457,9,1466,19
2020-12-13,Butte,007,227075,5954,5103,549,5652,75
2020-12-13,Calaveras,009,45235,818,710,0,710,21
2020-12-13,Colusa,011,21464,1089,945,40,985,7
2020-12-13,Contra Costa,013,1133247,33290,29667,299,29966,281
2020-12-13,Del Norte,015,27424,611,542,0,542,1
2020-12-13,El Dorado,017,186661,4757,3770,150,3920,9
2020-12-13,Fresno,019,978130,56513,44114,2940,47054,559
2020-12-13,Glenn,021,27897,1290,1171,137,1308,9
2020-12-13,Humboldt,023,135768,1395,1238,4,1242,9
2020-12-13,Imperial,025,180216,20563,19472,409,19881,379
2020-12-13,Inyo,027,18085,481,380,6,386,16
2020-12-13,Kern,029,883053,54936,49051,3160,52211,510
2020-12-13,Kings,031,150075,14294,13357,334,13691,97
2020-12-13,Lake,033,64148,1476,1271,0,1271,21
2020-12-13,Lassen,035,31185,3474,2867,25,2892,1
2020-12-13,Los Angeles,037,10098052,573651,517472,12187,529659,8294
2020-12-13,Madera,039,155013,8738,7909,278,8187,60
2020-12-13,Marin,041,260295,8821,8409,57,8466,141
2020-12-13,Mariposa,043,17540,188,167,2,169,3
2020-12-13,Mendocino,045,87422,2047,1793,19,1812,24
2020-12-13,Merced,047,269075,15685,14384,225,14609,189
2020-12-13,Modoc,049,8938,190,179,56,235,0
2020-12-13,Mono,051,14174,742,675,12,687,3
2020-12-13,Monterey,053,433212,21999,18913,445,19358,153
2020-12-13,Napa,055,140530,4714,4194,24,4218,22
2020-12-13,Nevada,057,99092,2277,2030,65,2095,11
2020-12-13,Orange,059,3164182,120433,104768,4127,108895,1688
2020-12-13,Placer,061,380077,11441,9405,337,9742,95
2020-12-13,Plumas,063,18699,382,291,8,299,0
2020-12-13,Riverside,065,2383286,138817,119691,4825,124516,1581
2020-12-13,Sacramento,067,1510023,53845,49480,342,49822,682
2020-12-13,San Benito,069,59416,2738,2408,19,2427,19
2020-12-13,San Bernardino,071,2135413,151361,126718,3676,130394,1333
2020-12-13,San Diego,073,3302833,120006,107372,5109,112481,1162
2020-12-13,San Francisco,075,870044,20007,18686,159,18845,167
2020-12-13,San Joaquin,077,732212,37005,32170,958,33128,534
2020-12-13,San Luis Obispo,079,281455,8751,7625,177,7802,52
2020-12-13,San Mateo,081,765935,20498,18090,46,18136,177
2020-12-13,Santa Barbara,083,443738,14354,13249,323,13572,144
2020-12-13,Santa Clara,085,1922200,55094,47920,196,48116,499
2020-12-13,Santa Cruz,087,273765,7055,5986,151,6137,54
2020-12-13,Shasta,089,179085,7196,6647,457,7104,54
2020-12-13,Sierra,091,2930,23,21,0,21,0
2020-12-13,Siskiyou,093,43540,890,762,68,830,2
2020-12-13,Solano,095,438530,14881,13276,142,13418,93
2020-12-13,Sonoma,097,501317,16145,14495,94,14589,167
2020-12-13,Stanislaus,099,539301,29305,26569,2260,28829,485
2020-12-13,Sutter,101,95872,5379,4798,26,4824,34
2020-12-13,Tehama,103,63373,2507,2325,150,2475,9
2020-12-13,Trinity,105,12862,365,204,46,250,1
2020-12-13,Tulare,107,460477,28635,25496,2576,28072,340
2020-12-13,Tuolumne,109,53932,2026,1611,11,1622,8
2020-12-13,Ventura,111,848112,30488,26588,1047,27635,202
2020-12-13,Yolo,113,214977,7003,6265,33,6298,95
2020-12-13,Yuba,115,75493,3073,2754,26,2780,11
2020-12-12,Alameda,001,1643700,41719,37027,603,37630,486
2020-12-12,Alpine,003,1148,65,63,0,63,0
2020-12-12,Amador,005,37829,1761,1236,8,1244,19
2020-12-12,Butte,007,227075,5881,4972,535,5507,73
2020-12-12,Calaveras,009,45235,808,708,0,708,21
2020-12-12,Colusa,011,21464,1069,945,39,984,7
2020-12-12,Contra Costa,013,1133247,32943,29506,290,29796,281
2020-12-12,Del Norte,015,27424,603,529,0,529,1
2020-12-12,El Dorado,017,186661,4682,3706,134,3840,9
2020-12-12,Fresno,019,978130,56161,43756,2881,46637,559
2020-12-12,Glenn,021,27897,1282,1143,133,1276,8
2020-12-12,Humboldt,023,135768,1376,1208,4,1212,9
2020-12-12,Imperial,025,180216,20474,18947,354,19301,379
2020-12-12,Inyo,027,18085,475,380,6,386,16
2020-12-12,Kern,029,883053,54417,48194,3073,51267,507
2020-12-12,Kings,031,150075,14205,13205,330,13535,96
2020-12-12,Lake,033,64148,1460,1232,0,1232,21
2020-12-12,Lassen,035,31185,3451,2866,22,2888,1
2020-12-12,Los Angeles,037,10098052,566834,504317,11699,516016,8269
2020-12-12,Madera,039,155013,8611,7765,275,8040,59
2020-12-12,Marin,041,260295,8765,8363,56,8419,141
2020-12-12,Mariposa,043,17540,187,164,2,166,3
2020-12-12,Mendocino,045,87422,2011,1771,19,1790,24
2020-12-12,Merced,047,269075,15593,14181,221,14402,188
2020-12-12,Modoc,049,8938,189,169,53,222,0
2020-12-12,Mono,051,14174,735,640,12,652,3
2020-12-12,Monterey,053,433212,21886,18596,416,19012,151
2020-12-12,Napa,055,140530,4669,4113,24,4137,22
2020-12-12,Nevada,057,99092,2259,1981,63,2044,10
2020-12-12,Orange,059,3164182,118535,100468,3982,104450,1674
2020-12-12,Placer,061,380077,11276,9390,332,9722,95
2020-12-12,Plumas,063,18699,376,291,8,299,0
2020-12-12,Riverside,065,2383286,136756,118335,4624,122959,1579
2020-12-12,Sacramento,067,1510023,53263,48319,329,48648,673
2020-12-12,San Benito,069,59416,2683,2355,19,2374,19
2020-12-12,San Bernardino,071,2135413,149728,125741,3574,129315,1321
2020-12-12,San Diego,073,3302833,118385,104958,5012,109970,1151
2020-12-12,San Francisco,075,870044,19810,18413,155,18568,167
2020-12-12,San Joaquin,077,732212,36677,32200,928,33128,534
2020-12-12,San Luis Obispo,079,281455,8652,7462,171,7633,50
2020-12-12,San Mateo,081,765935,20277,17574,45,17619,177
2020-12-12,Santa Barbara,083,443738,14202,13174,315,13489,144
2020-12-12,Santa Clara,085,1922200,54159,45892,193,46085,498
2020-12-12,Santa Cruz,087,273765,6957,5905,142,6047,54
2020-12-12,Shasta,089,179085,7163,6551,439,6990,54
2020-12-12,Sierra,091,2930,23,21,0,21,0
2020-12-12,Siskiyou,093,43540,888,762,65,827,2
2020-12-12,Solano,095,438530,14687,12748,135,12883,93
2020-12-12,Sonoma,097,501317,16024,14466,94,14560,166
2020-12-12,Stanislaus,099,539301,29000,26246,2211,28457,483
2020-12-12,Sutter,101,95872,5317,4717,26,4743,32
2020-12-12,Tehama,103,63373,2489,2252,145,2397,9
2020-12-12,Trinity,105,12862,363,204,44,248,1
2020-12-12,Tulare,107,460477,28371,25333,2517,27850,341
2020-12-12,Tuolumne,109,53932,1982,1536,11,1547,8
2020-12-12,Ventura,111,848112,30043,25955,1014,26969,202
2020-12-12,Yolo,113,214977,6920,6116,31,6147,95
2020-12-12,Yuba,115,75493,3046,2692,25,2717,10
2020-12-11,Alameda,001,1643700,41152,36281,591,36872,482
2020-12-11,Alpine,003,1148,65,63,0,63,0
2020-12-11,Amador,005,37829,1745,1213,8,1221,19
2020-12-11,Butte,007,227075,5808,4941,516,5457,73
2020-12-11,Calaveras,009,45235,792,697,0,697,21
2020-12-11,Colusa,011,21464,1059,923,37,960,7
2020-12-11,Contra Costa,013,1133247,32512,29036,287,29323,282
2020-12-11,Del Norte,015,27424,595,505,0,505,1
2020-12-11,El Dorado,017,186661,4601,3669,119,3788,9
2020-12-11,Fresno,019,978130,55149,43071,2815,45886,550
2020-12-11,Glenn,021,27897,1266,1135,129,1264,8
2020-12-11,Humboldt,023,135768,1358,1190,4,1194,9
2020-12-11,Imperial,025,180216,20384,18599,310,18909,377
2020-12-11,Inyo,027,18085,465,372,6,378,16
2020-12-11,Kern,029,883053,53739,47664,3010,50674,502
2020-12-11,Kings,031,150075,14061,13118,326,13444,94
2020-12-11,Lake,033,64148,1443,1205,0,1205,21
2020-12-11,Lassen,035,31185,3439,2790,21,2811,1
2020-12-11,Los Angeles,037,10098052,555026,493592,11294,504886,8198
2020-12-11,Madera,039,155013,8519,7648,265,7913,59
2020-12-11,Marin,041,260295,8676,8317,55,8372,141
2020-12-11,Mariposa,043,17540,186,164,2,166,3
2020-12-11,Mendocino,045,87422,1987,1769,19,1788,24
2020-12-11,Merced,047,269075,15473,14038,213,14251,186
2020-12-11,Modoc,049,8938,189,168,52,220,0
2020-12-11,Mono,051,14174,725,631,12,643,3
2020-12-11,Monterey,053,433212,21585,18421,411,18832,150
2020-12-11,Napa,055,140530,4614,4054,24,4078,22
2020-12-11,Nevada,057,99092,2242,1959,60,2019,10
2020-12-11,Orange,059,3164182,116213,98357,3881,102238,1656
2020-12-11,Placer,061,380077,11114,8904,316,9220,93
2020-12-11,Plumas,063,18699,368,286,8,294,0
2020-12-11,Riverside,065,2383286,133682,115329,4406,119735,1573
2020-12-11,Sacramento,067,1510023,52600,47468,321,47789,669
2020-12-11,San Benito,069,59416,2632,2319,19,2338,19
2020-12-11,San Bernardino,071,2135413,147030,123092,3460,126552,1313
2020-12-11,San Diego,073,3302833,116425,102468,4929,107397,1137
2020-12-11,San Francisco,075,870044,19580,18246,154,18400,165
2020-12-11,San Joaquin,077,732212,36328,32044,901,32945,534
2020-12-11,San Luis Obispo,079,281455,8491,7415,169,7584,49
2020-12-11,San Mateo,081,765935,20007,17240,34,17274,177
2020-12-11,Santa Barbara,083,443738,14059,12997,307,13304,144
2020-12-11,Santa Clara,085,1922200,53152,45101,184,45285,494
2020-12-11,Santa Cruz,087,273765,6837,5764,133,5897,50
2020-12-11,Shasta,089,179085,7118,6459,432,6891,54
2020-12-11,Sierra,091,2930,23,19,0,19,0
2020-12-11,Siskiyou,093,43540,881,753,62,815,2
2020-12-11,Solano,095,438530,14500,12554,131,12685,92
2020-12-11,Sonoma,097,501317,15857,14298,92,14390,166
2020-12-11,Stanislaus,099,539301,28728,25928,2164,28092,464
2020-12-11,Sutter,101,95872,5254,4600,25,4625,30
2020-12-11,Tehama,103,63373,2458,2232,141,2373,9
2020-12-11,Trinity,105,12862,360,204,44,248,1
2020-12-11,Tulare,107,460477,28016,24953,2464,27417,338
2020-12-11,Tuolumne,109,53932,1967,1510,11,1521,8
2020-12-11,Ventura,111,848112,29436,24999,992,25991,202
2020-12-11,Yolo,113,214977,6816,6006,30,6036,95
2020-12-11,Yuba,115,75493,2985,2649,23,2672,10
2020-12-10,Alameda,001,1643700,40381,35686,571,36257,477
2020-12-10,Alpine,003,1148,65,63,0,63,0
2020-12-10,Amador,005,37829,1688,1191,8,1199,18
2020-12-10,Butte,007,227075,5693,4863,492,5355,72
2020-12-10,Calaveras,009,45235,774,684,0,684,21
2020-12-10,Colusa,011,21464,1036,909,34,943,7
2020-12-10,Contra Costa,013,1133247,31834,28413,281,28694,276
2020-12-10,Del Norte,015,27424,584,501,0,501,1
2020-12-10,El Dorado,017,186661,4483,3557,114,3671,9
2020-12-10,Fresno,019,978130,54171,42461,2675,45136,540
2020-12-10,Glenn,021,27897,1246,1126,120,1246,8
2020-12-10,Humboldt,023,135768,1338,1140,4,1144,9
2020-12-10,Imperial,025,180216,20172,18333,235,18568,370
2020-12-10,Inyo,027,18085,445,365,6,371,15
2020-12-10,Kern,029,883053,52758,47176,2847,50023,499
2020-12-10,Kings,031,150075,13903,12993,320,13313,92
2020-12-10,Lake,033,64148,1403,1167,0,1167,21
2020-12-10,Lassen,035,31185,3417,2764,17,2781,0
2020-12-10,Los Angeles,037,10098052,541046,480354,10771,491125,8149
2020-12-10,Madera,039,155013,8411,7445,250,7695,59
2020-12-10,Marin,041,260295,8626,8245,54,8299,140
2020-12-10,Mariposa,043,17540,185,160,2,162,3
2020-12-10,Mendocino,045,87422,1961,1748,16,1764,24
2020-12-10,Merced,047,269075,15227,13756,210,13966,186
2020-12-10,Modoc,049,8938,184,165,50,215,0
2020-12-10,Mono,051,14174,720,601,12,613,3
2020-12-10,Monterey,053,433212,21103,18266,401,18667,145
2020-12-10,Napa,055,140530,4528,3974,23,3997,22
2020-12-10,Nevada,057,99092,2206,1919,60,1979,10
2020-12-10,Orange,059,3164182,113109,95297,3721,99018,1651
2020-12-10,Placer,061,380077,10861,8906,299,9205,90
2020-12-10,Plumas,063,18699,357,281,8,289,0
2020-12-10,Riverside,065,2383286,129997,112794,4139,116933,1552
2020-12-10,Sacramento,067,1510023,51699,46471,300,46771,664
2020-12-10,San Benito,069,59416,2571,2268,18,2286,19
2020-12-10,San Bernardino,071,2135413,142788,120186,3286,123472,1306
2020-12-10,San Diego,073,3302833,113900,99601,4780,104381,1114
2020-12-10,San Francisco,075,870044,19272,17945,147,18092,164
2020-12-10,San Joaquin,077,732212,35694,31228,872,32100,534
2020-12-10,San Luis Obispo,079,281455,8328,7245,158,7403,49
2020-12-10,San Mateo,081,765935,19565,16701,24,16725,177
2020-12-10,Santa Barbara,083,443738,13880,12788,299,13087,143
2020-12-10,Santa Clara,085,1922200,51998,43939,170,44109,491
2020-12-10,Santa Cruz,087,273765,6671,5645,121,5766,48
2020-12-10,Shasta,089,179085,7051,6312,407,6719,53
2020-12-10,Sierra,091,2930,23,18,0,18,0
2020-12-10,Siskiyou,093,43540,871,712,61,773,2
2020-12-10,Solano,095,438530,14136,12017,126,12143,90
2020-12-10,Sonoma,097,501317,15602,14282,90,14372,167
2020-12-10,Stanislaus,099,539301,28269,25582,2090,27672,464
2020-12-10,Sutter,101,95872,5124,4528,23,4551,27
2020-12-10,Tehama,103,63373,2414,2190,133,2323,9
2020-12-10,Trinity,105,12862,356,202,42,244,1
2020-12-10,Tulare,107,460477,27559,24506,2401,26907,337
2020-12-10,Tuolumne,109,53932,1724,1451,11,1462,8
2020-12-10,Ventura,111,848112,28586,24075,948,25023,202
2020-12-10,Yolo,113,214977,6695,5896,29,5925,95
2020-12-10,Yuba,115,75493,2921,2604,22,2626,10
2020-12-09,Alameda,001,1643700,39546,35047,550,35597,470
2020-12-09,Alpine,003,1148,65,58,0,58,0
2020-12-09,Amador,005,37829,1645,1121,8,1129,19
2020-12-09,Butte,007,227075,5550,4733,473,5206,70
2020-12-09,Calaveras,009,45235,745,670,0,670,21
2020-12-09,Colusa,011,21464,1021,896,33,929,7
2020-12-09,Contra Costa,013,1133247,31126,28308,269,28577,273
2020-12-09,Del Norte,015,27424,576,481,0,481,2
2020-12-09,El Dorado,017,186661,4348,3449,106,3555,8
2020-12-09,Fresno,019,978130,53169,41954,2522,44476,533
2020-12-09,Glenn,021,27897,1232,1107,114,1221,8
2020-12-09,Humboldt,023,135768,1306,1086,4,1090,10
2020-12-09,Imperial,025,180216,19914,17757,199,17956,368
2020-12-09,Inyo,027,18085,432,356,6,362,15
2020-12-09,Kern,029,883053,51601,46379,2705,49084,494
2020-12-09,Kings,031,150075,13758,12716,312,13028,92
2020-12-09,Lake,033,64148,1374,1158,0,1158,20
2020-12-09,Lassen,035,31185,3348,2331,15,2346,0
2020-12-09,Los Angeles,037,10098052,527540,467971,10241,478212,8075
2020-12-09,Madera,039,155013,8295,7216,247,7463,59
2020-12-09,Marin,041,260295,8563,8182,53,8235,138
2020-12-09,Mariposa,043,17540,183,154,2,156,3
2020-12-09,Mendocino,045,87422,1936,1703,15,1718,24
2020-12-09,Merced,047,269075,14986,13588,204,13792,183
2020-12-09,Modoc,049,8938,179,146,41,187,0
2020-12-09,Mono,051,14174,708,601,12,613,3
2020-12-09,Monterey,053,433212,20703,17891,393,18284,143
2020-12-09,Napa,055,140530,4443,3858,22,3880,21
2020-12-09,Nevada,057,99092,2153,1864,60,1924,10
2020-12-09,Orange,059,3164182,110004,93763,3553,97316,1629
2020-12-09,Placer,061,380077,10600,8588,285,8873,85
2020-12-09,Plumas,063,18699,349,271,8,279,0
2020-12-09,Riverside,065,2383286,126295,110376,3938,114314,1543
2020-12-09,Sacramento,067,1510023,50636,45284,275,45559,659
2020-12-09,San Benito,069,59416,2499,2217,16,2233,19
2020-12-09,San Bernardino,071,2135413,138508,114516,3090,117606,1305
2020-12-09,San Diego,073,3302833,110920,97551,4641,102192,1103
2020-12-09,San Francisco,075,870044,18973,17628,146,17774,163
2020-12-09,San Joaquin,077,732212,34880,30539,848,31387,531
2020-12-09,San Luis Obispo,079,281455,8110,7105,150,7255,47
2020-12-09,San Mateo,081,765935,19115,16422,23,16445,175
2020-12-09,Santa Barbara,083,443738,13680,12630,289,12919,142
2020-12-09,Santa Clara,085,1922200,50821,42912,155,43067,489
2020-12-09,Santa Cruz,087,273765,6510,5527,106,5633,47
2020-12-09,Shasta,089,179085,6986,6105,393,6498,52
2020-12-09,Sierra,091,2930,23,18,0,18,0
2020-12-09,Siskiyou,093,43540,860,713,60,773,2
2020-12-09,Solano,095,438530,13793,11862,118,11980,90
2020-12-09,Sonoma,097,501317,15345,13994,87,14081,164
2020-12-09,Stanislaus,099,539301,27780,25157,2027,27184,463
2020-12-09,Sutter,101,95872,5005,4418,19,4437,24
2020-12-09,Tehama,103,63373,2378,2102,129,2231,9
2020-12-09,Trinity,105,12862,348,199,39,238,0
2020-12-09,Tulare,107,460477,26957,24124,2325,26449,334
2020-12-09,Tuolumne,109,53932,1691,1319,11,1330,8
2020-12-09,Ventura,111,848112,27722,23830,906,24736,201
2020-12-09,Yolo,113,214977,6569,5760,27,5787,95
2020-12-09,Yuba,115,75493,2853,2513,21,2534,10
2020-12-08,Alameda,001,1643700,38645,34373,534,34907,469
2020-12-08,Alpine,003,1148,64,53,0,53,0
2020-12-08,Amador,005,37829,1359,1043,8,1051,17
2020-12-08,Butte,007,227075,5392,4651,433,5084,70
2020-12-08,Calaveras,009,45235,721,657,0,657,21
2020-12-08,Colusa,011,21464,1005,875,32,907,6
2020-12-08,Contra Costa,013,1133247,30431,27926,254,28180,270
2020-12-08,Del Norte,015,27424,562,465,0,465,2
2020-12-08,El Dorado,017,186661,4224,3296,93,3389,8
2020-12-08,Fresno,019,978130,51904,41574,2367,43941,529
2020-12-08,Glenn,021,27897,1212,1094,106,1200,8
2020-12-08,Humboldt,023,135768,1280,1059,4,1063,10
2020-12-08,Imperial,025,180216,19405,17568,192,17760,363
2020-12-08,Inyo,027,18085,408,333,6,339,15
2020-12-08,Kern,029,883053,50310,45116,2552,47668,487
2020-12-08,Kings,031,150075,13604,12623,303,12926,90
2020-12-08,Lake,033,64148,1334,1127,0,1127,20
2020-12-08,Lassen,035,31185,3192,2165,15,2180,0
2020-12-08,Los Angeles,037,10098052,514828,459738,9771,469509,8004
2020-12-08,Madera,039,155013,8166,7082,235,7317,59
2020-12-08,Marin,041,260295,8486,8099,52,8151,137
2020-12-08,Mariposa,043,17540,179,150,2,152,2
2020-12-08,Mendocino,045,87422,1894,1666,15,1681,23
2020-12-08,Merced,047,269075,14674,13380,203,13583,181
2020-12-08,Modoc,049,8938,171,138,38,176,0
2020-12-08,Mono,051,14174,694,597,12,609,3
2020-12-08,Monterey,053,433212,20132,17752,386,18138,134
2020-12-08,Napa,055,140530,4357,3778,20,3798,22
2020-12-08,Nevada,057,99092,2099,1809,57,1866,11
2020-12-08,Orange,059,3164182,106781,91406,3389,94795,1629
2020-12-08,Placer,061,380077,10332,8224,280,8504,82
2020-12-08,Plumas,063,18699,339,258,8,266,0
2020-12-08,Riverside,065,2383286,122926,107620,3761,111381,1514
2020-12-08,Sacramento,067,1510023,49573,44635,261,44896,649
2020-12-08,San Benito,069,59416,2445,2180,16,2196,18
2020-12-08,San Bernardino,071,2135413,134161,110676,2969,113645,1301
2020-12-08,San Diego,073,3302833,107549,95447,4484,99931,1088
2020-12-08,San Francisco,075,870044,18666,17384,144,17528,162
2020-12-08,San Joaquin,077,732212,33986,30225,815,31040,530
2020-12-08,San Luis Obispo,079,281455,7981,6903,139,7042,45
2020-12-08,San Mateo,081,765935,18716,16305,23,16328,175
2020-12-08,Santa Barbara,083,443738,13497,12516,280,12796,141
2020-12-08,Santa Clara,085,1922200,49510,41309,147,41456,484
2020-12-08,Santa Cruz,087,273765,6329,5374,104,5478,45
2020-12-08,Shasta,089,179085,6876,5946,385,6331,50
2020-12-08,Sierra,091,2930,22,18,0,18,0
2020-12-08,Siskiyou,093,43540,846,704,58,762,2
2020-12-08,Solano,095,438530,13387,11669,116,11785,89
2020-12-08,Sonoma,097,501317,15086,13601,86,13687,164
2020-12-08,Stanislaus,099,539301,27288,24793,1962,26755,461
2020-12-08,Sutter,101,95872,4909,4342,18,4360,24
2020-12-08,Tehama,103,63373,2304,2057,121,2178,9
2020-12-08,Trinity,105,12862,339,198,38,236,0
2020-12-08,Tulare,107,460477,26351,23607,2262,25869,330
2020-12-08,Tuolumne,109,53932,1667,1264,11,1275,7
2020-12-08,Ventura,111,848112,27061,23665,864,24529,195
2020-12-08,Yolo,113,214977,6437,5560,27,5587,90
2020-12-08,Yuba,115,75493,2775,2477,21,2498,10
2020-12-07,Alameda,001,1643700,37780,33887,500,34387,466
2020-12-07,Alpine,003,1148,63,53,0,53,0
2020-12-07,Amador,005,37829,1284,993,7,1000,17
2020-12-07,Butte,007,227075,5256,4604,412,5016,67
2020-12-07,Calaveras,009,45235,692,606,0,606,21
2020-12-07,Colusa,011,21464,980,825,27,852,6
2020-12-07,Contra Costa,013,1133247,29823,27307,241,27548,270
2020-12-07,Del Norte,015,27424,547,424,0,424,2
2020-12-07,El Dorado,017,186661,4045,3275,86,3361,8
2020-12-07,Fresno,019,978130,50431,41098,2247,43345,526
2020-12-07,Glenn,021,27897,1193,1085,100,1185,8
2020-12-07,Humboldt,023,135768,1245,1023,4,1027,9
2020-12-07,Imperial,025,180216,18990,17234,182,17416,364
2020-12-07,Inyo,027,18085,392,333,6,339,15
2020-12-07,Kern,029,883053,49284,44409,2418,46827,486
2020-12-07,Kings,031,150075,13461,12412,295,12707,90
2020-12-07,Lake,033,64148,1307,1090,0,1090,20
2020-12-07,Lassen,035,31185,3095,2167,15,2182,0
2020-12-07,Los Angeles,037,10098052,501155,451052,9351,460403,7937
2020-12-07,Madera,039,155013,7902,6935,230,7165,59
2020-12-07,Marin,041,260295,8428,8049,51,8100,136
2020-12-07,Mariposa,043,17540,176,146,2,148,2
2020-12-07,Mendocino,045,87422,1858,1638,14,1652,23
2020-12-07,Merced,047,269075,14316,13250,194,13444,179
2020-12-07,Modoc,049,8938,164,128,35,163,0
2020-12-07,Mono,051,14174,681,590,12,602,3
2020-12-07,Monterey,053,433212,19652,17746,375,18121,132
2020-12-07,Napa,055,140530,4266,3684,20,3704,21
2020-12-07,Nevada,057,99092,2050,1777,56,1833,11
2020-12-07,Orange,059,3164182,103513,89793,3270,93063,1628
2020-12-07,Placer,061,380077,10007,7911,266,8177,82
2020-12-07,Plumas,063,18699,327,256,5,261,0
2020-12-07,Riverside,065,2383286,119725,102363,3580,105943,1491
2020-12-07,Sacramento,067,1510023,48478,43419,244,43663,638
2020-12-07,San Benito,069,59416,2395,2165,15,2180,18
2020-12-07,San Bernardino,071,2135413,130210,108161,2854,111015,1295
2020-12-07,San Diego,073,3302833,104760,94171,4303,98474,1062
2020-12-07,San Francisco,075,870044,18370,17220,137,17357,161
2020-12-07,San Joaquin,077,732212,33111,28188,789,28977,530
2020-12-07,San Luis Obispo,079,281455,7799,6782,132,6914,45
2020-12-07,San Mateo,081,765935,18278,16029,22,16051,175
2020-12-07,Santa Barbara,083,443738,13255,12362,270,12632,141
2020-12-07,Santa Clara,085,1922200,48114,40621,138,40759,484
2020-12-07,Santa Cruz,087,273765,6165,5152,96,5248,41
2020-12-07,Shasta,089,179085,6753,5742,370,6112,50
2020-12-07,Sierra,091,2930,20,18,0,18,0
2020-12-07,Siskiyou,093,43540,820,652,58,710,2
2020-12-07,Solano,095,438530,13049,11354,112,11466,89
2020-12-07,Sonoma,097,501317,14802,13376,86,13462,164
2020-12-07,Stanislaus,099,539301,26714,24479,1909,26388,454
2020-12-07,Sutter,101,95872,4768,4106,18,4124,24
2020-12-07,Tehama,103,63373,2253,2030,116,2146,9
2020-12-07,Trinity,105,12862,335,194,38,232,0
2020-12-07,Tulare,107,460477,25803,22760,2203,24963,328
2020-12-07,Tuolumne,109,53932,1582,1256,10,1266,7
2020-12-07,Ventura,111,848112,26473,23354,828,24182,191
2020-12-07,Yolo,113,214977,6277,5537,26,5563,90
2020-12-07,Yuba,115,75493,2708,2428,19,2447,10
2020-12-06,Alameda,001,1643700,36786,33477,480,33957,465
2020-12-06,Alpine,003,1148,59,53,0,53,0
2020-12-06,Amador,005,37829,1221,952,6,958,17
2020-12-06,Butte,007,227075,5103,4527,378,4905,67
2020-12-06,Calaveras,009,45235,672,606,0,606,21
2020-12-06,Colusa,011,21464,963,824,23,847,6
2020-12-06,Contra Costa,013,1133247,29217,26566,234,26800,270
2020-12-06,Del Norte,015,27424,491,414,0,414,2
2020-12-06,El Dorado,017,186661,3908,3086,81,3167,8
2020-12-06,Fresno,019,978130,49479,40869,2131,43000,526
2020-12-06,Glenn,021,27897,1183,1067,96,1163,8
2020-12-06,Humboldt,023,135768,1220,1004,4,1008,9
2020-12-06,Imperial,025,180216,18682,16922,174,17096,364
2020-12-06,Inyo,027,18085,380,333,6,339,15
2020-12-06,Kern,029,883053,48293,43899,2251,46150,486
2020-12-06,Kings,031,150075,13189,12056,278,12334,90
2020-12-06,Lake,033,64148,1271,1075,0,1075,20
2020-12-06,Lassen,035,31185,2991,2168,13,2181,0
2020-12-06,Los Angeles,037,10098052,487559,443230,8924,452154,7910
2020-12-06,Madera,039,155013,7729,6826,221,7047,59
2020-12-06,Marin,041,260295,8348,8013,48,8061,136
2020-12-06,Mariposa,043,17540,175,144,2,146,2
2020-12-06,Mendocino,045,87422,1818,1614,14,1628,23
2020-12-06,Merced,047,269075,13979,12928,185,13113,179
2020-12-06,Modoc,049,8938,151,125,28,153,0
2020-12-06,Mono,051,14174,659,586,11,597,3
2020-12-06,Monterey,053,433212,19034,17426,365,17791,130
2020-12-06,Napa,055,140530,4154,3644,20,3664,21
2020-12-06,Nevada,057,99092,1991,1710,53,1763,10
2020-12-06,Orange,059,3164182,100442,87737,3141,90878,1627
2020-12-06,Placer,061,380077,9724,7837,247,8084,82
2020-12-06,Plumas,063,18699,314,254,4,258,0
2020-12-06,Riverside,065,2383286,116632,100088,3359,103447,1482
2020-12-06,Sacramento,067,1510023,47237,42808,230,43038,638
2020-12-06,San Benito,069,59416,2358,2135,15,2150,18
2020-12-06,San Bernardino,071,2135413,126061,106927,2700,109627,1286
2020-12-06,San Diego,073,3302833,101727,92173,4149,96322,1062
2020-12-06,San Francisco,075,870044,18047,17107,130,17237,161
2020-12-06,San Joaquin,077,732212,32267,28188,761,28949,530
2020-12-06,San Luis Obispo,079,281455,7634,6723,127,6850,45
2020-12-06,San Mateo,081,765935,17774,15855,20,15875,175
2020-12-06,Santa Barbara,083,443738,13023,12252,261,12513,141
2020-12-06,Santa Clara,085,1922200,46719,39112,133,39245,482
2020-12-06,Santa Cruz,087,273765,5988,5069,90,5159,40
2020-12-06,Shasta,089,179085,6613,5743,349,6092,49
2020-12-06,Sierra,091,2930,20,17,0,17,0
2020-12-06,Siskiyou,093,43540,801,652,56,708,2
2020-12-06,Solano,095,438530,12760,11354,102,11456,88
2020-12-06,Sonoma,097,501317,14514,13238,85,13323,164
2020-12-06,Stanislaus,099,539301,26154,24036,1845,25881,454
2020-12-06,Sutter,101,95872,4652,4009,17,4026,21
2020-12-06,Tehama,103,63373,2195,1982,107,2089,9
2020-12-06,Trinity,105,12862,328,181,36,217,0
2020-12-06,Tulare,107,460477,25271,22756,2136,24892,327
2020-12-06,Tuolumne,109,53932,1486,1210,10,1220,7
2020-12-06,Ventura,111,848112,25931,23035,803,23838,191
2020-12-06,Yolo,113,214977,6116,5465,22,5487,90
2020-12-06,Yuba,115,75493,2664,2340,18,2358,10
2020-12-05,Alameda,001,1643700,36428,32781,469,33250,465
2020-12-05,Alpine,003,1148,58,53,0,53,0
2020-12-05,Amador,005,37829,1197,847,6,853,17
2020-12-05,Butte,007,227075,5035,4455,359,4814,66
2020-12-05,Calaveras,009,45235,660,606,0,606,21
2020-12-05,Colusa,011,21464,945,825,20,845,6
2020-12-05,Contra Costa,013,1133247,28919,26217,226,26443,270
2020-12-05,Del Norte,015,27424,486,408,0,408,2
2020-12-05,El Dorado,017,186661,3843,3061,76,3137,8
2020-12-05,Fresno,019,978130,49160,40568,2077,42645,525
2020-12-05,Glenn,021,27897,1170,1056,90,1146,8
2020-12-05,Humboldt,023,135768,1187,979,4,983,9
2020-12-05,Imperial,025,180216,18508,16544,173,16717,362
2020-12-05,Inyo,027,18085,375,332,6,338,15
2020-12-05,Kern,029,883053,47830,43332,2166,45498,484
2020-12-05,Kings,031,150075,13108,11898,275,12173,90
2020-12-05,Lake,033,64148,1242,1069,0,1069,20
2020-12-05,Lassen,035,31185,2800,2168,11,2179,0
2020-12-05,Los Angeles,037,10098052,481760,433120,8612,441732,7888
2020-12-05,Madera,039,155013,7635,6619,214,6833,59
2020-12-05,Marin,041,260295,8321,7961,48,8009,136
2020-12-05,Mariposa,043,17540,170,143,2,145,2
2020-12-05,Mendocino,045,87422,1779,1585,14,1599,23
2020-12-05,Merced,047,269075,13872,12747,174,12921,180
2020-12-05,Modoc,049,8938,151,118,27,145,0
2020-12-05,Mono,051,14174,654,554,11,565,3
2020-12-05,Monterey,053,433212,18888,17077,361,17438,127
2020-12-05,Napa,055,140530,4084,3565,20,3585,21
2020-12-05,Nevada,057,99092,1976,1642,51,1693,10
2020-12-05,Orange,059,3164182,98971,85735,3044,88779,1612
2020-12-05,Placer,061,380077,9605,7811,238,8049,78
2020-12-05,Plumas,063,18699,307,246,1,247,0
2020-12-05,Riverside,065,2383286,115019,98612,3185,101797,1477
2020-12-05,Sacramento,067,1510023,46572,41878,216,42094,625
2020-12-05,San Benito,069,59416,2314,2073,15,2088,18
2020-12-05,San Bernardino,071,2135413,124532,105382,2572,107954,1283
2020-12-05,San Diego,073,3302833,100375,90470,4068,94538,1055
2020-12-05,San Francisco,075,870044,17861,16786,126,16912,161
2020-12-05,San Joaquin,077,732212,32000,28105,729,28834,523
2020-12-05,San Luis Obispo,079,281455,7567,6623,124,6747,44
2020-12-05,San Mateo,081,765935,17517,15512,20,15532,175
2020-12-05,Santa Barbara,083,443738,12923,12107,255,12362,141
2020-12-05,Santa Clara,085,1922200,45959,38339,128,38467,474
2020-12-05,Santa Cruz,087,273765,5915,4997,89,5086,40
2020-12-05,Shasta,089,179085,6552,5653,338,5991,49
2020-12-05,Sierra,091,2930,20,17,0,17,0
2020-12-05,Siskiyou,093,43540,793,649,55,704,2
2020-12-05,Solano,095,438530,12589,11351,100,11451,87
2020-12-05,Sonoma,097,501317,14418,13137,85,13222,164
2020-12-05,Stanislaus,099,539301,25835,23662,1810,25472,454
2020-12-05,Sutter,101,95872,4587,3937,17,3954,20
2020-12-05,Tehama,103,63373,2180,1926,105,2031,9
2020-12-05,Trinity,105,12862,327,177,36,213,0
2020-12-05,Tulare,107,460477,25052,22660,2078,24738,324
2020-12-05,Tuolumne,109,53932,1429,1180,10,1190,7
2020-12-05,Ventura,111,848112,25559,22710,789,23499,191
2020-12-05,Yolo,113,214977,6037,5351,21,5372,90
2020-12-05,Yuba,115,75493,2627,2275,18,2293,10
2020-12-04,Alameda,001,1643700,35878,31871,456,32327,465
2020-12-04,Alpine,003,1148,58,53,0,53,0
2020-12-04,Amador,005,37829,1183,766,3,769,16
2020-12-04,Butte,007,227075,4963,4336,339,4675,65
2020-12-04,Calaveras,009,45235,655,585,0,585,21
2020-12-04,Colusa,011,21464,931,790,18,808,6
2020-12-04,Contra Costa,013,1133247,28573,25705,214,25919,264
2020-12-04,Del Norte,015,27424,477,401,0,401,2
2020-12-04,El Dorado,017,186661,3755,2933,73,3006,7
2020-12-04,Fresno,019,978130,48450,40108,2009,42117,522
2020-12-04,Glenn,021,27897,1164,1017,82,1099,8
2020-12-04,Humboldt,023,135768,1169,960,4,964,9
2020-12-04,Imperial,025,180216,18261,16484,173,16657,362
2020-12-04,Inyo,027,18085,366,324,6,330,15
2020-12-04,Kern,029,883053,47279,42497,2064,44561,485
2020-12-04,Kings,031,150075,13015,11767,269,12036,88
2020-12-04,Lake,033,64148,1212,1018,0,1018,20
2020-12-04,Lassen,035,31185,2793,2167,10,2177,0
2020-12-04,Los Angeles,037,10098052,473140,424164,8324,432488,7845
2020-12-04,Madera,039,155013,7540,6479,211,6690,58
2020-12-04,Marin,041,260295,8266,7896,45,7941,136
2020-12-04,Mariposa,043,17540,170,136,2,138,2
2020-12-04,Mendocino,045,87422,1760,1563,13,1576,23
2020-12-04,Merced,047,269075,13757,12474,166,12640,177
2020-12-04,Modoc,049,8938,151,115,27,142,0
2020-12-04,Mono,051,14174,649,549,11,560,3
2020-12-04,Monterey,053,433212,18676,16737,352,17089,127
2020-12-04,Napa,055,140530,4030,3432,20,3452,19
2020-12-04,Nevada,057,99092,1951,1560,48,1608,10
2020-12-04,Orange,059,3164182,97042,83738,2980,86718,1597
2020-12-04,Placer,061,380077,9481,7461,225,7686,76
2020-12-04,Plumas,063,18699,300,232,0,232,0
2020-12-04,Riverside,065,2383286,112819,95255,3028,98283,1475
2020-12-04,Sacramento,067,1510023,45807,41061,199,41260,618
2020-12-04,San Benito,069,59416,2281,2006,15,2021,17
2020-12-04,San Bernardino,071,2135413,122259,102418,2464,104882,1290
2020-12-04,San Diego,073,3302833,98891,88183,3981,92164,1047
2020-12-04,San Francisco,075,870044,17671,16499,126,16625,161
2020-12-04,San Joaquin,077,732212,31560,27806,692,28498,522
2020-12-04,San Luis Obispo,079,281455,7483,6473,121,6594,42
2020-12-04,San Mateo,081,765935,17229,15112,19,15131,173
2020-12-04,Santa Barbara,083,443738,12816,11947,249,12196,141
2020-12-04,Santa Clara,085,1922200,45022,37465,122,37587,468
2020-12-04,Santa Cruz,087,273765,5825,4985,87,5072,32
2020-12-04,Shasta,089,179085,6463,5439,329,5768,49
2020-12-04,Sierra,091,2930,19,17,0,17,0
2020-12-04,Siskiyou,093,43540,786,639,52,691,2
2020-12-04,Solano,095,438530,12439,11037,97,11134,87
2020-12-04,Sonoma,097,501317,14270,12962,84,13046,164
2020-12-04,Stanislaus,099,539301,25557,23206,1766,24972,448
2020-12-04,Sutter,101,95872,4515,3791,12,3803,20
2020-12-04,Tehama,103,63373,2140,1876,100,1976,9
2020-12-04,Trinity,105,12862,325,172,36,208,0
2020-12-04,Tulare,107,460477,24759,22273,2006,24279,322
2020-12-04,Tuolumne,109,53932,1398,1134,10,1144,7
2020-12-04,Ventura,111,848112,25182,22024,773,22797,189
2020-12-04,Yolo,113,214977,5964,5294,20,5314,87
2020-12-04,Yuba,115,75493,2583,2225,17,2242,10
2020-12-03,Alameda,001,1643700,35110,31184,439,31623,465
2020-12-03,Alpine,003,1148,57,53,0,53,0
2020-12-03,Amador,005,37829,1132,653,3,656,16
2020-12-03,Butte,007,227075,4868,4305,320,4625,65
2020-12-03,Calaveras,009,45235,634,572,0,572,21
2020-12-03,Colusa,011,21464,918,774,17,791,6
2020-12-03,Contra Costa,013,1133247,28065,25464,207,25671,265
2020-12-03,Del Norte,015,27424,471,388,0,388,2
2020-12-03,El Dorado,017,186661,3629,2740,71,2811,6
2020-12-03,Fresno,019,978130,47696,39680,1937,41617,516
2020-12-03,Glenn,021,27897,1146,997,74,1071,8
2020-12-03,Humboldt,023,135768,1139,923,4,927,9
2020-12-03,Imperial,025,180216,18053,16436,161,16597,359
2020-12-03,Inyo,027,18085,364,321,6,327,15
2020-12-03,Kern,029,883053,46433,42062,1963,44025,483
2020-12-03,Kings,031,150075,12916,11658,258,11916,87
2020-12-03,Lake,033,64148,1197,991,0,991,20
2020-12-03,Lassen,035,31185,2753,2128,9,2137,0
2020-12-03,Los Angeles,037,10098052,463039,415805,7967,423772,7787
2020-12-03,Madera,039,155013,7417,6398,205,6603,58
2020-12-03,Marin,041,260295,8202,7861,41,7902,136
2020-12-03,Mariposa,043,17540,166,132,2,134,2
2020-12-03,Mendocino,045,87422,1743,1547,10,1557,23
2020-12-03,Merced,047,269075,13512,12310,159,12469,177
2020-12-03,Modoc,049,8938,149,114,27,141,0
2020-12-03,Mono,051,14174,627,527,11,538,3
2020-12-03,Monterey,053,433212,18215,16218,343,16561,125
2020-12-03,Napa,055,140530,3916,3360,20,3380,19
2020-12-03,Nevada,057,99092,1873,1472,47,1519,10
2020-12-03,Orange,059,3164182,94508,82187,2912,85099,1591
2020-12-03,Placer,061,380077,9279,7270,209,7479,73
2020-12-03,Plumas,063,18699,285,223,0,223,0
2020-12-03,Riverside,065,2383286,110057,92489,2869,95358,1461
2020-12-03,Sacramento,067,1510023,44749,40280,186,40466,614
2020-12-03,San Benito,069,59416,2235,1967,15,1982,16
2020-12-03,San Bernardino,071,2135413,118931,100787,2381,103168,1283
2020-12-03,San Diego,073,3302833,97076,86144,3863,90007,1040
2020-12-03,San Francisco,075,870044,17447,16236,125,16361,161
2020-12-03,San Joaquin,077,732212,30840,27239,650,27889,522
2020-12-03,San Luis Obispo,079,281455,7315,6388,120,6508,42
2020-12-03,San Mateo,081,765935,16876,14909,19,14928,173
2020-12-03,Santa Barbara,083,443738,12687,11829,243,12072,141
2020-12-03,Santa Clara,085,1922200,43811,36621,116,36737,465
2020-12-03,Santa Cruz,087,273765,5681,4850,83,4933,28
2020-12-03,Shasta,089,179085,6354,5330,322,5652,48
2020-12-03,Sierra,091,2930,19,17,0,17,0
2020-12-03,Siskiyou,093,43540,771,629,49,678,2
2020-12-03,Solano,095,438530,12224,10857,93,10950,87
2020-12-03,Sonoma,097,501317,14029,12772,83,12855,164
2020-12-03,Stanislaus,099,539301,25137,22821,1719,24540,447
2020-12-03,Sutter,101,95872,4431,3727,12,3739,20
2020-12-03,Tehama,103,63373,2088,1832,93,1925,9
2020-12-03,Trinity,105,12862,322,166,36,202,0
2020-12-03,Tulare,107,460477,24356,21993,1914,23907,321
2020-12-03,Tuolumne,109,53932,1356,1105,10,1115,7
2020-12-03,Ventura,111,848112,24479,21555,760,22315,187
2020-12-03,Yolo,113,214977,5826,5069,20,5089,87
2020-12-03,Yuba,115,75493,2512,2182,16,2198,10
2020-12-02,Alameda,001,1643700,34481,30697,429,31126,463
2020-12-02,Alpine,003,1148,56,52,0,52,0
2020-12-02,Amador,005,37829,1060,585,3,588,16
2020-12-02,Butte,007,227075,4746,4243,309,4552,65
2020-12-02,Calaveras,009,45235,618,553,0,553,21
2020-12-02,Colusa,011,21464,902,756,15,771,6
2020-12-02,Contra Costa,013,1133247,27600,25147,195,25342,264
2020-12-02,Del Norte,015,27424,455,384,0,384,2
2020-12-02,El Dorado,017,186661,3528,2638,66,2704,5
2020-12-02,Fresno,019,978130,46940,39324,1839,41163,507
2020-12-02,Glenn,021,27897,1129,995,66,1061,7
2020-12-02,Humboldt,023,135768,1113,899,4,903,9
2020-12-02,Imperial,025,180216,17631,16360,154,16514,356
2020-12-02,Inyo,027,18085,357,314,6,320,15
2020-12-02,Kern,029,883053,45535,41660,1868,43528,479
2020-12-02,Kings,031,150075,12563,11531,244,11775,86
2020-12-02,Lake,033,64148,1167,971,0,971,20
2020-12-02,Lassen,035,31185,2694,2115,9,2124,0
2020-12-02,Los Angeles,037,10098052,452986,408289,7646,415935,7739
2020-12-02,Madera,039,155013,7292,6370,199,6569,57
2020-12-02,Marin,041,260295,8153,7819,39,7858,136
2020-12-02,Mariposa,043,17540,163,131,2,133,2
2020-12-02,Mendocino,045,87422,1710,1524,10,1534,23
2020-12-02,Merced,047,269075,13269,12168,151,12319,173
2020-12-02,Modoc,049,8938,146,113,27,140,0
2020-12-02,Mono,051,14174,618,520,11,531,3
2020-12-02,Monterey,053,433212,17735,16064,304,16368,121
2020-12-02,Napa,055,140530,3813,3298,19,3317,19
2020-12-02,Nevada,057,99092,1811,1430,46,1476,9
2020-12-02,Orange,059,3164182,92309,81046,2833,83879,1569
2020-12-02,Placer,061,380077,9045,6941,196,7137,73
2020-12-02,Plumas,063,18699,272,218,0,218,0
2020-12-02,Riverside,065,2383286,107339,90089,2690,92779,1451
2020-12-02,Sacramento,067,1510023,43709,39334,175,39509,597
2020-12-02,San Benito,069,59416,2170,1921,15,1936,16
2020-12-02,San Bernardino,071,2135413,115360,98567,2276,100843,1240
2020-12-02,San Diego,073,3302833,95160,84640,3748,88388,1035
2020-12-02,San Francisco,075,870044,17209,16058,123,16181,157
2020-12-02,San Joaquin,077,732212,30223,26740,627,27367,519
2020-12-02,San Luis Obispo,079,281455,7216,6324,118,6442,42
2020-12-02,San Mateo,081,765935,16513,14757,18,14775,170
2020-12-02,Santa Barbara,083,443738,12536,11705,231,11936,140
2020-12-02,Santa Clara,085,1922200,42688,35878,116,35994,458
2020-12-02,Santa Cruz,087,273765,5549,4766,80,4846,27
2020-12-02,Shasta,089,179085,6230,5188,305,5493,47
2020-12-02,Sierra,091,2930,19,17,0,17,0
2020-12-02,Siskiyou,093,43540,755,624,47,671,1
2020-12-02,Solano,095,438530,11977,10701,89,10790,87
2020-12-02,Sonoma,097,501317,13789,12635,82,12717,163
2020-12-02,Stanislaus,099,539301,24634,22615,1663,24278,448
2020-12-02,Sutter,101,95872,4272,3604,12,3616,18
2020-12-02,Tehama,103,63373,2044,1800,78,1878,9
2020-12-02,Trinity,105,12862,313,165,35,200,0
2020-12-02,Tulare,107,460477,23973,21789,1836,23625,321
2020-12-02,Tuolumne,109,53932,1315,1076,10,1086,7
2020-12-02,Ventura,111,848112,24066,21208,742,21950,186
2020-12-02,Yolo,113,214977,5718,5053,19,5072,87
2020-12-02,Yuba,115,75493,2434,2119,15,2134,10
2020-12-01,Alameda,001,1643700,33789,30252,419,30671,460
2020-12-01,Alpine,003,1148,56,41,0,41,0
2020-12-01,Amador,005,37829,913,575,2,577,16
2020-12-01,Butte,007,227075,4641,4177,293,4470,65
2020-12-01,Calaveras,009,45235,600,544,0,544,21
2020-12-01,Colusa,011,21464,885,747,15,762,6
2020-12-01,Contra Costa,013,1133247,27028,24788,187,24975,264
2020-12-01,Del Norte,015,27424,427,357,0,357,2
2020-12-01,El Dorado,017,186661,3384,2542,61,2603,4
2020-12-01,Fresno,019,978130,46037,39004,1763,40767,505
2020-12-01,Glenn,021,27897,1108,989,62,1051,7
2020-12-01,Humboldt,023,135768,1083,886,4,890,9
2020-12-01,Imperial,025,180216,17316,16278,151,16429,356
2020-12-01,Inyo,027,18085,351,304,6,310,15
2020-12-01,Kern,029,883053,44733,41345,1741,43086,478
2020-12-01,Kings,031,150075,12248,11415,230,11645,86
2020-12-01,Lake,033,64148,1145,969,0,969,19
2020-12-01,Lassen,035,31185,2528,2047,8,2055,0
2020-12-01,Los Angeles,037,10098052,442608,403266,7336,410602,7704
2020-12-01,Madera,039,155013,7172,6270,189,6459,57
2020-12-01,Marin,041,260295,8082,7787,38,7825,136
2020-12-01,Mariposa,043,17540,158,128,2,130,2
2020-12-01,Mendocino,045,87422,1676,1497,10,1507,23
2020-12-01,Merced,047,269075,13029,12032,142,12174,172
2020-12-01,Modoc,049,8938,141,113,23,136,0
2020-12-01,Mono,051,14174,605,520,11,531,3
2020-12-01,Monterey,053,433212,17227,15835,293,16128,121
2020-12-01,Napa,055,140530,3729,3124,18,3142,19
2020-12-01,Nevada,057,99092,1749,1411,45,1456,9
2020-12-01,Orange,059,3164182,90205,79468,2744,82212,1567
2020-12-01,Placer,061,380077,8720,6794,189,6983,72
2020-12-01,Plumas,063,18699,260,201,0,201,0
2020-12-01,Riverside,065,2383286,104529,88530,2530,91060,1448
2020-12-01,Sacramento,067,1510023,42662,38966,172,39138,589
2020-12-01,San Benito,069,59416,2115,1888,15,1903,15
2020-12-01,San Bernardino,071,2135413,111891,95854,2154,98008,1220
2020-12-01,San Diego,073,3302833,92903,83423,3638,87061,1019
2020-12-01,San Francisco,075,870044,16927,15797,120,15917,157
2020-12-01,San Joaquin,077,732212,29422,26432,605,27037,514
2020-12-01,San Luis Obispo,079,281455,7074,6264,113,6377,40
2020-12-01,San Mateo,081,765935,16188,14495,18,14513,170
2020-12-01,Santa Barbara,083,443738,12397,11611,221,11832,140
2020-12-01,Santa Clara,085,1922200,41432,35397,110,35507,452
2020-12-01,Santa Cruz,087,273765,5391,4638,72,4710,27
2020-12-01,Shasta,089,179085,6105,5077,286,5363,47
2020-12-01,Sierra,091,2930,19,17,0,17,0
2020-12-01,Siskiyou,093,43540,741,608,43,651,1
2020-12-01,Solano,095,438530,11716,10604,84,10688,87
2020-12-01,Sonoma,097,501317,13585,12491,79,12570,163
2020-12-01,Stanislaus,099,539301,24173,22351,1605,23956,447
2020-12-01,Sutter,101,95872,4130,3538,12,3550,17
2020-12-01,Tehama,103,63373,1978,1773,68,1841,9
2020-12-01,Trinity,105,12862,299,165,29,194,0
2020-12-01,Tulare,107,460477,23517,21645,1768,23413,319
2020-12-01,Tuolumne,109,53932,1279,1052,8,1060,7
2020-12-01,Ventura,111,848112,23452,20604,720,21324,186
2020-12-01,Yolo,113,214977,5579,4928,19,4947,86
2020-12-01,Yuba,115,75493,2370,2088,14,2102,10
2020-11-30,Alameda,001,1643700,32969,29972,402,30374,457
2020-11-30,Alpine,003,1148,54,41,0,41,0
2020-11-30,Amador,005,37829,872,559,2,561,16
2020-11-30,Butte,007,227075,4523,4148,277,4425,65
2020-11-30,Calaveras,009,45235,579,478,0,478,21
2020-11-30,Colusa,011,21464,858,737,12,749,6
2020-11-30,Contra Costa,013,1133247,26444,24365,183,24548,264
2020-11-30,Del Norte,015,27424,401,339,0,339,2
2020-11-30,El Dorado,017,186661,3210,2488,55,2543,4
2020-11-30,Fresno,019,978130,44924,38712,1653,40365,500
2020-11-30,Glenn,021,27897,1085,954,57,1011,5
2020-11-30,Humboldt,023,135768,1036,870,4,874,9
2020-11-30,Imperial,025,180216,17059,16212,130,16342,356
2020-11-30,Inyo,027,18085,345,304,5,309,15
2020-11-30,Kern,029,883053,43974,40941,1609,42550,473
2020-11-30,Kings,031,150075,12100,11346,215,11561,85
2020-11-30,Lake,033,64148,1111,939,0,939,18
2020-11-30,Lassen,035,31185,2436,1793,8,1801,0
2020-11-30,Los Angeles,037,10098052,431928,396202,7012,403214,7658
2020-11-30,Madera,039,155013,7007,6210,175,6385,57
2020-11-30,Marin,041,260295,8037,7764,37,7801,136
2020-11-30,Mariposa,043,17540,151,123,2,125,2
2020-11-30,Mendocino,045,87422,1648,1482,10,1492,23
2020-11-30,Merced,047,269075,12754,11913,131,12044,172
2020-11-30,Modoc,049,8938,131,113,23,136,0
2020-11-30,Mono,051,14174,583,519,11,530,3
2020-11-30,Monterey,053,433212,16797,15837,285,16122,119
2020-11-30,Napa,055,140530,3630,3091,18,3109,18
2020-11-30,Nevada,057,99092,1663,1347,42,1389,9
2020-11-30,Orange,059,3164182,88090,78711,2648,81359,1568
2020-11-30,Placer,061,380077,8423,6575,176,6751,72
2020-11-30,Plumas,063,18699,249,192,0,192,0
2020-11-30,Riverside,065,2383286,101539,87722,2385,90107,1446
2020-11-30,Sacramento,067,1510023,41580,37834,163,37997,586
2020-11-30,San Benito,069,59416,2068,1875,14,1889,15
2020-11-30,San Bernardino,071,2135413,108160,92704,2042,94746,1220
2020-11-30,San Diego,073,3302833,90540,82045,3511,85556,997
2020-11-30,San Francisco,075,870044,16629,15638,116,15754,157
2020-11-30,San Joaquin,077,732212,28717,25742,579,26321,509
2020-11-30,San Luis Obispo,079,281455,6940,6224,111,6335,36
2020-11-30,San Mateo,081,765935,15829,14276,18,14294,170
2020-11-30,Santa Barbara,083,443738,12218,11572,213,11785,140
2020-11-30,Santa Clara,085,1922200,40218,35019,109,35128,451
2020-11-30,Santa Cruz,087,273765,5252,4558,69,4627,26
2020-11-30,Shasta,089,179085,5960,4933,258,5191,44
2020-11-30,Sierra,091,2930,19,16,0,16,0
2020-11-30,Siskiyou,093,43540,732,605,39,644,1
2020-11-30,Solano,095,438530,11453,10392,79,10471,87
2020-11-30,Sonoma,097,501317,13339,12232,75,12307,163
2020-11-30,Stanislaus,099,539301,23710,22110,1563,23673,446
2020-11-30,Sutter,101,95872,3974,3430,12,3442,16
2020-11-30,Tehama,103,63373,1929,1724,61,1785,9
2020-11-30,Trinity,105,12862,292,162,29,191,0
2020-11-30,Tulare,107,460477,23128,20833,1675,22508,319
2020-11-30,Tuolumne,109,53932,1235,1027,8,1035,7
2020-11-30,Ventura,111,848112,22698,20308,704,21012,180
2020-11-30,Yolo,113,214977,5462,4894,19,4913,81
2020-11-30,Yuba,115,75493,2311,2028,12,2040,10
2020-11-29,Alameda,001,1643700,32180,29918,380,30298,457
2020-11-29,Alpine,003,1148,51,41,0,41,0
2020-11-29,Amador,005,37829,721,548,2,550,16
2020-11-29,Butte,007,227075,4423,4008,261,4269,65
2020-11-29,Calaveras,009,45235,548,478,0,478,21
2020-11-29,Colusa,011,21464,829,723,8,731,6
2020-11-29,Contra Costa,013,1133247,25937,24165,177,24342,264
2020-11-29,Del Norte,015,27424,395,339,0,339,2
2020-11-29,El Dorado,017,186661,3079,2447,53,2500,4
2020-11-29,Fresno,019,978130,43970,38568,1581,40149,500
2020-11-29,Glenn,021,27897,1062,951,55,1006,4
2020-11-29,Humboldt,023,135768,1007,856,4,860,9
2020-11-29,Imperial,025,180216,16826,16138,105,16243,356
2020-11-29,Inyo,027,18085,328,289,5,294,15
2020-11-29,Kern,029,883053,43211,40596,1461,42057,473
2020-11-29,Kings,031,150075,11949,11247,197,11444,85
2020-11-29,Lake,033,64148,1087,927,0,927,18
2020-11-29,Lassen,035,31185,2333,1793,8,1801,0
2020-11-29,Los Angeles,037,10098052,421518,391162,6722,397884,7642
2020-11-29,Madera,039,155013,6864,6184,169,6353,57
2020-11-29,Marin,041,260295,7971,7739,34,7773,135
2020-11-29,Mariposa,043,17540,147,123,2,125,2
2020-11-29,Mendocino,045,87422,1614,1473,10,1483,23
2020-11-29,Merced,047,269075,12514,11773,122,11895,172
2020-11-29,Modoc,049,8938,127,105,21,126,0
2020-11-29,Mono,051,14174,560,515,10,525,3
2020-11-29,Monterey,053,433212,16484,15621,278,15899,119
2020-11-29,Napa,055,140530,3525,3090,17,3107,18
2020-11-29,Nevada,057,99092,1583,1311,40,1351,9
2020-11-29,Orange,059,3164182,86067,78057,2602,80659,1567
2020-11-29,Placer,061,380077,8125,6535,164,6699,72
2020-11-29,Plumas,063,18699,244,191,0,191,0
2020-11-29,Riverside,065,2383286,99147,87383,2233,89616,1442
2020-11-29,Sacramento,067,1510023,40502,37415,154,37569,585
2020-11-29,San Benito,069,59416,2024,1860,14,1874,15
2020-11-29,San Bernardino,071,2135413,104809,92052,1939,93991,1223
2020-11-29,San Diego,073,3302833,88129,81086,3358,84444,997
2020-11-29,San Francisco,075,870044,16347,15571,111,15682,153
2020-11-29,San Joaquin,077,732212,27968,25740,573,26313,509
2020-11-29,San Luis Obispo,079,281455,6817,6145,111,6256,36
2020-11-29,San Mateo,081,765935,15497,14177,18,14195,169
2020-11-29,Santa Barbara,083,443738,12064,11520,209,11729,140
2020-11-29,Santa Clara,085,1922200,39006,34234,103,34337,451
2020-11-29,Santa Cruz,087,273765,5092,4490,67,4557,26
2020-11-29,Shasta,089,179085,5788,4935,230,5165,43
2020-11-29,Sierra,091,2930,19,16,0,16,0
2020-11-29,Siskiyou,093,43540,709,590,37,627,1
2020-11-29,Solano,095,438530,11220,10393,75,10468,87
2020-11-29,Sonoma,097,501317,13087,12052,71,12123,163
2020-11-29,Stanislaus,099,539301,23214,21701,1529,23230,446
2020-11-29,Sutter,101,95872,3858,3297,12,3309,16
2020-11-29,Tehama,103,63373,1878,1710,47,1757,9
2020-11-29,Trinity,105,12862,289,159,27,186,0
2020-11-29,Tulare,107,460477,22759,20793,1600,22393,319
2020-11-29,Tuolumne,109,53932,1198,988,8,996,7
2020-11-29,Ventura,111,848112,22014,19952,692,20644,179
2020-11-29,Yolo,113,214977,5325,4830,18,4848,80
2020-11-29,Yuba,115,75493,2255,1959,12,1971,10
2020-11-28,Alameda,001,1643700,31870,29368,375,29743,456
2020-11-28,Alpine,003,1148,51,41,0,41,0
2020-11-28,Amador,005,37829,644,536,2,538,16
2020-11-28,Butte,007,227075,4365,3894,257,4151,65
2020-11-28,Calaveras,009,45235,542,478,0,478,21
2020-11-28,Colusa,011,21464,820,711,6,717,6
2020-11-28,Contra Costa,013,1133247,25604,23798,173,23971,264
2020-11-28,Del Norte,015,27424,385,328,0,328,2
2020-11-28,El Dorado,017,186661,3011,2415,47,2462,4
2020-11-28,Fresno,019,978130,43623,38288,1543,39831,500
2020-11-28,Glenn,021,27897,1051,925,51,976,4
2020-11-28,Humboldt,023,135768,972,844,4,848,9
2020-11-28,Imperial,025,180216,16757,16019,103,16122,356
2020-11-28,Inyo,027,18085,320,289,5,294,15
2020-11-28,Kern,029,883053,42848,40255,1372,41627,473
2020-11-28,Kings,031,150075,11884,11070,190,11260,85
2020-11-28,Lake,033,64148,1071,920,0,920,18
2020-11-28,Lassen,035,31185,2266,1714,8,1722,0
2020-11-28,Los Angeles,037,10098052,416598,386194,6565,392759,7625
2020-11-28,Madera,039,155013,6761,6119,162,6281,57
2020-11-28,Marin,041,260295,7941,7696,30,7726,135
2020-11-28,Mariposa,043,17540,144,120,2,122,2
2020-11-28,Mendocino,045,87422,1583,1458,10,1468,22
2020-11-28,Merced,047,269075,12414,11688,116,11804,172
2020-11-28,Modoc,049,8938,124,103,21,124,0
2020-11-28,Mono,051,14174,554,505,10,515,3
2020-11-28,Monterey,053,433212,16318,15328,274,15602,118
2020-11-28,Napa,055,140530,3474,3033,17,3050,18
2020-11-28,Nevada,057,99092,1554,1272,38,1310,9
2020-11-28,Orange,059,3164182,84967,76882,2555,79437,1568
2020-11-28,Placer,061,380077,7965,6497,161,6658,70
2020-11-28,Plumas,063,18699,237,188,0,188,0
2020-11-28,Riverside,065,2383286,97739,86854,2132,88986,1440
2020-11-28,Sacramento,067,1510023,39925,36905,150,37055,580
2020-11-28,San Benito,069,59416,1979,1835,14,1849,15
2020-11-28,San Bernardino,071,2135413,103408,91183,1837,93020,1224
2020-11-28,San Diego,073,3302833,86875,80020,3274,83294,997
2020-11-28,San Francisco,075,870044,16172,15450,104,15554,153
2020-11-28,San Joaquin,077,732212,27767,25742,558,26300,509
2020-11-28,San Luis Obispo,079,281455,6747,6106,107,6213,36
2020-11-28,San Mateo,081,765935,15307,14040,18,14058,169
2020-11-28,Santa Barbara,083,443738,11962,11481,204,11685,140
2020-11-28,Santa Clara,085,1922200,38255,33701,101,33802,449
2020-11-28,Santa Cruz,087,273765,5016,4426,67,4493,26
2020-11-28,Shasta,089,179085,5711,4882,223,5105,43
2020-11-28,Sierra,091,2930,19,16,0,16,0
2020-11-28,Siskiyou,093,43540,699,558,34,592,1
2020-11-28,Solano,095,438530,11098,10252,73,10325,87
2020-11-28,Sonoma,097,501317,12983,12008,62,12070,162
2020-11-28,Stanislaus,099,539301,22975,21574,1495,23069,446
2020-11-28,Sutter,101,95872,3774,3244,12,3256,15
2020-11-28,Tehama,103,63373,1859,1678,43,1721,9
2020-11-28,Trinity,105,12862,286,157,25,182,0
2020-11-28,Tulare,107,460477,22561,20701,1558,22259,319
2020-11-28,Tuolumne,109,53932,1176,976,8,984,7
2020-11-28,Ventura,111,848112,21716,19510,682,20192,179
2020-11-28,Yolo,113,214977,5248,4739,16,4755,80
2020-11-28,Yuba,115,75493,2200,1912,12,1924,10
2020-11-27,Alameda,001,1643700,31427,29064,365,29429,450
2020-11-27,Alpine,003,1148,51,41,0,41,0
2020-11-27,Amador,005,37829,597,498,1,499,16
2020-11-27,Butte,007,227075,4324,3894,251,4145,65
2020-11-27,Calaveras,009,45235,533,478,0,478,21
2020-11-27,Colusa,011,21464,803,694,4,698,6
2020-11-27,Contra Costa,013,1133247,25343,23463,167,23630,264
2020-11-27,Del Norte,015,27424,379,307,0,307,2
2020-11-27,El Dorado,017,186661,2940,2238,44,2282,4
2020-11-27,Fresno,019,978130,43218,37994,1487,39481,500
2020-11-27,Glenn,021,27897,1038,891,46,937,4
2020-11-27,Humboldt,023,135768,953,795,3,798,9
2020-11-27,Imperial,025,180216,16689,15960,95,16055,356
2020-11-27,Inyo,027,18085,314,289,5,294,15
2020-11-27,Kern,029,883053,42425,39707,1302,41009,473
2020-11-27,Kings,031,150075,11799,10667,172,10839,85
2020-11-27,Lake,033,64148,1035,909,0,909,18
2020-11-27,Lassen,035,31185,2254,1714,8,1722,0
2020-11-27,Los Angeles,037,10098052,410074,382740,6419,389159,7606
2020-11-27,Madera,039,155013,6689,6050,157,6207,57
2020-11-27,Marin,041,260295,7899,7660,30,7690,135
2020-11-27,Mariposa,043,17540,142,118,2,120,2
2020-11-27,Mendocino,045,87422,1569,1387,9,1396,22
2020-11-27,Merced,047,269075,12308,11550,109,11659,172
2020-11-27,Modoc,049,8938,123,100,21,121,0
2020-11-27,Mono,051,14174,550,498,10,508,3
2020-11-27,Monterey,053,433212,16150,14753,274,15027,113
2020-11-27,Napa,055,140530,3434,2988,17,3005,18
2020-11-27,Nevada,057,99092,1524,1184,36,1220,9
2020-11-27,Orange,059,3164182,83679,75151,2516,77667,1568
2020-11-27,Placer,061,380077,7806,6283,151,6434,68
2020-11-27,Plumas,063,18699,234,188,0,188,0
2020-11-27,Riverside,065,2383286,96129,85769,1980,87749,1440
2020-11-27,Sacramento,067,1510023,39304,36579,146,36725,579
2020-11-27,San Benito,069,59416,1945,1805,13,1818,15
2020-11-27,San Bernardino,071,2135413,101889,90254,1756,92010,1224
2020-11-27,San Diego,073,3302833,85681,78161,3185,81346,996
2020-11-27,San Francisco,075,870044,16016,15377,102,15479,153
2020-11-27,San Joaquin,077,732212,27543,25741,538,26279,509
2020-11-27,San Luis Obispo,079,281455,6664,6039,104,6143,36
2020-11-27,San Mateo,081,765935,15105,13872,17,13889,169
2020-11-27,Santa Barbara,083,443738,11869,11340,201,11541,140
2020-11-27,Santa Clara,085,1922200,37580,32935,94,33029,449
2020-11-27,Santa Cruz,087,273765,4945,4358,65,4423,26
2020-11-27,Shasta,089,179085,5634,4710,210,4920,43
2020-11-27,Sierra,091,2930,18,16,0,16,0
2020-11-27,Siskiyou,093,43540,684,554,31,585,1
2020-11-27,Solano,095,438530,10979,10044,70,10114,87
2020-11-27,Sonoma,097,501317,12850,11924,60,11984,162
2020-11-27,Stanislaus,099,539301,22746,21185,1466,22651,446
2020-11-27,Sutter,101,95872,3706,3101,12,3113,15
2020-11-27,Tehama,103,63373,1833,1649,39,1688,9
2020-11-27,Trinity,105,12862,282,151,25,176,0
2020-11-27,Tulare,107,460477,22371,20634,1501,22135,319
2020-11-27,Tuolumne,109,53932,1144,881,8,889,7
2020-11-27,Ventura,111,848112,21392,19379,660,20039,179
2020-11-27,Yolo,113,214977,5197,4737,16,4753,79
2020-11-27,Yuba,115,75493,2171,1864,11,1875,10
2020-11-26,Alameda,001,1643700,31012,28797,347,29144,447
2020-11-26,Alpine,003,1148,51,41,0,41,0
2020-11-26,Amador,005,37829,589,488,1,489,16
2020-11-26,Butte,007,227075,4261,3894,245,4139,65
2020-11-26,Calaveras,009,45235,506,478,0,478,21
2020-11-26,Colusa,011,21464,789,694,4,698,6
2020-11-26,Contra Costa,013,1133247,25010,23468,161,23629,264
2020-11-26,Del Norte,015,27424,368,307,0,307,2
2020-11-26,El Dorado,017,186661,2859,2217,42,2259,4
2020-11-26,Fresno,019,978130,42813,37724,1442,39166,500
2020-11-26,Glenn,021,27897,1022,892,44,936,4
2020-11-26,Humboldt,023,135768,930,795,2,797,9
2020-11-26,Imperial,025,180216,16574,15722,92,15814,355
2020-11-26,Inyo,027,18085,312,289,5,294,15
2020-11-26,Kern,029,883053,41975,39123,1242,40365,471
2020-11-26,Kings,031,150075,11744,10475,160,10635,85
2020-11-26,Lake,033,64148,1022,890,0,890,18
2020-11-26,Lassen,035,31185,2239,1714,8,1722,0
2020-11-26,Los Angeles,037,10098052,404909,378340,6187,384527,7581
2020-11-26,Madera,039,155013,6610,6003,152,6155,57
2020-11-26,Marin,041,260295,7861,7610,30,7640,135
2020-11-26,Mariposa,043,17540,137,116,2,118,2
2020-11-26,Mendocino,045,87422,1555,1387,7,1394,22
2020-11-26,Merced,047,269075,12160,11440,107,11547,172
2020-11-26,Modoc,049,8938,121,100,21,121,0
2020-11-26,Mono,051,14174,542,485,10,495,2
2020-11-26,Monterey,053,433212,15914,14750,266,15016,113
2020-11-26,Napa,055,140530,3370,2988,17,3005,18
2020-11-26,Nevada,057,99092,1479,1184,36,1220,9
2020-11-26,Orange,059,3164182,82290,74264,2456,76720,1563
2020-11-26,Placer,061,380077,7642,6278,142,6420,68
2020-11-26,Plumas,063,18699,226,188,0,188,0
2020-11-26,Riverside,065,2383286,94527,85774,1856,87630,1440
2020-11-26,Sacramento,067,1510023,38661,35854,138,35992,580
2020-11-26,San Benito,069,59416,1918,1769,13,1782,15
2020-11-26,San Bernardino,071,2135413,100236,89727,1663,91390,1223
2020-11-26,San Diego,073,3302833,84071,76359,3081,79440,996
2020-11-26,San Francisco,075,870044,15881,15156,98,15254,153
2020-11-26,San Joaquin,077,732212,27287,25738,526,26264,509
2020-11-26,San Luis Obispo,079,281455,6571,5964,101,6065,36
2020-11-26,San Mateo,081,765935,14916,13715,16,13731,169
2020-11-26,Santa Barbara,083,443738,11788,11277,200,11477,139
2020-11-26,Santa Clara,085,1922200,36934,32411,87,32498,446
2020-11-26,Santa Cruz,087,273765,4812,4269,59,4328,26
2020-11-26,Shasta,089,179085,5551,4712,198,4910,43
2020-11-26,Sierra,091,2930,18,15,0,15,0
2020-11-26,Siskiyou,093,43540,674,526,31,557,1
2020-11-26,Solano,095,438530,10834,9941,68,10009,87
2020-11-26,Sonoma,097,501317,12702,11922,58,11980,162
2020-11-26,Stanislaus,099,539301,22514,21186,1426,22612,445
2020-11-26,Sutter,101,95872,3612,3101,11,3112,15
2020-11-26,Tehama,103,63373,1793,1612,36,1648,9
2020-11-26,Trinity,105,12862,278,139,25,164,0
2020-11-26,Tulare,107,460477,22131,20649,1440,22089,319
2020-11-26,Tuolumne,109,53932,1116,871,8,879,7
2020-11-26,Ventura,111,848112,20895,19058,646,19704,179
2020-11-26,Yolo,113,214977,5110,4566,16,4582,76
2020-11-26,Yuba,115,75493,2111,1865,9,1874,10
2020-11-25,Alameda,001,1643700,30797,28378,339,28717,447
2020-11-25,Alpine,003,1148,51,41,0,41,0
2020-11-25,Amador,005,37829,579,484,1,485,16
2020-11-25,Butte,007,227075,4230,3848,242,4090,64
2020-11-25,Calaveras,009,45235,503,475,0,475,21
2020-11-25,Colusa,011,21464,772,693,4,697,6
2020-11-25,Contra Costa,013,1133247,24854,23307,160,23467,263
2020-11-25,Del Norte,015,27424,367,304,0,304,2
2020-11-25,El Dorado,017,186661,2823,2154,42,2196,4
2020-11-25,Fresno,019,978130,42580,37349,1420,38769,494
2020-11-25,Glenn,021,27897,1005,891,42,933,4
2020-11-25,Humboldt,023,135768,922,777,2,779,9
2020-11-25,Imperial,025,180216,16502,15640,91,15731,355
2020-11-25,Inyo,027,18085,310,289,5,294,15
2020-11-25,Kern,029,883053,41819,38878,1225,40103,467
2020-11-25,Kings,031,150075,11709,10417,156,10573,85
2020-11-25,Lake,033,64148,1005,878,0,878,18
2020-11-25,Lassen,035,31185,2196,1701,8,1709,0
2020-11-25,Los Angeles,037,10098052,401881,373919,6086,380005,7545
2020-11-25,Madera,039,155013,6587,5989,149,6138,57
2020-11-25,Marin,041,260295,7832,7601,29,7630,135
2020-11-25,Mariposa,043,17540,136,114,2,116,2
2020-11-25,Mendocino,045,87422,1536,1373,7,1380,22
2020-11-25,Merced,047,269075,12103,11346,107,11453,172
2020-11-25,Modoc,049,8938,121,96,21,117,0
2020-11-25,Mono,051,14174,537,487,10,497,2
2020-11-25,Monterey,053,433212,15799,14695,264,14959,113
2020-11-25,Napa,055,140530,3337,2945,17,2962,17
2020-11-25,Nevada,057,99092,1461,1170,34,1204,9
2020-11-25,Orange,059,3164182,81534,73014,2436,75450,1551
2020-11-25,Placer,061,380077,7566,6221,141,6362,68
2020-11-25,Plumas,063,18699,221,183,0,183,0
2020-11-25,Riverside,065,2383286,93982,85077,1838,86915,1438
2020-11-25,Sacramento,067,1510023,38325,35687,135,35822,574
2020-11-25,San Benito,069,59416,1895,1764,13,1777,15
2020-11-25,San Bernardino,071,2135413,99394,88469,1634,90103,1225
2020-11-25,San Diego,073,3302833,83414,75307,3045,78352,988
2020-11-25,San Francisco,075,870044,15774,15053,96,15149,153
2020-11-25,San Joaquin,077,732212,27159,25556,514,26070,515
2020-11-25,San Luis Obispo,079,281455,6528,5913,101,6014,34
2020-11-25,San Mateo,081,765935,14801,13614,16,13630,170
2020-11-25,Santa Barbara,083,443738,11738,11183,200,11383,138
2020-11-25,Santa Clara,085,1922200,36485,32032,86,32118,442
2020-11-25,Santa Cruz,087,273765,4759,4202,58,4260,25
2020-11-25,Shasta,089,179085,5505,4588,191,4779,43
2020-11-25,Sierra,091,2930,18,15,0,15,0
2020-11-25,Siskiyou,093,43540,667,499,31,530,1
2020-11-25,Solano,095,438530,10729,9832,67,9899,87
2020-11-25,Sonoma,097,501317,12640,11775,57,11832,162
2020-11-25,Stanislaus,099,539301,22382,21022,1399,22421,445
2020-11-25,Sutter,101,95872,3568,3064,11,3075,14
2020-11-25,Tehama,103,63373,1780,1587,30,1617,9
2020-11-25,Trinity,105,12862,276,135,25,160,0
2020-11-25,Tulare,107,460477,22040,20528,1410,21938,318
2020-11-25,Tuolumne,109,53932,1099,842,8,850,7
2020-11-25,Ventura,111,848112,20800,18914,640,19554,179
2020-11-25,Yolo,113,214977,5073,4527,16,4543,76
2020-11-25,Yuba,115,75493,2085,1840,9,1849,10
2020-11-24,Alameda,001,1643700,30321,28030,328,28358,444
2020-11-24,Alpine,003,1148,51,41,0,41,0
2020-11-24,Amador,005,37829,554,470,1,471,16
2020-11-24,Butte,007,227075,4144,3798,234,4032,63
2020-11-24,Calaveras,009,45235,497,466,0,466,21
2020-11-24,Colusa,011,21464,754,682,4,686,6
2020-11-24,Contra Costa,013,1133247,24501,23072,154,23226,259
2020-11-24,Del Norte,015,27424,358,298,0,298,2
2020-11-24,El Dorado,017,186661,2718,2005,41,2046,4
2020-11-24,Fresno,019,978130,42177,37021,1345,38366,493
2020-11-24,Glenn,021,27897,987,883,38,921,4
2020-11-24,Humboldt,023,135768,903,774,2,776,9
2020-11-24,Imperial,025,180216,16398,15600,86,15686,355
2020-11-24,Inyo,027,18085,309,282,5,287,15
2020-11-24,Kern,029,883053,41345,38551,1149,39700,465
2020-11-24,Kings,031,150075,11442,10338,143,10481,85
2020-11-24,Lake,033,64148,988,872,0,872,18
2020-11-24,Lassen,035,31185,2173,1657,8,1665,0
2020-11-24,Los Angeles,037,10098052,395570,370008,5855,375863,7501
2020-11-24,Madera,039,155013,6504,5881,142,6023,57
2020-11-24,Marin,041,260295,7785,7591,29,7620,135
2020-11-24,Mariposa,043,17540,126,114,1,115,2
2020-11-24,Mendocino,045,87422,1514,1346,6,1352,22
2020-11-24,Merced,047,269075,11915,11268,101,11369,171
2020-11-24,Modoc,049,8938,117,91,21,112,0
2020-11-24,Mono,051,14174,533,483,10,493,2
2020-11-24,Monterey,053,433212,15537,14354,255,14609,113
2020-11-24,Napa,055,140530,3270,2904,17,2921,17
2020-11-24,Nevada,057,99092,1397,1156,32,1188,9
2020-11-24,Orange,059,3164182,80093,71975,2359,74334,1547
2020-11-24,Placer,061,380077,7386,6147,134,6281,67
2020-11-24,Plumas,063,18699,218,180,0,180,0
2020-11-24,Riverside,065,2383286,92223,83685,1712,85397,1420
2020-11-24,Sacramento,067,1510023,37645,35097,128,35225,568
2020-11-24,San Benito,069,59416,1864,1740,12,1752,15
2020-11-24,San Bernardino,071,2135413,97054,86645,1533,88178,1226
2020-11-24,San Diego,073,3302833,82004,74363,2974,77337,984
2020-11-24,San Francisco,075,870044,15579,14874,92,14966,153
2020-11-24,San Joaquin,077,732212,26846,25318,487,25805,517
2020-11-24,San Luis Obispo,079,281455,6465,5805,100,5905,34
2020-11-24,San Mateo,081,765935,14592,13558,15,13573,170
2020-11-24,Santa Barbara,083,443738,11632,11154,199,11353,138
2020-11-24,Santa Clara,085,1922200,35697,31564,82,31646,438
2020-11-24,Santa Cruz,087,273765,4646,4132,57,4189,25
2020-11-24,Shasta,089,179085,5405,4410,172,4582,43
2020-11-24,Sierra,091,2930,18,15,0,15,0
2020-11-24,Siskiyou,093,43540,649,473,28,501,1
2020-11-24,Solano,095,438530,10557,9716,66,9782,86
2020-11-24,Sonoma,097,501317,12461,11644,54,11698,162
2020-11-24,Stanislaus,099,539301,22140,20830,1356,22186,438
2020-11-24,Sutter,101,95872,3462,2974,11,2985,14
2020-11-24,Tehama,103,63373,1736,1565,25,1590,9
2020-11-24,Trinity,105,12862,269,129,24,153,0
2020-11-24,Tulare,107,460477,21790,20319,1349,21668,315
2020-11-24,Tuolumne,109,53932,1070,832,8,840,7
2020-11-24,Ventura,111,848112,20419,18637,630,19267,179
2020-11-24,Yolo,113,214977,4987,4420,16,4436,76
2020-11-24,Yuba,115,75493,2034,1804,7,1811,10
2020-11-23,Alameda,001,1643700,29904,27718,316,28034,444
2020-11-23,Alpine,003,1148,49,41,0,41,0
2020-11-23,Amador,005,37829,513,457,1,458,16
2020-11-23,Butte,007,227075,4080,3765,228,3993,61
2020-11-23,Calaveras,009,45235,481,434,0,434,21
2020-11-23,Colusa,011,21464,740,662,4,666,6
2020-11-23,Contra Costa,013,1133247,24233,22674,149,22823,260
2020-11-23,Del Norte,015,27424,336,296,0,296,2
2020-11-23,El Dorado,017,186661,2598,2005,40,2045,4
2020-11-23,Fresno,019,978130,41729,36688,1284,37972,488
2020-11-23,Glenn,021,27897,961,853,38,891,4
2020-11-23,Humboldt,023,135768,890,746,2,748,9
2020-11-23,Imperial,025,180216,16235,15104,81,15185,355
2020-11-23,Inyo,027,18085,302,279,5,284,15
2020-11-23,Kern,029,883053,40832,38245,1086,39331,463
2020-11-23,Kings,031,150075,11022,10204,137,10341,85
2020-11-23,Lake,033,64148,965,840,0,840,18
2020-11-23,Lassen,035,31185,2093,1271,7,1278,0
2020-11-23,Los Angeles,037,10098052,389465,366374,5610,371984,7447
2020-11-23,Madera,039,155013,6379,5787,138,5925,56
2020-11-23,Marin,041,260295,7742,7543,29,7572,135
2020-11-23,Mariposa,043,17540,125,97,1,98,2
2020-11-23,Mendocino,045,87422,1484,1330,6,1336,22
2020-11-23,Merced,047,269075,11726,11148,98,11246,169
2020-11-23,Modoc,049,8938,104,91,20,111,0
2020-11-23,Mono,051,14174,520,480,10,490,2
2020-11-23,Monterey,053,433212,15258,14265,249,14514,112
2020-11-23,Napa,055,140530,3203,2811,17,2828,17
2020-11-23,Nevada,057,99092,1308,1087,32,1119,9
2020-11-23,Orange,059,3164182,78687,71074,2315,73389,1546
2020-11-23,Placer,061,380077,7184,5999,133,6132,66
2020-11-23,Plumas,063,18699,214,172,0,172,0
2020-11-23,Riverside,065,2383286,90446,82175,1648,83823,1415
2020-11-23,Sacramento,067,1510023,37074,34141,122,34263,556
2020-11-23,San Benito,069,59416,1836,1729,11,1740,15
2020-11-23,San Bernardino,071,2135413,94946,84387,1469,85856,1224
2020-11-23,San Diego,073,3302833,80541,72817,2886,75703,968
2020-11-23,San Francisco,075,870044,15421,14646,90,14736,153
2020-11-23,San Joaquin,077,732212,26496,24622,483,25105,517
2020-11-23,San Luis Obispo,079,281455,6383,5772,98,5870,34
2020-11-23,San Mateo,081,765935,14402,13364,15,13379,170
2020-11-23,Santa Barbara,083,443738,11525,10944,195,11139,137
2020-11-23,Santa Clara,085,1922200,35043,31064,79,31143,435
2020-11-23,Santa Cruz,087,273765,4536,4003,53,4056,25
2020-11-23,Shasta,089,179085,5287,4100,160,4260,43
2020-11-23,Sierra,091,2930,17,15,0,15,0
2020-11-23,Siskiyou,093,43540,622,460,28,488,0
2020-11-23,Solano,095,438530,10400,9394,63,9457,86
2020-11-23,Sonoma,097,501317,12288,11507,50,11557,160
2020-11-23,Stanislaus,099,539301,21846,20487,1324,21811,436
2020-11-23,Sutter,101,95872,3325,2840,10,2850,14
2020-11-23,Tehama,103,63373,1687,1526,21,1547,9
2020-11-23,Trinity,105,12862,260,120,22,142,0
2020-11-23,Tulare,107,460477,21497,19818,1284,21102,315
2020-11-23,Tuolumne,109,53932,1030,774,8,782,7
2020-11-23,Ventura,111,848112,20044,18480,617,19097,179
2020-11-23,Yolo,113,214977,4906,4265,15,4280,75
2020-11-23,Yuba,115,75493,1967,1702,7,1709,10
2020-11-22,Alameda,001,1643700,29466,27472,305,27777,444
2020-11-22,Alpine,003,1148,46,41,0,41,0
2020-11-22,Amador,005,37829,501,450,1,451,16
2020-11-22,Butte,007,227075,4030,3712,220,3932,61
2020-11-22,Calaveras,009,45235,473,434,0,434,21
2020-11-22,Colusa,011,21464,722,642,3,645,6
2020-11-22,Contra Costa,013,1133247,23928,22407,144,22551,260
2020-11-22,Del Norte,015,27424,312,271,0,271,2
2020-11-22,El Dorado,017,186661,2488,1917,36,1953,4
2020-11-22,Fresno,019,978130,41245,36315,1229,37544,488
2020-11-22,Glenn,021,27897,939,832,34,866,4
2020-11-22,Humboldt,023,135768,874,729,2,731,9
2020-11-22,Imperial,025,180216,16031,15109,36,15145,355
2020-11-22,Inyo,027,18085,295,279,5,284,15
2020-11-22,Kern,029,883053,40253,37904,1053,38957,463
2020-11-22,Kings,031,150075,10923,10035,128,10163,85
2020-11-22,Lake,033,64148,943,834,0,834,18
2020-11-22,Lassen,035,31185,1928,1211,6,1217,0
2020-11-22,Los Angeles,037,10098052,383180,360341,5368,365709,7438
2020-11-22,Madera,039,155013,6297,5745,127,5872,56
2020-11-22,Marin,041,260295,7708,7506,28,7534,135
2020-11-22,Mariposa,043,17540,124,95,1,96,2
2020-11-22,Mendocino,045,87422,1460,1285,5,1290,22
2020-11-22,Merced,047,269075,11577,10939,98,11037,169
2020-11-22,Modoc,049,8938,103,87,19,106,0
2020-11-22,Mono,051,14174,505,481,10,491,2
2020-11-22,Monterey,053,433212,15017,13887,244,14131,111
2020-11-22,Napa,055,140530,3124,2778,17,2795,17
2020-11-22,Nevada,057,99092,1250,1052,32,1084,9
2020-11-22,Orange,059,3164182,77270,69913,2277,72190,1546
2020-11-22,Placer,061,380077,6958,5880,123,6003,66
2020-11-22,Plumas,063,18699,201,172,0,172,0
2020-11-22,Riverside,065,2383286,88847,81565,1589,83154,1409
2020-11-22,Sacramento,067,1510023,36340,33421,109,33530,555
2020-11-22,San Benito,069,59416,1807,1704,11,1715,15
2020-11-22,San Bernardino,071,2135413,92607,83505,1399,84904,1224
2020-11-22,San Diego,073,3302833,78804,71649,2811,74460,968
2020-11-22,San Francisco,075,870044,15251,14515,89,14604,153
2020-11-22,San Joaquin,077,732212,26196,24619,471,25090,517
2020-11-22,San Luis Obispo,079,281455,6276,5664,97,5761,34
2020-11-22,San Mateo,081,765935,14197,13228,15,13243,170
2020-11-22,Santa Barbara,083,443738,11390,10946,190,11136,137
2020-11-22,Santa Clara,085,1922200,34365,30633,77,30710,434
2020-11-22,Santa Cruz,087,273765,4454,3896,46,3942,25
2020-11-22,Shasta,089,179085,5131,4100,142,4242,43
2020-11-22,Sierra,091,2930,17,13,0,13,0
2020-11-22,Siskiyou,093,43540,591,411,28,439,0
2020-11-22,Solano,095,438530,10226,9363,59,9422,86
2020-11-22,Sonoma,097,501317,12130,11415,48,11463,159
2020-11-22,Stanislaus,099,539301,21522,20223,1294,21517,436
2020-11-22,Sutter,101,95872,3208,2677,10,2687,13
2020-11-22,Tehama,103,63373,1650,1457,17,1474,9
2020-11-22,Trinity,105,12862,254,114,22,136,0
2020-11-22,Tulare,107,460477,21243,19818,1218,21036,314
2020-11-22,Tuolumne,109,53932,1003,689,8,697,7
2020-11-22,Ventura,111,848112,19683,18105,604,18709,179
2020-11-22,Yolo,113,214977,4806,4206,15,4221,75
2020-11-22,Yuba,115,75493,1914,1672,7,1679,10
2020-11-21,Alameda,001,1643700,29279,27424,303,27727,444
2020-11-21,Alpine,003,1148,46,41,0,41,0
2020-11-21,Amador,005,37829,487,450,1,451,16
2020-11-21,Butte,007,227075,3982,3664,217,3881,61
2020-11-21,Calaveras,009,45235,465,434,0,434,21
2020-11-21,Colusa,011,21464,713,642,3,645,6
2020-11-21,Contra Costa,013,1133247,23774,22338,142,22480,260
2020-11-21,Del Norte,015,27424,307,271,0,271,2
2020-11-21,El Dorado,017,186661,2439,1900,35,1935,4
2020-11-21,Fresno,019,978130,40991,35973,1194,37167,482
2020-11-21,Glenn,021,27897,934,829,32,861,4
2020-11-21,Humboldt,023,135768,864,728,2,730,9
2020-11-21,Imperial,025,180216,15951,15053,36,15089,355
2020-11-21,Inyo,027,18085,293,283,5,288,15
2020-11-21,Kern,029,883053,39997,37403,1018,38421,463
2020-11-21,Kings,031,150075,10875,10019,124,10143,85
2020-11-21,Lake,033,64148,930,832,0,832,18
2020-11-21,Lassen,035,31185,1861,1211,6,1217,0
2020-11-21,Los Angeles,037,10098052,379995,357754,5228,362982,7428
2020-11-21,Madera,039,155013,6259,5706,127,5833,56
2020-11-21,Marin,041,260295,7685,7488,27,7515,134
2020-11-21,Mariposa,043,17540,124,92,1,93,2
2020-11-21,Mendocino,045,87422,1429,1282,5,1287,22
2020-11-21,Merced,047,269075,11516,10849,97,10946,169
2020-11-21,Modoc,049,8938,99,87,18,105,0
2020-11-21,Mono,051,14174,500,469,10,479,2
2020-11-21,Monterey,053,433212,14919,13886,239,14125,110
2020-11-21,Napa,055,140530,3090,2757,17,2774,17
2020-11-21,Nevada,057,99092,1238,1018,31,1049,9
2020-11-21,Orange,059,3164182,76466,69021,2247,71268,1543
2020-11-21,Placer,061,380077,6843,5778,120,5898,65
2020-11-21,Plumas,063,18699,196,172,0,172,0
2020-11-21,Riverside,065,2383286,88070,80676,1543,82219,1407
2020-11-21,Sacramento,067,1510023,35944,33133,101,33234,548
2020-11-21,San Benito,069,59416,1788,1691,11,1702,15
2020-11-21,San Bernardino,071,2135413,91730,83206,1323,84529,1222
2020-11-21,San Diego,073,3302833,78025,70711,2756,73467,966
2020-11-21,San Francisco,075,870044,15147,14445,88,14533,153
2020-11-21,San Joaquin,077,732212,26063,24620,456,25076,517
2020-11-21,San Luis Obispo,079,281455,6223,5618,94,5712,34
2020-11-21,San Mateo,081,765935,14096,13138,15,13153,170
2020-11-21,Santa Barbara,083,443738,11338,10922,187,11109,137
2020-11-21,Santa Clara,085,1922200,33981,30377,74,30451,433
2020-11-21,Santa Cruz,087,273765,4397,3898,46,3944,25
2020-11-21,Shasta,089,179085,5058,4095,139,4234,42
2020-11-21,Sierra,091,2930,17,13,0,13,0
2020-11-21,Siskiyou,093,43540,575,403,28,431,0
2020-11-21,Solano,095,438530,10136,9290,56,9346,86
2020-11-21,Sonoma,097,501317,12055,11394,47,11441,158
2020-11-21,Stanislaus,099,539301,21379,20111,1270,21381,435
2020-11-21,Sutter,101,95872,3148,2615,9,2624,13
2020-11-21,Tehama,103,63373,1630,1435,16,1451,9
2020-11-21,Trinity,105,12862,251,110,22,132,0
2020-11-21,Tulare,107,460477,21116,19752,1184,20936,313
2020-11-21,Tuolumne,109,53932,984,690,8,698,7
2020-11-21,Ventura,111,848112,19520,18040,594,18634,177
2020-11-21,Yolo,113,214977,4732,4147,14,4161,75
2020-11-21,Yuba,115,75493,1882,1643,7,1650,10
2020-11-20,Alameda,001,1643700,29065,27221,296,27517,444
2020-11-20,Alpine,003,1148,46,20,0,20,0
2020-11-20,Amador,005,37829,483,446,1,447,16
2020-11-20,Butte,007,227075,3950,3618,213,3831,60
2020-11-20,Calaveras,009,45235,455,424,0,424,21
2020-11-20,Colusa,011,21464,705,631,2,633,6
2020-11-20,Contra Costa,013,1133247,23589,22116,138,22254,260
2020-11-20,Del Norte,015,27424,304,264,0,264,2
2020-11-20,El Dorado,017,186661,2342,1868,33,1901,4
2020-11-20,Fresno,019,978130,40697,35635,1165,36800,480
2020-11-20,Glenn,021,27897,922,826,30,856,4
2020-11-20,Humboldt,023,135768,855,714,1,715,9
2020-11-20,Imperial,025,180216,15887,14864,32,14896,353
2020-11-20,Inyo,027,18085,291,262,5,267,15
2020-11-20,Kern,029,883053,39703,37143,993,38136,462
2020-11-20,Kings,031,150075,10827,9903,123,10026,85
2020-11-20,Lake,033,64148,921,820,0,820,18
2020-11-20,Lassen,035,31185,1776,1212,5,1217,0
2020-11-20,Los Angeles,037,10098052,376098,353554,5067,358621,7398
2020-11-20,Madera,039,155013,6165,5635,126,5761,54
2020-11-20,Marin,041,260295,7661,7467,26,7493,134
2020-11-20,Mariposa,043,17540,116,89,1,90,2
2020-11-20,Mendocino,045,87422,1409,1269,5,1274,22
2020-11-20,Merced,047,269075,11431,10729,97,10826,167
2020-11-20,Modoc,049,8938,99,83,18,101,0
2020-11-20,Mono,051,14174,498,469,10,479,2
2020-11-20,Monterey,053,433212,14794,13738,230,13968,110
2020-11-20,Napa,055,140530,3060,2718,17,2735,17
2020-11-20,Nevada,057,99092,1220,990,30,1020,9
2020-11-20,Orange,059,3164182,75630,68212,2210,70422,1532
2020-11-20,Placer,061,380077,6708,5687,105,5792,66
2020-11-20,Plumas,063,18699,194,163,0,163,0
2020-11-20,Riverside,065,2383286,87058,79613,1483,81096,1405
2020-11-20,Sacramento,067,1510023,35568,32832,94,32926,549
2020-11-20,San Benito,069,59416,1776,1668,11,1679,15
2020-11-20,San Bernardino,071,2135413,90360,81203,1241,82444,1220
2020-11-20,San Diego,073,3302833,77027,69233,2674,71907,960
2020-11-20,San Francisco,075,870044,15044,14327,87,14414,153
2020-11-20,San Joaquin,077,732212,25910,24460,443,24903,515
2020-11-20,San Luis Obispo,079,281455,6168,5524,91,5615,34
2020-11-20,San Mateo,081,765935,13963,12980,14,12994,169
2020-11-20,Santa Barbara,083,443738,11282,10825,181,11006,136
2020-11-20,Santa Clara,085,1922200,33560,30002,69,30071,431
2020-11-20,Santa Cruz,087,273765,4332,3815,46,3861,25
2020-11-20,Shasta,089,179085,4985,3861,134,3995,42
2020-11-20,Sierra,091,2930,17,12,0,12,0
2020-11-20,Siskiyou,093,43540,561,387,27,414,0
2020-11-20,Solano,095,438530,10043,9216,54,9270,85
2020-11-20,Sonoma,097,501317,11971,11316,46,11362,158
2020-11-20,Stanislaus,099,539301,21222,19889,1244,21133,433
2020-11-20,Sutter,101,95872,3098,2580,9,2589,13
2020-11-20,Tehama,103,63373,1613,1410,13,1423,9
2020-11-20,Trinity,105,12862,250,102,22,124,0
2020-11-20,Tulare,107,460477,20983,19568,1146,20714,311
2020-11-20,Tuolumne,109,53932,945,662,8,670,7
2020-11-20,Ventura,111,848112,19352,17741,567,18308,175
2020-11-20,Yolo,113,214977,4653,4081,13,4094,74
2020-11-20,Yuba,115,75493,1854,1611,7,1618,10
2020-11-19,Alameda,001,1643700,28719,26971,288,27259,441
2020-11-19,Alpine,003,1148,43,20,0,20,0
2020-11-19,Amador,005,37829,479,436,1,437,16
2020-11-19,Butte,007,227075,3901,3576,206,3782,60
2020-11-19,Calaveras,009,45235,444,417,0,417,21
2020-11-19,Colusa,011,21464,687,621,2,623,6
2020-11-19,Contra Costa,013,1133247,23318,21886,135,22021,259
2020-11-19,Del Norte,015,27424,296,251,0,251,2
2020-11-19,El Dorado,017,186661,2268,1825,29,1854,4
2020-11-19,Fresno,019,978130,40248,35278,1109,36387,478
2020-11-19,Glenn,021,27897,900,806,29,835,4
2020-11-19,Humboldt,023,135768,835,693,1,694,9
2020-11-19,Imperial,025,180216,15677,14507,32,14539,349
2020-11-19,Inyo,027,18085,289,262,5,267,15
2020-11-19,Kern,029,883053,39283,36779,951,37730,459
2020-11-19,Kings,031,150075,10679,9763,116,9879,85
2020-11-19,Lake,033,64148,907,809,0,809,18
2020-11-19,Lassen,035,31185,1659,1201,3,1204,0
2020-11-19,Los Angeles,037,10098052,371071,349493,4904,354397,7365
2020-11-19,Madera,039,155013,6093,5540,118,5658,54
2020-11-19,Marin,041,260295,7630,7451,26,7477,134
2020-11-19,Mariposa,043,17540,109,88,0,88,2
2020-11-19,Mendocino,045,87422,1388,1237,5,1242,23
2020-11-19,Merced,047,269075,11291,10634,91,10725,167
2020-11-19,Modoc,049,8938,96,82,18,100,0
2020-11-19,Mono,051,14174,490,468,10,478,2
2020-11-19,Monterey,053,433212,14580,13369,219,13588,108
2020-11-19,Napa,055,140530,3006,2641,17,2658,17
2020-11-19,Nevada,057,99092,1179,945,29,974,9
2020-11-19,Orange,059,3164182,74365,66998,2168,69166,1530
2020-11-19,Placer,061,380077,6517,5612,104,5716,65
2020-11-19,Plumas,063,18699,189,158,0,158,0
2020-11-19,Riverside,065,2383286,85575,78535,1412,79947,1402
2020-11-19,Sacramento,067,1510023,35054,32367,92,32459,546
2020-11-19,San Benito,069,59416,1753,1643,11,1654,15
2020-11-19,San Bernardino,071,2135413,88462,79244,1163,80407,1215
2020-11-19,San Diego,073,3302833,75777,68142,2570,70712,952
2020-11-19,San Francisco,075,870044,14888,14178,81,14259,153
2020-11-19,San Joaquin,077,732212,25591,24270,433,24703,516
2020-11-19,San Luis Obispo,079,281455,6091,5410,87,5497,34
2020-11-19,San Mateo,081,765935,13825,12714,14,12728,169
2020-11-19,Santa Barbara,083,443738,11202,10741,178,10919,136
2020-11-19,Santa Clara,085,1922200,33006,29630,68,29698,424
2020-11-19,Santa Cruz,087,273765,4240,3679,44,3723,25
2020-11-19,Shasta,089,179085,4847,3685,124,3809,42
2020-11-19,Sierra,091,2930,17,11,0,11,0
2020-11-19,Siskiyou,093,43540,536,360,26,386,0
2020-11-19,Solano,095,438530,9906,9093,50,9143,84
2020-11-19,Sonoma,097,501317,11801,11205,44,11249,156
2020-11-19,Stanislaus,099,539301,20981,19736,1201,20937,433
2020-11-19,Sutter,101,95872,2999,2509,9,2518,13
2020-11-19,Tehama,103,63373,1578,1373,10,1383,9
2020-11-19,Trinity,105,12862,244,97,22,119,0
2020-11-19,Tulare,107,460477,20762,19384,1083,20467,304
2020-11-19,Tuolumne,109,53932,914,602,8,610,7
2020-11-19,Ventura,111,848112,18999,17300,554,17854,174
2020-11-19,Yolo,113,214977,4559,3973,13,3986,72
2020-11-19,Yuba,115,75493,1814,1568,7,1575,10
2020-11-18,Alameda,001,1643700,28455,26610,283,26893,440
2020-11-18,Alpine,003,1148,42,16,0,16,0
2020-11-18,Amador,005,37829,474,430,1,431,16
2020-11-18,Butte,007,227075,3848,3537,193,3730,59
2020-11-18,Calaveras,009,45235,438,409,0,409,21
2020-11-18,Colusa,011,21464,674,611,2,613,6
2020-11-18,Contra Costa,013,1133247,23054,21685,132,21817,258
2020-11-18,Del Norte,015,27424,284,240,0,240,2
2020-11-18,El Dorado,017,186661,2180,1799,28,1827,4
2020-11-18,Fresno,019,978130,39808,34997,1060,36057,474
2020-11-18,Glenn,021,27897,883,803,27,830,4
2020-11-18,Humboldt,023,135768,820,690,1,691,9
2020-11-18,Imperial,025,180216,15451,14428,32,14460,348
2020-11-18,Inyo,027,18085,287,262,5,267,15
2020-11-18,Kern,029,883053,38893,36537,902,37439,456
2020-11-18,Kings,031,150075,10531,9696,113,9809,85
2020-11-18,Lake,033,64148,895,802,0,802,18
2020-11-18,Lassen,035,31185,1559,1124,3,1127,0
2020-11-18,Los Angeles,037,10098052,366193,344675,4727,349402,7338
2020-11-18,Madera,039,155013,6006,5519,106,5625,54
2020-11-18,Marin,041,260295,7606,7435,26,7461,134
2020-11-18,Mariposa,043,17540,106,88,0,88,2
2020-11-18,Mendocino,045,87422,1368,1237,5,1242,23
2020-11-18,Merced,047,269075,11175,10536,90,10626,166
2020-11-18,Modoc,049,8938,93,77,18,95,0
2020-11-18,Mono,051,14174,485,468,10,478,2
2020-11-18,Monterey,053,433212,14385,13340,205,13545,108
2020-11-18,Napa,055,140530,2961,2607,17,2624,17
2020-11-18,Nevada,057,99092,1139,933,27,960,9
2020-11-18,Orange,059,3164182,73270,66381,2143,68524,1521
2020-11-18,Placer,061,380077,6339,5543,99,5642,64
2020-11-18,Plumas,063,18699,184,143,0,143,0
2020-11-18,Riverside,065,2383286,84112,77739,1311,79050,1387
2020-11-18,Sacramento,067,1510023,34429,31816,84,31900,541
2020-11-18,San Benito,069,59416,1728,1632,10,1642,15
2020-11-18,San Bernardino,071,2135413,86703,77400,1084,78484,1206
2020-11-18,San Diego,073,3302833,74483,67243,2510,69753,945
2020-11-18,San Francisco,075,870044,14744,14057,79,14136,153
2020-11-18,San Joaquin,077,732212,25329,24146,419,24565,517
2020-11-18,San Luis Obispo,079,281455,6015,5322,86,5408,34
2020-11-18,San Mateo,081,765935,13672,12631,13,12644,169
2020-11-18,Santa Barbara,083,443738,11123,10684,171,10855,136
2020-11-18,Santa Clara,085,1922200,32540,29285,64,29349,421
2020-11-18,Santa Cruz,087,273765,4151,3618,42,3660,25
2020-11-18,Shasta,089,179085,4714,3547,120,3667,42
2020-11-18,Sierra,091,2930,17,11,0,11,0
2020-11-18,Siskiyou,093,43540,504,351,25,376,0
2020-11-18,Solano,095,438530,9774,8994,48,9042,84
2020-11-18,Sonoma,097,501317,11694,11129,41,11170,155
2020-11-18,Stanislaus,099,539301,20739,19609,1177,20786,431
2020-11-18,Sutter,101,95872,2881,2442,9,2451,13
2020-11-18,Tehama,103,63373,1540,1338,10,1348,8
2020-11-18,Trinity,105,12862,230,95,21,116,0
2020-11-18,Tulare,107,460477,20551,19286,1032,20318,306
2020-11-18,Tuolumne,109,53932,879,590,8,598,7
2020-11-18,Ventura,111,848112,18674,17169,539,17708,173
2020-11-18,Yolo,113,214977,4486,3929,13,3942,71
2020-11-18,Yuba,115,75493,1760,1540,7,1547,10
2020-11-17,Alameda,001,1643700,28128,26425,272,26697,439
2020-11-17,Alpine,003,1148,40,12,0,12,0
2020-11-17,Amador,005,37829,463,423,1,424,16
2020-11-17,Butte,007,227075,3806,3500,182,3682,59
2020-11-17,Calaveras,009,45235,421,405,0,405,21
2020-11-17,Colusa,011,21464,663,606,1,607,6
2020-11-17,Contra Costa,013,1133247,22783,21557,127,21684,256
2020-11-17,Del Norte,015,27424,278,233,0,233,2
2020-11-17,El Dorado,017,186661,2121,1758,28,1786,4
2020-11-17,Fresno,019,978130,39210,34765,1001,35766,472
2020-11-17,Glenn,021,27897,872,795,26,821,4
2020-11-17,Humboldt,023,135768,798,685,1,686,9
2020-11-17,Imperial,025,180216,15213,14204,30,14234,346
2020-11-17,Inyo,027,18085,286,263,5,268,15
2020-11-17,Kern,029,883053,38444,36164,849,37013,455
2020-11-17,Kings,031,150075,10458,9653,105,9758,85
2020-11-17,Lake,033,64148,875,792,0,792,18
2020-11-17,Lassen,035,31185,1480,1124,3,1127,0
2020-11-17,Los Angeles,037,10098052,361241,340933,4570,345503,7302
2020-11-17,Madera,039,155013,5918,5485,99,5584,54
2020-11-17,Marin,041,260295,7574,7404,25,7429,134
2020-11-17,Mariposa,043,17540,103,87,0,87,2
2020-11-17,Mendocino,045,87422,1347,1216,5,1221,23
2020-11-17,Merced,047,269075,11031,10457,84,10541,162
2020-11-17,Modoc,049,8938,87,71,17,88,0
2020-11-17,Mono,051,14174,480,459,10,469,2
2020-11-17,Monterey,053,433212,14156,13220,195,13415,108
2020-11-17,Napa,055,140530,2907,2568,17,2585,17
2020-11-17,Nevada,057,99092,1098,918,26,944,9
2020-11-17,Orange,059,3164182,72118,65757,2117,67874,1519
2020-11-17,Placer,061,380077,6177,5435,93,5528,63
2020-11-17,Plumas,063,18699,176,142,0,142,0
2020-11-17,Riverside,065,2383286,82726,77079,1220,78299,1379
2020-11-17,Sacramento,067,1510023,33831,31341,80,31421,538
2020-11-17,San Benito,069,59416,1712,1611,4,1615,15
2020-11-17,San Bernardino,071,2135413,84894,76134,995,77129,1188
2020-11-17,San Diego,073,3302833,73230,66321,2454,68775,933
2020-11-17,San Francisco,075,870044,14578,13952,78,14030,153
2020-11-17,San Joaquin,077,732212,25053,23997,399,24396,516
2020-11-17,San Luis Obispo,079,281455,5919,5235,86,5321,34
2020-11-17,San Mateo,081,765935,13512,12491,12,12503,169
2020-11-17,Santa Barbara,083,443738,11038,10597,166,10763,136
2020-11-17,Santa Clara,085,1922200,31992,29013,63,29076,419
2020-11-17,Santa Cruz,087,273765,4065,3548,39,3587,25
2020-11-17,Shasta,089,179085,4556,3457,108,3565,40
2020-11-17,Sierra,091,2930,15,11,0,11,0
2020-11-17,Siskiyou,093,43540,456,333,24,357,0
2020-11-17,Solano,095,438530,9629,8905,47,8952,84
2020-11-17,Sonoma,097,501317,11560,11084,40,11124,155
2020-11-17,Stanislaus,099,539301,20516,19466,1150,20616,425
2020-11-17,Sutter,101,95872,2798,2370,8,2378,12
2020-11-17,Tehama,103,63373,1487,1290,10,1300,7
2020-11-17,Trinity,105,12862,213,83,21,104,0
2020-11-17,Tulare,107,460477,20323,19176,971,20147,305
2020-11-17,Tuolumne,109,53932,840,568,8,576,7
2020-11-17,Ventura,111,848112,18402,16797,521,17318,173
2020-11-17,Yolo,113,214977,4310,3887,12,3899,70
2020-11-17,Yuba,115,75493,1712,1519,7,1526,10
2020-11-16,Alameda,001,1643700,27781,26063,267,26330,436
2020-11-16,Alpine,003,1148,37,12,0,12,0
2020-11-16,Amador,005,37829,455,414,1,415,16
2020-11-16,Butte,007,227075,3767,3490,174,3664,58
2020-11-16,Calaveras,009,45235,413,402,0,402,21
2020-11-16,Colusa,011,21464,654,601,1,602,6
2020-11-16,Contra Costa,013,1133247,22517,21386,122,21508,256
2020-11-16,Del Norte,015,27424,271,225,0,225,2
2020-11-16,El Dorado,017,186661,2061,1694,26,1720,4
2020-11-16,Fresno,019,978130,38720,34593,949,35542,471
2020-11-16,Glenn,021,27897,860,786,25,811,4
2020-11-16,Humboldt,023,135768,782,660,1,661,9
2020-11-16,Imperial,025,180216,14965,14111,30,14141,346
2020-11-16,Inyo,027,18085,283,263,5,268,15
2020-11-16,Kern,029,883053,38049,36049,807,36856,455
2020-11-16,Kings,031,150075,10191,9569,101,9670,85
2020-11-16,Lake,033,64148,864,784,0,784,18
2020-11-16,Lassen,035,31185,1299,1124,3,1127,0
2020-11-16,Los Angeles,037,10098052,356485,338778,4402,343180,7277
2020-11-16,Madera,039,155013,5833,5433,93,5526,54
2020-11-16,Marin,041,260295,7543,7359,24,7383,134
2020-11-16,Mariposa,043,17540,100,86,0,86,2
2020-11-16,Mendocino,045,87422,1322,1209,5,1214,23
2020-11-16,Merced,047,269075,10892,10399,81,10480,162
2020-11-16,Modoc,049,8938,85,71,17,88,0
2020-11-16,Mono,051,14174,478,453,10,463,2
2020-11-16,Monterey,053,433212,13910,13089,185,13274,107
2020-11-16,Napa,055,140530,2833,2536,17,2553,17
2020-11-16,Nevada,057,99092,1055,889,24,913,9
2020-11-16,Orange,059,3164182,71023,65396,2103,67499,1519
2020-11-16,Placer,061,380077,6058,5387,85,5472,63
2020-11-16,Plumas,063,18699,169,127,0,127,0
2020-11-16,Riverside,065,2383286,81351,76449,1156,77605,1379
2020-11-16,Sacramento,067,1510023,33193,30954,73,31027,534
2020-11-16,San Benito,069,59416,1694,1603,3,1606,15
2020-11-16,San Bernardino,071,2135413,83068,74401,929,75330,1186
2020-11-16,San Diego,073,3302833,71919,65603,2382,67985,926
2020-11-16,San Francisco,075,870044,14420,13847,76,13923,153
2020-11-16,San Joaquin,077,732212,24765,23515,389,23904,513
2020-11-16,San Luis Obispo,079,281455,5816,5161,82,5243,34
2020-11-16,San Mateo,081,765935,13352,12398,12,12410,169
2020-11-16,Santa Barbara,083,443738,10973,10565,162,10727,135
2020-11-16,Santa Clara,085,1922200,31430,28673,62,28735,419
2020-11-16,Santa Cruz,087,273765,3992,3520,39,3559,25
2020-11-16,Shasta,089,179085,4408,3284,103,3387,37
2020-11-16,Sierra,091,2930,15,11,0,11,0
2020-11-16,Siskiyou,093,43540,429,294,24,318,0
2020-11-16,Solano,095,438530,9430,8827,47,8874,84
2020-11-16,Sonoma,097,501317,11469,10961,39,11000,155
2020-11-16,Stanislaus,099,539301,20279,19333,1123,20456,425
2020-11-16,Sutter,101,95872,2692,2322,8,2330,12
2020-11-16,Tehama,103,63373,1442,1261,7,1268,7
2020-11-16,Trinity,105,12862,201,67,21,88,0
2020-11-16,Tulare,107,460477,20145,18891,918,19809,305
2020-11-16,Tuolumne,109,53932,803,543,8,551,7
2020-11-16,Ventura,111,848112,18064,16691,513,17204,172
2020-11-16,Yolo,113,214977,4215,3858,12,3870,70
2020-11-16,Yuba,115,75493,1676,1500,6,1506,10
2020-11-15,Alameda,001,1643700,27464,25879,262,26141,436
2020-11-15,Alpine,003,1148,35,12,0,12,0
2020-11-15,Amador,005,37829,443,409,1,410,16
2020-11-15,Butte,007,227075,3713,3452,165,3617,58
2020-11-15,Calaveras,009,45235,398,386,0,386,21
2020-11-15,Colusa,011,21464,645,601,1,602,6
2020-11-15,Contra Costa,013,1133247,22219,21179,121,21300,256
2020-11-15,Del Norte,015,27424,257,224,0,224,2
2020-11-15,El Dorado,017,186661,1999,1683,25,1708,4
2020-11-15,Fresno,019,978130,38209,34297,911,35208,471
2020-11-15,Glenn,021,27897,848,783,24,807,4
2020-11-15,Humboldt,023,135768,754,653,1,654,9
2020-11-15,Imperial,025,180216,14730,13940,30,13970,346
2020-11-15,Inyo,027,18085,273,263,5,268,15
2020-11-15,Kern,029,883053,37643,35911,772,36683,455
2020-11-15,Kings,031,150075,9998,9533,98,9631,85
2020-11-15,Lake,033,64148,854,777,0,777,17
2020-11-15,Lassen,035,31185,1252,1124,3,1127,0
2020-11-15,Los Angeles,037,10098052,351437,336035,4234,340269,7271
2020-11-15,Madera,039,155013,5735,5391,87,5478,54
2020-11-15,Marin,041,260295,7516,7347,24,7371,133
2020-11-15,Mariposa,043,17540,97,86,0,86,2
2020-11-15,Mendocino,045,87422,1303,1197,5,1202,22
2020-11-15,Merced,047,269075,10759,10350,81,10431,162
2020-11-15,Modoc,049,8938,84,68,17,85,0
2020-11-15,Mono,051,14174,476,453,10,463,2
2020-11-15,Monterey,053,433212,13714,12999,172,13171,107
2020-11-15,Napa,055,140530,2774,2509,15,2524,17
2020-11-15,Nevada,057,99092,999,859,24,883,9
2020-11-15,Orange,059,3164182,69979,65008,2087,67095,1519
2020-11-15,Placer,061,380077,5903,5330,77,5407,63
2020-11-15,Plumas,063,18699,163,127,0,127,0
2020-11-15,Riverside,065,2383286,80029,75531,1098,76629,1374
2020-11-15,Sacramento,067,1510023,32567,30601,68,30669,534
2020-11-15,San Benito,069,59416,1669,1589,2,1591,15
2020-11-15,San Bernardino,071,2135413,80919,73769,854,74623,1185
2020-11-15,San Diego,073,3302833,70418,64770,2325,67095,926
2020-11-15,San Francisco,075,870044,14244,13757,75,13832,153
2020-11-15,San Joaquin,077,732212,24555,23516,374,23890,513
2020-11-15,San Luis Obispo,079,281455,5695,5120,80,5200,34
2020-11-15,San Mateo,081,765935,13175,12348,12,12360,169
2020-11-15,Santa Barbara,083,443738,10878,10516,160,10676,135
2020-11-15,Santa Clara,085,1922200,30972,28289,61,28350,418
2020-11-15,Santa Cruz,087,273765,3851,3439,38,3477,25
2020-11-15,Shasta,089,179085,4235,3290,94,3384,37
2020-11-15,Sierra,091,2930,15,11,0,11,0
2020-11-15,Siskiyou,093,43540,410,294,24,318,0
2020-11-15,Solano,095,438530,9269,8713,44,8757,84
2020-11-15,Sonoma,097,501317,11351,10833,38,10871,154
2020-11-15,Stanislaus,099,539301,20005,19228,1098,20326,425
2020-11-15,Sutter,101,95872,2602,2230,8,2238,12
2020-11-15,Tehama,103,63373,1391,1222,6,1228,7
2020-11-15,Trinity,105,12862,191,67,19,86,0
2020-11-15,Tulare,107,460477,19927,18891,866,19757,305
2020-11-15,Tuolumne,109,53932,761,486,8,494,7
2020-11-15,Ventura,111,848112,17790,16564,505,17069,172
2020-11-15,Yolo,113,214977,4112,3819,12,3831,67
2020-11-15,Yuba,115,75493,1635,1470,5,1475,10
2020-11-14,Alameda,001,1643700,27197,25714,260,25974,435
2020-11-14,Alpine,003,1148,35,12,0,12,0
2020-11-14,Amador,005,37829,434,404,0,404,16
2020-11-14,Butte,007,227075,3677,3434,151,3585,58
2020-11-14,Calaveras,009,45235,397,386,0,386,21
2020-11-14,Colusa,011,21464,633,601,1,602,6
2020-11-14,Contra Costa,013,1133247,22077,20975,114,21089,256
2020-11-14,Del Norte,015,27424,250,219,0,219,2
2020-11-14,El Dorado,017,186661,1955,1648,25,1673,4
2020-11-14,Fresno,019,978130,37959,33969,875,34844,471
2020-11-14,Glenn,021,27897,839,772,21,793,3
2020-11-14,Humboldt,023,135768,739,643,1,644,9
2020-11-14,Imperial,025,180216,14637,13932,29,13961,346
2020-11-14,Inyo,027,18085,272,263,5,268,15
2020-11-14,Kern,029,883053,37433,35626,753,36379,454
2020-11-14,Kings,031,150075,9963,9490,95,9585,85
2020-11-14,Lake,033,64148,845,773,0,773,17
2020-11-14,Lassen,035,31185,1238,833,3,836,0
2020-11-14,Los Angeles,037,10098052,348729,333021,4125,337146,7269
2020-11-14,Madera,039,155013,5704,5371,85,5456,54
2020-11-14,Marin,041,260295,7499,7325,24,7349,133
2020-11-14,Mariposa,043,17540,96,86,0,86,2
2020-11-14,Mendocino,045,87422,1287,1181,5,1186,22
2020-11-14,Merced,047,269075,10703,10286,79,10365,161
2020-11-14,Modoc,049,8938,83,64,16,80,0
2020-11-14,Mono,051,14174,476,453,10,463,2
2020-11-14,Monterey,053,433212,13618,12854,162,13016,105
2020-11-14,Napa,055,140530,2740,2473,15,2488,17
2020-11-14,Nevada,057,99092,983,835,24,859,9
2020-11-14,Orange,059,3164182,69356,64340,2076,66416,1517
2020-11-14,Placer,061,380077,5827,5215,71,5286,63
2020-11-14,Plumas,063,18699,158,128,0,128,0
2020-11-14,Riverside,065,2383286,79289,74910,1059,75969,1373
2020-11-14,Sacramento,067,1510023,32241,30298,68,30366,532
2020-11-14,San Benito,069,59416,1654,1573,2,1575,15
2020-11-14,San Bernardino,071,2135413,79984,72868,823,73691,1184
2020-11-14,San Diego,073,3302833,69653,63715,2273,65988,926
2020-11-14,San Francisco,075,870044,14157,13661,74,13735,153
2020-11-14,San Joaquin,077,732212,24462,23516,367,23883,511
2020-11-14,San Luis Obispo,079,281455,5632,5073,75,5148,34
2020-11-14,San Mateo,081,765935,13067,12293,12,12305,169
2020-11-14,Santa Barbara,083,443738,10824,10482,158,10640,135
2020-11-14,Santa Clara,085,1922200,30687,27962,59,28021,416
2020-11-14,Santa Cruz,087,273765,3796,3402,38,3440,25
2020-11-14,Shasta,089,179085,4154,3195,92,3287,37
2020-11-14,Sierra,091,2930,15,11,0,11,0
2020-11-14,Siskiyou,093,43540,397,292,24,316,0
2020-11-14,Solano,095,438530,9190,8655,44,8699,84
2020-11-14,Sonoma,097,501317,11298,10769,38,10807,154
2020-11-14,Stanislaus,099,539301,19862,19068,1076,20144,424
2020-11-14,Sutter,101,95872,2557,2182,8,2190,12
2020-11-14,Tehama,103,63373,1369,1206,5,1211,7
2020-11-14,Trinity,105,12862,186,67,19,86,0
2020-11-14,Tulare,107,460477,19834,18853,838,19691,305
2020-11-14,Tuolumne,109,53932,733,448,8,456,7
2020-11-14,Ventura,111,848112,17644,16297,494,16791,172
2020-11-14,Yolo,113,214977,4068,3765,10,3775,65
2020-11-14,Yuba,115,75493,1606,1453,5,1458,10
2020-11-13,Alameda,001,1643700,26981,25515,255,25770,434
2020-11-13,Alpine,003,1148,35,12,0,12,0
2020-11-13,Amador,005,37829,431,397,0,397,16
2020-11-13,Butte,007,227075,3653,3402,141,3543,58
2020-11-13,Calaveras,009,45235,393,378,0,378,21
2020-11-13,Colusa,011,21464,625,598,1,599,6
2020-11-13,Contra Costa,013,1133247,21903,20799,114,20913,256
2020-11-13,Del Norte,015,27424,247,208,0,208,2
2020-11-13,El Dorado,017,186661,1910,1611,24,1635,4
2020-11-13,Fresno,019,978130,37713,33693,861,34554,470
2020-11-13,Glenn,021,27897,825,755,17,772,3
2020-11-13,Humboldt,023,135768,724,638,1,639,9
2020-11-13,Imperial,025,180216,14566,13790,28,13818,341
2020-11-13,Inyo,027,18085,271,262,5,267,15
2020-11-13,Kern,029,883053,37231,35431,736,36167,453
2020-11-13,Kings,031,150075,9904,9428,94,9522,85
2020-11-13,Lake,033,64148,839,770,0,770,17
2020-11-13,Lassen,035,31185,1229,832,3,835,0
2020-11-13,Los Angeles,037,10098052,345599,329364,4023,333387,7248
2020-11-13,Madera,039,155013,5664,5340,84,5424,54
2020-11-13,Marin,041,260295,7486,7307,23,7330,133
2020-11-13,Mariposa,043,17540,94,86,0,86,2
2020-11-13,Mendocino,045,87422,1275,1173,5,1178,22
2020-11-13,Merced,047,269075,10647,10185,76,10261,159
2020-11-13,Modoc,049,8938,83,63,14,77,0
2020-11-13,Mono,051,14174,476,448,9,457,2
2020-11-13,Monterey,053,433212,13423,12681,150,12831,104
2020-11-13,Napa,055,140530,2701,2440,15,2455,17
2020-11-13,Nevada,057,99092,964,798,24,822,9
2020-11-13,Orange,059,3164182,68756,63804,2056,65860,1514
2020-11-13,Placer,061,380077,5722,5122,65,5187,63
2020-11-13,Plumas,063,18699,152,125,0,125,0
2020-11-13,Riverside,065,2383286,78551,74138,1030,75168,1372
2020-11-13,Sacramento,067,1510023,31922,29787,64,29851,524
2020-11-13,San Benito,069,59416,1642,1553,1,1554,15
2020-11-13,San Bernardino,071,2135413,78936,71895,802,72697,1184
2020-11-13,San Diego,073,3302833,68806,62978,2235,65213,921
2020-11-13,San Francisco,075,870044,14064,13516,72,13588,146
2020-11-13,San Joaquin,077,732212,24367,23314,361,23675,510
2020-11-13,San Luis Obispo,079,281455,5565,4960,72,5032,34
2020-11-13,San Mateo,081,765935,12974,12182,12,12194,169
2020-11-13,Santa Barbara,083,443738,10772,10405,156,10561,134
2020-11-13,Santa Clara,085,1922200,30359,27609,57,27666,415
2020-11-13,Santa Cruz,087,273765,3722,3343,38,3381,25
2020-11-13,Shasta,089,179085,4070,2983,88,3071,37
2020-11-13,Sierra,091,2930,15,11,0,11,0
2020-11-13,Siskiyou,093,43540,392,280,23,303,0
2020-11-13,Solano,095,438530,9100,8525,44,8569,84
2020-11-13,Sonoma,097,501317,11237,10685,36,10721,151
2020-11-13,Stanislaus,099,539301,19736,18936,1049,19985,422
2020-11-13,Sutter,101,95872,2511,2121,7,2128,12
2020-11-13,Tehama,103,63373,1342,1167,5,1172,7
2020-11-13,Trinity,105,12862,184,64,19,83,0
2020-11-13,Tulare,107,460477,19710,18714,798,19512,305
2020-11-13,Tuolumne,109,53932,700,427,8,435,7
2020-11-13,Ventura,111,848112,17498,16172,480,16652,171
2020-11-13,Yolo,113,214977,4017,3716,10,3726,65
2020-11-13,Yuba,115,75493,1579,1435,5,1440,10
2020-11-12,Alameda,001,1643700,26714,25345,255,25600,432
2020-11-12,Alpine,003,1148,34,12,0,12,0
2020-11-12,Amador,005,37829,430,392,0,392,16
2020-11-12,Butte,007,227075,3604,3347,138,3485,58
2020-11-12,Calaveras,009,45235,388,373,0,373,21
2020-11-12,Colusa,011,21464,620,591,1,592,6
2020-11-12,Contra Costa,013,1133247,21694,20619,113,20732,255
2020-11-12,Del Norte,015,27424,239,203,0,203,2
2020-11-12,El Dorado,017,186661,1864,1573,20,1593,4
2020-11-12,Fresno,019,978130,37364,33459,820,34279,468
2020-11-12,Glenn,021,27897,806,727,17,744,3
2020-11-12,Humboldt,023,135768,711,625,1,626,9
2020-11-12,Imperial,025,180216,14401,13619,28,13647,341
2020-11-12,Inyo,027,18085,270,255,5,260,15
2020-11-12,Kern,029,883053,36967,35207,722,35929,451
2020-11-12,Kings,031,150075,9837,9335,93,9428,85
2020-11-12,Lake,033,64148,830,764,0,764,17
2020-11-12,Lassen,035,31185,1160,832,2,834,0
2020-11-12,Los Angeles,037,10098052,341855,327001,3925,330926,7223
2020-11-12,Madera,039,155013,5629,5273,80,5353,54
2020-11-12,Marin,041,260295,7457,7268,23,7291,133
2020-11-12,Mariposa,043,17540,92,84,0,84,2
2020-11-12,Mendocino,045,87422,1256,1142,5,1147,22
2020-11-12,Merced,047,269075,10533,10107,73,10180,158
2020-11-12,Modoc,049,8938,83,63,14,77,0
2020-11-12,Mono,051,14174,475,442,9,451,2
2020-11-12,Monterey,053,433212,13302,12489,136,12625,100
2020-11-12,Napa,055,140530,2639,2398,15,2413,16
2020-11-12,Nevada,057,99092,942,780,23,803,9
2020-11-12,Orange,059,3164182,68012,63232,2037,65269,1514
2020-11-12,Placer,061,380077,5613,5044,56,5100,62
2020-11-12,Plumas,063,18699,148,121,0,121,0
2020-11-12,Riverside,065,2383286,77620,73381,987,74368,1362
2020-11-12,Sacramento,067,1510023,31431,29459,56,29515,520
2020-11-12,San Benito,069,59416,1622,1525,1,1526,15
2020-11-12,San Bernardino,071,2135413,77570,70758,763,71521,1183
2020-11-12,San Diego,073,3302833,67826,62336,2184,64520,918
2020-11-12,San Francisco,075,870044,13965,13289,71,13360,146
2020-11-12,San Joaquin,077,732212,24173,23002,340,23342,509
2020-11-12,San Luis Obispo,079,281455,5501,4898,71,4969,33
2020-11-12,San Mateo,081,765935,12849,12086,11,12097,169
2020-11-12,Santa Barbara,083,443738,10710,10325,151,10476,134
2020-11-12,Santa Clara,085,1922200,29982,27261,56,27317,414
2020-11-12,Santa Cruz,087,273765,3639,3317,36,3353,25
2020-11-12,Shasta,089,179085,3933,2825,77,2902,37
2020-11-12,Sierra,091,2930,15,11,0,11,0
2020-11-12,Siskiyou,093,43540,375,275,19,294,0
2020-11-12,Solano,095,438530,9000,8417,43,8460,85
2020-11-12,Sonoma,097,501317,11135,10602,35,10637,151
2020-11-12,Stanislaus,099,539301,19566,18787,1020,19807,422
2020-11-12,Sutter,101,95872,2428,2075,6,2081,12
2020-11-12,Tehama,103,63373,1314,1117,5,1122,7
2020-11-12,Trinity,105,12862,176,62,18,80,0
2020-11-12,Tulare,107,460477,19597,18545,760,19305,305
2020-11-12,Tuolumne,109,53932,661,353,8,361,7
2020-11-12,Ventura,111,848112,17248,16013,474,16487,158
2020-11-12,Yolo,113,214977,3974,3646,10,3656,63
2020-11-12,Yuba,115,75493,1544,1410,5,1415,10
2020-11-11,Alameda,001,1643700,26470,25140,253,25393,429
2020-11-11,Alpine,003,1148,29,12,0,12,0
2020-11-11,Amador,005,37829,423,389,0,389,16
2020-11-11,Butte,007,227075,3578,3348,125,3473,58
2020-11-11,Calaveras,009,45235,378,373,0,373,21
2020-11-11,Colusa,011,21464,614,591,1,592,6
2020-11-11,Contra Costa,013,1133247,21477,20452,111,20563,255
2020-11-11,Del Norte,015,27424,231,203,0,203,2
2020-11-11,El Dorado,017,186661,1818,1564,19,1583,4
2020-11-11,Fresno,019,978130,37046,33287,785,34072,468
2020-11-11,Glenn,021,27897,790,722,16,738,3
2020-11-11,Humboldt,023,135768,697,623,1,624,9
2020-11-11,Imperial,025,180216,14231,13623,26,13649,340
2020-11-11,Inyo,027,18085,268,255,5,260,15
2020-11-11,Kern,029,883053,36692,35014,705,35719,449
2020-11-11,Kings,031,150075,9731,9263,90,9353,85
2020-11-11,Lake,033,64148,819,763,0,763,17
2020-11-11,Lassen,035,31185,1135,831,2,833,0
2020-11-11,Los Angeles,037,10098052,338486,324567,3843,328410,7220
2020-11-11,Madera,039,155013,5595,5248,79,5327,54
2020-11-11,Marin,041,260295,7435,7268,23,7291,133
2020-11-11,Mariposa,043,17540,92,84,0,84,2
2020-11-11,Mendocino,045,87422,1244,1142,5,1147,22
2020-11-11,Merced,047,269075,10462,10074,71,10145,157
2020-11-11,Modoc,049,8938,79,62,13,75,0
2020-11-11,Mono,051,14174,473,443,9,452,2
2020-11-11,Monterey,053,433212,13159,12417,132,12549,100
2020-11-11,Napa,055,140530,2590,2365,13,2378,15
2020-11-11,Nevada,057,99092,900,741,23,764,9
2020-11-11,Orange,059,3164182,67373,62929,2013,64942,1506
2020-11-11,Placer,061,380077,5529,4981,48,5029,60
2020-11-11,Plumas,063,18699,146,111,0,111,0
2020-11-11,Riverside,065,2383286,76718,72953,941,73894,1361
2020-11-11,Sacramento,067,1510023,30974,28968,54,29022,520
2020-11-11,San Benito,069,59416,1608,1512,1,1513,15
2020-11-11,San Bernardino,071,2135413,76284,70374,737,71111,1182
2020-11-11,San Diego,073,3302833,66891,61746,2123,63869,918
2020-11-11,San Francisco,075,870044,13858,13287,70,13357,146
2020-11-11,San Joaquin,077,732212,24013,23001,335,23336,509
2020-11-11,San Luis Obispo,079,281455,5426,4832,68,4900,33
2020-11-11,San Mateo,081,765935,12735,12008,11,12019,169
2020-11-11,Santa Barbara,083,443738,10644,10278,151,10429,134
2020-11-11,Santa Clara,085,1922200,29631,27075,55,27130,413
2020-11-11,Santa Cruz,087,273765,3571,3247,36,3283,25
2020-11-11,Shasta,089,179085,3810,2766,67,2833,36
2020-11-11,Sierra,091,2930,13,11,0,11,0
2020-11-11,Siskiyou,093,43540,344,261,16,277,0
2020-11-11,Solano,095,438530,8881,8353,41,8394,85
2020-11-11,Sonoma,097,501317,11061,10498,35,10533,150
2020-11-11,Stanislaus,099,539301,19429,18671,990,19661,422
2020-11-11,Sutter,101,95872,2380,2049,5,2054,12
2020-11-11,Tehama,103,63373,1270,1105,4,1109,7
2020-11-11,Trinity,105,12862,165,62,18,80,0
2020-11-11,Tulare,107,460477,19467,18500,730,19230,305
2020-11-11,Tuolumne,109,53932,608,354,7,361,7
2020-11-11,Ventura,111,848112,17033,15801,461,16262,158
2020-11-11,Yolo,113,214977,3923,3606,10,3616,63
2020-11-11,Yuba,115,75493,1529,1400,5,1405,10
2020-11-10,Alameda,001,1643700,26240,25008,250,25258,424
2020-11-10,Alpine,003,1148,29,9,0,9,0
2020-11-10,Amador,005,37829,417,384,0,384,16
2020-11-10,Butte,007,227075,3542,3327,121,3448,58
2020-11-10,Calaveras,009,45235,374,367,0,367,21
2020-11-10,Colusa,011,21464,606,590,1,591,6
2020-11-10,Contra Costa,013,1133247,21271,20326,109,20435,255
2020-11-10,Del Norte,015,27424,225,196,0,196,2
2020-11-10,El Dorado,017,186661,1758,1551,19,1570,4
2020-11-10,Fresno,019,978130,36775,33024,749,33773,465
2020-11-10,Glenn,021,27897,782,719,12,731,3
2020-11-10,Humboldt,023,135768,680,610,1,611,9
2020-11-10,Imperial,025,180216,14101,13570,26,13596,338
2020-11-10,Inyo,027,18085,267,252,5,257,14
2020-11-10,Kern,029,883053,36416,34858,686,35544,448
2020-11-10,Kings,031,150075,9684,9236,83,9319,85
2020-11-10,Lake,033,64148,809,762,0,762,16
2020-11-10,Lassen,035,31185,1120,830,2,832,0
2020-11-10,Los Angeles,037,10098052,335235,322569,3728,326297,7205
2020-11-10,Madera,039,155013,5553,5229,73,5302,54
2020-11-10,Marin,041,260295,7416,7259,23,7282,133
2020-11-10,Mariposa,043,17540,90,84,0,84,2
2020-11-10,Mendocino,045,87422,1236,1137,5,1142,22
2020-11-10,Merced,047,269075,10400,9992,65,10057,157
2020-11-10,Modoc,049,8938,77,61,13,74,0
2020-11-10,Mono,051,14174,471,443,9,452,2
2020-11-10,Monterey,053,433212,13024,12335,124,12459,100
2020-11-10,Napa,055,140530,2552,2341,11,2352,15
2020-11-10,Nevada,057,99092,884,734,23,757,9
2020-11-10,Orange,059,3164182,66819,62597,2003,64600,1504
2020-11-10,Placer,061,380077,5449,4902,47,4949,60
2020-11-10,Plumas,063,18699,142,108,0,108,0
2020-11-10,Riverside,065,2383286,76076,72316,916,73232,1359
2020-11-10,Sacramento,067,1510023,30568,28677,51,28728,519
2020-11-10,San Benito,069,59416,1593,1508,1,1509,15
2020-11-10,San Bernardino,071,2135413,75115,69666,704,70370,1182
2020-11-10,San Diego,073,3302833,66000,61085,2086,63171,915
2020-11-10,San Francisco,075,870044,13742,13210,70,13280,146
2020-11-10,San Joaquin,077,732212,23848,22865,328,23193,508
2020-11-10,San Luis Obispo,079,281455,5363,4780,65,4845,33
2020-11-10,San Mateo,081,765935,12635,11939,11,11950,169
2020-11-10,Santa Barbara,083,443738,10577,10252,147,10399,134
2020-11-10,Santa Clara,085,1922200,29283,26917,54,26971,409
2020-11-10,Santa Cruz,087,273765,3509,3221,36,3257,25
2020-11-10,Shasta,089,179085,3667,2686,59,2745,36
2020-11-10,Sierra,091,2930,12,10,0,10,0
2020-11-10,Siskiyou,093,43540,327,263,15,278,0
2020-11-10,Solano,095,438530,8784,8299,41,8340,85
2020-11-10,Sonoma,097,501317,10974,10414,35,10449,150
2020-11-10,Stanislaus,099,539301,19296,18592,966,19558,420
2020-11-10,Sutter,101,95872,2285,2035,4,2039,12
2020-11-10,Tehama,103,63373,1245,1099,3,1102,7
2020-11-10,Trinity,105,12862,156,62,16,78,0
2020-11-10,Tulare,107,460477,19352,18430,706,19136,305
2020-11-10,Tuolumne,109,53932,558,353,7,360,7
2020-11-10,Ventura,111,848112,16850,15625,459,16084,158
2020-11-10,Yolo,113,214977,3862,3573,10,3583,63
2020-11-10,Yuba,115,75493,1506,1392,5,1397,10
2020-11-09,Alameda,001,1643700,25994,24899,246,25145,424
2020-11-09,Alpine,003,1148,27,6,0,6,0
2020-11-09,Amador,005,37829,408,380,0,380,16
2020-11-09,Butte,007,227075,3498,3301,112,3413,57
2020-11-09,Calaveras,009,45235,370,360,0,360,21
2020-11-09,Colusa,011,21464,600,583,1,584,6
2020-11-09,Contra Costa,013,1133247,21097,20193,107,20300,255
2020-11-09,Del Norte,015,27424,219,195,0,195,2
2020-11-09,El Dorado,017,186661,1717,1515,19,1534,4
2020-11-09,Fresno,019,978130,36465,32755,709,33464,465
2020-11-09,Glenn,021,27897,776,714,9,723,3
2020-11-09,Humboldt,023,135768,667,607,1,608,9
2020-11-09,Imperial,025,180216,13982,13508,25,13533,338
2020-11-09,Inyo,027,18085,267,252,5,257,14
2020-11-09,Kern,029,883053,36186,34764,650,35414,448
2020-11-09,Kings,031,150075,9614,9141,81,9222,84
2020-11-09,Lake,033,64148,800,755,0,755,16
2020-11-09,Lassen,035,31185,1024,799,2,801,0
2020-11-09,Los Angeles,037,10098052,332138,320370,3653,324023,7180
2020-11-09,Madera,039,155013,5507,5209,70,5279,54
2020-11-09,Marin,041,260295,7390,7237,22,7259,131
2020-11-09,Mariposa,043,17540,90,84,0,84,2
2020-11-09,Mendocino,045,87422,1224,1132,5,1137,22
2020-11-09,Merced,047,269075,10297,9922,62,9984,157
2020-11-09,Modoc,049,8938,73,54,12,66,0
2020-11-09,Mono,051,14174,468,352,9,361,2
2020-11-09,Monterey,053,433212,12877,12148,116,12264,98
2020-11-09,Napa,055,140530,2509,2309,11,2320,15
2020-11-09,Nevada,057,99092,847,729,22,751,9
2020-11-09,Orange,059,3164182,66177,62335,1990,64325,1501
2020-11-09,Placer,061,380077,5364,4843,36,4879,60
2020-11-09,Plumas,063,18699,135,102,0,102,0
2020-11-09,Riverside,065,2383286,75294,72059,882,72941,1346
2020-11-09,Sacramento,067,1510023,30096,28200,50,28250,516
2020-11-09,San Benito,069,59416,1584,1506,1,1507,15
2020-11-09,San Bernardino,071,2135413,74061,69015,661,69676,1182
2020-11-09,San Diego,073,3302833,65145,60572,2046,62618,908
2020-11-09,San Francisco,075,870044,13622,12984,67,13051,146
2020-11-09,San Joaquin,077,732212,23683,22512,323,22835,505
2020-11-09,San Luis Obispo,079,281455,5276,4746,63,4809,32
2020-11-09,San Mateo,081,765935,12528,11857,11,11868,169
2020-11-09,Santa Barbara,083,443738,10520,10214,142,10356,134
2020-11-09,Santa Clara,085,1922200,28887,26693,54,26747,409
2020-11-09,Santa Cruz,087,273765,3451,3194,36,3230,25
2020-11-09,Shasta,089,179085,3513,2581,50,2631,36
2020-11-09,Sierra,091,2930,10,10,0,10,0
2020-11-09,Siskiyou,093,43540,316,257,13,270,0
2020-11-09,Solano,095,438530,8671,8254,40,8294,85
2020-11-09,Sonoma,097,501317,10866,10310,35,10345,150
2020-11-09,Stanislaus,099,539301,19147,18482,951,19433,418
2020-11-09,Sutter,101,95872,2218,2010,3,2013,12
2020-11-09,Tehama,103,63373,1208,1071,2,1073,7
2020-11-09,Trinity,105,12862,149,46,16,62,0
2020-11-09,Tulare,107,460477,19230,18272,675,18947,304
2020-11-09,Tuolumne,109,53932,504,346,6,352,7
2020-11-09,Ventura,111,848112,16648,15568,456,16024,156
2020-11-09,Yolo,113,214977,3801,3522,10,3532,62
2020-11-09,Yuba,115,75493,1473,1380,5,1385,10
2020-11-08,Alameda,001,1643700,25764,24731,246,24977,424
2020-11-08,Alpine,003,1148,24,6,0,6,0
2020-11-08,Amador,005,37829,401,376,0,376,16
2020-11-08,Butte,007,227075,3460,3285,104,3389,57
2020-11-08,Calaveras,009,45235,368,360,0,360,21
2020-11-08,Colusa,011,21464,597,583,1,584,6
2020-11-08,Contra Costa,013,1133247,20926,20031,105,20136,254
2020-11-08,Del Norte,015,27424,212,195,0,195,2
2020-11-08,El Dorado,017,186661,1680,1502,19,1521,4
2020-11-08,Fresno,019,978130,36126,32619,671,33290,465
2020-11-08,Glenn,021,27897,770,707,8,715,3
2020-11-08,Humboldt,023,135768,651,605,1,606,9
2020-11-08,Imperial,025,180216,13866,13428,25,13453,338
2020-11-08,Inyo,027,18085,264,252,5,257,14
2020-11-08,Kern,029,883053,35967,34644,632,35276,448
2020-11-08,Kings,031,150075,9481,9026,78,9104,84
2020-11-08,Lake,033,64148,792,754,0,754,16
2020-11-08,Lassen,035,31185,876,799,2,801,0
2020-11-08,Los Angeles,037,10098052,329010,318960,3588,322548,7176
2020-11-08,Madera,039,155013,5437,5196,67,5263,54
2020-11-08,Marin,041,260295,7370,7227,22,7249,131
2020-11-08,Mariposa,043,17540,90,83,0,83,2
2020-11-08,Mendocino,045,87422,1215,1129,5,1134,22
2020-11-08,Merced,047,269075,10222,9885,60,9945,157
2020-11-08,Modoc,049,8938,69,54,12,66,0
2020-11-08,Mono,051,14174,462,352,9,361,2
2020-11-08,Monterey,053,433212,12732,12122,106,12228,98
2020-11-08,Napa,055,140530,2470,2274,11,2285,15
2020-11-08,Nevada,057,99092,831,715,22,737,9
2020-11-08,Orange,059,3164182,65589,62034,1976,64010,1501
2020-11-08,Placer,061,380077,5261,4800,31,4831,60
2020-11-08,Plumas,063,18699,130,102,0,102,0
2020-11-08,Riverside,065,2383286,74639,71442,841,72283,1345
2020-11-08,Sacramento,067,1510023,29537,28059,47,28106,515
2020-11-08,San Benito,069,59416,1569,1496,1,1497,15
2020-11-08,San Bernardino,071,2135413,72809,68412,622,69034,1182
2020-11-08,San Diego,073,3302833,64300,60199,2002,62201,908
2020-11-08,San Francisco,075,870044,13492,12985,63,13048,146
2020-11-08,San Joaquin,077,732212,23489,22514,319,22833,505
2020-11-08,San Luis Obispo,079,281455,5210,4698,58,4756,32
2020-11-08,San Mateo,081,765935,12410,11783,11,11794,169
2020-11-08,Santa Barbara,083,443738,10450,10180,140,10320,134
2020-11-08,Santa Clara,085,1922200,28513,26442,53,26495,410
2020-11-08,Santa Cruz,087,273765,3394,3134,36,3170,25
2020-11-08,Shasta,089,179085,3377,2582,44,2626,36
2020-11-08,Sierra,091,2930,10,7,0,7,0
2020-11-08,Siskiyou,093,43540,304,246,12,258,0
2020-11-08,Solano,095,438530,8550,8132,39,8171,85
2020-11-08,Sonoma,097,501317,10759,10229,35,10264,149
2020-11-08,Stanislaus,099,539301,18973,18413,930,19343,418
2020-11-08,Sutter,101,95872,2160,1980,3,1983,12
2020-11-08,Tehama,103,63373,1182,1054,2,1056,7
2020-11-08,Trinity,105,12862,146,46,15,61,0
2020-11-08,Tulare,107,460477,19088,18272,646,18918,304
2020-11-08,Tuolumne,109,53932,478,341,6,347,7
2020-11-08,Ventura,111,848112,16453,15504,448,15952,156
2020-11-08,Yolo,113,214977,3739,3492,10,3502,61
2020-11-08,Yuba,115,75493,1452,1369,5,1374,10
2020-11-07,Alameda,001,1643700,25654,24578,244,24822,424
2020-11-07,Alpine,003,1148,24,6,0,6,0
2020-11-07,Amador,005,37829,398,375,0,375,16
2020-11-07,Butte,007,227075,3448,3277,99,3376,57
2020-11-07,Calaveras,009,45235,366,360,0,360,21
2020-11-07,Colusa,011,21464,597,583,1,584,6
2020-11-07,Contra Costa,013,1133247,20825,19943,104,20047,254
2020-11-07,Del Norte,015,27424,207,194,0,194,2
2020-11-07,El Dorado,017,186661,1655,1495,18,1513,4
2020-11-07,Fresno,019,978130,35971,32497,649,33146,465
2020-11-07,Glenn,021,27897,762,707,8,715,3
2020-11-07,Humboldt,023,135768,640,590,1,591,9
2020-11-07,Imperial,025,180216,13808,13388,24,13412,338
2020-11-07,Inyo,027,18085,262,252,5,257,14
2020-11-07,Kern,029,883053,35811,34513,622,35135,448
2020-11-07,Kings,031,150075,9448,9005,72,9077,84
2020-11-07,Lake,033,64148,788,751,0,751,16
2020-11-07,Lassen,035,31185,860,799,2,801,0
2020-11-07,Los Angeles,037,10098052,327497,316756,3521,320277,7174
2020-11-07,Madera,039,155013,5414,5177,65,5242,54
2020-11-07,Marin,041,260295,7359,7215,22,7237,131
2020-11-07,Mariposa,043,17540,90,81,0,81,2
2020-11-07,Mendocino,045,87422,1204,1118,5,1123,22
2020-11-07,Merced,047,269075,10190,9855,56,9911,157
2020-11-07,Modoc,049,8938,69,51,12,63,0
2020-11-07,Mono,051,14174,459,352,9,361,2
2020-11-07,Monterey,053,433212,12662,12030,102,12132,98
2020-11-07,Napa,055,140530,2440,2260,10,2270,15
2020-11-07,Nevada,057,99092,814,710,22,732,9
2020-11-07,Orange,059,3164182,65301,62038,1970,64008,1505
2020-11-07,Placer,061,380077,5198,4745,31,4776,60
2020-11-07,Plumas,063,18699,127,94,0,94,0
2020-11-07,Riverside,065,2383286,74244,71153,814,71967,1345
2020-11-07,Sacramento,067,1510023,29287,27773,47,27820,515
2020-11-07,San Benito,069,59416,1557,1489,1,1490,15
2020-11-07,San Bernardino,071,2135413,72293,67935,611,68546,1182
2020-11-07,San Diego,073,3302833,63788,59682,1970,61652,909
2020-11-07,San Francisco,075,870044,13431,12980,62,13042,146
2020-11-07,San Joaquin,077,732212,23381,22517,313,22830,505
2020-11-07,San Luis Obispo,079,281455,5161,4668,55,4723,32
2020-11-07,San Mateo,081,765935,12347,11711,11,11722,169
2020-11-07,Santa Barbara,083,443738,10408,10157,138,10295,134
2020-11-07,Santa Clara,085,1922200,28309,26244,52,26296,410
2020-11-07,Santa Cruz,087,273765,3356,3130,36,3166,25
2020-11-07,Shasta,089,179085,3310,2547,42,2589,36
2020-11-07,Sierra,091,2930,10,7,0,7,0
2020-11-07,Siskiyou,093,43540,300,241,12,253,0
2020-11-07,Solano,095,438530,8498,8066,39,8105,85
2020-11-07,Sonoma,097,501317,10713,10200,35,10235,149
2020-11-07,Stanislaus,099,539301,18862,18386,914,19300,418
2020-11-07,Sutter,101,95872,2120,1973,3,1976,12
2020-11-07,Tehama,103,63373,1157,1043,2,1045,7
2020-11-07,Trinity,105,12862,146,42,14,56,0
2020-11-07,Tulare,107,460477,19032,18229,628,18857,304
2020-11-07,Tuolumne,109,53932,466,327,6,333,7
2020-11-07,Ventura,111,848112,16393,15364,443,15807,156
2020-11-07,Yolo,113,214977,3708,3486,10,3496,61
2020-11-07,Yuba,115,75493,1437,1349,5,1354,10
2020-11-06,Alameda,001,1643700,25522,24389,242,24631,420
2020-11-06,Alpine,003,1148,24,6,0,6,0
2020-11-06,Amador,005,37829,396,369,0,369,16
2020-11-06,Butte,007,227075,3423,3254,91,3345,57
2020-11-06,Calaveras,009,45235,365,359,0,359,21
2020-11-06,Colusa,011,21464,595,580,1,581,6
2020-11-06,Contra Costa,013,1133247,20678,19744,104,19848,252
2020-11-06,Del Norte,015,27424,204,194,0,194,2
2020-11-06,El Dorado,017,186661,1629,1475,18,1493,4
2020-11-06,Fresno,019,978130,35783,32278,633,32911,460
2020-11-06,Glenn,021,27897,756,707,7,714,3
2020-11-06,Humboldt,023,135768,637,587,1,588,9
2020-11-06,Imperial,025,180216,13754,13230,24,13254,338
2020-11-06,Inyo,027,18085,260,246,5,251,14
2020-11-06,Kern,029,883053,35647,34360,605,34965,443
2020-11-06,Kings,031,150075,9424,8883,70,8953,83
2020-11-06,Lake,033,64148,787,741,0,741,16
2020-11-06,Lassen,035,31185,852,794,2,796,0
2020-11-06,Los Angeles,037,10098052,325527,314356,3469,317825,7160
2020-11-06,Madera,039,155013,5398,5136,64,5200,54
2020-11-06,Marin,041,260295,7338,7184,22,7206,131
2020-11-06,Mariposa,043,17540,89,79,0,79,2
2020-11-06,Mendocino,045,87422,1199,1113,5,1118,22
2020-11-06,Merced,047,269075,10150,9778,53,9831,157
2020-11-06,Modoc,049,8938,69,48,12,60,0
2020-11-06,Mono,051,14174,453,308,9,317,1
2020-11-06,Monterey,053,433212,12545,11914,101,12015,96
2020-11-06,Napa,055,140530,2415,2189,10,2199,15
2020-11-06,Nevada,057,99092,801,692,21,713,9
2020-11-06,Orange,059,3164182,64998,61049,1960,63009,1494
2020-11-06,Placer,061,380077,5125,4680,31,4711,60
2020-11-06,Plumas,063,18699,122,90,0,90,0
2020-11-06,Riverside,065,2383286,73794,70409,773,71182,1341
2020-11-06,Sacramento,067,1510023,28996,27489,45,27534,514
2020-11-06,San Benito,069,59416,1548,1479,1,1480,15
2020-11-06,San Bernardino,071,2135413,71696,66740,591,67331,1179
2020-11-06,San Diego,073,3302833,63264,59143,1938,61081,907
2020-11-06,San Francisco,075,870044,13361,12825,61,12886,146
2020-11-06,San Joaquin,077,732212,23296,22424,303,22727,502
2020-11-06,San Luis Obispo,079,281455,5096,4531,49,4580,32
2020-11-06,San Mateo,081,765935,12272,11587,11,11598,168
2020-11-06,Santa Barbara,083,443738,10372,10118,134,10252,133
2020-11-06,Santa Clara,085,1922200,28067,25831,52,25883,402
2020-11-06,Santa Cruz,087,273765,3318,3063,36,3099,25
2020-11-06,Shasta,089,179085,3237,2475,41,2516,35
2020-11-06,Sierra,091,2930,9,7,0,7,0
2020-11-06,Siskiyou,093,43540,287,237,11,248,0
2020-11-06,Solano,095,438530,8432,7959,39,7998,85
2020-11-06,Sonoma,097,501317,10663,10142,35,10177,149
2020-11-06,Stanislaus,099,539301,18775,18250,906,19156,417
2020-11-06,Sutter,101,95872,2093,1937,2,1939,12
2020-11-06,Tehama,103,63373,1136,1024,2,1026,6
2020-11-06,Trinity,105,12862,143,41,14,55,0
2020-11-06,Tulare,107,460477,18968,18136,603,18739,300
2020-11-06,Tuolumne,109,53932,442,316,6,322,5
2020-11-06,Ventura,111,848112,16307,15222,440,15662,154
2020-11-06,Yolo,113,214977,3679,3420,10,3430,62
2020-11-06,Yuba,115,75493,1424,1335,5,1340,10
2020-11-05,Alameda,001,1643700,25346,24270,242,24512,420
2020-11-05,Alpine,003,1148,24,6,0,6,0
2020-11-05,Amador,005,37829,393,363,0,363,16
2020-11-05,Butte,007,227075,3400,3239,85,3324,57
2020-11-05,Calaveras,009,45235,357,333,0,333,19
2020-11-05,Colusa,011,21464,591,574,1,575,6
2020-11-05,Contra Costa,013,1133247,20496,19656,101,19757,252
2020-11-05,Del Norte,015,27424,202,192,0,192,2
2020-11-05,El Dorado,017,186661,1605,1466,18,1484,4
2020-11-05,Fresno,019,978130,35542,32056,609,32665,460
2020-11-05,Glenn,021,27897,736,702,7,709,3
2020-11-05,Humboldt,023,135768,627,581,1,582,9
2020-11-05,Imperial,025,180216,13662,13178,23,13201,337
2020-11-05,Inyo,027,18085,259,247,5,252,14
2020-11-05,Kern,029,883053,35446,34232,592,34824,443
2020-11-05,Kings,031,150075,9269,8846,67,8913,83
2020-11-05,Lake,033,64148,783,739,0,739,16
2020-11-05,Lassen,035,31185,821,782,2,784,0
2020-11-05,Los Angeles,037,10098052,323172,312381,3416,315797,7146
2020-11-05,Madera,039,155013,5360,5129,61,5190,54
2020-11-05,Marin,041,260295,7315,7171,22,7193,131
2020-11-05,Mariposa,043,17540,88,79,0,79,2
2020-11-05,Mendocino,045,87422,1187,1112,5,1117,22
2020-11-05,Merced,047,269075,10091,9753,48,9801,155
2020-11-05,Modoc,049,8938,68,47,11,58,0
2020-11-05,Mono,051,14174,451,307,9,316,1
2020-11-05,Monterey,053,433212,12435,11784,97,11881,96
2020-11-05,Napa,055,140530,2388,2158,10,2168,15
2020-11-05,Nevada,057,99092,779,687,20,707,9
2020-11-05,Orange,059,3164182,64551,60740,1949,62689,1484
2020-11-05,Placer,061,380077,5056,4627,26,4653,60
2020-11-05,Plumas,063,18699,114,90,0,90,0
2020-11-05,Riverside,065,2383286,73083,70094,717,70811,1338
2020-11-05,Sacramento,067,1510023,28616,27232,44,27276,512
2020-11-05,San Benito,069,59416,1533,1477,1,1478,15
2020-11-05,San Bernardino,071,2135413,70868,66407,579,66986,1174
2020-11-05,San Diego,073,3302833,62638,58659,1912,60571,904
2020-11-05,San Francisco,075,870044,13249,12726,60,12786,146
2020-11-05,San Joaquin,077,732212,23132,22318,299,22617,502
2020-11-05,San Luis Obispo,079,281455,5029,4459,47,4506,32
2020-11-05,San Mateo,081,765935,12178,11535,11,11546,168
2020-11-05,Santa Barbara,083,443738,10328,10080,131,10211,133
2020-11-05,Santa Clara,085,1922200,27802,25651,52,25703,402
2020-11-05,Santa Cruz,087,273765,3280,3023,36,3059,25
2020-11-05,Shasta,089,179085,3147,2401,40,2441,34
2020-11-05,Sierra,091,2930,9,6,0,6,0
2020-11-05,Siskiyou,093,43540,276,228,11,239,0
2020-11-05,Solano,095,438530,8349,7842,39,7881,85
2020-11-05,Sonoma,097,501317,10551,10064,34,10098,145
2020-11-05,Stanislaus,099,539301,18661,18194,893,19087,417
2020-11-05,Sutter,101,95872,2061,1925,2,1927,12
2020-11-05,Tehama,103,63373,1115,1015,2,1017,6
2020-11-05,Trinity,105,12862,127,41,14,55,0
2020-11-05,Tulare,107,460477,18879,18049,577,18626,301
2020-11-05,Tuolumne,109,53932,412,312,6,318,5
2020-11-05,Ventura,111,848112,16141,15113,429,15542,155
2020-11-05,Yolo,113,214977,3629,3391,10,3401,61
2020-11-05,Yuba,115,75493,1406,1322,5,1327,10
2020-11-04,Alameda,001,1643700,25170,24172,240,24412,418
2020-11-04,Alpine,003,1148,20,5,0,5,0
2020-11-04,Amador,005,37829,390,362,0,362,16
2020-11-04,Butte,007,227075,3375,3218,82,3300,57
2020-11-04,Calaveras,009,45235,354,290,0,290,19
2020-11-04,Colusa,011,21464,589,571,1,572,6
2020-11-04,Contra Costa,013,1133247,20331,19472,98,19570,251
2020-11-04,Del Norte,015,27424,198,188,0,188,2
2020-11-04,El Dorado,017,186661,1590,1448,15,1463,4
2020-11-04,Fresno,019,978130,35310,31952,581,32533,457
2020-11-04,Glenn,021,27897,732,701,6,707,3
2020-11-04,Humboldt,023,135768,618,571,1,572,9
2020-11-04,Imperial,025,180216,13564,13087,23,13110,335
2020-11-04,Inyo,027,18085,258,247,5,252,14
2020-11-04,Kern,029,883053,35291,34027,581,34608,439
2020-11-04,Kings,031,150075,9235,8817,65,8882,83
2020-11-04,Lake,033,64148,776,735,0,735,16
2020-11-04,Lassen,035,31185,816,781,2,783,0
2020-11-04,Los Angeles,037,10098052,320860,310456,3338,313794,7124
2020-11-04,Madera,039,155013,5340,5083,57,5140,54
2020-11-04,Marin,041,260295,7303,7157,22,7179,131
2020-11-04,Mariposa,043,17540,88,79,0,79,2
2020-11-04,Mendocino,045,87422,1169,1089,5,1094,22
2020-11-04,Merced,047,269075,10042,9717,46,9763,153
2020-11-04,Modoc,049,8938,59,47,11,58,0
2020-11-04,Mono,051,14174,448,237,8,245,1
2020-11-04,Monterey,053,433212,12231,11743,91,11834,96
2020-11-04,Napa,055,140530,2334,2133,10,2143,15
2020-11-04,Nevada,057,99092,760,675,20,695,9
2020-11-04,Orange,059,3164182,64116,60463,1928,62391,1483
2020-11-04,Placer,061,380077,4980,4526,23,4549,60
2020-11-04,Plumas,063,18699,112,88,0,88,0
2020-11-04,Riverside,065,2383286,72466,69562,658,70220,1335
2020-11-04,Sacramento,067,1510023,28266,27005,43,27048,510
2020-11-04,San Benito,069,59416,1518,1464,1,1465,15
2020-11-04,San Bernardino,071,2135413,70072,65891,556,66447,1169
2020-11-04,San Diego,073,3302833,61992,58126,1886,60012,904
2020-11-04,San Francisco,075,870044,13166,12649,57,12706,146
2020-11-04,San Joaquin,077,732212,22995,22197,286,22483,500
2020-11-04,San Luis Obispo,079,281455,4962,4389,45,4434,32
2020-11-04,San Mateo,081,765935,12084,11456,11,11467,168
2020-11-04,Santa Barbara,083,443738,10290,10026,130,10156,132
2020-11-04,Santa Clara,085,1922200,27541,25487,52,25539,393
2020-11-04,Santa Cruz,087,273765,3243,2997,36,3033,25
2020-11-04,Shasta,089,179085,3016,2321,35,2356,34
2020-11-04,Sierra,091,2930,9,6,0,6,0
2020-11-04,Siskiyou,093,43540,267,222,11,233,0
2020-11-04,Solano,095,438530,8250,7733,39,7772,85
2020-11-04,Sonoma,097,501317,10457,9965,34,9999,142
2020-11-04,Stanislaus,099,539301,18543,18114,878,18992,416
2020-11-04,Sutter,101,95872,2027,1916,2,1918,12
2020-11-04,Tehama,103,63373,1088,997,2,999,6
2020-11-04,Trinity,105,12862,123,37,14,51,0
2020-11-04,Tulare,107,460477,18769,17952,549,18501,298
2020-11-04,Tuolumne,109,53932,388,310,6,316,5
2020-11-04,Ventura,111,848112,16001,14936,426,15362,155
2020-11-04,Yolo,113,214977,3589,3361,10,3371,62
2020-11-04,Yuba,115,75493,1385,1312,5,1317,10
2020-11-03,Alameda,001,1643700,24986,24055,238,24293,418
2020-11-03,Alpine,003,1148,19,4,0,4,0
2020-11-03,Amador,005,37829,385,361,0,361,16
2020-11-03,Butte,007,227075,3352,3211,76,3287,57
2020-11-03,Calaveras,009,45235,350,287,0,287,19
2020-11-03,Colusa,011,21464,584,572,1,573,6
2020-11-03,Contra Costa,013,1133247,20176,19416,98,19514,250
2020-11-03,Del Norte,015,27424,197,187,0,187,2
2020-11-03,El Dorado,017,186661,1568,1445,14,1459,4
2020-11-03,Fresno,019,978130,35047,31856,559,32415,457
2020-11-03,Glenn,021,27897,726,698,6,704,3
2020-11-03,Humboldt,023,135768,612,570,1,571,8
2020-11-03,Imperial,025,180216,13474,13044,22,13066,335
2020-11-03,Inyo,027,18085,257,244,5,249,14
2020-11-03,Kern,029,883053,35100,33957,570,34527,439
2020-11-03,Kings,031,150075,9072,8783,60,8843,83
2020-11-03,Lake,033,64148,766,732,0,732,16
2020-11-03,Lassen,035,31185,807,782,2,784,0
2020-11-03,Los Angeles,037,10098052,318403,308812,3271,312083,7104
2020-11-03,Madera,039,155013,5304,5058,56,5114,54
2020-11-03,Marin,041,260295,7283,7147,21,7168,131
2020-11-03,Mariposa,043,17540,87,79,0,79,2
2020-11-03,Mendocino,045,87422,1154,1084,5,1089,22
2020-11-03,Merced,047,269075,9989,9713,45,9758,153
2020-11-03,Modoc,049,8938,57,47,9,56,0
2020-11-03,Mono,051,14174,444,210,8,218,1
2020-11-03,Monterey,053,433212,12162,11703,86,11789,94
2020-11-03,Napa,055,140530,2298,2130,10,2140,15
2020-11-03,Nevada,057,99092,740,670,19,689,9
2020-11-03,Orange,059,3164182,63686,60283,1916,62199,1477
2020-11-03,Placer,061,380077,4907,4514,23,4537,60
2020-11-03,Plumas,063,18699,109,86,0,86,0
2020-11-03,Riverside,065,2383286,71847,69300,633,69933,1325
2020-11-03,Sacramento,067,1510023,27885,26841,41,26882,510
2020-11-03,San Benito,069,59416,1508,1463,1,1464,15
2020-11-03,San Bernardino,071,2135413,69261,65320,549,65869,1159
2020-11-03,San Diego,073,3302833,61316,57722,1842,59564,901
2020-11-03,San Francisco,075,870044,13044,12585,57,12642,146
2020-11-03,San Joaquin,077,732212,22860,22109,280,22389,500
2020-11-03,San Luis Obispo,079,281455,4878,4371,43,4414,32
2020-11-03,San Mateo,081,765935,11989,11406,11,11417,162
2020-11-03,Santa Barbara,083,443738,10236,10008,126,10134,132
2020-11-03,Santa Clara,085,1922200,27267,25386,51,25437,393
2020-11-03,Santa Cruz,087,273765,3193,2980,35,3015,25
2020-11-03,Shasta,089,179085,2922,2288,28,2316,33
2020-11-03,Sierra,091,2930,7,6,0,6,0
2020-11-03,Siskiyou,093,43540,263,219,11,230,0
2020-11-03,Solano,095,438530,8166,7691,39,7730,85
2020-11-03,Sonoma,097,501317,10355,9906,34,9940,142
2020-11-03,Stanislaus,099,539301,18422,18080,867,18947,416
2020-11-03,Sutter,101,95872,1994,1914,2,1916,12
2020-11-03,Tehama,103,63373,1067,988,2,990,6
2020-11-03,Trinity,105,12862,116,36,13,49,0
2020-11-03,Tulare,107,460477,18663,17890,524,18414,297
2020-11-03,Tuolumne,109,53932,365,302,6,308,5
2020-11-03,Ventura,111,848112,15874,14816,419,15235,155
2020-11-03,Yolo,113,214977,3537,3343,10,3353,61
2020-11-03,Yuba,115,75493,1372,1295,5,1300,10
2020-11-02,Alameda,001,1643700,24790,23991,236,24227,419
2020-11-02,Alpine,003,1148,16,4,0,4,0
2020-11-02,Amador,005,37829,377,357,0,357,16
2020-11-02,Butte,007,227075,3332,3198,73,3271,57
2020-11-02,Calaveras,009,45235,350,282,0,282,18
2020-11-02,Colusa,011,21464,579,571,1,572,6
2020-11-02,Contra Costa,013,1133247,20018,19339,97,19436,250
2020-11-02,Del Norte,015,27424,194,175,0,175,2
2020-11-02,El Dorado,017,186661,1544,1405,14,1419,4
2020-11-02,Fresno,019,978130,34778,31738,542,32280,451
2020-11-02,Glenn,021,27897,720,692,5,697,3
2020-11-02,Humboldt,023,135768,603,569,1,570,8
2020-11-02,Imperial,025,180216,13394,13004,21,13025,334
2020-11-02,Inyo,027,18085,254,243,5,248,14
2020-11-02,Kern,029,883053,34942,33834,560,34394,437
2020-11-02,Kings,031,150075,9042,8654,57,8711,82
2020-11-02,Lake,033,64148,760,728,0,728,17
2020-11-02,Lassen,035,31185,799,782,2,784,0
2020-11-02,Los Angeles,037,10098052,316055,307620,3197,310817,7079
2020-11-02,Madera,039,155013,5273,5033,55,5088,54
2020-11-02,Marin,041,260295,7265,7132,20,7152,125
2020-11-02,Mariposa,043,17540,87,79,0,79,2
2020-11-02,Mendocino,045,87422,1140,1076,5,1081,21
2020-11-02,Merced,047,269075,9927,9664,39,9703,152
2020-11-02,Modoc,049,8938,54,45,5,50,0
2020-11-02,Mono,051,14174,442,211,8,219,1
2020-11-02,Monterey,053,433212,12055,11602,83,11685,93
2020-11-02,Napa,055,140530,2256,2081,10,2091,15
2020-11-02,Nevada,057,99092,724,656,19,675,9
2020-11-02,Orange,059,3164182,63280,59996,1901,61897,1474
2020-11-02,Placer,061,380077,4837,4461,21,4482,60
2020-11-02,Plumas,063,18699,101,86,0,86,0
2020-11-02,Riverside,065,2383286,71216,68833,592,69425,1321
2020-11-02,Sacramento,067,1510023,27543,26676,39,26715,508
2020-11-02,San Benito,069,59416,1496,1459,1,1460,15
2020-11-02,San Bernardino,071,2135413,68405,64629,538,65167,1157
2020-11-02,San Diego,073,3302833,60593,57429,1797,59226,891
2020-11-02,San Francisco,075,870044,12947,12436,56,12492,145
2020-11-02,San Joaquin,077,732212,22720,21919,272,22191,500
2020-11-02,San Luis Obispo,079,281455,4778,4303,40,4343,31
2020-11-02,San Mateo,081,765935,11880,11328,11,11339,161
2020-11-02,Santa Barbara,083,443738,10195,9985,121,10106,130
2020-11-02,Santa Clara,085,1922200,26980,25222,51,25273,387
2020-11-02,Santa Cruz,087,273765,3151,2943,35,2978,25
2020-11-02,Shasta,089,179085,2819,2174,24,2198,33
2020-11-02,Sierra,091,2930,7,6,0,6,0
2020-11-02,Siskiyou,093,43540,253,216,11,227,0
2020-11-02,Solano,095,438530,8048,7665,39,7704,84
2020-11-02,Sonoma,097,501317,10273,9796,33,9829,140
2020-11-02,Stanislaus,099,539301,18326,18005,858,18863,412
2020-11-02,Sutter,101,95872,1970,1895,2,1897,12
2020-11-02,Tehama,103,63373,1044,971,2,973,6
2020-11-02,Trinity,105,12862,110,30,13,43,0
2020-11-02,Tulare,107,460477,18569,17774,504,18278,299
2020-11-02,Tuolumne,109,53932,349,302,6,308,5
2020-11-02,Ventura,111,848112,15733,14767,405,15172,156
2020-11-02,Yolo,113,214977,3489,3318,10,3328,61
2020-11-02,Yuba,115,75493,1359,1280,5,1285,10
2020-11-01,Alameda,001,1643700,24627,23892,234,24126,419
2020-11-01,Alpine,003,1148,10,4,0,4,0
2020-11-01,Amador,005,37829,374,352,0,352,16
2020-11-01,Butte,007,227075,3309,3185,72,3257,57
2020-11-01,Calaveras,009,45235,349,282,0,282,18
2020-11-01,Colusa,011,21464,577,567,1,568,6
2020-11-01,Contra Costa,013,1133247,19845,19246,96,19342,250
2020-11-01,Del Norte,015,27424,190,175,0,175,2
2020-11-01,El Dorado,017,186661,1528,1394,14,1408,4
2020-11-01,Fresno,019,978130,34522,31613,522,32135,451
2020-11-01,Glenn,021,27897,711,688,3,691,3
2020-11-01,Humboldt,023,135768,595,568,1,569,8
2020-11-01,Imperial,025,180216,13303,12969,19,12988,334
2020-11-01,Inyo,027,18085,252,241,5,246,14
2020-11-01,Kern,029,883053,34761,33760,480,34240,437
2020-11-01,Kings,031,150075,9004,8641,56,8697,82
2020-11-01,Lake,033,64148,754,727,0,727,17
2020-11-01,Lassen,035,31185,799,782,2,784,0
2020-11-01,Los Angeles,037,10098052,313485,306217,3106,309323,7077
2020-11-01,Madera,039,155013,5226,5019,53,5072,54
2020-11-01,Marin,041,260295,7248,7124,20,7144,125
2020-11-01,Mariposa,043,17540,83,79,0,79,2
2020-11-01,Mendocino,045,87422,1126,1074,5,1079,21
2020-11-01,Merced,047,269075,9866,9626,39,9665,152
2020-11-01,Modoc,049,8938,53,45,5,50,0
2020-11-01,Mono,051,14174,413,211,7,218,1
2020-11-01,Monterey,053,433212,11948,11587,80,11667,93
2020-11-01,Napa,055,140530,2222,2067,10,2077,15
2020-11-01,Nevada,057,99092,708,646,18,664,9
2020-11-01,Orange,059,3164182,62878,59733,1875,61608,1475
2020-11-01,Placer,061,380077,4769,4422,20,4442,58
2020-11-01,Plumas,063,18699,96,86,0,86,0
2020-11-01,Riverside,065,2383286,70586,68493,557,69050,1319
2020-11-01,Sacramento,067,1510023,27221,26442,39,26481,508
2020-11-01,San Benito,069,59416,1481,1451,1,1452,15
2020-11-01,San Bernardino,071,2135413,67564,64339,517,64856,1157
2020-11-01,San Diego,073,3302833,59905,57122,1757,58879,891
2020-11-01,San Francisco,075,870044,12824,12436,51,12487,145
2020-11-01,San Joaquin,077,732212,22592,21919,266,22185,500
2020-11-01,San Luis Obispo,079,281455,4698,4303,39,4342,31
2020-11-01,San Mateo,081,765935,11799,11280,11,11291,160
2020-11-01,Santa Barbara,083,443738,10144,9969,105,10074,130
2020-11-01,Santa Clara,085,1922200,26697,25090,51,25141,386
2020-11-01,Santa Cruz,087,273765,3098,2921,35,2956,25
2020-11-01,Shasta,089,179085,2684,2172,23,2195,33
2020-11-01,Sierra,091,2930,7,6,0,6,0
2020-11-01,Siskiyou,093,43540,248,205,11,216,0
2020-11-01,Solano,095,438530,7958,7591,39,7630,84
2020-11-01,Sonoma,097,501317,10181,9688,33,9721,140
2020-11-01,Stanislaus,099,539301,18225,17961,839,18800,412
2020-11-01,Sutter,101,95872,1944,1888,1,1889,12
2020-11-01,Tehama,103,63373,1027,965,2,967,5
2020-11-01,Trinity,105,12862,108,30,12,42,0
2020-11-01,Tulare,107,460477,18457,17774,473,18247,299
2020-11-01,Tuolumne,109,53932,328,295,6,301,5
2020-11-01,Ventura,111,848112,15585,14686,377,15063,156
2020-11-01,Yolo,113,214977,3441,3303,10,3313,60
2020-11-01,Yuba,115,75493,1342,1273,5,1278,10
2020-10-31,Alameda,001,1643700,24511,23780,230,24010,416
2020-10-31,Alpine,003,1148,10,4,0,4,0
2020-10-31,Amador,005,37829,370,347,0,347,16
2020-10-31,Butte,007,227075,3296,3172,70,3242,57
2020-10-31,Calaveras,009,45235,349,280,0,280,18
2020-10-31,Colusa,011,21464,575,555,1,556,6
2020-10-31,Contra Costa,013,1133247,19740,19161,96,19257,249
2020-10-31,Del Norte,015,27424,189,175,0,175,2
2020-10-31,El Dorado,017,186661,1519,1390,14,1404,4
2020-10-31,Fresno,019,978130,34385,31558,519,32077,451
2020-10-31,Glenn,021,27897,709,678,3,681,3
2020-10-31,Humboldt,023,135768,592,561,1,562,8
2020-10-31,Imperial,025,180216,13261,12912,19,12931,334
2020-10-31,Inyo,027,18085,251,241,5,246,14
2020-10-31,Kern,029,883053,34658,33666,471,34137,437
2020-10-31,Kings,031,150075,8983,8612,55,8667,82
2020-10-31,Lake,033,64148,750,724,0,724,16
2020-10-31,Lassen,035,31185,794,782,2,784,0
2020-10-31,Los Angeles,037,10098052,312107,304704,3067,307771,7073
2020-10-31,Madera,039,155013,5207,5013,50,5063,54
2020-10-31,Marin,041,260295,7232,7112,20,7132,125
2020-10-31,Mariposa,043,17540,83,79,0,79,2
2020-10-31,Mendocino,045,87422,1118,1066,5,1071,21
2020-10-31,Merced,047,269075,9833,9597,38,9635,151
2020-10-31,Modoc,049,8938,52,34,4,38,0
2020-10-31,Mono,051,14174,264,194,6,200,1
2020-10-31,Monterey,053,433212,11880,11539,76,11615,93
2020-10-31,Napa,055,140530,2203,2040,10,2050,15
2020-10-31,Nevada,057,99092,690,644,18,662,9
2020-10-31,Orange,059,3164182,62619,59488,1857,61345,1473
2020-10-31,Placer,061,380077,4719,4374,19,4393,58
2020-10-31,Plumas,063,18699,95,85,0,85,0
2020-10-31,Riverside,065,2383286,70229,68178,534,68712,1319
2020-10-31,Sacramento,067,1510023,27022,26316,37,26353,507
2020-10-31,San Benito,069,59416,1474,1448,1,1449,15
2020-10-31,San Bernardino,071,2135413,67138,64016,507,64523,1157
2020-10-31,San Diego,073,3302833,59452,56769,1729,58498,891
2020-10-31,San Francisco,075,870044,12750,12438,50,12488,145
2020-10-31,San Joaquin,077,732212,22517,21918,257,22175,500
2020-10-31,San Luis Obispo,079,281455,4629,4285,36,4321,31
2020-10-31,San Mateo,081,765935,11748,11253,11,11264,160
2020-10-31,Santa Barbara,083,443738,10115,9957,97,10054,130
2020-10-31,Santa Clara,085,1922200,26529,24957,51,25008,379
2020-10-31,Santa Cruz,087,273765,3063,2895,34,2929,25
2020-10-31,Shasta,089,179085,2630,2122,22,2144,33
2020-10-31,Sierra,091,2930,7,6,0,6,0
2020-10-31,Siskiyou,093,43540,246,200,11,211,0
2020-10-31,Solano,095,438530,7893,7545,39,7584,84
2020-10-31,Sonoma,097,501317,10128,9648,33,9681,140
2020-10-31,Stanislaus,099,539301,18162,17920,823,18743,412
2020-10-31,Sutter,101,95872,1935,1876,1,1877,12
2020-10-31,Tehama,103,63373,1017,953,2,955,5
2020-10-31,Trinity,105,12862,105,30,12,42,0
2020-10-31,Tulare,107,460477,18408,17758,466,18224,299
2020-10-31,Tuolumne,109,53932,321,290,6,296,5
2020-10-31,Ventura,111,848112,15501,14635,359,14994,155
2020-10-31,Yolo,113,214977,3406,3290,10,3300,60
2020-10-31,Yuba,115,75493,1326,1260,4,1264,10
2020-10-30,Alameda,001,1643700,24432,23676,228,23904,401
2020-10-30,Alpine,003,1148,10,4,0,4,0
2020-10-30,Amador,005,37829,370,344,0,344,16
2020-10-30,Butte,007,227075,3291,3160,70,3230,57
2020-10-30,Calaveras,009,45235,348,279,0,279,18
2020-10-30,Colusa,011,21464,573,554,1,555,6
2020-10-30,Contra Costa,013,1133247,19667,19074,96,19170,249
2020-10-30,Del Norte,015,27424,188,175,0,175,2
2020-10-30,El Dorado,017,186661,1506,1386,14,1400,4
2020-10-30,Fresno,019,978130,34263,31409,511,31920,446
2020-10-30,Glenn,021,27897,703,674,2,676,3
2020-10-30,Humboldt,023,135768,591,561,1,562,7
2020-10-30,Imperial,025,180216,13220,12853,19,12872,334
2020-10-30,Inyo,027,18085,250,241,5,246,14
2020-10-30,Kern,029,883053,34565,33583,470,34053,437
2020-10-30,Kings,031,150075,8973,8564,53,8617,82
2020-10-30,Lake,033,64148,750,720,0,720,16
2020-10-30,Lassen,035,31185,788,777,2,779,0
2020-10-30,Los Angeles,037,10098052,310671,303425,3032,306457,7060
2020-10-30,Madera,039,155013,5194,4991,48,5039,54
2020-10-30,Marin,041,260295,7212,7097,20,7117,125
2020-10-30,Mariposa,043,17540,83,78,0,78,2
2020-10-30,Mendocino,045,87422,1116,1062,5,1067,21
2020-10-30,Merced,047,269075,9801,9539,38,9577,150
2020-10-30,Modoc,049,8938,51,34,3,37,0
2020-10-30,Mono,051,14174,263,193,6,199,1
2020-10-30,Monterey,053,433212,11817,11491,71,11562,92
2020-10-30,Napa,055,140530,2185,2028,10,2038,15
2020-10-30,Nevada,057,99092,684,634,18,652,9
2020-10-30,Orange,059,3164182,62378,59334,1845,61179,1469
2020-10-30,Placer,061,380077,4672,4335,19,4354,58
2020-10-30,Plumas,063,18699,92,80,0,80,0
2020-10-30,Riverside,065,2383286,69890,67752,514,68266,1317
2020-10-30,Sacramento,067,1510023,26874,26147,37,26184,505
2020-10-30,San Benito,069,59416,1468,1440,1,1441,15
2020-10-30,San Bernardino,071,2135413,66722,63512,504,64016,1156
2020-10-30,San Diego,073,3302833,59047,56387,1707,58094,888
2020-10-30,San Francisco,075,870044,12695,12384,50,12434,145
2020-10-30,San Joaquin,077,732212,22450,21849,251,22100,500
2020-10-30,San Luis Obispo,079,281455,4587,4256,36,4292,31
2020-10-30,San Mateo,081,765935,11689,11207,11,11218,159
2020-10-30,Santa Barbara,083,443738,10092,9937,97,10034,128
2020-10-30,Santa Clara,085,1922200,26381,24811,51,24862,378
2020-10-30,Santa Cruz,087,273765,3045,2874,34,2908,25
2020-10-30,Shasta,089,179085,2586,2048,21,2069,32
2020-10-30,Sierra,091,2930,7,6,0,6,0
2020-10-30,Siskiyou,093,43540,246,192,11,203,0
2020-10-30,Solano,095,438530,7832,7497,39,7536,84
2020-10-30,Sonoma,097,501317,10053,9602,33,9635,140
2020-10-30,Stanislaus,099,539301,18114,17861,808,18669,410
2020-10-30,Sutter,101,95872,1922,1860,1,1861,12
2020-10-30,Tehama,103,63373,1013,932,2,934,5
2020-10-30,Trinity,105,12862,105,29,12,41,0
2020-10-30,Tulare,107,460477,18363,17682,452,18134,299
2020-10-30,Tuolumne,109,53932,313,286,6,292,4
2020-10-30,Ventura,111,848112,15428,14578,348,14926,154
2020-10-30,Yolo,113,214977,3389,3263,10,3273,60
2020-10-30,Yuba,115,75493,1318,1256,4,1260,10
2020-10-29,Alameda,001,1643700,24269,23530,227,23757,401
2020-10-29,Alpine,003,1148,7,4,0,4,0
2020-10-29,Amador,005,37829,366,338,0,338,16
2020-10-29,Butte,007,227075,3273,3143,68,3211,57
2020-10-29,Calaveras,009,45235,346,278,0,278,13
2020-10-29,Colusa,011,21464,569,552,1,553,6
2020-10-29,Contra Costa,013,1133247,19569,18933,95,19028,249
2020-10-29,Del Norte,015,27424,186,174,0,174,2
2020-10-29,El Dorado,017,186661,1484,1370,14,1384,4
2020-10-29,Fresno,019,978130,34105,31321,504,31825,445
2020-10-29,Glenn,021,27897,701,673,2,675,3
2020-10-29,Humboldt,023,135768,586,559,1,560,7
2020-10-29,Imperial,025,180216,13177,12769,19,12788,334
2020-10-29,Inyo,027,18085,248,238,5,243,14
2020-10-29,Kern,029,883053,34464,33460,465,33925,437
2020-10-29,Kings,031,150075,8819,8502,52,8554,82
2020-10-29,Lake,033,64148,747,702,0,702,16
2020-10-29,Lassen,035,31185,787,772,2,774,0
2020-10-29,Los Angeles,037,10098052,309043,302246,2986,305232,7046
2020-10-29,Madera,039,155013,5163,4970,46,5016,53
2020-10-29,Marin,041,260295,7198,7083,20,7103,125
2020-10-29,Mariposa,043,17540,81,78,0,78,2
2020-10-29,Mendocino,045,87422,1110,1058,5,1063,21
2020-10-29,Merced,047,269075,9749,9496,38,9534,150
2020-10-29,Modoc,049,8938,49,31,3,34,0
2020-10-29,Mono,051,14174,256,176,6,182,1
2020-10-29,Monterey,053,433212,11736,11425,69,11494,92
2020-10-29,Napa,055,140530,2161,2009,10,2019,15
2020-10-29,Nevada,057,99092,677,632,18,650,9
2020-10-29,Orange,059,3164182,62110,59046,1825,60871,1464
2020-10-29,Placer,061,380077,4627,4270,18,4288,58
2020-10-29,Plumas,063,18699,90,69,0,69,0
2020-10-29,Riverside,065,2383286,69514,67268,484,67752,1304
2020-10-29,Sacramento,067,1510023,26661,25978,36,26014,507
2020-10-29,San Benito,069,59416,1463,1431,1,1432,15
2020-10-29,San Bernardino,071,2135413,66154,62968,494,63462,1150
2020-10-29,San Diego,073,3302833,58581,55916,1678,57594,885
2020-10-29,San Francisco,075,870044,12617,12312,50,12362,145
2020-10-29,San Joaquin,077,732212,22366,21736,239,21975,498
2020-10-29,San Luis Obispo,079,281455,4556,4223,35,4258,31
2020-10-29,San Mateo,081,765935,11644,11145,11,11156,157
2020-10-29,Santa Barbara,083,443738,10059,9902,95,9997,128
2020-10-29,Santa Clara,085,1922200,26230,24614,51,24665,377
2020-10-29,Santa Cruz,087,273765,3020,2850,34,2884,24
2020-10-29,Shasta,089,179085,2523,2008,21,2029,32
2020-10-29,Sierra,091,2930,6,6,0,6,0
2020-10-29,Siskiyou,093,43540,230,185,11,196,0
2020-10-29,Solano,095,438530,7770,7453,39,7492,78
2020-10-29,Sonoma,097,501317,9988,9533,33,9566,140
2020-10-29,Stanislaus,099,539301,18061,17790,787,18577,410
2020-10-29,Sutter,101,95872,1915,1852,1,1853,12
2020-10-29,Tehama,103,63373,995,925,2,927,5
2020-10-29,Trinity,105,12862,100,28,11,39,0
2020-10-29,Tulare,107,460477,18285,17627,434,18061,299
2020-10-29,Tuolumne,109,53932,308,279,6,285,4
2020-10-29,Ventura,111,848112,15337,14486,344,14830,154
2020-10-29,Yolo,113,214977,3360,3246,10,3256,60
2020-10-29,Yuba,115,75493,1307,1248,4,1252,10
2020-10-28,Alameda,001,1643700,24169,23468,226,23694,400
2020-10-28,Alpine,003,1148,6,4,0,4,0
2020-10-28,Amador,005,37829,363,337,0,337,16
2020-10-28,Butte,007,227075,3257,3134,65,3199,56
2020-10-28,Calaveras,009,45235,345,278,0,278,13
2020-10-28,Colusa,011,21464,566,551,1,552,6
2020-10-28,Contra Costa,013,1133247,19482,18828,94,18922,246
2020-10-28,Del Norte,015,27424,183,173,0,173,2
2020-10-28,El Dorado,017,186661,1472,1363,14,1377,4
2020-10-28,Fresno,019,978130,33985,31195,498,31693,444
2020-10-28,Glenn,021,27897,697,673,2,675,3
2020-10-28,Humboldt,023,135768,582,559,1,560,7
2020-10-28,Imperial,025,180216,13127,12730,19,12749,333
2020-10-28,Inyo,027,18085,248,238,5,243,14
2020-10-28,Kern,029,883053,34362,33424,447,33871,436
2020-10-28,Kings,031,150075,8797,8486,52,8538,82
2020-10-28,Lake,033,64148,744,700,0,700,15
2020-10-28,Lassen,035,31185,783,771,2,773,0
2020-10-28,Los Angeles,037,10098052,307588,300726,2943,303669,7031
2020-10-28,Madera,039,155013,5146,4954,45,4999,53
2020-10-28,Marin,041,260295,7187,7079,20,7099,126
2020-10-28,Mariposa,043,17540,81,78,0,78,2
2020-10-28,Mendocino,045,87422,1109,1037,5,1042,20
2020-10-28,Merced,047,269075,9723,9480,37,9517,150
2020-10-28,Modoc,049,8938,48,31,2,33,0
2020-10-28,Mono,051,14174,238,176,6,182,1
2020-10-28,Monterey,053,433212,11678,11330,67,11397,89
2020-10-28,Napa,055,140530,2135,1998,9,2007,15
2020-10-28,Nevada,057,99092,669,629,18,647,9
2020-10-28,Orange,059,3164182,61846,58801,1809,60610,1459
2020-10-28,Placer,061,380077,4571,4236,18,4254,57
2020-10-28,Plumas,063,18699,89,67,0,67,0
2020-10-28,Riverside,065,2383286,69117,67003,460,67463,1302
2020-10-28,Sacramento,067,1510023,26464,25838,35,25873,506
2020-10-28,San Benito,069,59416,1455,1429,1,1430,15
2020-10-28,San Bernardino,071,2135413,65695,62778,485,63263,1154
2020-10-28,San Diego,073,3302833,58198,55556,1649,57205,881
2020-10-28,San Francisco,075,870044,12559,12261,49,12310,145
2020-10-28,San Joaquin,077,732212,22282,21707,228,21935,498
2020-10-28,San Luis Obispo,079,281455,4512,4197,32,4229,31
2020-10-28,San Mateo,081,765935,11577,11101,11,11112,157
2020-10-28,Santa Barbara,083,443738,10036,9872,93,9965,127
2020-10-28,Santa Clara,085,1922200,26086,24503,51,24554,375
2020-10-28,Santa Cruz,087,273765,2989,2836,34,2870,24
2020-10-28,Shasta,089,179085,2443,1996,20,2016,31
2020-10-28,Sierra,091,2930,6,6,0,6,0
2020-10-28,Siskiyou,093,43540,227,182,10,192,0
2020-10-28,Solano,095,438530,7711,7362,39,7401,77
2020-10-28,Sonoma,097,501317,9898,9457,28,9485,140
2020-10-28,Stanislaus,099,539301,17996,17765,778,18543,409
2020-10-28,Sutter,101,95872,1906,1840,1,1841,12
2020-10-28,Tehama,103,63373,984,921,2,923,5
2020-10-28,Trinity,105,12862,93,28,10,38,0
2020-10-28,Tulare,107,460477,18228,17569,419,17988,297
2020-10-28,Tuolumne,109,53932,304,277,6,283,4
2020-10-28,Ventura,111,848112,15264,14409,335,14744,153
2020-10-28,Yolo,113,214977,3335,3230,10,3240,60
2020-10-28,Yuba,115,75493,1295,1245,4,1249,10
2020-10-27,Alameda,001,1643700,24054,23365,224,23589,400
2020-10-27,Alpine,003,1148,6,3,0,3,0
2020-10-27,Amador,005,37829,360,335,0,335,16
2020-10-27,Butte,007,227075,3241,3107,62,3169,56
2020-10-27,Calaveras,009,45235,343,277,0,277,13
2020-10-27,Colusa,011,21464,561,549,1,550,6
2020-10-27,Contra Costa,013,1133247,19376,18766,94,18860,246
2020-10-27,Del Norte,015,27424,180,173,0,173,2
2020-10-27,El Dorado,017,186661,1459,1351,14,1365,4
2020-10-27,Fresno,019,978130,33866,31096,493,31589,442
2020-10-27,Glenn,021,27897,695,667,1,668,3
2020-10-27,Humboldt,023,135768,579,559,1,560,7
2020-10-27,Imperial,025,180216,13078,12680,19,12699,333
2020-10-27,Inyo,027,18085,248,231,5,236,14
2020-10-27,Kern,029,883053,34245,33328,443,33771,436
2020-10-27,Kings,031,150075,8766,8411,52,8463,83
2020-10-27,Lake,033,64148,741,700,0,700,15
2020-10-27,Lassen,035,31185,781,764,2,766,0
2020-10-27,Los Angeles,037,10098052,306200,299438,2914,302352,7008
2020-10-27,Madera,039,155013,5116,4942,44,4986,53
2020-10-27,Marin,041,260295,7171,7070,20,7090,126
2020-10-27,Mariposa,043,17540,80,78,0,78,2
2020-10-27,Mendocino,045,87422,1103,1033,4,1037,20
2020-10-27,Merced,047,269075,9682,9449,37,9486,150
2020-10-27,Modoc,049,8938,46,31,2,33,0
2020-10-27,Mono,051,14174,224,169,6,175,1
2020-10-27,Monterey,053,433212,11622,11261,65,11326,88
2020-10-27,Napa,055,140530,2119,1979,9,1988,15
2020-10-27,Nevada,057,99092,663,622,18,640,8
2020-10-27,Orange,059,3164182,61576,58550,1793,60343,1448
2020-10-27,Placer,061,380077,4522,4197,16,4213,57
2020-10-27,Plumas,063,18699,86,63,0,63,0
2020-10-27,Riverside,065,2383286,68764,66699,415,67114,1299
2020-10-27,Sacramento,067,1510023,26277,25701,34,25735,501
2020-10-27,San Benito,069,59416,1450,1428,1,1429,15
2020-10-27,San Bernardino,071,2135413,65233,62357,472,62829,1154
2020-10-27,San Diego,073,3302833,57725,55226,1626,56852,877
2020-10-27,San Francisco,075,870044,12484,12218,48,12266,140
2020-10-27,San Joaquin,077,732212,22191,21637,219,21856,496
2020-10-27,San Luis Obispo,079,281455,4485,4148,28,4176,31
2020-10-27,San Mateo,081,765935,11530,11074,11,11085,156
2020-10-27,Santa Barbara,083,443738,10006,9874,92,9966,125
2020-10-27,Santa Clara,085,1922200,25944,24368,51,24419,367
2020-10-27,Santa Cruz,087,273765,2959,2815,33,2848,24
2020-10-27,Shasta,089,179085,2357,1962,20,1982,29
2020-10-27,Sierra,091,2930,6,6,0,6,0
2020-10-27,Siskiyou,093,43540,218,181,10,191,0
2020-10-27,Solano,095,438530,7642,7298,39,7337,77
2020-10-27,Sonoma,097,501317,9831,9389,28,9417,140
2020-10-27,Stanislaus,099,539301,17928,17720,771,18491,408
2020-10-27,Sutter,101,95872,1893,1832,1,1833,12
2020-10-27,Tehama,103,63373,970,913,2,915,5
2020-10-27,Trinity,105,12862,90,28,10,38,0
2020-10-27,Tulare,107,460477,18165,17520,396,17916,296
2020-10-27,Tuolumne,109,53932,300,275,6,281,4
2020-10-27,Ventura,111,848112,15181,14347,328,14675,153
2020-10-27,Yolo,113,214977,3322,3216,10,3226,58
2020-10-27,Yuba,115,75493,1282,1235,4,1239,10
2020-10-26,Alameda,001,1643700,23941,23284,223,23507,398
2020-10-26,Alpine,003,1148,4,3,0,3,0
2020-10-26,Amador,005,37829,356,331,0,331,16
2020-10-26,Butte,007,227075,3230,3095,60,3155,56
2020-10-26,Calaveras,009,45235,340,274,0,274,13
2020-10-26,Colusa,011,21464,559,548,1,549,6
2020-10-26,Contra Costa,013,1133247,19280,18718,93,18811,245
2020-10-26,Del Norte,015,27424,180,171,0,171,2
2020-10-26,El Dorado,017,186661,1445,1336,14,1350,4
2020-10-26,Fresno,019,978130,33753,30969,486,31455,441
2020-10-26,Glenn,021,27897,688,660,1,661,3
2020-10-26,Humboldt,023,135768,571,554,1,555,7
2020-10-26,Imperial,025,180216,13024,12654,16,12670,333
2020-10-26,Inyo,027,18085,248,226,5,231,14
2020-10-26,Kern,029,883053,34161,33233,438,33671,432
2020-10-26,Kings,031,150075,8745,8264,50,8314,82
2020-10-26,Lake,033,64148,739,697,0,697,15
2020-10-26,Lassen,035,31185,778,764,2,766,0
2020-10-26,Los Angeles,037,10098052,304773,297961,2873,300834,6979
2020-10-26,Madera,039,155013,5095,4922,43,4965,53
2020-10-26,Marin,041,260295,7165,7064,19,7083,104
2020-10-26,Mariposa,043,17540,80,77,0,77,2
2020-10-26,Mendocino,045,87422,1095,1026,4,1030,20
2020-10-26,Merced,047,269075,9635,9375,36,9411,150
2020-10-26,Modoc,049,8938,44,28,0,28,0
2020-10-26,Mono,051,14174,218,167,6,173,1
2020-10-26,Monterey,053,433212,11571,11207,61,11268,87
2020-10-26,Napa,055,140530,2087,1966,9,1975,14
2020-10-26,Nevada,057,99092,656,618,18,636,8
2020-10-26,Orange,059,3164182,61372,58377,1775,60152,1442
2020-10-26,Placer,061,380077,4480,4161,15,4176,57
2020-10-26,Plumas,063,18699,84,63,0,63,0
2020-10-26,Riverside,065,2383286,68313,66475,389,66864,1294
2020-10-26,Sacramento,067,1510023,26097,25555,32,25587,496
2020-10-26,San Benito,069,59416,1442,1424,1,1425,15
2020-10-26,San Bernardino,071,2135413,64762,61871,469,62340,1153
2020-10-26,San Diego,073,3302833,57332,54957,1588,56545,870
2020-10-26,San Francisco,075,870044,12424,12072,48,12120,138
2020-10-26,San Joaquin,077,732212,22108,21459,213,21672,495
2020-10-26,San Luis Obispo,079,281455,4459,4133,28,4161,31
2020-10-26,San Mateo,081,765935,11486,11037,11,11048,156
2020-10-26,Santa Barbara,083,443738,9983,9827,92,9919,122
2020-10-26,Santa Clara,085,1922200,25754,24258,50,24308,365
2020-10-26,Santa Cruz,087,273765,2933,2808,33,2841,24
2020-10-26,Shasta,089,179085,2303,1889,20,1909,29
2020-10-26,Sierra,091,2930,6,6,0,6,0
2020-10-26,Siskiyou,093,43540,210,179,10,189,0
2020-10-26,Solano,095,438530,7562,7271,39,7310,62
2020-10-26,Sonoma,097,501317,9754,9315,28,9343,140
2020-10-26,Stanislaus,099,539301,17878,17666,761,18427,400
2020-10-26,Sutter,101,95872,1885,1817,1,1818,12
2020-10-26,Tehama,103,63373,950,892,2,894,5
2020-10-26,Trinity,105,12862,89,26,10,36,0
2020-10-26,Tulare,107,460477,18088,17432,373,17805,296
2020-10-26,Tuolumne,109,53932,291,271,6,277,4
2020-10-26,Ventura,111,848112,15112,14330,325,14655,154
2020-10-26,Yolo,113,214977,3303,3206,10,3216,58
2020-10-26,Yuba,115,75493,1266,1226,4,1230,10
2020-10-25,Alameda,001,1643700,23834,23192,223,23415,398
2020-10-25,Alpine,003,1148,3,3,0,3,0
2020-10-25,Amador,005,37829,345,330,0,330,16
2020-10-25,Butte,007,227075,3210,3087,60,3147,56
2020-10-25,Calaveras,009,45235,339,274,0,274,13
2020-10-25,Colusa,011,21464,555,548,1,549,6
2020-10-25,Contra Costa,013,1133247,19177,18640,93,18733,245
2020-10-25,Del Norte,015,27424,176,171,0,171,2
2020-10-25,El Dorado,017,186661,1430,1328,14,1342,4
2020-10-25,Fresno,019,978130,33619,30858,473,31331,441
2020-10-25,Glenn,021,27897,685,652,1,653,3
2020-10-25,Humboldt,023,135768,568,554,1,555,7
2020-10-25,Imperial,025,180216,12975,12572,16,12588,333
2020-10-25,Inyo,027,18085,245,226,5,231,14
2020-10-25,Kern,029,883053,34054,33185,434,33619,432
2020-10-25,Kings,031,150075,8712,8246,48,8294,82
2020-10-25,Lake,033,64148,722,695,0,695,15
2020-10-25,Lassen,035,31185,776,764,2,766,0
2020-10-25,Los Angeles,037,10098052,303209,297110,2837,299947,6973
2020-10-25,Madera,039,155013,5065,4909,38,4947,53
2020-10-25,Marin,041,260295,7155,7052,19,7071,102
2020-10-25,Mariposa,043,17540,80,77,0,77,2
2020-10-25,Mendocino,045,87422,1088,1024,4,1028,20
2020-10-25,Merced,047,269075,9570,9352,34,9386,150
2020-10-25,Modoc,049,8938,39,28,0,28,0
2020-10-25,Mono,051,14174,210,167,6,173,1
2020-10-25,Monterey,053,433212,11488,11182,56,11238,87
2020-10-25,Napa,055,140530,2057,1962,9,1971,14
2020-10-25,Nevada,057,99092,648,616,18,634,8
2020-10-25,Orange,059,3164182,61083,58185,1766,59951,1443
2020-10-25,Placer,061,380077,4428,4140,15,4155,57
2020-10-25,Plumas,063,18699,84,63,0,63,0
2020-10-25,Riverside,065,2383286,67863,66192,373,66565,1289
2020-10-25,Sacramento,067,1510023,25882,25445,30,25475,496
2020-10-25,San Benito,069,59416,1435,1423,1,1424,15
2020-10-25,San Bernardino,071,2135413,64222,61551,457,62008,1153
2020-10-25,San Diego,073,3302833,56869,54599,1556,56155,870
2020-10-25,San Francisco,075,870044,12351,12072,48,12120,137
2020-10-25,San Joaquin,077,732212,22000,21459,204,21663,495
2020-10-25,San Luis Obispo,079,281455,4417,4126,26,4152,31
2020-10-25,San Mateo,081,765935,11441,10987,11,10998,156
2020-10-25,Santa Barbara,083,443738,9964,9814,92,9906,122
2020-10-25,Santa Clara,085,1922200,25566,24087,50,24137,365
2020-10-25,Santa Cruz,087,273765,2906,2789,33,2822,24
2020-10-25,Shasta,089,179085,2239,1889,20,1909,29
2020-10-25,Sierra,091,2930,6,6,0,6,0
2020-10-25,Siskiyou,093,43540,207,176,10,186,0
2020-10-25,Solano,095,438530,7484,7197,39,7236,60
2020-10-25,Sonoma,097,501317,9661,9235,27,9262,140
2020-10-25,Stanislaus,099,539301,17821,17641,752,18393,400
2020-10-25,Sutter,101,95872,1867,1811,1,1812,12
2020-10-25,Tehama,103,63373,933,880,2,882,5
2020-10-25,Trinity,105,12862,85,26,10,36,0
2020-10-25,Tulare,107,460477,18014,17431,363,17794,296
2020-10-25,Tuolumne,109,53932,286,271,6,277,4
2020-10-25,Ventura,111,848112,15019,14300,319,14619,154
2020-10-25,Yolo,113,214977,3282,3190,10,3200,58
2020-10-25,Yuba,115,75493,1258,1219,4,1223,10
2020-10-24,Alameda,001,1643700,23763,23099,220,23319,398
2020-10-24,Alpine,003,1148,3,3,0,3,0
2020-10-24,Amador,005,37829,344,328,0,328,16
2020-10-24,Butte,007,227075,3201,3078,60,3138,56
2020-10-24,Calaveras,009,45235,337,274,0,274,13
2020-10-24,Colusa,011,21464,550,548,1,549,6
2020-10-24,Contra Costa,013,1133247,19111,18567,93,18660,244
2020-10-24,Del Norte,015,27424,175,171,0,171,2
2020-10-24,El Dorado,017,186661,1414,1317,14,1331,4
2020-10-24,Fresno,019,978130,33558,30752,468,31220,441
2020-10-24,Glenn,021,27897,682,650,1,651,3
2020-10-24,Humboldt,023,135768,566,553,1,554,7
2020-10-24,Imperial,025,180216,12948,12469,16,12485,333
2020-10-24,Inyo,027,18085,245,226,5,231,14
2020-10-24,Kern,029,883053,33996,33105,429,33534,432
2020-10-24,Kings,031,150075,8702,8228,47,8275,82
2020-10-24,Lake,033,64148,717,696,0,696,15
2020-10-24,Lassen,035,31185,775,764,2,766,0
2020-10-24,Los Angeles,037,10098052,302391,296323,2815,299138,6969
2020-10-24,Madera,039,155013,5052,4898,37,4935,53
2020-10-24,Marin,041,260295,7146,7042,19,7061,102
2020-10-24,Mariposa,043,17540,80,77,0,77,2
2020-10-24,Mendocino,045,87422,1076,1022,4,1026,20
2020-10-24,Merced,047,269075,9546,9351,34,9385,150
2020-10-24,Modoc,049,8938,38,28,0,28,0
2020-10-24,Mono,051,14174,196,167,6,173,1
2020-10-24,Monterey,053,433212,11419,11153,55,11208,87
2020-10-24,Napa,055,140530,2040,1957,8,1965,14
2020-10-24,Nevada,057,99092,644,608,18,626,8
2020-10-24,Orange,059,3164182,60928,57928,1756,59684,1441
2020-10-24,Placer,061,380077,4397,4093,15,4108,57
2020-10-24,Plumas,063,18699,78,63,0,63,0
2020-10-24,Riverside,065,2383286,67655,65902,359,66261,1288
2020-10-24,Sacramento,067,1510023,25801,25372,30,25402,496
2020-10-24,San Benito,069,59416,1430,1417,1,1418,15
2020-10-24,San Bernardino,071,2135413,63983,61351,449,61800,1153
2020-10-24,San Diego,073,3302833,56592,54330,1543,55873,868
2020-10-24,San Francisco,075,870044,12292,12073,47,12120,137
2020-10-24,San Joaquin,077,732212,21947,21458,199,21657,495
2020-10-24,San Luis Obispo,079,281455,4394,4119,25,4144,31
2020-10-24,San Mateo,081,765935,11402,10942,11,10953,155
2020-10-24,Santa Barbara,083,443738,9947,9781,92,9873,122
2020-10-24,Santa Clara,085,1922200,25479,23978,50,24028,365
2020-10-24,Santa Cruz,087,273765,2887,2775,33,2808,24
2020-10-24,Shasta,089,179085,2194,1878,20,1898,29
2020-10-24,Sierra,091,2930,6,6,0,6,0
2020-10-24,Siskiyou,093,43540,206,174,10,184,0
2020-10-24,Solano,095,438530,7431,7189,39,7228,60
2020-10-24,Sonoma,097,501317,9627,9179,27,9206,140
2020-10-24,Stanislaus,099,539301,17778,17574,737,18311,400
2020-10-24,Sutter,101,95872,1858,1804,1,1805,12
2020-10-24,Tehama,103,63373,925,872,2,874,5
2020-10-24,Trinity,105,12862,85,25,10,35,0
2020-10-24,Tulare,107,460477,17992,17406,351,17757,295
2020-10-24,Tuolumne,109,53932,283,269,6,275,4
2020-10-24,Ventura,111,848112,14966,14240,318,14558,154
2020-10-24,Yolo,113,214977,3270,3164,10,3174,57
2020-10-24,Yuba,115,75493,1255,1210,4,1214,10
2020-10-23,Alameda,001,1643700,23690,23047,218,23265,393
2020-10-23,Alpine,003,1148,3,3,0,3,0
2020-10-23,Amador,005,37829,343,324,0,324,16
2020-10-23,Butte,007,227075,3192,3059,60,3119,55
2020-10-23,Calaveras,009,45235,336,273,0,273,13
2020-10-23,Colusa,011,21464,550,547,1,548,6
2020-10-23,Contra Costa,013,1133247,19041,18483,92,18575,244
2020-10-23,Del Norte,015,27424,175,171,0,171,2
2020-10-23,El Dorado,017,186661,1405,1310,14,1324,4
2020-10-23,Fresno,019,978130,33491,30590,465,31055,441
2020-10-23,Glenn,021,27897,679,644,1,645,3
2020-10-23,Humboldt,023,135768,564,553,1,554,7
2020-10-23,Imperial,025,180216,12917,12398,15,12413,333
2020-10-23,Inyo,027,18085,244,226,5,231,14
2020-10-23,Kern,029,883053,33928,33077,424,33501,431
2020-10-23,Kings,031,150075,8693,8218,47,8265,82
2020-10-23,Lake,033,64148,715,689,0,689,15
2020-10-23,Lassen,035,31185,774,764,2,766,0
2020-10-23,Los Angeles,037,10098052,301305,294287,2788,297075,6956
2020-10-23,Madera,039,155013,5047,4888,37,4925,53
2020-10-23,Marin,041,260295,7133,7029,19,7048,102
2020-10-23,Mariposa,043,17540,80,77,0,77,2
2020-10-23,Mendocino,045,87422,1073,1019,4,1023,20
2020-10-23,Merced,047,269075,9532,9327,34,9361,149
2020-10-23,Modoc,049,8938,38,28,0,28,0
2020-10-23,Mono,051,14174,194,159,6,165,1
2020-10-23,Monterey,053,433212,11372,11099,51,11150,86
2020-10-23,Napa,055,140530,2032,1942,8,1950,14
2020-10-23,Nevada,057,99092,641,604,18,622,8
2020-10-23,Orange,059,3164182,60758,57595,1741,59336,1430
2020-10-23,Placer,061,380077,4350,4073,15,4088,57
2020-10-23,Plumas,063,18699,75,63,0,63,0
2020-10-23,Riverside,065,2383286,67416,65512,351,65863,1279
2020-10-23,Sacramento,067,1510023,25696,25224,30,25254,496
2020-10-23,San Benito,069,59416,1428,1412,1,1413,15
2020-10-23,San Bernardino,071,2135413,63697,60854,435,61289,1150
2020-10-23,San Diego,073,3302833,56286,53944,1516,55460,867
2020-10-23,San Francisco,075,870044,12261,12015,47,12062,137
2020-10-23,San Joaquin,077,732212,21891,21361,193,21554,495
2020-10-23,San Luis Obispo,079,281455,4369,4102,25,4127,31
2020-10-23,San Mateo,081,765935,11353,10872,11,10883,155
2020-10-23,Santa Barbara,083,443738,9931,9751,92,9843,121
2020-10-23,Santa Clara,085,1922200,25377,23822,50,23872,364
2020-10-23,Santa Cruz,087,273765,2873,2757,33,2790,24
2020-10-23,Shasta,089,179085,2157,1846,19,1865,29
2020-10-23,Sierra,091,2930,6,6,0,6,0
2020-10-23,Siskiyou,093,43540,202,172,10,182,0
2020-10-23,Solano,095,438530,7400,7174,39,7213,59
2020-10-23,Sonoma,097,501317,9570,9112,27,9139,139
2020-10-23,Stanislaus,099,539301,17741,17496,730,18226,395
2020-10-23,Sutter,101,95872,1851,1797,1,1798,12
2020-10-23,Tehama,103,63373,916,862,2,864,5
2020-10-23,Trinity,105,12862,85,26,10,36,0
2020-10-23,Tulare,107,460477,17947,17334,340,17674,295
2020-10-23,Tuolumne,109,53932,280,254,6,260,4
2020-10-23,Ventura,111,848112,14937,14192,318,14510,155
2020-10-23,Yolo,113,214977,3258,3140,10,3150,57
2020-10-23,Yuba,115,75493,1251,1206,4,1210,10
2020-10-22,Alameda,001,1643700,23589,22915,218,23133,393
2020-10-22,Alpine,003,1148,3,3,0,3,0
2020-10-22,Amador,005,37829,339,317,0,317,16
2020-10-22,Butte,007,227075,3182,3046,58,3104,55
2020-10-22,Calaveras,009,45235,333,273,0,273,13
2020-10-22,Colusa,011,21464,550,547,1,548,6
2020-10-22,Contra Costa,013,1133247,18970,18393,92,18485,243
2020-10-22,Del Norte,015,27424,174,168,0,168,2
2020-10-22,El Dorado,017,186661,1395,1308,14,1322,4
2020-10-22,Fresno,019,978130,33380,30471,457,30928,438
2020-10-22,Glenn,021,27897,672,643,1,644,3
2020-10-22,Humboldt,023,135768,562,548,1,549,7
2020-10-22,Imperial,025,180216,12864,12311,15,12326,333
2020-10-22,Inyo,027,18085,241,220,5,225,14
2020-10-22,Kern,029,883053,33847,32991,421,33412,431
2020-10-22,Kings,031,150075,8442,8201,47,8248,82
2020-10-22,Lake,033,64148,711,678,0,678,15
2020-10-22,Lassen,035,31185,771,764,2,766,0
2020-10-22,Los Angeles,037,10098052,299925,291599,2734,294333,6935
2020-10-22,Madera,039,155013,5026,4847,37,4884,52
2020-10-22,Marin,041,260295,7126,7014,19,7033,102
2020-10-22,Mariposa,043,17540,80,77,0,77,2
2020-10-22,Mendocino,045,87422,1068,1016,4,1020,20
2020-10-22,Merced,047,269075,9504,9323,34,9357,149
2020-10-22,Modoc,049,8938,34,26,0,26,0
2020-10-22,Mono,051,14174,189,156,6,162,1
2020-10-22,Monterey,053,433212,11313,11059,48,11107,84
2020-10-22,Napa,055,140530,2017,1928,8,1936,14
2020-10-22,Nevada,057,99092,635,600,18,618,8
2020-10-22,Orange,059,3164182,60544,57418,1724,59142,1422
2020-10-22,Placer,061,380077,4301,4036,15,4051,57
2020-10-22,Plumas,063,18699,72,62,0,62,0
2020-10-22,Riverside,065,2383286,67081,65104,333,65437,1279
2020-10-22,Sacramento,067,1510023,25556,25054,30,25084,492
2020-10-22,San Benito,069,59416,1424,1403,1,1404,15
2020-10-22,San Bernardino,071,2135413,63295,60402,420,60822,1149
2020-10-22,San Diego,073,3302833,55899,53514,1497,55011,866
2020-10-22,San Francisco,075,870044,12203,11991,45,12036,137
2020-10-22,San Joaquin,077,732212,21818,21282,187,21469,495
2020-10-22,San Luis Obispo,079,281455,4353,4081,25,4106,31
2020-10-22,San Mateo,081,765935,11297,10796,11,10807,155
2020-10-22,Santa Barbara,083,443738,9898,9710,90,9800,120
2020-10-22,Santa Clara,085,1922200,25223,23621,50,23671,363
2020-10-22,Santa Cruz,087,273765,2855,2738,32,2770,24
2020-10-22,Shasta,089,179085,2111,1799,19,1818,29
2020-10-22,Sierra,091,2930,6,6,0,6,0
2020-10-22,Siskiyou,093,43540,201,169,10,179,0
2020-10-22,Solano,095,438530,7354,7116,39,7155,59
2020-10-22,Sonoma,097,501317,9504,9052,26,9078,139
2020-10-22,Stanislaus,099,539301,17688,17440,718,18158,395
2020-10-22,Sutter,101,95872,1837,1794,1,1795,12
2020-10-22,Tehama,103,63373,905,852,2,854,5
2020-10-22,Trinity,105,12862,84,26,10,36,0
2020-10-22,Tulare,107,460477,17881,17265,327,17592,293
2020-10-22,Tuolumne,109,53932,277,252,6,258,4
2020-10-22,Ventura,111,848112,14890,14124,316,14440,154
2020-10-22,Yolo,113,214977,3246,3116,10,3126,58
2020-10-22,Yuba,115,75493,1244,1199,3,1202,10
2020-10-21,Alameda,001,1643700,23501,22853,216,23069,392
2020-10-21,Alpine,003,1148,3,3,0,3,0
2020-10-21,Amador,005,37829,334,313,0,313,16
2020-10-21,Butte,007,227075,3170,3041,58,3099,55
2020-10-21,Calaveras,009,45235,332,272,0,272,13
2020-10-21,Colusa,011,21464,550,546,1,547,6
2020-10-21,Contra Costa,013,1133247,18896,18299,92,18391,243
2020-10-21,Del Norte,015,27424,174,169,0,169,2
2020-10-21,El Dorado,017,186661,1383,1305,13,1318,4
2020-10-21,Fresno,019,978130,33284,30328,452,30780,433
2020-10-21,Glenn,021,27897,667,640,1,641,3
2020-10-21,Humboldt,023,135768,561,548,1,549,7
2020-10-21,Imperial,025,180216,12807,12210,15,12225,331
2020-10-21,Inyo,027,18085,237,220,5,225,14
2020-10-21,Kern,029,883053,33772,32956,419,33375,430
2020-10-21,Kings,031,150075,8415,8186,47,8233,80
2020-10-21,Lake,033,64148,710,676,0,676,15
2020-10-21,Lassen,035,31185,770,764,2,766,0
2020-10-21,Los Angeles,037,10098052,298584,288096,2692,290788,6923
2020-10-21,Madera,039,155013,5001,4831,37,4868,52
2020-10-21,Marin,041,260295,7117,7002,19,7021,102
2020-10-21,Mariposa,043,17540,80,77,0,77,2
2020-10-21,Mendocino,045,87422,1066,1011,4,1015,21
2020-10-21,Merced,047,269075,9480,9319,32,9351,149
2020-10-21,Modoc,049,8938,33,26,0,26,0
2020-10-21,Mono,051,14174,187,156,6,162,1
2020-10-21,Monterey,053,433212,11275,11005,47,11052,83
2020-10-21,Napa,055,140530,2002,1918,8,1926,13
2020-10-21,Nevada,057,99092,629,597,18,615,8
2020-10-21,Orange,059,3164182,60332,57189,1715,58904,1409
2020-10-21,Placer,061,380077,4264,4007,15,4022,56
2020-10-21,Plumas,063,18699,69,58,0,58,0
2020-10-21,Riverside,065,2383286,66785,64778,309,65087,1278
2020-10-21,Sacramento,067,1510023,25362,24908,30,24938,490
2020-10-21,San Benito,069,59416,1423,1401,1,1402,14
2020-10-21,San Bernardino,071,2135413,62885,59948,413,60361,1141
2020-10-21,San Diego,073,3302833,55547,53279,1469,54748,863
2020-10-21,San Francisco,075,870044,12154,11976,44,12020,137
2020-10-21,San Joaquin,077,732212,21742,21201,181,21382,495
2020-10-21,San Luis Obispo,079,281455,4326,4055,23,4078,31
2020-10-21,San Mateo,081,765935,11248,10730,11,10741,155
2020-10-21,Santa Barbara,083,443738,9881,9681,89,9770,121
2020-10-21,Santa Clara,085,1922200,25096,23537,50,23587,361
2020-10-21,Santa Cruz,087,273765,2832,2729,32,2761,24
2020-10-21,Shasta,089,179085,2075,1777,19,1796,27
2020-10-21,Sierra,091,2930,6,6,0,6,0
2020-10-21,Siskiyou,093,43540,197,169,10,179,0
2020-10-21,Solano,095,438530,7308,7088,39,7127,59
2020-10-21,Sonoma,097,501317,9424,8987,26,9013,138
2020-10-21,Stanislaus,099,539301,17639,17419,710,18129,392
2020-10-21,Sutter,101,95872,1823,1786,1,1787,12
2020-10-21,Tehama,103,63373,889,824,2,826,5
2020-10-21,Trinity,105,12862,78,25,9,34,0
2020-10-21,Tulare,107,460477,17843,17204,313,17517,292
2020-10-21,Tuolumne,109,53932,276,251,6,257,4
2020-10-21,Ventura,111,848112,14827,14050,313,14363,153
2020-10-21,Yolo,113,214977,3227,3095,10,3105,58
2020-10-21,Yuba,115,75493,1236,1194,3,1197,10
2020-10-20,Alameda,001,1643700,23399,22750,212,22962,391
2020-10-20,Alpine,003,1148,3,3,0,3,0
2020-10-20,Amador,005,37829,333,313,0,313,16
2020-10-20,Butte,007,227075,3158,3027,58,3085,56
2020-10-20,Calaveras,009,45235,330,273,0,273,13
2020-10-20,Colusa,011,21464,547,546,1,547,6
2020-10-20,Contra Costa,013,1133247,18803,18246,92,18338,241
2020-10-20,Del Norte,015,27424,173,169,0,169,2
2020-10-20,El Dorado,017,186661,1377,1295,13,1308,4
2020-10-20,Fresno,019,978130,33181,30220,446,30666,431
2020-10-20,Glenn,021,27897,662,638,1,639,3
2020-10-20,Humboldt,023,135768,557,545,1,546,7
2020-10-20,Imperial,025,180216,12739,12114,15,12129,330
2020-10-20,Inyo,027,18085,237,218,5,223,14
2020-10-20,Kern,029,883053,33697,32889,406,33295,429
2020-10-20,Kings,031,150075,8397,8178,46,8224,80
2020-10-20,Lake,033,64148,708,675,0,675,15
2020-10-20,Lassen,035,31185,769,757,2,759,0
2020-10-20,Los Angeles,037,10098052,297089,287727,2644,290371,6891
2020-10-20,Madera,039,155013,4984,4823,37,4860,52
2020-10-20,Marin,041,260295,7102,6994,19,7013,101
2020-10-20,Mariposa,043,17540,79,77,0,77,2
2020-10-20,Mendocino,045,87422,1064,1004,4,1008,21
2020-10-20,Merced,047,269075,9458,9323,32,9355,149
2020-10-20,Modoc,049,8938,32,26,0,26,0
2020-10-20,Mono,051,14174,187,156,6,162,1
2020-10-20,Monterey,053,433212,11232,10942,44,10986,81
2020-10-20,Napa,055,140530,1983,1912,8,1920,13
2020-10-20,Nevada,057,99092,619,596,18,614,8
2020-10-20,Orange,059,3164182,60068,56914,1705,58619,1397
2020-10-20,Placer,061,380077,4226,3997,15,4012,56
2020-10-20,Plumas,063,18699,66,53,0,53,0
2020-10-20,Riverside,065,2383286,66406,64452,297,64749,1275
2020-10-20,Sacramento,067,1510023,25234,24767,29,24796,485
2020-10-20,San Benito,069,59416,1420,1398,1,1399,14
2020-10-20,San Bernardino,071,2135413,62501,59571,411,59982,1109
2020-10-20,San Diego,073,3302833,55211,53004,1449,54453,857
2020-10-20,San Francisco,075,870044,12107,12013,43,12056,126
2020-10-20,San Joaquin,077,732212,21663,21173,172,21345,490
2020-10-20,San Luis Obispo,079,281455,4308,4043,22,4065,31
2020-10-20,San Mateo,081,765935,11201,10659,11,10670,155
2020-10-20,Santa Barbara,083,443738,9852,9664,87,9751,121
2020-10-20,Santa Clara,085,1922200,24958,23406,50,23456,358
2020-10-20,Santa Cruz,087,273765,2809,2710,32,2742,23
2020-10-20,Shasta,089,179085,2052,1747,19,1766,20
2020-10-20,Sierra,091,2930,6,6,0,6,0
2020-10-20,Siskiyou,093,43540,189,168,10,178,0
2020-10-20,Solano,095,438530,7259,7044,39,7083,57
2020-10-20,Sonoma,097,501317,9361,8904,24,8928,135
2020-10-20,Stanislaus,099,539301,17586,17367,706,18073,393
2020-10-20,Sutter,101,95872,1814,1783,1,1784,12
2020-10-20,Tehama,103,63373,874,813,2,815,5
2020-10-20,Trinity,105,12862,77,25,9,34,0
2020-10-20,Tulare,107,460477,17776,17156,308,17464,289
2020-10-20,Tuolumne,109,53932,274,250,6,256,4
2020-10-20,Ventura,111,848112,14763,13980,311,14291,152
2020-10-20,Yolo,113,214977,3204,3083,10,3093,56
2020-10-20,Yuba,115,75493,1226,1191,3,1194,10
2020-10-19,Alameda,001,1643700,23289,22647,211,22858,392
2020-10-19,Alpine,003,1148,3,3,0,3,0
2020-10-19,Amador,005,37829,327,313,0,313,16
2020-10-19,Butte,007,227075,3147,3026,58,3084,55
2020-10-19,Calaveras,009,45235,329,268,0,268,13
2020-10-19,Colusa,011,21464,547,544,1,545,6
2020-10-19,Contra Costa,013,1133247,18705,18173,92,18265,239
2020-10-19,Del Norte,015,27424,170,167,0,167,2
2020-10-19,El Dorado,017,186661,1356,1287,13,1300,4
2020-10-19,Fresno,019,978130,33070,30152,440,30592,431
2020-10-19,Glenn,021,27897,657,635,0,635,3
2020-10-19,Humboldt,023,135768,557,543,1,544,7
2020-10-19,Imperial,025,180216,12685,12036,14,12050,330
2020-10-19,Inyo,027,18085,236,218,5,223,14
2020-10-19,Kern,029,883053,33621,32840,403,33243,428
2020-10-19,Kings,031,150075,8379,8173,46,8219,80
2020-10-19,Lake,033,64148,705,673,0,673,15
2020-10-19,Lassen,035,31185,768,757,2,759,0
2020-10-19,Los Angeles,037,10098052,295604,287119,2607,289726,6858
2020-10-19,Madera,039,155013,4969,4787,37,4824,52
2020-10-19,Marin,041,260295,7084,6981,19,7000,100
2020-10-19,Mariposa,043,17540,79,77,0,77,2
2020-10-19,Mendocino,045,87422,1059,1001,4,1005,21
2020-10-19,Merced,047,269075,9433,9305,29,9334,148
2020-10-19,Modoc,049,8938,31,26,0,26,0
2020-10-19,Mono,051,14174,182,156,6,162,1
2020-10-19,Monterey,053,433212,11171,10907,44,10951,80
2020-10-19,Napa,055,140530,1971,1892,8,1900,12
2020-10-19,Nevada,057,99092,616,590,18,608,8
2020-10-19,Orange,059,3164182,59784,56652,1690,58342,1396
2020-10-19,Placer,061,380077,4178,3962,15,3977,49
2020-10-19,Plumas,063,18699,64,52,0,52,0
2020-10-19,Riverside,065,2383286,65975,64016,281,64297,1272
2020-10-19,Sacramento,067,1510023,25095,24542,29,24571,483
2020-10-19,San Benito,069,59416,1413,1395,1,1396,14
2020-10-19,San Bernardino,071,2135413,62049,59265,399,59664,1100
2020-10-19,San Diego,073,3302833,54825,52739,1424,54163,853
2020-10-19,San Francisco,075,870044,12063,11879,43,11922,126
2020-10-19,San Joaquin,077,732212,21588,20930,164,21094,489
2020-10-19,San Luis Obispo,079,281455,4292,4016,22,4038,31
2020-10-19,San Mateo,081,765935,11155,10568,11,10579,154
2020-10-19,Santa Barbara,083,443738,9816,9632,87,9719,121
2020-10-19,Santa Clara,085,1922200,24808,23301,50,23351,352
2020-10-19,Santa Cruz,087,273765,2792,2705,32,2737,19
2020-10-19,Shasta,089,179085,2008,1709,18,1727,20
2020-10-19,Sierra,091,2930,6,6,0,6,0
2020-10-19,Siskiyou,093,43540,182,167,10,177,0
2020-10-19,Solano,095,438530,7218,7003,39,7042,57
2020-10-19,Sonoma,097,501317,9274,8830,24,8854,135
2020-10-19,Stanislaus,099,539301,17535,17342,696,18038,390
2020-10-19,Sutter,101,95872,1809,1773,1,1774,12
2020-10-19,Tehama,103,63373,871,793,2,795,5
2020-10-19,Trinity,105,12862,75,23,9,32,0
2020-10-19,Tulare,107,460477,17726,17047,301,17348,291
2020-10-19,Tuolumne,109,53932,272,247,6,253,4
2020-10-19,Ventura,111,848112,14698,13930,308,14238,152
2020-10-19,Yolo,113,214977,3191,3069,10,3079,56
2020-10-19,Yuba,115,75493,1219,1183,3,1186,10
2020-10-18,Alameda,001,1643700,23185,22546,210,22756,392
2020-10-18,Alpine,003,1148,3,3,0,3,0
2020-10-18,Amador,005,37829,316,313,0,313,16
2020-10-18,Butte,007,227075,3134,3019,58,3077,55
2020-10-18,Calaveras,009,45235,328,267,0,267,13
2020-10-18,Colusa,011,21464,545,544,1,545,6
2020-10-18,Contra Costa,013,1133247,18607,18120,92,18212,237
2020-10-18,Del Norte,015,27424,170,167,0,167,2
2020-10-18,El Dorado,017,186661,1347,1283,13,1296,4
2020-10-18,Fresno,019,978130,32940,30051,432,30483,430
2020-10-18,Glenn,021,27897,655,634,0,634,3
2020-10-18,Humboldt,023,135768,554,540,1,541,7
2020-10-18,Imperial,025,180216,12622,11987,13,12000,330
2020-10-18,Inyo,027,18085,233,215,5,220,14
2020-10-18,Kern,029,883053,33548,32799,396,33195,428
2020-10-18,Kings,031,150075,8364,8159,46,8205,80
2020-10-18,Lake,033,64148,698,670,0,670,15
2020-10-18,Lassen,035,31185,768,757,2,759,0
2020-10-18,Los Angeles,037,10098052,293894,286187,2565,288752,6857
2020-10-18,Madera,039,155013,4944,4770,37,4807,52
2020-10-18,Marin,041,260295,7063,6969,19,6988,99
2020-10-18,Mariposa,043,17540,79,77,0,77,2
2020-10-18,Mendocino,045,87422,1057,988,4,992,21
2020-10-18,Merced,047,269075,9398,9292,29,9321,148
2020-10-18,Modoc,049,8938,30,26,0,26,0
2020-10-18,Mono,051,14174,177,155,6,161,1
2020-10-18,Monterey,053,433212,11118,10872,44,10916,80
2020-10-18,Napa,055,140530,1958,1882,8,1890,12
2020-10-18,Nevada,057,99092,610,582,18,600,8
2020-10-18,Orange,059,3164182,59487,56394,1673,58067,1396
2020-10-18,Placer,061,380077,4130,3938,15,3953,49
2020-10-18,Plumas,063,18699,62,52,0,52,0
2020-10-18,Riverside,065,2383286,65662,63765,260,64025,1270
2020-10-18,Sacramento,067,1510023,24940,24425,29,24454,482
2020-10-18,San Benito,069,59416,1406,1395,1,1396,14
2020-10-18,San Bernardino,071,2135413,61550,58893,391,59284,1098
2020-10-18,San Diego,073,3302833,54436,52359,1403,53762,853
2020-10-18,San Francisco,075,870044,12024,11878,43,11921,126
2020-10-18,San Joaquin,077,732212,21505,20931,151,21082,489
2020-10-18,San Luis Obispo,079,281455,4261,4009,20,4029,31
2020-10-18,San Mateo,081,765935,11096,10503,11,10514,154
2020-10-18,Santa Barbara,083,443738,9776,9608,86,9694,121
2020-10-18,Santa Clara,085,1922200,24635,23169,50,23219,352
2020-10-18,Santa Cruz,087,273765,2778,2692,32,2724,19
2020-10-18,Shasta,089,179085,1983,1708,18,1726,20
2020-10-18,Sierra,091,2930,6,6,0,6,0
2020-10-18,Siskiyou,093,43540,182,167,10,177,0
2020-10-18,Solano,095,438530,7171,6962,39,7001,57
2020-10-18,Sonoma,097,501317,9197,8781,23,8804,134
2020-10-18,Stanislaus,099,539301,17478,17290,687,17977,390
2020-10-18,Sutter,101,95872,1800,1764,1,1765,12
2020-10-18,Tehama,103,63373,839,774,2,776,5
2020-10-18,Trinity,105,12862,75,20,9,29,0
2020-10-18,Tulare,107,460477,17632,17048,292,17340,290
2020-10-18,Tuolumne,109,53932,266,245,6,251,4
2020-10-18,Ventura,111,848112,14618,13901,307,14208,151
2020-10-18,Yolo,113,214977,3152,3059,10,3069,55
2020-10-18,Yuba,115,75493,1208,1176,3,1179,10
2020-10-17,Alameda,001,1643700,23140,22394,208,22602,398
2020-10-17,Alpine,003,1148,3,3,0,3,0
2020-10-17,Amador,005,37829,314,309,0,309,16
2020-10-17,Butte,007,227075,3127,3012,56,3068,55
2020-10-17,Calaveras,009,45235,328,267,0,267,13
2020-10-17,Colusa,011,21464,544,544,1,545,6
2020-10-17,Contra Costa,013,1133247,18554,18005,92,18097,237
2020-10-17,Del Norte,015,27424,170,167,0,167,2
2020-10-17,El Dorado,017,186661,1343,1277,13,1290,4
2020-10-17,Fresno,019,978130,32885,29911,430,30341,430
2020-10-17,Glenn,021,27897,652,633,0,633,3
2020-10-17,Humboldt,023,135768,551,535,1,536,7
2020-10-17,Imperial,025,180216,12594,11962,13,11975,330
2020-10-17,Inyo,027,18085,228,212,5,217,14
2020-10-17,Kern,029,883053,33497,32710,393,33103,428
2020-10-17,Kings,031,150075,8358,8151,45,8196,80
2020-10-17,Lake,033,64148,695,663,0,663,15
2020-10-17,Lassen,035,31185,768,757,2,759,0
2020-10-17,Los Angeles,037,10098052,293140,285858,2538,288396,6844
2020-10-17,Madera,039,155013,4938,4759,37,4796,53
2020-10-17,Marin,041,260295,7060,6958,19,6977,99
2020-10-17,Mariposa,043,17540,78,77,0,77,2
2020-10-17,Mendocino,045,87422,1050,977,4,981,21
2020-10-17,Merced,047,269075,9385,9275,29,9304,148
2020-10-17,Modoc,049,8938,30,26,0,26,0
2020-10-17,Mono,051,14174,176,155,6,161,1
2020-10-17,Monterey,053,433212,11079,10807,43,10850,80
2020-10-17,Napa,055,140530,1949,1866,8,1874,12
2020-10-17,Nevada,057,99092,609,580,18,598,8
2020-10-17,Orange,059,3164182,59345,56197,1667,57864,1396
2020-10-17,Placer,061,380077,4103,3898,15,3913,49
2020-10-17,Plumas,063,18699,62,52,0,52,0
2020-10-17,Riverside,065,2383286,65465,63171,251,63422,1270
2020-10-17,Sacramento,067,1510023,24857,24304,29,24333,482
2020-10-17,San Benito,069,59416,1402,1389,1,1390,14
2020-10-17,San Bernardino,071,2135413,61277,58415,384,58799,1097
2020-10-17,San Diego,073,3302833,54211,51986,1392,53378,853
2020-10-17,San Francisco,075,870044,11997,11877,42,11919,126
2020-10-17,San Joaquin,077,732212,21451,20932,145,21077,489
2020-10-17,San Luis Obispo,079,281455,4246,3979,20,3999,31
2020-10-17,San Mateo,081,765935,11068,10423,11,10434,153
2020-10-17,Santa Barbara,083,443738,9757,9588,84,9672,121
2020-10-17,Santa Clara,085,1922200,24545,22997,50,23047,349
2020-10-17,Santa Cruz,087,273765,2764,2680,32,2712,19
2020-10-17,Shasta,089,179085,1957,1679,18,1697,20
2020-10-17,Sierra,091,2930,6,6,0,6,0
2020-10-17,Siskiyou,093,43540,181,167,10,177,0
2020-10-17,Solano,095,438530,7144,6929,39,6968,57
2020-10-17,Sonoma,097,501317,9154,8725,23,8748,134
2020-10-17,Stanislaus,099,539301,17437,17232,678,17910,390
2020-10-17,Sutter,101,95872,1798,1762,1,1763,12
2020-10-17,Tehama,103,63373,823,764,2,766,5
2020-10-17,Trinity,105,12862,75,20,9,29,0
2020-10-17,Tulare,107,460477,17602,16995,283,17278,290
2020-10-17,Tuolumne,109,53932,266,241,6,247,4
2020-10-17,Ventura,111,848112,14573,13845,304,14149,151
2020-10-17,Yolo,113,214977,3137,3045,9,3054,55
2020-10-17,Yuba,115,75493,1203,1164,3,1167,10
2020-10-16,Alameda,001,1643700,23086,22315,208,22523,397
2020-10-16,Alpine,003,1148,3,3,0,3,0
2020-10-16,Amador,005,37829,314,309,0,309,16
2020-10-16,Butte,007,227075,3115,3004,56,3060,54
2020-10-16,Calaveras,009,45235,328,267,0,267,13
2020-10-16,Colusa,011,21464,543,544,1,545,6
2020-10-16,Contra Costa,013,1133247,18502,17956,92,18048,237
2020-10-16,Del Norte,015,27424,169,166,0,166,2
2020-10-16,El Dorado,017,186661,1337,1273,13,1286,4
2020-10-16,Fresno,019,978130,32810,29796,429,30225,427
2020-10-16,Glenn,021,27897,647,632,0,632,3
2020-10-16,Humboldt,023,135768,551,533,1,534,7
2020-10-16,Imperial,025,180216,12554,11885,13,11898,330
2020-10-16,Inyo,027,18085,224,212,5,217,14
2020-10-16,Kern,029,883053,33454,32660,391,33051,428
2020-10-16,Kings,031,150075,8349,8146,44,8190,80
2020-10-16,Lake,033,64148,693,644,0,644,14
2020-10-16,Lassen,035,31185,768,757,2,759,0
2020-10-16,Los Angeles,037,10098052,292076,284988,2517,287505,6835
2020-10-16,Madera,039,155013,4926,4736,36,4772,53
2020-10-16,Marin,041,260295,7050,6933,19,6952,99
2020-10-16,Mariposa,043,17540,78,76,0,76,2
2020-10-16,Mendocino,045,87422,1043,974,4,978,21
2020-10-16,Merced,047,269075,9368,9246,29,9275,148
2020-10-16,Modoc,049,8938,30,26,0,26,0
2020-10-16,Mono,051,14174,174,155,6,161,1
2020-10-16,Monterey,053,433212,11044,10727,43,10770,79
2020-10-16,Napa,055,140530,1940,1855,8,1863,12
2020-10-16,Nevada,057,99092,607,579,18,597,8
2020-10-16,Orange,059,3164182,59167,56091,1661,57752,1388
2020-10-16,Placer,061,380077,4082,3864,15,3879,49
2020-10-16,Plumas,063,18699,61,52,0,52,0
2020-10-16,Riverside,065,2383286,65239,62986,250,63236,1267
2020-10-16,Sacramento,067,1510023,24762,24144,29,24173,479
2020-10-16,San Benito,069,59416,1399,1388,1,1389,14
2020-10-16,San Bernardino,071,2135413,61007,58233,384,58617,1069
2020-10-16,San Diego,073,3302833,53969,51785,1378,53163,850
2020-10-16,San Francisco,075,870044,11974,11840,41,11881,126
2020-10-16,San Joaquin,077,732212,21406,20910,144,21054,489
2020-10-16,San Luis Obispo,079,281455,4230,3952,20,3972,32
2020-10-16,San Mateo,081,765935,11042,10405,11,10416,153
2020-10-16,Santa Barbara,083,443738,9738,9549,84,9633,119
2020-10-16,Santa Clara,085,1922200,24457,22920,50,22970,345
2020-10-16,Santa Cruz,087,273765,2751,2666,32,2698,20
2020-10-16,Shasta,089,179085,1935,1660,18,1678,20
2020-10-16,Sierra,091,2930,6,6,0,6,0
2020-10-16,Siskiyou,093,43540,179,167,10,177,0
2020-10-16,Solano,095,438530,7121,6879,39,6918,55
2020-10-16,Sonoma,097,501317,9098,8652,23,8675,133
2020-10-16,Stanislaus,099,539301,17403,17201,670,17871,366
2020-10-16,Sutter,101,95872,1790,1756,1,1757,12
2020-10-16,Tehama,103,63373,822,737,2,739,3
2020-10-16,Trinity,105,12862,75,20,9,29,0
2020-10-16,Tulare,107,460477,17570,16965,275,17240,290
2020-10-16,Tuolumne,109,53932,264,237,6,243,4
2020-10-16,Ventura,111,848112,14530,13805,299,14104,152
2020-10-16,Yolo,113,214977,3128,3030,9,3039,55
2020-10-16,Yuba,115,75493,1203,1155,3,1158,10
2020-10-15,Alameda,001,1643700,23018,22267,207,22474,390
2020-10-15,Alpine,003,1148,3,3,0,3,0
2020-10-15,Amador,005,37829,314,309,0,309,16
2020-10-15,Butte,007,227075,3103,3000,55,3055,54
2020-10-15,Calaveras,009,45235,327,267,0,267,13
2020-10-15,Colusa,011,21464,542,543,1,544,6
2020-10-15,Contra Costa,013,1133247,18434,17893,91,17984,237
2020-10-15,Del Norte,015,27424,169,164,0,164,2
2020-10-15,El Dorado,017,186661,1332,1265,13,1278,4
2020-10-15,Fresno,019,978130,32710,29727,426,30153,425
2020-10-15,Glenn,021,27897,642,632,0,632,3
2020-10-15,Humboldt,023,135768,547,531,1,532,7
2020-10-15,Imperial,025,180216,12513,11820,12,11832,330
2020-10-15,Inyo,027,18085,224,210,5,215,14
2020-10-15,Kern,029,883053,33373,32593,388,32981,427
2020-10-15,Kings,031,150075,8334,8134,44,8178,80
2020-10-15,Lake,033,64148,691,642,0,642,14
2020-10-15,Lassen,035,31185,767,752,2,754,0
2020-10-15,Los Angeles,037,10098052,290791,284019,2484,286503,6807
2020-10-15,Madera,039,155013,4913,4723,35,4758,50
2020-10-15,Marin,041,260295,7042,6912,19,6931,99
2020-10-15,Mariposa,043,17540,78,76,0,76,2
2020-10-15,Mendocino,045,87422,1037,963,4,967,21
2020-10-15,Merced,047,269075,9341,9213,28,9241,147
2020-10-15,Modoc,049,8938,30,26,0,26,0
2020-10-15,Mono,051,14174,174,155,6,161,1
2020-10-15,Monterey,053,433212,10977,10677,42,10719,79
2020-10-15,Napa,055,140530,1927,1842,8,1850,12
2020-10-15,Nevada,057,99092,603,575,18,593,8
2020-10-15,Orange,059,3164182,58951,55952,1649,57601,1379
2020-10-15,Placer,061,380077,4053,3848,15,3863,48
2020-10-15,Plumas,063,18699,58,52,0,52,0
2020-10-15,Riverside,065,2383286,64907,62819,247,63066,1266
2020-10-15,Sacramento,067,1510023,24646,24068,29,24097,474
2020-10-15,San Benito,069,59416,1396,1384,1,1385,14
2020-10-15,San Bernardino,071,2135413,60668,58068,381,58449,1067
2020-10-15,San Diego,073,3302833,53685,51472,1362,52834,847
2020-10-15,San Francisco,075,870044,11946,11808,38,11846,126
2020-10-15,San Joaquin,077,732212,21335,20880,138,21018,487
2020-10-15,San Luis Obispo,079,281455,4214,3934,20,3954,32
2020-10-15,San Mateo,081,765935,11002,10340,11,10351,152
2020-10-15,Santa Barbara,083,443738,9714,9526,83,9609,117
2020-10-15,Santa Clara,085,1922200,24341,22808,50,22858,343
2020-10-15,Santa Cruz,087,273765,2737,2656,32,2688,13
2020-10-15,Shasta,089,179085,1924,1635,18,1653,20
2020-10-15,Sierra,091,2930,6,6,0,6,0
2020-10-15,Siskiyou,093,43540,175,166,10,176,0
2020-10-15,Solano,095,438530,7082,6830,39,6869,55
2020-10-15,Sonoma,097,501317,9006,8571,23,8594,133
2020-10-15,Stanislaus,099,539301,17365,17151,656,17807,366
2020-10-15,Sutter,101,95872,1787,1752,1,1753,12
2020-10-15,Tehama,103,63373,795,726,2,728,3
2020-10-15,Trinity,105,12862,75,20,9,29,0
2020-10-15,Tulare,107,460477,17510,16918,260,17178,289
2020-10-15,Tuolumne,109,53932,262,236,6,242,4
2020-10-15,Ventura,111,848112,14474,13750,294,14044,152
2020-10-15,Yolo,113,214977,3108,3014,9,3023,55
2020-10-15,Yuba,115,75493,1196,1151,3,1154,10
2020-10-14,Alameda,001,1643700,22919,22227,206,22433,398
2020-10-14,Alpine,003,1148,3,3,0,3,0
2020-10-14,Amador,005,37829,312,308,0,308,16
2020-10-14,Butte,007,227075,3095,2995,55,3050,54
2020-10-14,Calaveras,009,45235,327,266,0,266,12
2020-10-14,Colusa,011,21464,542,543,1,544,6
2020-10-14,Contra Costa,013,1133247,18376,17820,89,17909,236
2020-10-14,Del Norte,015,27424,168,163,0,163,2
2020-10-14,El Dorado,017,186661,1326,1264,12,1276,4
2020-10-14,Fresno,019,978130,32597,29650,420,30070,424
2020-10-14,Glenn,021,27897,641,629,0,629,3
2020-10-14,Humboldt,023,135768,544,531,1,532,7
2020-10-14,Imperial,025,180216,12476,11765,10,11775,330
2020-10-14,Inyo,027,18085,223,209,4,213,14
2020-10-14,Kern,029,883053,33298,32528,386,32914,425
2020-10-14,Kings,031,150075,8316,8118,44,8162,80
2020-10-14,Lake,033,64148,690,642,0,642,14
2020-10-14,Lassen,035,31185,765,752,2,754,0
2020-10-14,Los Angeles,037,10098052,289476,282918,2441,285359,6786
2020-10-14,Madera,039,155013,4898,4713,33,4746,50
2020-10-14,Marin,041,260295,7036,6907,19,6926,99
2020-10-14,Mariposa,043,17540,77,76,0,76,2
2020-10-14,Mendocino,045,87422,1031,955,4,959,21
2020-10-14,Merced,047,269075,9316,9201,27,9228,147
2020-10-14,Modoc,049,8938,30,27,0,27,0
2020-10-14,Mono,051,14174,174,155,6,161,1
2020-10-14,Monterey,053,433212,10927,10616,42,10658,78
2020-10-14,Napa,055,140530,1910,1837,8,1845,12
2020-10-14,Nevada,057,99092,601,573,18,591,7
2020-10-14,Orange,059,3164182,58738,55756,1640,57396,1348
2020-10-14,Placer,061,380077,4030,3829,15,3844,48
2020-10-14,Plumas,063,18699,54,52,0,52,0
2020-10-14,Riverside,065,2383286,64624,62607,246,62853,1261
2020-10-14,Sacramento,067,1510023,24502,24013,29,24042,472
2020-10-14,San Benito,069,59416,1394,1381,0,1381,14
2020-10-14,San Bernardino,071,2135413,60342,57774,377,58151,1063
2020-10-14,San Diego,073,3302833,53366,51329,1338,52667,844
2020-10-14,San Francisco,075,870044,11914,11783,37,11820,123
2020-10-14,San Joaquin,077,732212,21256,20845,124,20969,487
2020-10-14,San Luis Obispo,079,281455,4191,3901,19,3920,32
2020-10-14,San Mateo,081,765935,10951,10309,11,10320,132
2020-10-14,Santa Barbara,083,443738,9680,9509,83,9592,117
2020-10-14,Santa Clara,085,1922200,24192,22735,50,22785,343
2020-10-14,Santa Cruz,087,273765,2727,2618,32,2650,13
2020-10-14,Shasta,089,179085,1886,1553,18,1571,20
2020-10-14,Sierra,091,2930,6,6,0,6,0
2020-10-14,Siskiyou,093,43540,175,166,10,176,0
2020-10-14,Solano,095,438530,7026,6786,39,6825,55
2020-10-14,Sonoma,097,501317,8953,8514,23,8537,133
2020-10-14,Stanislaus,099,539301,17320,17105,653,17758,365
2020-10-14,Sutter,101,95872,1778,1747,1,1748,12
2020-10-14,Tehama,103,63373,784,721,2,723,3
2020-10-14,Trinity,105,12862,74,20,9,29,0
2020-10-14,Tulare,107,460477,17448,16863,247,17110,287
2020-10-14,Tuolumne,109,53932,261,236,6,242,4
2020-10-14,Ventura,111,848112,14420,13697,290,13987,152
2020-10-14,Yolo,113,214977,3090,3007,8,3015,55
2020-10-14,Yuba,115,75493,1188,1147,3,1150,10
2020-10-13,Alameda,001,1643700,22814,22185,204,22389,389
2020-10-13,Alpine,003,1148,3,3,0,3,0
2020-10-13,Amador,005,37829,310,306,0,306,16
2020-10-13,Butte,007,227075,3087,2992,55,3047,54
2020-10-13,Calaveras,009,45235,323,262,0,262,12
2020-10-13,Colusa,011,21464,542,541,1,542,6
2020-10-13,Contra Costa,013,1133247,18319,17783,89,17872,234
2020-10-13,Del Norte,015,27424,168,163,0,163,2
2020-10-13,El Dorado,017,186661,1317,1262,12,1274,4
2020-10-13,Fresno,019,978130,32474,29579,416,29995,424
2020-10-13,Glenn,021,27897,640,629,0,629,3
2020-10-13,Humboldt,023,135768,542,523,1,524,7
2020-10-13,Imperial,025,180216,12440,11727,10,11737,327
2020-10-13,Inyo,027,18085,220,207,4,211,14
2020-10-13,Kern,029,883053,33224,32497,384,32881,419
2020-10-13,Kings,031,150075,8307,8111,44,8155,80
2020-10-13,Lake,033,64148,687,639,0,639,12
2020-10-13,Lassen,035,31185,763,752,2,754,0
2020-10-13,Los Angeles,037,10098052,288195,281716,2401,284117,6767
2020-10-13,Madera,039,155013,4879,4700,33,4733,50
2020-10-13,Marin,041,260295,7014,6900,18,6918,97
2020-10-13,Mariposa,043,17540,77,76,0,76,2
2020-10-13,Mendocino,045,87422,1022,950,4,954,21
2020-10-13,Merced,047,269075,9299,9181,27,9208,146
2020-10-13,Modoc,049,8938,29,28,0,28,0
2020-10-13,Mono,051,14174,174,155,5,160,1
2020-10-13,Monterey,053,433212,10866,10574,41,10615,78
2020-10-13,Napa,055,140530,1901,1825,8,1833,12
2020-10-13,Nevada,057,99092,594,572,18,590,7
2020-10-13,Orange,059,3164182,58525,55515,1627,57142,1326
2020-10-13,Placer,061,380077,3992,3825,15,3840,48
2020-10-13,Plumas,063,18699,52,51,0,51,0
2020-10-13,Riverside,065,2383286,64305,62279,244,62523,1254
2020-10-13,Sacramento,067,1510023,24425,23930,29,23959,466
2020-10-13,San Benito,069,59416,1386,1380,0,1380,14
2020-10-13,San Bernardino,071,2135413,60004,57411,375,57786,1061
2020-10-13,San Diego,073,3302833,53073,51026,1321,52347,840
2020-10-13,San Francisco,075,870044,11877,11659,37,11696,122
2020-10-13,San Joaquin,077,732212,21194,20822,120,20942,481
2020-10-13,San Luis Obispo,079,281455,4174,3892,18,3910,32
2020-10-13,San Mateo,081,765935,10908,10286,11,10297,130
2020-10-13,Santa Barbara,083,443738,9648,9489,83,9572,117
2020-10-13,Santa Clara,085,1922200,24064,22678,50,22728,343
2020-10-13,Santa Cruz,087,273765,2709,2603,32,2635,13
2020-10-13,Shasta,089,179085,1862,1606,18,1624,20
2020-10-13,Sierra,091,2930,6,6,0,6,0
2020-10-13,Siskiyou,093,43540,174,163,10,173,0
2020-10-13,Solano,095,438530,6991,6761,39,6800,55
2020-10-13,Sonoma,097,501317,8870,8456,23,8479,133
2020-10-13,Stanislaus,099,539301,17275,17082,648,17730,362
2020-10-13,Sutter,101,95872,1769,1748,1,1749,12
2020-10-13,Tehama,103,63373,777,717,2,719,3
2020-10-13,Trinity,105,12862,70,19,8,27,0
2020-10-13,Tulare,107,460477,17390,16822,239,17061,286
2020-10-13,Tuolumne,109,53932,259,235,6,241,4
2020-10-13,Ventura,111,848112,14366,13645,286,13931,151
2020-10-13,Yolo,113,214977,3082,2983,7,2990,55
2020-10-13,Yuba,115,75493,1183,1143,3,1146,10
2020-10-12,Alameda,001,1643700,22735,22126,203,22329,389
2020-10-12,Alpine,003,1148,3,3,0,3,0
2020-10-12,Amador,005,37829,309,305,0,305,16
2020-10-12,Butte,007,227075,3080,2975,55,3030,54
2020-10-12,Calaveras,009,45235,323,262,0,262,12
2020-10-12,Colusa,011,21464,542,541,1,542,6
2020-10-12,Contra Costa,013,1133247,18245,17728,89,17817,233
2020-10-12,Del Norte,015,27424,168,161,0,161,2
2020-10-12,El Dorado,017,186661,1314,1254,12,1266,4
2020-10-12,Fresno,019,978130,32342,29523,412,29935,421
2020-10-12,Glenn,021,27897,639,626,0,626,3
2020-10-12,Humboldt,023,135768,539,522,1,523,7
2020-10-12,Imperial,025,180216,12402,11689,10,11699,328
2020-10-12,Inyo,027,18085,217,201,4,205,14
2020-10-12,Kern,029,883053,33131,32425,380,32805,419
2020-10-12,Kings,031,150075,8301,8106,44,8150,80
2020-10-12,Lake,033,64148,681,633,0,633,12
2020-10-12,Lassen,035,31185,763,752,2,754,0
2020-10-12,Los Angeles,037,10098052,286975,280961,2374,283335,6747
2020-10-12,Madera,039,155013,4859,4689,33,4722,50
2020-10-12,Marin,041,260295,6997,6886,18,6904,97
2020-10-12,Mariposa,043,17540,77,76,0,76,2
2020-10-12,Mendocino,045,87422,1016,947,4,951,21
2020-10-12,Merced,047,269075,9278,9141,27,9168,146
2020-10-12,Modoc,049,8938,29,27,0,27,0
2020-10-12,Mono,051,14174,174,154,5,159,1
2020-10-12,Monterey,053,433212,10800,10473,41,10514,77
2020-10-12,Napa,055,140530,1893,1819,8,1827,11
2020-10-12,Nevada,057,99092,590,570,18,588,7
2020-10-12,Orange,059,3164182,58296,55373,1617,56990,1326
2020-10-12,Placer,061,380077,3960,3808,14,3822,48
2020-10-12,Plumas,063,18699,52,51,0,51,0
2020-10-12,Riverside,065,2383286,63994,62279,240,62519,1254
2020-10-12,Sacramento,067,1510023,24320,23807,29,23836,466
2020-10-12,San Benito,069,59416,1383,1376,0,1376,13
2020-10-12,San Bernardino,071,2135413,59628,57235,374,57609,1061
2020-10-12,San Diego,073,3302833,52783,50748,1294,52042,826
2020-10-12,San Francisco,075,870044,11845,11659,37,11696,122
2020-10-12,San Joaquin,077,732212,21131,20701,114,20815,480
2020-10-12,San Luis Obispo,079,281455,4146,3874,18,3892,32
2020-10-12,San Mateo,081,765935,10860,10262,11,10273,130
2020-10-12,Santa Barbara,083,443738,9609,9462,83,9545,117
2020-10-12,Santa Clara,085,1922200,23948,22578,50,22628,343
2020-10-12,Santa Cruz,087,273765,2692,2590,32,2622,13
2020-10-12,Shasta,089,179085,1837,1515,18,1533,20
2020-10-12,Sierra,091,2930,6,6,0,6,0
2020-10-12,Siskiyou,093,43540,173,162,10,172,0
2020-10-12,Solano,095,438530,6952,6742,39,6781,55
2020-10-12,Sonoma,097,501317,8798,8377,23,8400,133
2020-10-12,Stanislaus,099,539301,17226,17051,639,17690,361
2020-10-12,Sutter,101,95872,1761,1741,1,1742,12
2020-10-12,Tehama,103,63373,761,708,2,710,3
2020-10-12,Trinity,105,12862,69,19,8,27,0
2020-10-12,Tulare,107,460477,17339,16742,232,16974,286
2020-10-12,Tuolumne,109,53932,254,234,6,240,4
2020-10-12,Ventura,111,848112,14304,13617,282,13899,151
2020-10-12,Yolo,113,214977,3067,2964,7,2971,55
2020-10-12,Yuba,115,75493,1173,1141,3,1144,10
2020-10-11,Alameda,001,1643700,22645,22057,199,22256,392
2020-10-11,Alpine,003,1148,3,3,0,3,0
2020-10-11,Amador,005,37829,307,305,0,305,16
2020-10-11,Butte,007,227075,3072,2967,54,3021,54
2020-10-11,Calaveras,009,45235,321,262,0,262,12
2020-10-11,Colusa,011,21464,540,541,1,542,6
2020-10-11,Contra Costa,013,1133247,18161,17678,89,17767,233
2020-10-11,Del Norte,015,27424,166,161,0,161,2
2020-10-11,El Dorado,017,186661,1305,1242,12,1254,4
2020-10-11,Fresno,019,978130,32204,29419,404,29823,421
2020-10-11,Glenn,021,27897,637,625,0,625,3
2020-10-11,Humboldt,023,135768,538,521,1,522,7
2020-10-11,Imperial,025,180216,12343,11614,10,11624,328
2020-10-11,Inyo,027,18085,213,201,4,205,14
2020-10-11,Kern,029,883053,33044,32399,372,32771,418
2020-10-11,Kings,031,150075,8284,8094,43,8137,80
2020-10-11,Lake,033,64148,668,631,0,631,12
2020-10-11,Lassen,035,31185,762,752,2,754,0
2020-10-11,Los Angeles,037,10098052,285539,280190,2332,282522,6745
2020-10-11,Madera,039,155013,4831,4680,32,4712,50
2020-10-11,Marin,041,260295,6988,6870,18,6888,97
2020-10-11,Mariposa,043,17540,77,76,0,76,2
2020-10-11,Mendocino,045,87422,1009,944,4,948,21
2020-10-11,Merced,047,269075,9260,9124,27,9151,146
2020-10-11,Modoc,049,8938,29,27,0,27,0
2020-10-11,Mono,051,14174,174,154,5,159,1
2020-10-11,Monterey,053,433212,10749,10445,39,10484,77
2020-10-11,Napa,055,140530,1877,1811,8,1819,11
2020-10-11,Nevada,057,99092,588,569,18,587,7
2020-10-11,Orange,059,3164182,58066,55202,1611,56813,1326
2020-10-11,Placer,061,380077,3939,3787,14,3801,48
2020-10-11,Plumas,063,18699,52,51,0,51,0
2020-10-11,Riverside,065,2383286,63706,62112,236,62348,1254
2020-10-11,Sacramento,067,1510023,24177,23778,29,23807,466
2020-10-11,San Benito,069,59416,1382,1374,0,1374,13
2020-10-11,San Bernardino,071,2135413,59176,56997,372,57369,1061
2020-10-11,San Diego,073,3302833,52433,50553,1272,51825,826
2020-10-11,San Francisco,075,870044,11802,11659,37,11696,122
2020-10-11,San Joaquin,077,732212,21056,20700,104,20804,480
2020-10-11,San Luis Obispo,079,281455,4129,3874,17,3891,32
2020-10-11,San Mateo,081,765935,10828,10240,11,10251,130
2020-10-11,Santa Barbara,083,443738,9578,9440,82,9522,117
2020-10-11,Santa Clara,085,1922200,23808,22487,49,22536,336
2020-10-11,Santa Cruz,087,273765,2678,2578,32,2610,13
2020-10-11,Shasta,089,179085,1807,1515,17,1532,20
2020-10-11,Sierra,091,2930,6,6,0,6,0
2020-10-11,Siskiyou,093,43540,172,162,10,172,0
2020-10-11,Solano,095,438530,6898,6685,39,6724,53
2020-10-11,Sonoma,097,501317,8741,8319,23,8342,133
2020-10-11,Stanislaus,099,539301,17162,17007,623,17630,360
2020-10-11,Sutter,101,95872,1758,1742,1,1743,12
2020-10-11,Tehama,103,63373,737,702,2,704,3
2020-10-11,Trinity,105,12862,69,19,8,27,0
2020-10-11,Tulare,107,460477,17275,16741,224,16965,286
2020-10-11,Tuolumne,109,53932,249,234,6,240,4
2020-10-11,Ventura,111,848112,14243,13604,277,13881,151
2020-10-11,Yolo,113,214977,3037,2952,7,2959,55
2020-10-11,Yuba,115,75493,1162,1137,3,1140,10
2020-10-10,Alameda,001,1643700,22595,21979,198,22177,398
2020-10-10,Alpine,003,1148,3,3,0,3,0
2020-10-10,Amador,005,37829,306,304,0,304,16
2020-10-10,Butte,007,227075,3067,2962,53,3015,54
2020-10-10,Calaveras,009,45235,320,262,0,262,12
2020-10-10,Colusa,011,21464,540,541,1,542,6
2020-10-10,Contra Costa,013,1133247,18125,17566,88,17654,233
2020-10-10,Del Norte,015,27424,166,161,0,161,2
2020-10-10,El Dorado,017,186661,1303,1240,12,1252,4
2020-10-10,Fresno,019,978130,32140,29286,402,29688,421
2020-10-10,Glenn,021,27897,637,623,0,623,3
2020-10-10,Humboldt,023,135768,535,518,1,519,7
2020-10-10,Imperial,025,180216,12328,11591,10,11601,327
2020-10-10,Inyo,027,18085,210,201,4,205,14
2020-10-10,Kern,029,883053,33007,32338,372,32710,418
2020-10-10,Kings,031,150075,8280,8078,43,8121,80
2020-10-10,Lake,033,64148,667,630,0,630,11
2020-10-10,Lassen,035,31185,762,752,2,754,0
2020-10-10,Los Angeles,037,10098052,284821,279213,2298,281511,6743
2020-10-10,Madera,039,155013,4819,4662,32,4694,50
2020-10-10,Marin,041,260295,6979,6852,18,6870,97
2020-10-10,Mariposa,043,17540,77,76,0,76,2
2020-10-10,Mendocino,045,87422,1002,935,4,939,21
2020-10-10,Merced,047,269075,9254,9105,26,9131,146
2020-10-10,Modoc,049,8938,29,27,0,27,0
2020-10-10,Mono,051,14174,174,154,5,159,1
2020-10-10,Monterey,053,433212,10716,10410,39,10449,75
2020-10-10,Napa,055,140530,1870,1804,8,1812,11
2020-10-10,Nevada,057,99092,585,564,18,582,6
2020-10-10,Orange,059,3164182,57945,54965,1606,56571,1324
2020-10-10,Placer,061,380077,3922,3757,14,3771,48
2020-10-10,Plumas,063,18699,52,51,0,51,0
2020-10-10,Riverside,065,2383286,63503,61845,234,62079,1254
2020-10-10,Sacramento,067,1510023,24109,23689,29,23718,466
2020-10-10,San Benito,069,59416,1380,1370,0,1370,13
2020-10-10,San Bernardino,071,2135413,59014,56683,370,57053,1061
2020-10-10,San Diego,073,3302833,52203,50145,1254,51399,825
2020-10-10,San Francisco,075,870044,11781,11663,37,11700,122
2020-10-10,San Joaquin,077,732212,21028,20700,100,20800,481
2020-10-10,San Luis Obispo,079,281455,4109,3832,17,3849,32
2020-10-10,San Mateo,081,765935,10791,10218,11,10229,130
2020-10-10,Santa Barbara,083,443738,9567,9417,82,9499,116
2020-10-10,Santa Clara,085,1922200,23717,22354,49,22403,330
2020-10-10,Santa Cruz,087,273765,2664,2572,32,2604,13
2020-10-10,Shasta,089,179085,1790,1473,17,1490,20
2020-10-10,Sierra,091,2930,6,6,0,6,0
2020-10-10,Siskiyou,093,43540,172,161,10,171,0
2020-10-10,Solano,095,438530,6872,6655,39,6694,53
2020-10-10,Sonoma,097,501317,8721,8235,23,8258,133
2020-10-10,Stanislaus,099,539301,17127,16960,615,17575,360
2020-10-10,Sutter,101,95872,1755,1735,1,1736,12
2020-10-10,Tehama,103,63373,730,693,2,695,3
2020-10-10,Trinity,105,12862,69,19,8,27,0
2020-10-10,Tulare,107,460477,17239,16709,219,16928,286
2020-10-10,Tuolumne,109,53932,249,233,6,239,4
2020-10-10,Ventura,111,848112,14218,13520,277,13797,151
2020-10-10,Yolo,113,214977,3028,2939,7,2946,55
2020-10-10,Yuba,115,75493,1160,1134,3,1137,10
2020-10-09,Alameda,001,1643700,22547,21924,198,22122,399
2020-10-09,Alpine,003,1148,3,3,0,3,0
2020-10-09,Amador,005,37829,306,303,0,303,16
2020-10-09,Butte,007,227075,3064,2956,53,3009,51
2020-10-09,Calaveras,009,45235,318,262,0,262,11
2020-10-09,Colusa,011,21464,540,541,1,542,6
2020-10-09,Contra Costa,013,1133247,18074,17487,88,17575,229
2020-10-09,Del Norte,015,27424,165,161,0,161,2
2020-10-09,El Dorado,017,186661,1299,1234,12,1246,4
2020-10-09,Fresno,019,978130,32067,29208,400,29608,417
2020-10-09,Glenn,021,27897,632,617,0,617,3
2020-10-09,Humboldt,023,135768,533,516,1,517,7
2020-10-09,Imperial,025,180216,12302,11516,10,11526,330
2020-10-09,Inyo,027,18085,207,200,4,204,14
2020-10-09,Kern,029,883053,32963,32237,370,32607,417
2020-10-09,Kings,031,150075,8273,7993,41,8034,80
2020-10-09,Lake,033,64148,657,610,0,610,11
2020-10-09,Lassen,035,31185,762,751,2,753,0
2020-10-09,Los Angeles,037,10098052,283686,278039,2274,280313,6715
2020-10-09,Madera,039,155013,4809,4646,32,4678,50
2020-10-09,Marin,041,260295,6965,6838,18,6856,96
2020-10-09,Mariposa,043,17540,77,76,0,76,2
2020-10-09,Mendocino,045,87422,992,933,4,937,20
2020-10-09,Merced,047,269075,9240,9095,26,9121,145
2020-10-09,Modoc,049,8938,29,27,0,27,0
2020-10-09,Mono,051,14174,174,154,5,159,1
2020-10-09,Monterey,053,433212,10682,10369,39,10408,75
2020-10-09,Napa,055,140530,1860,1795,8,1803,11
2020-10-09,Nevada,057,99092,580,561,18,579,6
2020-10-09,Orange,059,3164182,57774,54746,1601,56347,1305
2020-10-09,Placer,061,380077,3908,3737,13,3750,48
2020-10-09,Plumas,063,18699,52,50,0,50,0
2020-10-09,Riverside,065,2383286,63267,61529,233,61762,1252
2020-10-09,Sacramento,067,1510023,24040,23606,29,23635,457
2020-10-09,San Benito,069,59416,1375,1367,0,1367,13
2020-10-09,San Bernardino,071,2135413,58774,56434,368,56802,1057
2020-10-09,San Diego,073,3302833,51927,49825,1243,51068,821
2020-10-09,San Francisco,075,870044,11751,11620,37,11657,120
2020-10-09,San Joaquin,077,732212,20998,20648,92,20740,481
2020-10-09,San Luis Obispo,079,281455,4090,3810,17,3827,32
2020-10-09,San Mateo,081,765935,10763,10140,11,10151,130
2020-10-09,Santa Barbara,083,443738,9539,9396,82,9478,116
2020-10-09,Santa Clara,085,1922200,23615,22251,48,22299,328
2020-10-09,Santa Cruz,087,273765,2655,2555,32,2587,13
2020-10-09,Shasta,089,179085,1764,1353,16,1369,20
2020-10-09,Sierra,091,2930,6,6,0,6,0
2020-10-09,Siskiyou,093,43540,170,156,10,166,0
2020-10-09,Solano,095,438530,6833,6614,39,6653,53
2020-10-09,Sonoma,097,501317,8667,8133,23,8156,133
2020-10-09,Stanislaus,099,539301,17102,16904,608,17512,362
2020-10-09,Sutter,101,95872,1751,1732,1,1733,12
2020-10-09,Tehama,103,63373,724,682,2,684,3
2020-10-09,Trinity,105,12862,69,25,8,33,0
2020-10-09,Tulare,107,460477,17199,16644,210,16854,286
2020-10-09,Tuolumne,109,53932,246,230,6,236,4
2020-10-09,Ventura,111,848112,14182,13469,274,13743,151
2020-10-09,Yolo,113,214977,3021,2928,7,2935,55
2020-10-09,Yuba,115,75493,1159,1129,3,1132,10
2020-10-08,Alameda,001,1643700,22466,21826,197,22023,395
2020-10-08,Alpine,003,1148,3,3,0,3,0
2020-10-08,Amador,005,37829,305,302,0,302,16
2020-10-08,Butte,007,227075,3054,2935,53,2988,51
2020-10-08,Calaveras,009,45235,317,262,0,262,11
2020-10-08,Colusa,011,21464,540,539,1,540,6
2020-10-08,Contra Costa,013,1133247,18014,17418,87,17505,228
2020-10-08,Del Norte,015,27424,165,151,0,151,2
2020-10-08,El Dorado,017,186661,1298,1230,12,1242,4
2020-10-08,Fresno,019,978130,31963,29111,400,29511,416
2020-10-08,Glenn,021,27897,629,616,0,616,3
2020-10-08,Humboldt,023,135768,529,515,1,516,7
2020-10-08,Imperial,025,180216,12262,11405,10,11415,330
2020-10-08,Inyo,027,18085,204,199,4,203,14
2020-10-08,Kern,029,883053,32905,32169,365,32534,411
2020-10-08,Kings,031,150075,8267,7968,41,8009,80
2020-10-08,Lake,033,64148,652,604,0,604,11
2020-10-08,Lassen,035,31185,757,751,2,753,0
2020-10-08,Los Angeles,037,10098052,282484,276763,2234,278997,6699
2020-10-08,Madera,039,155013,4791,4637,32,4669,50
2020-10-08,Marin,041,260295,6951,6810,18,6828,96
2020-10-08,Mariposa,043,17540,77,76,0,76,2
2020-10-08,Mendocino,045,87422,987,930,4,934,20
2020-10-08,Merced,047,269075,9220,9069,26,9095,144
2020-10-08,Modoc,049,8938,29,27,0,27,0
2020-10-08,Mono,051,14174,174,153,5,158,1
2020-10-08,Monterey,053,433212,10615,10343,39,10382,75
2020-10-08,Napa,055,140530,1845,1779,8,1787,11
2020-10-08,Nevada,057,99092,577,556,18,574,6
2020-10-08,Orange,059,3164182,57581,54523,1590,56113,1293
2020-10-08,Placer,061,380077,3890,3715,13,3728,48
2020-10-08,Plumas,063,18699,52,50,0,50,0
2020-10-08,Riverside,065,2383286,62999,61105,232,61337,1244
2020-10-08,Sacramento,067,1510023,23933,23482,29,23511,454
2020-10-08,San Benito,069,59416,1370,1367,0,1367,13
2020-10-08,San Bernardino,071,2135413,58409,56152,367,56519,1048
2020-10-08,San Diego,073,3302833,51647,49468,1211,50679,819
2020-10-08,San Francisco,075,870044,11713,11608,37,11645,115
2020-10-08,San Joaquin,077,732212,20946,20576,87,20663,478
2020-10-08,San Luis Obispo,079,281455,4074,3785,17,3802,32
2020-10-08,San Mateo,081,765935,10731,10044,11,10055,130
2020-10-08,Santa Barbara,083,443738,9511,9374,82,9456,116
2020-10-08,Santa Clara,085,1922200,23513,22095,48,22143,323
2020-10-08,Santa Cruz,087,273765,2643,2535,32,2567,13
2020-10-08,Shasta,089,179085,1730,1305,16,1321,20
2020-10-08,Sierra,091,2930,6,6,0,6,0
2020-10-08,Siskiyou,093,43540,170,156,10,166,0
2020-10-08,Solano,095,438530,6809,6556,39,6595,53
2020-10-08,Sonoma,097,501317,8601,8063,23,8086,132
2020-10-08,Stanislaus,099,539301,17056,16821,600,17421,360
2020-10-08,Sutter,101,95872,1751,1725,1,1726,12
2020-10-08,Tehama,103,63373,715,676,2,678,3
2020-10-08,Trinity,105,12862,68,25,8,33,0
2020-10-08,Tulare,107,460477,17138,16573,202,16775,283
2020-10-08,Tuolumne,109,53932,245,230,6,236,4
2020-10-08,Ventura,111,848112,14134,13399,272,13671,151
2020-10-08,Yolo,113,214977,3004,2914,7,2921,55
2020-10-08,Yuba,115,75493,1154,1126,3,1129,10
2020-10-07,Alameda,001,1643700,22389,21736,197,21933,395
2020-10-07,Alpine,003,1148,3,3,0,3,0
2020-10-07,Amador,005,37829,305,302,0,302,16
2020-10-07,Butte,007,227075,3043,2927,53,2980,47
2020-10-07,Calaveras,009,45235,315,262,0,262,11
2020-10-07,Colusa,011,21464,539,539,0,539,6
2020-10-07,Contra Costa,013,1133247,17944,17346,86,17432,225
2020-10-07,Del Norte,015,27424,164,149,0,149,2
2020-10-07,El Dorado,017,186661,1290,1219,12,1231,4
2020-10-07,Fresno,019,978130,31842,29069,395,29464,413
2020-10-07,Glenn,021,27897,629,615,0,615,3
2020-10-07,Humboldt,023,135768,526,512,1,513,7
2020-10-07,Imperial,025,180216,12225,11289,9,11298,330
2020-10-07,Inyo,027,18085,204,199,4,203,14
2020-10-07,Kern,029,883053,32832,32068,364,32432,410
2020-10-07,Kings,031,150075,8252,7948,41,7989,80
2020-10-07,Lake,033,64148,651,599,0,599,11
2020-10-07,Lassen,035,31185,757,751,2,753,0
2020-10-07,Los Angeles,037,10098052,281302,275559,2202,277761,6681
2020-10-07,Madera,039,155013,4771,4618,32,4650,50
2020-10-07,Marin,041,260295,6924,6790,18,6808,95
2020-10-07,Mariposa,043,17540,77,75,0,75,2
2020-10-07,Mendocino,045,87422,981,927,4,931,19
2020-10-07,Merced,047,269075,9183,9045,25,9070,144
2020-10-07,Modoc,049,8938,29,27,0,27,0
2020-10-07,Mono,051,14174,173,153,4,157,1
2020-10-07,Monterey,053,433212,10556,10272,39,10311,75
2020-10-07,Napa,055,140530,1832,1774,8,1782,11
2020-10-07,Nevada,057,99092,573,552,18,570,6
2020-10-07,Orange,059,3164182,57364,54332,1579,55911,1277
2020-10-07,Placer,061,380077,3874,3693,13,3706,48
2020-10-07,Plumas,063,18699,52,50,0,50,0
2020-10-07,Riverside,065,2383286,62652,60857,228,61085,1241
2020-10-07,Sacramento,067,1510023,23836,23380,29,23409,452
2020-10-07,San Benito,069,59416,1367,1363,0,1363,13
2020-10-07,San Bernardino,071,2135413,58060,55738,366,56104,1043
2020-10-07,San Diego,073,3302833,51331,49177,1187,50364,813
2020-10-07,San Francisco,075,870044,11677,11551,37,11588,115
2020-10-07,San Joaquin,077,732212,20894,20527,80,20607,478
2020-10-07,San Luis Obispo,079,281455,4044,3749,17,3766,32
2020-10-07,San Mateo,081,765935,10688,9980,11,9991,130
2020-10-07,Santa Barbara,083,443738,9485,9350,81,9431,116
2020-10-07,Santa Clara,085,1922200,23385,21993,48,22041,320
2020-10-07,Santa Cruz,087,273765,2631,2518,32,2550,14
2020-10-07,Shasta,089,179085,1687,1268,16,1284,20
2020-10-07,Sierra,091,2930,6,6,0,6,0
2020-10-07,Siskiyou,093,43540,168,154,10,164,0
2020-10-07,Solano,095,438530,6774,6526,39,6565,53
2020-10-07,Sonoma,097,501317,8526,7993,22,8015,130
2020-10-07,Stanislaus,099,539301,17021,16786,594,17380,357
2020-10-07,Sutter,101,95872,1748,1723,1,1724,12
2020-10-07,Tehama,103,63373,706,666,2,668,3
2020-10-07,Trinity,105,12862,64,25,8,33,0
2020-10-07,Tulare,107,460477,17095,16483,194,16677,282
2020-10-07,Tuolumne,109,53932,245,227,6,233,3
2020-10-07,Ventura,111,848112,14084,13333,266,13599,150
2020-10-07,Yolo,113,214977,2979,2904,7,2911,55
2020-10-07,Yuba,115,75493,1148,1120,3,1123,10
2020-10-06,Alameda,001,1643700,22298,21698,195,21893,385
2020-10-06,Alpine,003,1148,3,3,0,3,0
2020-10-06,Amador,005,37829,303,301,0,301,16
2020-10-06,Butte,007,227075,3036,2925,53,2978,47
2020-10-06,Calaveras,009,45235,315,261,0,261,11
2020-10-06,Colusa,011,21464,538,538,0,538,6
2020-10-06,Contra Costa,013,1133247,17865,17295,86,17381,219
2020-10-06,Del Norte,015,27424,164,144,0,144,2
2020-10-06,El Dorado,017,186661,1286,1211,12,1223,4
2020-10-06,Fresno,019,978130,31699,29022,392,29414,412
2020-10-06,Glenn,021,27897,626,604,0,604,3
2020-10-06,Humboldt,023,135768,523,508,1,509,7
2020-10-06,Imperial,025,180216,12187,11196,9,11205,327
2020-10-06,Inyo,027,18085,202,198,4,202,14
2020-10-06,Kern,029,883053,32756,32006,362,32368,407
2020-10-06,Kings,031,150075,8236,7943,41,7984,81
2020-10-06,Lake,033,64148,645,596,0,596,11
2020-10-06,Lassen,035,31185,757,743,2,745,0
2020-10-06,Los Angeles,037,10098052,280064,274115,2153,276268,6657
2020-10-06,Madera,039,155013,4759,4608,32,4640,50
2020-10-06,Marin,041,260295,6909,6766,18,6784,91
2020-10-06,Mariposa,043,17540,77,75,0,75,2
2020-10-06,Mendocino,045,87422,974,920,4,924,19
2020-10-06,Merced,047,269075,9147,9034,24,9058,143
2020-10-06,Modoc,049,8938,29,26,0,26,0
2020-10-06,Mono,051,14174,173,153,4,157,1
2020-10-06,Monterey,053,433212,10501,10235,37,10272,72
2020-10-06,Napa,055,140530,1826,1770,8,1778,11
2020-10-06,Nevada,057,99092,570,551,18,569,6
2020-10-06,Orange,059,3164182,57148,54203,1570,55773,1273
2020-10-06,Placer,061,380077,3852,3680,13,3693,48
2020-10-06,Plumas,063,18699,52,49,0,49,0
2020-10-06,Riverside,065,2383286,62387,60593,226,60819,1238
2020-10-06,Sacramento,067,1510023,23750,23322,29,23351,442
2020-10-06,San Benito,069,59416,1366,1358,0,1358,12
2020-10-06,San Bernardino,071,2135413,57746,55416,361,55777,1040
2020-10-06,San Diego,073,3302833,50994,48823,1170,49993,806
2020-10-06,San Francisco,075,870044,11651,11513,36,11549,115
2020-10-06,San Joaquin,077,732212,20854,20481,77,20558,477
2020-10-06,San Luis Obispo,079,281455,4010,3723,17,3740,32
2020-10-06,San Mateo,081,765935,10656,9934,11,9945,129
2020-10-06,Santa Barbara,083,443738,9456,9331,80,9411,116
2020-10-06,Santa Clara,085,1922200,23290,21914,48,21962,320
2020-10-06,Santa Cruz,087,273765,2609,2510,32,2542,12
2020-10-06,Shasta,089,179085,1647,1242,16,1258,18
2020-10-06,Sierra,091,2930,6,6,0,6,0
2020-10-06,Siskiyou,093,43540,168,154,10,164,0
2020-10-06,Solano,095,438530,6728,6506,39,6545,52
2020-10-06,Sonoma,097,501317,8433,7895,22,7917,130
2020-10-06,Stanislaus,099,539301,16976,16759,588,17347,354
2020-10-06,Sutter,101,95872,1746,1722,1,1723,12
2020-10-06,Tehama,103,63373,696,660,2,662,3
2020-10-06,Trinity,105,12862,64,25,8,33,0
2020-10-06,Tulare,107,460477,17053,16456,186,16642,280
2020-10-06,Tuolumne,109,53932,244,227,6,233,2
2020-10-06,Ventura,111,848112,14017,13242,261,13503,150
2020-10-06,Yolo,113,214977,2965,2899,7,2906,56
2020-10-06,Yuba,115,75493,1147,1114,3,1117,10
2020-10-05,Alameda,001,1643700,22210,21637,192,21829,383
2020-10-05,Alpine,003,1148,3,2,0,2,0
2020-10-05,Amador,005,37829,303,299,0,299,16
2020-10-05,Butte,007,227075,3026,2910,53,2963,46
2020-10-05,Calaveras,009,45235,315,259,0,259,11
2020-10-05,Colusa,011,21464,538,537,0,537,6
2020-10-05,Contra Costa,013,1133247,17788,17250,86,17336,216
2020-10-05,Del Norte,015,27424,161,142,0,142,2
2020-10-05,El Dorado,017,186661,1282,1202,11,1213,4
2020-10-05,Fresno,019,978130,31582,29136,392,29528,408
2020-10-05,Glenn,021,27897,624,603,0,603,3
2020-10-05,Humboldt,023,135768,522,506,1,507,6
2020-10-05,Imperial,025,180216,12146,11169,9,11178,327
2020-10-05,Inyo,027,18085,202,197,4,201,14
2020-10-05,Kern,029,883053,32677,31933,358,32291,404
2020-10-05,Kings,031,150075,8139,7932,41,7973,80
2020-10-05,Lake,033,64148,641,592,0,592,10
2020-10-05,Lassen,035,31185,756,743,2,745,0
2020-10-05,Los Angeles,037,10098052,278968,273200,2115,275315,6632
2020-10-05,Madera,039,155013,4751,4598,30,4628,50
2020-10-05,Marin,041,260295,6892,6751,18,6769,91
2020-10-05,Mariposa,043,17540,77,75,0,75,2
2020-10-05,Mendocino,045,87422,966,913,4,917,19
2020-10-05,Merced,047,269075,9128,9021,23,9044,143
2020-10-05,Modoc,049,8938,29,26,0,26,0
2020-10-05,Mono,051,14174,173,152,4,156,1
2020-10-05,Monterey,053,433212,10454,10187,37,10224,72
2020-10-05,Napa,055,140530,1815,1760,8,1768,11
2020-10-05,Nevada,057,99092,567,550,17,567,6
2020-10-05,Orange,059,3164182,56932,54103,1557,55660,1271
2020-10-05,Placer,061,380077,3826,3670,13,3683,46
2020-10-05,Plumas,063,18699,51,49,0,49,0
2020-10-05,Riverside,065,2383286,62067,60454,222,60676,1232
2020-10-05,Sacramento,067,1510023,23646,23207,29,23236,438
2020-10-05,San Benito,069,59416,1363,1356,0,1356,12
2020-10-05,San Bernardino,071,2135413,57439,55100,360,55460,1031
2020-10-05,San Diego,073,3302833,50658,48662,1146,49808,803
2020-10-05,San Francisco,075,870044,11612,11476,34,11510,110
2020-10-05,San Joaquin,077,732212,20784,20319,74,20393,476
2020-10-05,San Luis Obispo,079,281455,3983,3710,17,3727,32
2020-10-05,San Mateo,081,765935,10629,9896,11,9907,128
2020-10-05,Santa Barbara,083,443738,9434,9309,80,9389,116
2020-10-05,Santa Clara,085,1922200,23173,21861,48,21909,319
2020-10-05,Santa Cruz,087,273765,2597,2492,32,2524,9
2020-10-05,Shasta,089,179085,1615,1158,16,1174,18
2020-10-05,Sierra,091,2930,6,6,0,6,0
2020-10-05,Siskiyou,093,43540,168,153,10,163,0
2020-10-05,Solano,095,438530,6690,6475,39,6514,52
2020-10-05,Sonoma,097,501317,8341,7817,22,7839,130
2020-10-05,Stanislaus,099,539301,16940,16730,581,17311,351
2020-10-05,Sutter,101,95872,1738,1719,1,1720,12
2020-10-05,Tehama,103,63373,688,642,2,644,3
2020-10-05,Trinity,105,12862,62,22,8,30,0
2020-10-05,Tulare,107,460477,16994,16343,181,16524,278
2020-10-05,Tuolumne,109,53932,241,226,6,232,2
2020-10-05,Ventura,111,848112,13948,13224,242,13466,149
2020-10-05,Yolo,113,214977,2946,2889,7,2896,56
2020-10-05,Yuba,115,75493,1134,1108,3,1111,9
2020-10-04,Alameda,001,1643700,22114,21597,192,21789,383
2020-10-04,Alpine,003,1148,3,2,0,2,0
2020-10-04,Amador,005,37829,302,297,0,297,16
2020-10-04,Butte,007,227075,3012,2903,53,2956,46
2020-10-04,Calaveras,009,45235,315,259,0,259,11
2020-10-04,Colusa,011,21464,537,537,0,537,6
2020-10-04,Contra Costa,013,1133247,17724,17192,86,17278,214
2020-10-04,Del Norte,015,27424,157,142,0,142,2
2020-10-04,El Dorado,017,186661,1278,1196,11,1207,4
2020-10-04,Fresno,019,978130,31459,29065,392,29457,408
2020-10-04,Glenn,021,27897,622,601,0,601,3
2020-10-04,Humboldt,023,135768,521,506,1,507,6
2020-10-04,Imperial,025,180216,12107,11127,9,11136,327
2020-10-04,Inyo,027,18085,199,195,4,199,14
2020-10-04,Kern,029,883053,32602,31906,355,32261,404
2020-10-04,Kings,031,150075,8124,7919,41,7960,80
2020-10-04,Lake,033,64148,627,589,0,589,10
2020-10-04,Lassen,035,31185,756,743,2,745,0
2020-10-04,Los Angeles,037,10098052,277580,272822,2069,274891,6625
2020-10-04,Madera,039,155013,4735,4587,30,4617,50
2020-10-04,Marin,041,260295,6872,6741,18,6759,91
2020-10-04,Mariposa,043,17540,77,75,0,75,2
2020-10-04,Mendocino,045,87422,953,905,4,909,18
2020-10-04,Merced,047,269075,9103,9006,23,9029,140
2020-10-04,Modoc,049,8938,29,26,0,26,0
2020-10-04,Mono,051,14174,172,152,3,155,1
2020-10-04,Monterey,053,433212,10413,10141,36,10177,72
2020-10-04,Napa,055,140530,1803,1759,8,1767,11
2020-10-04,Nevada,057,99092,563,547,16,563,6
2020-10-04,Orange,059,3164182,56696,53966,1548,55514,1270
2020-10-04,Placer,061,380077,3805,3664,13,3677,46
2020-10-04,Plumas,063,18699,51,49,0,49,0
2020-10-04,Riverside,065,2383286,61781,60251,218,60469,1226
2020-10-04,Sacramento,067,1510023,23530,23162,29,23191,438
2020-10-04,San Benito,069,59416,1363,1355,0,1355,12
2020-10-04,San Bernardino,071,2135413,56990,55100,358,55458,1031
2020-10-04,San Diego,073,3302833,50291,48438,1121,49559,803
2020-10-04,San Francisco,075,870044,11580,11474,32,11506,110
2020-10-04,San Joaquin,077,732212,20707,20320,68,20388,476
2020-10-04,San Luis Obispo,079,281455,3958,3688,17,3705,31
2020-10-04,San Mateo,081,765935,10569,9858,11,9869,128
2020-10-04,Santa Barbara,083,443738,9408,9276,78,9354,116
2020-10-04,Santa Clara,085,1922200,23036,21780,48,21828,316
2020-10-04,Santa Cruz,087,273765,2581,2483,32,2515,9
2020-10-04,Shasta,089,179085,1517,1158,15,1173,18
2020-10-04,Sierra,091,2930,6,6,0,6,0
2020-10-04,Siskiyou,093,43540,168,153,10,163,0
2020-10-04,Solano,095,438530,6639,6445,39,6484,52
2020-10-04,Sonoma,097,501317,8253,7794,22,7816,129
2020-10-04,Stanislaus,099,539301,16890,16711,572,17283,351
2020-10-04,Sutter,101,95872,1735,1711,1,1712,11
2020-10-04,Tehama,103,63373,673,637,2,639,3
2020-10-04,Trinity,105,12862,61,21,8,29,0
2020-10-04,Tulare,107,460477,16917,16343,170,16513,278
2020-10-04,Tuolumne,109,53932,239,226,6,232,2
2020-10-04,Ventura,111,848112,13866,13197,225,13422,149
2020-10-04,Yolo,113,214977,2935,2875,7,2882,56
2020-10-04,Yuba,115,75493,1130,1103,3,1106,9
2020-10-03,Alameda,001,1643700,22068,21510,191,21701,386
2020-10-03,Alpine,003,1148,3,2,0,2,0
2020-10-03,Amador,005,37829,301,296,0,296,16
2020-10-03,Butte,007,227075,3006,2894,53,2947,46
2020-10-03,Calaveras,009,45235,315,259,0,259,11
2020-10-03,Colusa,011,21464,536,537,0,537,6
2020-10-03,Contra Costa,013,1133247,17674,17087,84,17171,213
2020-10-03,Del Norte,015,27424,153,142,0,142,2
2020-10-03,El Dorado,017,186661,1271,1188,11,1199,4
2020-10-03,Fresno,019,978130,31399,28975,391,29366,408
2020-10-03,Glenn,021,27897,620,601,0,601,3
2020-10-03,Humboldt,023,135768,520,504,1,505,6
2020-10-03,Imperial,025,180216,12084,11090,9,11099,327
2020-10-03,Inyo,027,18085,199,194,4,198,14
2020-10-03,Kern,029,883053,32552,31864,351,32215,403
2020-10-03,Kings,031,150075,8120,7887,41,7928,80
2020-10-03,Lake,033,64148,617,588,0,588,10
2020-10-03,Lassen,035,31185,756,743,2,745,0
2020-10-03,Los Angeles,037,10098052,276873,271869,2040,273909,6620
2020-10-03,Madera,039,155013,4718,4565,30,4595,50
2020-10-03,Marin,041,260295,6866,6728,18,6746,91
2020-10-03,Mariposa,043,17540,77,75,0,75,2
2020-10-03,Mendocino,045,87422,951,898,4,902,18
2020-10-03,Merced,047,269075,9090,8986,23,9009,139
2020-10-03,Modoc,049,8938,29,26,0,26,0
2020-10-03,Mono,051,14174,171,152,3,155,1
2020-10-03,Monterey,053,433212,10379,10092,33,10125,72
2020-10-03,Napa,055,140530,1799,1752,8,1760,11
2020-10-03,Nevada,057,99092,562,544,16,560,6
2020-10-03,Orange,059,3164182,56579,53573,1543,55116,1268
2020-10-03,Placer,061,380077,3794,3648,13,3661,47
2020-10-03,Plumas,063,18699,51,48,0,48,0
2020-10-03,Riverside,065,2383286,61629,59991,216,60207,1226
2020-10-03,Sacramento,067,1510023,23479,23076,29,23105,437
2020-10-03,San Benito,069,59416,1363,1351,0,1351,12
2020-10-03,San Bernardino,071,2135413,56817,55004,355,55359,1031
2020-10-03,San Diego,073,3302833,50060,48202,1104,49306,798
2020-10-03,San Francisco,075,870044,11555,11475,30,11505,110
2020-10-03,San Joaquin,077,732212,20681,20322,68,20390,476
2020-10-03,San Luis Obispo,079,281455,3934,3670,17,3687,31
2020-10-03,San Mateo,081,765935,10542,9822,10,9832,128
2020-10-03,Santa Barbara,083,443738,9395,9256,78,9334,116
2020-10-03,Santa Clara,085,1922200,22956,21672,48,21720,309
2020-10-03,Santa Cruz,087,273765,2573,2476,32,2508,9
2020-10-03,Shasta,089,179085,1489,1117,14,1131,18
2020-10-03,Sierra,091,2930,6,6,0,6,0
2020-10-03,Siskiyou,093,43540,168,152,10,162,0
2020-10-03,Solano,095,438530,6613,6419,39,6458,52
2020-10-03,Sonoma,097,501317,8211,7747,22,7769,129
2020-10-03,Stanislaus,099,539301,16857,16645,568,17213,351
2020-10-03,Sutter,101,95872,1731,1705,1,1706,11
2020-10-03,Tehama,103,63373,667,630,2,632,3
2020-10-03,Trinity,105,12862,61,15,8,23,0
2020-10-03,Tulare,107,460477,16873,16322,166,16488,278
2020-10-03,Tuolumne,109,53932,238,224,6,230,2
2020-10-03,Ventura,111,848112,13828,13150,221,13371,148
2020-10-03,Yolo,113,214977,2928,2863,7,2870,56
2020-10-03,Yuba,115,75493,1122,1097,3,1100,8
2020-10-02,Alameda,001,1643700,22013,21404,190,21594,382
2020-10-02,Alpine,003,1148,3,2,0,2,0
2020-10-02,Amador,005,37829,300,296,0,296,16
2020-10-02,Butte,007,227075,2996,2879,53,2932,46
2020-10-02,Calaveras,009,45235,314,259,0,259,11
2020-10-02,Colusa,011,21464,535,537,0,537,6
2020-10-02,Contra Costa,013,1133247,17631,17002,83,17085,213
2020-10-02,Del Norte,015,27424,152,141,0,141,2
2020-10-02,El Dorado,017,186661,1264,1168,11,1179,4
2020-10-02,Fresno,019,978130,31316,28855,391,29246,403
2020-10-02,Glenn,021,27897,615,594,0,594,3
2020-10-02,Humboldt,023,135768,519,503,1,504,6
2020-10-02,Imperial,025,180216,12062,11024,9,11033,327
2020-10-02,Inyo,027,18085,197,191,4,195,14
2020-10-02,Kern,029,883053,32500,31790,344,32134,399
2020-10-02,Kings,031,150075,8111,7716,41,7757,79
2020-10-02,Lake,033,64148,611,579,0,579,10
2020-10-02,Lassen,035,31185,756,742,2,744,0
2020-10-02,Los Angeles,037,10098052,275972,270935,2014,272949,6602
2020-10-02,Madera,039,155013,4710,4537,30,4567,49
2020-10-02,Marin,041,260295,6849,6717,18,6735,91
2020-10-02,Mariposa,043,17540,77,75,0,75,2
2020-10-02,Mendocino,045,87422,946,883,4,887,18
2020-10-02,Merced,047,269075,9080,8961,23,8984,139
2020-10-02,Modoc,049,8938,29,26,0,26,0
2020-10-02,Mono,051,14174,171,150,3,153,1
2020-10-02,Monterey,053,433212,10345,9997,33,10030,71
2020-10-02,Napa,055,140530,1793,1737,8,1745,11
2020-10-02,Nevada,057,99092,559,543,16,559,6
2020-10-02,Orange,059,3164182,56448,53299,1536,54835,1262
2020-10-02,Placer,061,380077,3774,3612,13,3625,46
2020-10-02,Plumas,063,18699,51,48,0,48,0
2020-10-02,Riverside,065,2383286,61408,59673,213,59886,1223
2020-10-02,Sacramento,067,1510023,23414,22818,29,22847,436
2020-10-02,San Benito,069,59416,1359,1347,0,1347,12
2020-10-02,San Bernardino,071,2135413,56631,54613,355,54968,1028
2020-10-02,San Diego,073,3302833,49808,47793,1088,48881,794
2020-10-02,San Francisco,075,870044,11532,11398,30,11428,110
2020-10-02,San Joaquin,077,732212,20647,20235,67,20302,474
2020-10-02,San Luis Obispo,079,281455,3911,3654,17,3671,31
2020-10-02,San Mateo,081,765935,10501,9745,10,9755,128
2020-10-02,Santa Barbara,083,443738,9372,9234,78,9312,116
2020-10-02,Santa Clara,085,1922200,22870,21545,47,21592,305
2020-10-02,Santa Cruz,087,273765,2556,2463,32,2495,9
2020-10-02,Shasta,089,179085,1454,1046,14,1060,18
2020-10-02,Sierra,091,2930,6,6,0,6,0
2020-10-02,Siskiyou,093,43540,168,151,10,161,0
2020-10-02,Solano,095,438530,6583,6385,39,6424,52
2020-10-02,Sonoma,097,501317,8154,7662,22,7684,125
2020-10-02,Stanislaus,099,539301,16816,16609,559,17168,349
2020-10-02,Sutter,101,95872,1730,1693,1,1694,11
2020-10-02,Tehama,103,63373,662,619,2,621,3
2020-10-02,Trinity,105,12862,61,15,8,23,0
2020-10-02,Tulare,107,460477,16832,16245,159,16404,278
2020-10-02,Tuolumne,109,53932,236,225,6,231,2
2020-10-02,Ventura,111,848112,13789,13120,216,13336,146
2020-10-02,Yolo,113,214977,2923,2845,7,2852,55
2020-10-02,Yuba,115,75493,1120,1090,3,1093,8
2020-10-01,Alameda,001,1643700,21952,21349,186,21535,383
2020-10-01,Alpine,003,1148,3,2,0,2,0
2020-10-01,Amador,005,37829,300,294,0,294,16
2020-10-01,Butte,007,227075,2988,2865,53,2918,45
2020-10-01,Calaveras,009,45235,314,257,0,257,11
2020-10-01,Colusa,011,21464,535,536,0,536,6
2020-10-01,Contra Costa,013,1133247,17567,16898,83,16981,211
2020-10-01,Del Norte,015,27424,147,140,0,140,2
2020-10-01,El Dorado,017,186661,1260,1162,10,1172,4
2020-10-01,Fresno,019,978130,31236,28796,389,29185,397
2020-10-01,Glenn,021,27897,611,593,0,593,3
2020-10-01,Humboldt,023,135768,519,499,1,500,6
2020-10-01,Imperial,025,180216,12020,10928,9,10937,325
2020-10-01,Inyo,027,18085,197,191,4,195,14
2020-10-01,Kern,029,883053,32437,31678,339,32017,399
2020-10-01,Kings,031,150075,8100,7688,38,7726,79
2020-10-01,Lake,033,64148,605,572,0,572,11
2020-10-01,Lassen,035,31185,753,742,2,744,0
2020-10-01,Los Angeles,037,10098052,274926,271513,1981,273494,6621
2020-10-01,Madera,039,155013,4687,4508,30,4538,48
2020-10-01,Marin,041,260295,6835,6710,18,6728,92
2020-10-01,Mariposa,043,17540,77,76,0,76,2
2020-10-01,Mendocino,045,87422,941,874,4,878,19
2020-10-01,Merced,047,269075,9053,8942,23,8965,138
2020-10-01,Modoc,049,8938,29,26,0,26,0
2020-10-01,Mono,051,14174,169,150,3,153,1
2020-10-01,Monterey,053,433212,10270,9958,33,9991,71
2020-10-01,Napa,055,140530,1785,1729,8,1737,11
2020-10-01,Nevada,057,99092,558,543,16,559,6
2020-10-01,Orange,059,3164182,56282,53088,1523,54611,1257
2020-10-01,Placer,061,380077,3747,3599,13,3612,45
2020-10-01,Plumas,063,18699,51,48,0,48,0
2020-10-01,Riverside,065,2383286,61155,59293,207,59500,1223
2020-10-01,Sacramento,067,1510023,23302,22714,28,22742,433
2020-10-01,San Benito,069,59416,1357,1346,0,1346,12
2020-10-01,San Bernardino,071,2135413,56338,54350,352,54702,1021
2020-10-01,San Diego,073,3302833,49526,47487,1068,48555,792
2020-10-01,San Francisco,075,870044,11501,11284,28,11312,110
2020-10-01,San Joaquin,077,732212,20601,20204,64,20268,471
2020-10-01,San Luis Obispo,079,281455,3884,3625,17,3642,31
2020-10-01,San Mateo,081,765935,10456,9681,10,9691,128
2020-10-01,Santa Barbara,083,443738,9332,9215,78,9293,118
2020-10-01,Santa Clara,085,1922200,22769,21398,47,21445,305
2020-10-01,Santa Cruz,087,273765,2541,2418,32,2450,10
2020-10-01,Shasta,089,179085,1403,991,14,1005,18
2020-10-01,Sierra,091,2930,6,6,0,6,0
2020-10-01,Siskiyou,093,43540,165,150,10,160,0
2020-10-01,Solano,095,438530,6545,6352,39,6391,52
2020-10-01,Sonoma,097,501317,8087,7569,22,7591,125
2020-10-01,Stanislaus,099,539301,16783,16555,553,17108,346
2020-10-01,Sutter,101,95872,1725,1684,1,1685,11
2020-10-01,Tehama,103,63373,652,606,2,608,3
2020-10-01,Trinity,105,12862,61,15,8,23,0
2020-10-01,Tulare,107,460477,16757,16182,156,16338,275
2020-10-01,Tuolumne,109,53932,236,223,6,229,2
2020-10-01,Ventura,111,848112,13737,13057,203,13260,146
2020-10-01,Yolo,113,214977,2905,2833,7,2840,55
2020-10-01,Yuba,115,75493,1116,1082,3,1085,8
2020-09-30,Alameda,001,1643700,21874,21271,183,21454,380
2020-09-30,Alpine,003,1148,3,2,0,2,0
2020-09-30,Amador,005,37829,300,294,0,294,16
2020-09-30,Butte,007,227075,2980,2858,53,2911,44
2020-09-30,Calaveras,009,45235,313,258,0,258,11
2020-09-30,Colusa,011,21464,534,534,0,534,6
2020-09-30,Contra Costa,013,1133247,17499,16819,83,16902,211
2020-09-30,Del Norte,015,27424,146,140,0,140,2
2020-09-30,El Dorado,017,186661,1248,1157,10,1167,4
2020-09-30,Fresno,019,978130,31146,28706,386,29092,395
2020-09-30,Glenn,021,27897,606,592,0,592,3
2020-09-30,Humboldt,023,135768,517,497,1,498,6
2020-09-30,Imperial,025,180216,11995,10868,9,10877,287
2020-09-30,Inyo,027,18085,196,189,4,193,14
2020-09-30,Kern,029,883053,32361,31601,338,31939,398
2020-09-30,Kings,031,150075,8072,7685,38,7723,79
2020-09-30,Lake,033,64148,599,567,0,567,10
2020-09-30,Lassen,035,31185,750,742,2,744,0
2020-09-30,Los Angeles,037,10098052,273704,270260,1949,272209,6568
2020-09-30,Madera,039,155013,4678,4477,30,4507,47
2020-09-30,Marin,041,260295,6811,6700,17,6717,91
2020-09-30,Mariposa,043,17540,77,76,0,76,2
2020-09-30,Mendocino,045,87422,935,867,4,871,17
2020-09-30,Merced,047,269075,9033,8926,23,8949,136
2020-09-30,Modoc,049,8938,29,26,0,26,0
2020-09-30,Mono,051,14174,169,150,3,153,1
2020-09-30,Monterey,053,433212,10219,9898,32,9930,70
2020-09-30,Napa,055,140530,1771,1728,8,1736,11
2020-09-30,Nevada,057,99092,556,540,16,556,6
2020-09-30,Orange,059,3164182,56091,52916,1508,54424,1251
2020-09-30,Placer,061,380077,3726,3585,13,3598,43
2020-09-30,Plumas,063,18699,51,48,0,48,0
2020-09-30,Riverside,065,2383286,60799,59074,203,59277,1220
2020-09-30,Sacramento,067,1510023,23199,22613,28,22641,429
2020-09-30,San Benito,069,59416,1354,1342,0,1342,12
2020-09-30,San Bernardino,071,2135413,56061,53988,351,54339,1018
2020-09-30,San Diego,073,3302833,49222,47182,1047,48229,783
2020-09-30,San Francisco,075,870044,11471,11247,28,11275,106
2020-09-30,San Joaquin,077,732212,20518,20150,62,20212,461
2020-09-30,San Luis Obispo,079,281455,3859,3597,17,3614,31
2020-09-30,San Mateo,081,765935,10414,9634,10,9644,128
2020-09-30,Santa Barbara,083,443738,9306,9186,78,9264,115
2020-09-30,Santa Clara,085,1922200,22664,21318,47,21365,302
2020-09-30,Santa Cruz,087,273765,2528,2405,32,2437,10
2020-09-30,Shasta,089,179085,1347,976,13,989,17
2020-09-30,Sierra,091,2930,6,6,0,6,0
2020-09-30,Siskiyou,093,43540,163,150,10,160,0
2020-09-30,Solano,095,438530,6503,6315,39,6354,51
2020-09-30,Sonoma,097,501317,7998,7494,22,7516,125
2020-09-30,Stanislaus,099,539301,16736,16531,547,17078,343
2020-09-30,Sutter,101,95872,1709,1680,1,1681,10
2020-09-30,Tehama,103,63373,646,594,2,596,3
2020-09-30,Trinity,105,12862,58,15,8,23,0
2020-09-30,Tulare,107,460477,16690,16117,149,16266,274
2020-09-30,Tuolumne,109,53932,234,224,6,230,2
2020-09-30,Ventura,111,848112,13702,12968,187,13155,145
2020-09-30,Yolo,113,214977,2892,2822,7,2829,55
2020-09-30,Yuba,115,75493,1113,1075,3,1078,8
2020-09-29,Alameda,001,1643700,21799,21241,180,21421,374
2020-09-29,Alpine,003,1148,3,2,0,2,0
2020-09-29,Amador,005,37829,298,294,0,294,16
2020-09-29,Butte,007,227075,2966,2848,53,2901,44
2020-09-29,Calaveras,009,45235,311,261,0,261,11
2020-09-29,Colusa,011,21464,534,534,0,534,6
2020-09-29,Contra Costa,013,1133247,17443,16716,81,16797,209
2020-09-29,Del Norte,015,27424,142,142,0,142,2
2020-09-29,El Dorado,017,186661,1239,1151,10,1161,4
2020-09-29,Fresno,019,978130,31049,28621,385,29006,394
2020-09-29,Glenn,021,27897,602,589,0,589,3
2020-09-29,Humboldt,023,135768,515,497,1,498,6
2020-09-29,Imperial,025,180216,11960,10811,9,10820,283
2020-09-29,Inyo,027,18085,195,188,4,192,14
2020-09-29,Kern,029,883053,32305,31534,337,31871,397
2020-09-29,Kings,031,150075,8016,7681,38,7719,78
2020-09-29,Lake,033,64148,597,566,0,566,11
2020-09-29,Lassen,035,31185,750,741,2,743,0
2020-09-29,Los Angeles,037,10098052,272489,269246,1921,271167,6545
2020-09-29,Madera,039,155013,4655,4453,30,4483,47
2020-09-29,Marin,041,260295,6790,6692,17,6709,91
2020-09-29,Mariposa,043,17540,77,74,0,74,2
2020-09-29,Mendocino,045,87422,925,854,4,858,17
2020-09-29,Merced,047,269075,9020,8892,21,8913,136
2020-09-29,Modoc,049,8938,29,26,0,26,0
2020-09-29,Mono,051,14174,169,149,3,152,1
2020-09-29,Monterey,053,433212,10164,9826,30,9856,70
2020-09-29,Napa,055,140530,1768,1727,8,1735,11
2020-09-29,Nevada,057,99092,551,539,16,555,6
2020-09-29,Orange,059,3164182,55904,52755,1497,54252,1231
2020-09-29,Placer,061,380077,3704,3570,13,3583,42
2020-09-29,Plumas,063,18699,51,48,0,48,0
2020-09-29,Riverside,065,2383286,60469,58863,196,59059,1208
2020-09-29,Sacramento,067,1510023,23078,22547,27,22574,425
2020-09-29,San Benito,069,59416,1349,1341,0,1341,12
2020-09-29,San Bernardino,071,2135413,55751,53753,350,54103,1012
2020-09-29,San Diego,073,3302833,48945,46987,1024,48011,781
2020-09-29,San Francisco,075,870044,11435,11142,28,11170,104
2020-09-29,San Joaquin,077,732212,20450,20094,60,20154,454
2020-09-29,San Luis Obispo,079,281455,3837,3581,17,3598,31
2020-09-29,San Mateo,081,765935,10367,9619,10,9629,127
2020-09-29,Santa Barbara,083,443738,9286,9149,77,9226,114
2020-09-29,Santa Clara,085,1922200,22528,21233,46,21279,302
2020-09-29,Santa Cruz,087,273765,2513,2383,31,2414,10
2020-09-29,Shasta,089,179085,1286,943,13,956,17
2020-09-29,Sierra,091,2930,6,6,0,6,0
2020-09-29,Siskiyou,093,43540,157,150,10,160,0
2020-09-29,Solano,095,438530,6469,6303,39,6342,51
2020-09-29,Sonoma,097,501317,7926,7426,22,7448,125
2020-09-29,Stanislaus,099,539301,16706,16505,541,17046,341
2020-09-29,Sutter,101,95872,1703,1677,1,1678,10
2020-09-29,Tehama,103,63373,628,585,2,587,2
2020-09-29,Trinity,105,12862,56,16,8,24,0
2020-09-29,Tulare,107,460477,16625,16055,142,16197,270
2020-09-29,Tuolumne,109,53932,234,224,6,230,2
2020-09-29,Ventura,111,848112,13645,12875,184,13059,145
2020-09-29,Yolo,113,214977,2879,2818,7,2825,55
2020-09-29,Yuba,115,75493,1111,1071,3,1074,8
2020-09-28,Alameda,001,1643700,21712,21133,180,21313,370
2020-09-28,Alpine,003,1148,3,2,0,2,0
2020-09-28,Amador,005,37829,296,294,0,294,16
2020-09-28,Butte,007,227075,2951,2837,53,2890,44
2020-09-28,Calaveras,009,45235,311,257,0,257,11
2020-09-28,Colusa,011,21464,533,531,0,531,6
2020-09-28,Contra Costa,013,1133247,17380,16653,81,16734,195
2020-09-28,Del Norte,015,27424,142,138,0,138,2
2020-09-28,El Dorado,017,186661,1232,1144,10,1154,4
2020-09-28,Fresno,019,978130,30968,28517,379,28896,389
2020-09-28,Glenn,021,27897,600,585,0,585,3
2020-09-28,Humboldt,023,135768,509,495,1,496,6
2020-09-28,Imperial,025,180216,11925,10777,9,10786,283
2020-09-28,Inyo,027,18085,194,188,4,192,14
2020-09-28,Kern,029,883053,32240,31481,333,31814,395
2020-09-28,Kings,031,150075,7875,7661,36,7697,78
2020-09-28,Lake,033,64148,593,559,0,559,10
2020-09-28,Lassen,035,31185,749,737,2,739,0
2020-09-28,Los Angeles,037,10098052,271382,268404,1891,270295,6508
2020-09-28,Madera,039,155013,4634,4438,30,4468,47
2020-09-28,Marin,041,260295,6774,6676,17,6693,91
2020-09-28,Mariposa,043,17540,77,74,0,74,2
2020-09-28,Mendocino,045,87422,910,850,4,854,17
2020-09-28,Merced,047,269075,8992,8869,21,8890,136
2020-09-28,Modoc,049,8938,29,26,0,26,0
2020-09-28,Mono,051,14174,169,148,3,151,1
2020-09-28,Monterey,053,433212,10099,9780,28,9808,69
2020-09-28,Napa,055,140530,1756,1705,8,1713,11
2020-09-28,Nevada,057,99092,543,538,16,554,6
2020-09-28,Orange,059,3164182,55698,52633,1488,54121,1196
2020-09-28,Placer,061,380077,3683,3572,13,3585,42
2020-09-28,Plumas,063,18699,50,48,0,48,0
2020-09-28,Riverside,065,2383286,60171,58570,187,58757,1198
2020-09-28,Sacramento,067,1510023,22931,22392,27,22419,423
2020-09-28,San Benito,069,59416,1346,1336,0,1336,11
2020-09-28,San Bernardino,071,2135413,55403,53501,350,53851,988
2020-09-28,San Diego,073,3302833,48627,46736,1004,47740,776
2020-09-28,San Francisco,075,870044,11401,11114,28,11142,100
2020-09-28,San Joaquin,077,732212,20403,19982,59,20041,448
2020-09-28,San Luis Obispo,079,281455,3816,3567,17,3584,31
2020-09-28,San Mateo,081,765935,10317,9582,10,9592,127
2020-09-28,Santa Barbara,083,443738,9268,9121,77,9198,114
2020-09-28,Santa Clara,085,1922200,22411,21180,46,21226,271
2020-09-28,Santa Cruz,087,273765,2503,2359,31,2390,9
2020-09-28,Shasta,089,179085,1232,883,10,893,17
2020-09-28,Sierra,091,2930,6,6,0,6,0
2020-09-28,Siskiyou,093,43540,157,149,10,159,0
2020-09-28,Solano,095,438530,6432,6254,39,6293,51
2020-09-28,Sonoma,097,501317,7850,7369,22,7391,125
2020-09-28,Stanislaus,099,539301,16667,16467,534,17001,336
2020-09-28,Sutter,101,95872,1696,1676,1,1677,10
2020-09-28,Tehama,103,63373,620,579,2,581,2
2020-09-28,Trinity,105,12862,56,16,8,24,0
2020-09-28,Tulare,107,460477,16572,15918,137,16055,270
2020-09-28,Tuolumne,109,53932,234,225,6,231,2
2020-09-28,Ventura,111,848112,13567,12812,178,12990,139
2020-09-28,Yolo,113,214977,2862,2809,7,2816,55
2020-09-28,Yuba,115,75493,1108,1062,3,1065,7
2020-09-27,Alameda,001,1643700,21630,21077,176,21253,370
2020-09-27,Alpine,003,1148,3,2,0,2,0
2020-09-27,Amador,005,37829,296,291,0,291,16
2020-09-27,Butte,007,227075,2940,2833,52,2885,44
2020-09-27,Calaveras,009,45235,310,257,0,257,11
2020-09-27,Colusa,011,21464,532,531,0,531,6
2020-09-27,Contra Costa,013,1133247,17279,16596,80,16676,195
2020-09-27,Del Norte,015,27424,142,138,0,138,2
2020-09-27,El Dorado,017,186661,1217,1130,10,1140,4
2020-09-27,Fresno,019,978130,30863,28441,379,28820,389
2020-09-27,Glenn,021,27897,596,576,0,576,3
2020-09-27,Humboldt,023,135768,507,492,1,493,6
2020-09-27,Imperial,025,180216,11891,10743,9,10752,283
2020-09-27,Inyo,027,18085,192,188,4,192,14
2020-09-27,Kern,029,883053,32121,31462,330,31792,395
2020-09-27,Kings,031,150075,7855,7641,36,7677,78
2020-09-27,Lake,033,64148,589,555,0,555,10
2020-09-27,Lassen,035,31185,749,737,2,739,0
2020-09-27,Los Angeles,037,10098052,270201,267754,1872,269626,6507
2020-09-27,Madera,039,155013,4605,4416,30,4446,47
2020-09-27,Marin,041,260295,6764,6663,17,6680,91
2020-09-27,Mariposa,043,17540,77,74,0,74,2
2020-09-27,Mendocino,045,87422,904,846,4,850,17
2020-09-27,Merced,047,269075,8958,8853,21,8874,136
2020-09-27,Modoc,049,8938,29,26,0,26,0
2020-09-27,Mono,051,14174,169,148,3,151,1
2020-09-27,Monterey,053,433212,10039,9724,27,9751,69
2020-09-27,Napa,055,140530,1751,1690,8,1698,11
2020-09-27,Nevada,057,99092,542,537,16,553,6
2020-09-27,Orange,059,3164182,55423,52458,1479,53937,1195
2020-09-27,Placer,061,380077,3670,3562,13,3575,42
2020-09-27,Plumas,063,18699,50,48,0,48,0
2020-09-27,Riverside,065,2383286,59875,58509,179,58688,1191
2020-09-27,Sacramento,067,1510023,22833,22356,27,22383,422
2020-09-27,San Benito,069,59416,1346,1331,0,1331,11
2020-09-27,San Bernardino,071,2135413,54967,53127,350,53477,988
2020-09-27,San Diego,073,3302833,48283,46612,987,47599,776
2020-09-27,San Francisco,075,870044,11349,11114,28,11142,100
2020-09-27,San Joaquin,077,732212,20344,19981,59,20040,448
2020-09-27,San Luis Obispo,079,281455,3796,3562,17,3579,31
2020-09-27,San Mateo,081,765935,10249,9566,10,9576,127
2020-09-27,Santa Barbara,083,443738,9247,9090,76,9166,114
2020-09-27,Santa Clara,085,1922200,22302,21091,46,21137,271
2020-09-27,Santa Cruz,087,273765,2481,2359,31,2390,9
2020-09-27,Shasta,089,179085,1189,883,9,892,17
2020-09-27,Sierra,091,2930,6,6,0,6,0
2020-09-27,Siskiyou,093,43540,156,149,10,159,0
2020-09-27,Solano,095,438530,6397,6211,39,6250,51
2020-09-27,Sonoma,097,501317,7769,7336,22,7358,124
2020-09-27,Stanislaus,099,539301,16616,16448,528,16976,336
2020-09-27,Sutter,101,95872,1689,1672,1,1673,10
2020-09-27,Tehama,103,63373,603,573,2,575,2
2020-09-27,Trinity,105,12862,56,16,8,24,0
2020-09-27,Tulare,107,460477,16494,15918,128,16046,270
2020-09-27,Tuolumne,109,53932,233,224,6,230,2
2020-09-27,Ventura,111,848112,13478,12775,169,12944,139
2020-09-27,Yolo,113,214977,2848,2796,7,2803,55
2020-09-27,Yuba,115,75493,1098,1059,3,1062,7
2020-09-26,Alameda,001,1643700,21572,21019,175,21194,370
2020-09-26,Alpine,003,1148,3,2,0,2,0
2020-09-26,Amador,005,37829,295,291,0,291,16
2020-09-26,Butte,007,227075,2932,2827,52,2879,44
2020-09-26,Calaveras,009,45235,310,257,0,257,11
2020-09-26,Colusa,011,21464,532,529,0,529,6
2020-09-26,Contra Costa,013,1133247,17235,16508,80,16588,194
2020-09-26,Del Norte,015,27424,142,138,0,138,2
2020-09-26,El Dorado,017,186661,1212,1127,10,1137,4
2020-09-26,Fresno,019,978130,30796,28336,379,28715,389
2020-09-26,Glenn,021,27897,596,576,0,576,3
2020-09-26,Humboldt,023,135768,507,491,1,492,6
2020-09-26,Imperial,025,180216,11874,10721,9,10730,283
2020-09-26,Inyo,027,18085,191,187,4,191,14
2020-09-26,Kern,029,883053,32070,31410,330,31740,394
2020-09-26,Kings,031,150075,7843,7537,36,7573,78
2020-09-26,Lake,033,64148,586,549,0,549,10
2020-09-26,Lassen,035,31185,749,737,2,739,0
2020-09-26,Los Angeles,037,10098052,269569,266931,1858,268789,6497
2020-09-26,Madera,039,155013,4589,4410,30,4440,47
2020-09-26,Marin,041,260295,6751,6641,17,6658,91
2020-09-26,Mariposa,043,17540,76,74,0,74,2
2020-09-26,Mendocino,045,87422,899,836,4,840,17
2020-09-26,Merced,047,269075,8946,8841,20,8861,136
2020-09-26,Modoc,049,8938,29,26,0,26,0
2020-09-26,Mono,051,14174,169,148,3,151,1
2020-09-26,Monterey,053,433212,10012,9651,27,9678,68
2020-09-26,Napa,055,140530,1749,1681,8,1689,11
2020-09-26,Nevada,057,99092,542,534,16,550,6
2020-09-26,Orange,059,3164182,55284,52203,1473,53676,1194
2020-09-26,Placer,061,380077,3657,3551,13,3564,42
2020-09-26,Plumas,063,18699,49,48,0,48,0
2020-09-26,Riverside,065,2383286,59740,58076,177,58253,1190
2020-09-26,Sacramento,067,1510023,22775,22269,27,22296,421
2020-09-26,San Benito,069,59416,1344,1325,0,1325,11
2020-09-26,San Bernardino,071,2135413,54834,53122,350,53472,988
2020-09-26,San Diego,073,3302833,48078,46333,973,47306,775
2020-09-26,San Francisco,075,870044,11320,11113,28,11141,100
2020-09-26,San Joaquin,077,732212,20308,19982,57,20039,449
2020-09-26,San Luis Obispo,079,281455,3780,3546,17,3563,31
2020-09-26,San Mateo,081,765935,10215,9509,10,9519,127
2020-09-26,Santa Barbara,083,443738,9236,9061,76,9137,114
2020-09-26,Santa Clara,085,1922200,22231,20967,45,21012,270
2020-09-26,Santa Cruz,087,273765,2473,2336,31,2367,9
2020-09-26,Shasta,089,179085,1139,856,8,864,17
2020-09-26,Sierra,091,2930,6,6,0,6,0
2020-09-26,Siskiyou,093,43540,155,149,10,159,0
2020-09-26,Solano,095,438530,6378,6209,39,6248,51
2020-09-26,Sonoma,097,501317,7744,7285,21,7306,124
2020-09-26,Stanislaus,099,539301,16591,16421,520,16941,336
2020-09-26,Sutter,101,95872,1684,1662,1,1663,10
2020-09-26,Tehama,103,63373,591,560,2,562,2
2020-09-26,Trinity,105,12862,54,16,8,24,0
2020-09-26,Tulare,107,460477,16469,15881,126,16007,270
2020-09-26,Tuolumne,109,53932,233,223,6,229,2
2020-09-26,Ventura,111,848112,13443,12729,168,12897,137
2020-09-26,Yolo,113,214977,2846,2789,7,2796,55
2020-09-26,Yuba,115,75493,1094,1056,3,1059,7
2020-09-25,Alameda,001,1643700,21518,20911,175,21086,367
2020-09-25,Alpine,003,1148,3,2,0,2,0
2020-09-25,Amador,005,37829,295,289,0,289,16
2020-09-25,Butte,007,227075,2927,2819,52,2871,43
2020-09-25,Calaveras,009,45235,310,257,0,257,11
2020-09-25,Colusa,011,21464,532,528,0,528,6
2020-09-25,Contra Costa,013,1133247,17177,16401,80,16481,194
2020-09-25,Del Norte,015,27424,142,138,0,138,2
2020-09-25,El Dorado,017,186661,1208,1104,10,1114,4
2020-09-25,Fresno,019,978130,30736,28199,378,28577,385
2020-09-25,Glenn,021,27897,594,570,0,570,3
2020-09-25,Humboldt,023,135768,506,489,1,490,5
2020-09-25,Imperial,025,180216,11856,10681,9,10690,283
2020-09-25,Inyo,027,18085,189,187,4,191,14
2020-09-25,Kern,029,883053,32017,31333,328,31661,393
2020-09-25,Kings,031,150075,7838,7450,36,7486,77
2020-09-25,Lake,033,64148,585,539,0,539,9
2020-09-25,Lassen,035,31185,749,737,2,739,0
2020-09-25,Los Angeles,037,10098052,268775,265713,1845,267558,6483
2020-09-25,Madera,039,155013,4570,4369,30,4399,48
2020-09-25,Marin,041,260295,6748,6622,17,6639,90
2020-09-25,Mariposa,043,17540,76,74,0,74,2
2020-09-25,Mendocino,045,87422,884,819,3,822,17
2020-09-25,Merced,047,269075,8930,8830,20,8850,135
2020-09-25,Modoc,049,8938,29,26,0,26,0
2020-09-25,Mono,051,14174,169,149,3,152,1
2020-09-25,Monterey,053,433212,9960,9581,27,9608,68
2020-09-25,Napa,055,140530,1747,1669,8,1677,11
2020-09-25,Nevada,057,99092,540,529,16,545,6
2020-09-25,Orange,059,3164182,55157,52031,1465,53496,1184
2020-09-25,Placer,061,380077,3646,3527,13,3540,41
2020-09-25,Plumas,063,18699,49,48,0,48,0
2020-09-25,Riverside,065,2383286,59564,57783,172,57955,1183
2020-09-25,Sacramento,067,1510023,22698,22132,27,22159,418
2020-09-25,San Benito,069,59416,1343,1318,0,1318,11
2020-09-25,San Bernardino,071,2135413,54680,52814,350,53164,987
2020-09-25,San Diego,073,3302833,47876,46003,957,46960,775
2020-09-25,San Francisco,075,870044,11286,11066,27,11093,100
2020-09-25,San Joaquin,077,732212,20256,19909,57,19966,449
2020-09-25,San Luis Obispo,079,281455,3768,3512,17,3529,31
2020-09-25,San Mateo,081,765935,10179,9447,10,9457,127
2020-09-25,Santa Barbara,083,443738,9212,9026,76,9102,114
2020-09-25,Santa Clara,085,1922200,22166,20812,44,20856,265
2020-09-25,Santa Cruz,087,273765,2461,2309,30,2339,9
2020-09-25,Shasta,089,179085,1105,806,8,814,16
2020-09-25,Sierra,091,2930,6,6,0,6,0
2020-09-25,Siskiyou,093,43540,155,149,10,159,0
2020-09-25,Solano,095,438530,6362,6179,39,6218,50
2020-09-25,Sonoma,097,501317,7704,7202,21,7223,124
2020-09-25,Stanislaus,099,539301,16573,16381,518,16899,326
2020-09-25,Sutter,101,95872,1681,1655,1,1656,10
2020-09-25,Tehama,103,63373,583,546,2,548,2
2020-09-25,Trinity,105,12862,54,15,8,23,0
2020-09-25,Tulare,107,460477,16429,15815,125,15940,267
2020-09-25,Tuolumne,109,53932,233,223,6,229,2
2020-09-25,Ventura,111,848112,13400,12664,165,12829,137
2020-09-25,Yolo,113,214977,2838,2784,7,2791,55
2020-09-25,Yuba,115,75493,1089,1049,3,1052,5
2020-09-24,Alameda,001,1643700,21443,20838,172,21010,364
2020-09-24,Alpine,003,1148,3,2,0,2,0
2020-09-24,Amador,005,37829,295,288,0,288,16
2020-09-24,Butte,007,227075,2916,2803,52,2855,43
2020-09-24,Calaveras,009,45235,310,258,0,258,11
2020-09-24,Colusa,011,21464,532,523,0,523,6
2020-09-24,Contra Costa,013,1133247,17094,16252,80,16332,192
2020-09-24,Del Norte,015,27424,138,137,0,137,2
2020-09-24,El Dorado,017,186661,1199,1093,10,1103,4
2020-09-24,Fresno,019,978130,30630,28106,374,28480,375
2020-09-24,Glenn,021,27897,590,567,0,567,3
2020-09-24,Humboldt,023,135768,503,482,1,483,5
2020-09-24,Imperial,025,180216,11832,10622,9,10631,283
2020-09-24,Inyo,027,18085,189,187,4,191,13
2020-09-24,Kern,029,883053,31954,31273,326,31599,388
2020-09-24,Kings,031,150075,7822,7428,36,7464,76
2020-09-24,Lake,033,64148,576,531,0,531,9
2020-09-24,Lassen,035,31185,748,737,2,739,0
2020-09-24,Los Angeles,037,10098052,267733,264374,1828,266202,6452
2020-09-24,Madera,039,155013,4551,4344,30,4374,48
2020-09-24,Marin,041,260295,6720,6588,17,6605,85
2020-09-24,Mariposa,043,17540,76,74,0,74,2
2020-09-24,Mendocino,045,87422,880,810,3,813,17
2020-09-24,Merced,047,269075,8901,8813,19,8832,135
2020-09-24,Modoc,049,8938,29,24,0,24,0
2020-09-24,Mono,051,14174,169,149,3,152,1
2020-09-24,Monterey,053,433212,9894,9544,25,9569,67
2020-09-24,Napa,055,140530,1735,1661,8,1669,11
2020-09-24,Nevada,057,99092,539,527,16,543,6
2020-09-24,Orange,059,3164182,54951,51749,1447,53196,1164
2020-09-24,Placer,061,380077,3632,3514,13,3527,41
2020-09-24,Plumas,063,18699,49,48,0,48,0
2020-09-24,Riverside,065,2383286,59299,57491,166,57657,1172
2020-09-24,Sacramento,067,1510023,22570,21985,26,22011,417
2020-09-24,San Benito,069,59416,1341,1308,0,1308,11
2020-09-24,San Bernardino,071,2135413,54343,52455,349,52804,988
2020-09-24,San Diego,073,3302833,47607,45598,942,46540,773
2020-09-24,San Francisco,075,870044,11239,10992,27,11019,99
2020-09-24,San Joaquin,077,732212,20218,19851,55,19906,444
2020-09-24,San Luis Obispo,079,281455,3752,3480,17,3497,31
2020-09-24,San Mateo,081,765935,10131,9376,10,9386,127
2020-09-24,Santa Barbara,083,443738,9159,8988,75,9063,114
2020-09-24,Santa Clara,085,1922200,22078,20689,44,20733,262
2020-09-24,Santa Cruz,087,273765,2441,2300,28,2328,9
2020-09-24,Shasta,089,179085,1068,773,5,778,14
2020-09-24,Sierra,091,2930,6,6,0,6,0
2020-09-24,Siskiyou,093,43540,155,149,10,159,0
2020-09-24,Solano,095,438530,6329,6137,39,6176,49
2020-09-24,Sonoma,097,501317,7623,7163,21,7184,122
2020-09-24,Stanislaus,099,539301,16537,16326,513,16839,326
2020-09-24,Sutter,101,95872,1678,1646,1,1647,10
2020-09-24,Tehama,103,63373,580,540,2,542,2
2020-09-24,Trinity,105,12862,54,15,8,23,0
2020-09-24,Tulare,107,460477,16364,15754,124,15878,267
2020-09-24,Tuolumne,109,53932,233,224,6,230,2
2020-09-24,Ventura,111,848112,13318,12617,164,12781,138
2020-09-24,Yolo,113,214977,2831,2776,7,2783,55
2020-09-24,Yuba,115,75493,1084,1042,3,1045,5
2020-09-23,Alameda,001,1643700,21374,20718,170,20888,361
2020-09-23,Alpine,003,1148,3,2,0,2,0
2020-09-23,Amador,005,37829,294,288,0,288,16
2020-09-23,Butte,007,227075,2908,2790,52,2842,43
2020-09-23,Calaveras,009,45235,309,258,0,258,11
2020-09-23,Colusa,011,21464,531,521,0,521,6
2020-09-23,Contra Costa,013,1133247,17034,16167,80,16247,192
2020-09-23,Del Norte,015,27424,136,137,0,137,2
2020-09-23,El Dorado,017,186661,1185,1088,10,1098,4
2020-09-23,Fresno,019,978130,30536,28019,372,28391,371
2020-09-23,Glenn,021,27897,583,561,0,561,3
2020-09-23,Humboldt,023,135768,499,477,1,478,5
2020-09-23,Imperial,025,180216,11807,10587,9,10596,284
2020-09-23,Inyo,027,18085,188,177,4,181,13
2020-09-23,Kern,029,883053,31910,31172,324,31496,387
2020-09-23,Kings,031,150075,7800,7406,36,7442,76
2020-09-23,Lake,033,64148,571,519,0,519,9
2020-09-23,Lassen,035,31185,748,736,2,738,0
2020-09-23,Los Angeles,037,10098052,266714,263318,1801,265119,6421
2020-09-23,Madera,039,155013,4536,4311,30,4341,48
2020-09-23,Marin,041,260295,6701,6567,17,6584,85
2020-09-23,Mariposa,043,17540,76,74,0,74,2
2020-09-23,Mendocino,045,87422,879,801,2,803,17
2020-09-23,Merced,047,269075,8880,8785,17,8802,134
2020-09-23,Modoc,049,8938,29,24,0,24,0
2020-09-23,Mono,051,14174,169,149,3,152,1
2020-09-23,Monterey,053,433212,9825,9452,24,9476,67
2020-09-23,Napa,055,140530,1726,1653,8,1661,11
2020-09-23,Nevada,057,99092,538,523,16,539,6
2020-09-23,Orange,059,3164182,54724,51658,1439,53097,1155
2020-09-23,Placer,061,380077,3620,3506,13,3519,41
2020-09-23,Plumas,063,18699,49,48,0,48,0
2020-09-23,Riverside,065,2383286,58993,57257,163,57420,1165
2020-09-23,Sacramento,067,1510023,22494,21821,26,21847,415
2020-09-23,San Benito,069,59416,1335,1305,0,1305,10
2020-09-23,San Bernardino,071,2135413,54050,52132,347,52479,973
2020-09-23,San Diego,073,3302833,47331,45427,923,46350,767
2020-09-23,San Francisco,075,870044,11190,10926,27,10953,95
2020-09-23,San Joaquin,077,732212,20164,19785,55,19840,439
2020-09-23,San Luis Obispo,079,281455,3734,3447,17,3464,31
2020-09-23,San Mateo,081,765935,10091,9351,10,9361,127
2020-09-23,Santa Barbara,083,443738,9130,8952,75,9027,112
2020-09-23,Santa Clara,085,1922200,21968,20575,41,20616,260
2020-09-23,Santa Cruz,087,273765,2422,2283,28,2311,9
2020-09-23,Shasta,089,179085,1029,756,4,760,14
2020-09-23,Sierra,091,2930,6,6,0,6,0
2020-09-23,Siskiyou,093,43540,155,149,10,159,0
2020-09-23,Solano,095,438530,6303,6123,39,6162,50
2020-09-23,Sonoma,097,501317,7547,7091,21,7112,122
2020-09-23,Stanislaus,099,539301,16507,16271,510,16781,317
2020-09-23,Sutter,101,95872,1674,1646,1,1647,10
2020-09-23,Tehama,103,63373,574,533,2,535,2
2020-09-23,Trinity,105,12862,53,15,8,23,0
2020-09-23,Tulare,107,460477,16299,15664,123,15787,266
2020-09-23,Tuolumne,109,53932,233,223,6,229,2
2020-09-23,Ventura,111,848112,13262,12591,162,12753,137
2020-09-23,Yolo,113,214977,2813,2766,7,2773,55
2020-09-23,Yuba,115,75493,1082,1038,3,1041,5
2020-09-22,Alameda,001,1643700,21295,20607,168,20775,355
2020-09-22,Alpine,003,1148,2,2,0,2,0
2020-09-22,Amador,005,37829,293,287,0,287,16
2020-09-22,Butte,007,227075,2903,2776,52,2828,43
2020-09-22,Calaveras,009,45235,309,258,0,258,11
2020-09-22,Colusa,011,21464,529,518,0,518,6
2020-09-22,Contra Costa,013,1133247,16944,16090,80,16170,190
2020-09-22,Del Norte,015,27424,136,137,0,137,2
2020-09-22,El Dorado,017,186661,1166,1076,10,1086,4
2020-09-22,Fresno,019,978130,30441,27944,369,28313,369
2020-09-22,Glenn,021,27897,580,560,0,560,3
2020-09-22,Humboldt,023,135768,498,476,1,477,5
2020-09-22,Imperial,025,180216,11778,10529,9,10538,284
2020-09-22,Inyo,027,18085,188,177,4,181,13
2020-09-22,Kern,029,883053,31843,31110,317,31427,383
2020-09-22,Kings,031,150075,7743,7395,35,7430,76
2020-09-22,Lake,033,64148,565,516,0,516,9
2020-09-22,Lassen,035,31185,747,736,2,738,0
2020-09-22,Los Angeles,037,10098052,265648,262117,1775,263892,6394
2020-09-22,Madera,039,155013,4520,4303,30,4333,47
2020-09-22,Marin,041,260295,6688,6561,17,6578,84
2020-09-22,Mariposa,043,17540,76,74,0,74,2
2020-09-22,Mendocino,045,87422,859,794,1,795,18
2020-09-22,Merced,047,269075,8850,8769,17,8786,132
2020-09-22,Modoc,049,8938,29,24,0,24,0
2020-09-22,Mono,051,14174,168,149,3,152,1
2020-09-22,Monterey,053,433212,9767,9393,23,9416,67
2020-09-22,Napa,055,140530,1709,1652,8,1660,11
2020-09-22,Nevada,057,99092,538,523,16,539,6
2020-09-22,Orange,059,3164182,54474,51528,1430,52958,1132
2020-09-22,Placer,061,380077,3608,3492,13,3505,40
2020-09-22,Plumas,063,18699,49,48,0,48,0
2020-09-22,Riverside,065,2383286,58509,57066,159,57225,1162
2020-09-22,Sacramento,067,1510023,22375,21745,26,21771,410
2020-09-22,San Benito,069,59416,1330,1305,0,1305,10
2020-09-22,San Bernardino,071,2135413,53776,51899,347,52246,971
2020-09-22,San Diego,073,3302833,47024,45149,904,46053,765
2020-09-22,San Francisco,075,870044,11146,10893,26,10919,95
2020-09-22,San Joaquin,077,732212,20117,19755,54,19809,426
2020-09-22,San Luis Obispo,079,281455,3712,3420,17,3437,31
2020-09-22,San Mateo,081,765935,10053,9291,10,9301,127
2020-09-22,Santa Barbara,083,443738,9100,8927,74,9001,111
2020-09-22,Santa Clara,085,1922200,21849,20514,41,20555,253
2020-09-22,Santa Cruz,087,273765,2398,2264,28,2292,8
2020-09-22,Shasta,089,179085,994,723,4,727,14
2020-09-22,Sierra,091,2930,6,6,0,6,0
2020-09-22,Siskiyou,093,43540,155,149,10,159,0
2020-09-22,Solano,095,438530,6272,6107,39,6146,48
2020-09-22,Sonoma,097,501317,7468,7068,20,7088,117
2020-09-22,Stanislaus,099,539301,16484,16231,503,16734,316
2020-09-22,Sutter,101,95872,1668,1638,1,1639,10
2020-09-22,Tehama,103,63373,566,529,2,531,2
2020-09-22,Trinity,105,12862,53,15,8,23,0
2020-09-22,Tulare,107,460477,16232,15616,120,15736,263
2020-09-22,Tuolumne,109,53932,232,224,6,230,1
2020-09-22,Ventura,111,848112,13210,12507,158,12665,136
2020-09-22,Yolo,113,214977,2806,2763,7,2770,54
2020-09-22,Yuba,115,75493,1073,1035,3,1038,5
2020-09-21,Alameda,001,1643700,21216,20501,167,20668,343
2020-09-21,Alpine,003,1148,2,2,0,2,0
2020-09-21,Amador,005,37829,291,286,0,286,16
2020-09-21,Butte,007,227075,2889,2769,52,2821,41
2020-09-21,Calaveras,009,45235,307,256,0,256,10
2020-09-21,Colusa,011,21464,528,517,0,517,6
2020-09-21,Contra Costa,013,1133247,16863,16008,80,16088,189
2020-09-21,Del Norte,015,27424,136,132,0,132,2
2020-09-21,El Dorado,017,186661,1157,1074,10,1084,4
2020-09-21,Fresno,019,978130,30340,27843,362,28205,362
2020-09-21,Glenn,021,27897,576,556,0,556,3
2020-09-21,Humboldt,023,135768,494,473,1,474,5
2020-09-21,Imperial,025,180216,11747,10521,9,10530,284
2020-09-21,Inyo,027,18085,187,177,4,181,12
2020-09-21,Kern,029,883053,31772,31031,315,31346,379
2020-09-21,Kings,031,150075,7630,7297,34,7331,76
2020-09-21,Lake,033,64148,560,508,0,508,8
2020-09-21,Lassen,035,31185,745,735,2,737,0
2020-09-21,Los Angeles,037,10098052,264562,261418,1730,263148,6360
2020-09-21,Madera,039,155013,4509,4275,29,4304,47
2020-09-21,Marin,041,260295,6677,6538,16,6554,84
2020-09-21,Mariposa,043,17540,75,74,0,74,2
2020-09-21,Mendocino,045,87422,844,778,0,778,18
2020-09-21,Merced,047,269075,8831,8749,15,8764,128
2020-09-21,Modoc,049,8938,29,22,0,22,0
2020-09-21,Mono,051,14174,168,147,3,150,1
2020-09-21,Monterey,053,433212,9703,9331,20,9351,66
2020-09-21,Napa,055,140530,1698,1641,8,1649,11
2020-09-21,Nevada,057,99092,536,515,16,531,6
2020-09-21,Orange,059,3164182,54252,51363,1423,52786,1110
2020-09-21,Placer,061,380077,3598,3473,13,3486,40
2020-09-21,Plumas,063,18699,49,47,0,47,0
2020-09-21,Riverside,065,2383286,58237,57001,152,57153,1153
2020-09-21,Sacramento,067,1510023,22193,21568,26,21594,404
2020-09-21,San Benito,069,59416,1328,1298,0,1298,10
2020-09-21,San Bernardino,071,2135413,53489,51654,347,52001,970
2020-09-21,San Diego,073,3302833,46740,44927,883,45810,760
2020-09-21,San Francisco,075,870044,11098,10743,26,10769,95
2020-09-21,San Joaquin,077,732212,20060,19579,54,19633,423
2020-09-21,San Luis Obispo,079,281455,3686,3406,17,3423,27
2020-09-21,San Mateo,081,765935,10001,9239,10,9249,127
2020-09-21,Santa Barbara,083,443738,9072,8911,74,8985,110
2020-09-21,Santa Clara,085,1922200,21749,20432,41,20473,252
2020-09-21,Santa Cruz,087,273765,2382,2257,26,2283,8
2020-09-21,Shasta,089,179085,944,696,4,700,14
2020-09-21,Sierra,091,2930,6,6,0,6,0
2020-09-21,Siskiyou,093,43540,155,146,10,156,0
2020-09-21,Solano,095,438530,6248,6019,39,6058,46
2020-09-21,Sonoma,097,501317,7392,7017,20,7037,117
2020-09-21,Stanislaus,099,539301,16454,16186,503,16689,310
2020-09-21,Sutter,101,95872,1661,1634,1,1635,10
2020-09-21,Tehama,103,63373,547,513,2,515,2
2020-09-21,Trinity,105,12862,53,15,8,23,0
2020-09-21,Tulare,107,460477,16158,15528,111,15639,260
2020-09-21,Tuolumne,109,53932,232,221,6,227,1
2020-09-21,Ventura,111,848112,13126,12477,152,12629,133
2020-09-21,Yolo,113,214977,2800,2752,7,2759,54
2020-09-21,Yuba,115,75493,1069,1033,3,1036,1
2020-09-20,Alameda,001,1643700,21115,20425,164,20589,343
2020-09-20,Alpine,003,1148,2,2,0,2,0
2020-09-20,Amador,005,37829,290,286,0,286,16
2020-09-20,Butte,007,227075,2877,2764,52,2816,39
2020-09-20,Calaveras,009,45235,303,256,0,256,10
2020-09-20,Colusa,011,21464,526,510,0,510,6
2020-09-20,Contra Costa,013,1133247,16746,15917,79,15996,189
2020-09-20,Del Norte,015,27424,134,132,0,132,2
2020-09-20,El Dorado,017,186661,1142,1073,10,1083,4
2020-09-20,Fresno,019,978130,30226,27769,357,28126,362
2020-09-20,Glenn,021,27897,572,550,0,550,3
2020-09-20,Humboldt,023,135768,494,472,1,473,5
2020-09-20,Imperial,025,180216,11720,10496,8,10504,284
2020-09-20,Inyo,027,18085,187,177,4,181,12
2020-09-20,Kern,029,883053,31688,30992,311,31303,379
2020-09-20,Kings,031,150075,7583,7159,33,7192,76
2020-09-20,Lake,033,64148,548,492,0,492,8
2020-09-20,Lassen,035,31185,745,735,2,737,0
2020-09-20,Los Angeles,037,10098052,263334,260770,1705,262475,6347
2020-09-20,Madera,039,155013,4489,4257,29,4286,47
2020-09-20,Marin,041,260295,6652,6533,16,6549,83
2020-09-20,Mariposa,043,17540,75,74,0,74,2
2020-09-20,Mendocino,045,87422,832,765,0,765,18
2020-09-20,Merced,047,269075,8804,8745,15,8760,128
2020-09-20,Modoc,049,8938,27,22,0,22,0
2020-09-20,Mono,051,14174,167,147,3,150,1
2020-09-20,Monterey,053,433212,9624,9312,20,9332,65
2020-09-20,Napa,055,140530,1689,1626,8,1634,11
2020-09-20,Nevada,057,99092,533,511,16,527,6
2020-09-20,Orange,059,3164182,54011,51233,1413,52646,1110
2020-09-20,Placer,061,380077,3584,3452,13,3465,40
2020-09-20,Plumas,063,18699,49,47,0,47,0
2020-09-20,Riverside,065,2383286,58036,56783,146,56929,1147
2020-09-20,Sacramento,067,1510023,22006,21394,25,21419,401
2020-09-20,San Benito,069,59416,1317,1291,0,1291,9
2020-09-20,San Bernardino,071,2135413,53172,51559,345,51904,970
2020-09-20,San Diego,073,3302833,46367,44579,854,45433,760
2020-09-20,San Francisco,075,870044,11044,10743,26,10769,95
2020-09-20,San Joaquin,077,732212,19996,19578,47,19625,423
2020-09-20,San Luis Obispo,079,281455,3659,3393,17,3410,27
2020-09-20,San Mateo,081,765935,9935,9198,10,9208,127
2020-09-20,Santa Barbara,083,443738,9036,8880,73,8953,110
2020-09-20,Santa Clara,085,1922200,21630,20330,40,20370,252
2020-09-20,Santa Cruz,087,273765,2362,2199,26,2225,8
2020-09-20,Shasta,089,179085,903,696,3,699,14
2020-09-20,Sierra,091,2930,6,6,0,6,0
2020-09-20,Siskiyou,093,43540,155,146,10,156,0
2020-09-20,Solano,095,438530,6204,6020,39,6059,46
2020-09-20,Sonoma,097,501317,7288,6954,20,6974,117
2020-09-20,Stanislaus,099,539301,16422,16159,496,16655,310
2020-09-20,Sutter,101,95872,1655,1624,1,1625,10
2020-09-20,Tehama,103,63373,534,509,2,511,2
2020-09-20,Trinity,105,12862,53,15,8,23,0
2020-09-20,Tulare,107,460477,16072,15528,104,15632,260
2020-09-20,Tuolumne,109,53932,232,221,6,227,1
2020-09-20,Ventura,111,848112,13060,12406,148,12554,133
2020-09-20,Yolo,113,214977,2792,2745,7,2752,54
2020-09-20,Yuba,115,75493,1062,1029,3,1032,1
2020-09-19,Alameda,001,1643700,21065,20349,161,20510,343
2020-09-19,Alpine,003,1148,2,2,0,2,0
2020-09-19,Amador,005,37829,290,285,0,285,16
2020-09-19,Butte,007,227075,2871,2748,52,2800,38
2020-09-19,Calaveras,009,45235,303,256,0,256,10
2020-09-19,Colusa,011,21464,526,507,0,507,6
2020-09-19,Contra Costa,013,1133247,16684,15783,79,15862,186
2020-09-19,Del Norte,015,27424,133,132,0,132,2
2020-09-19,El Dorado,017,186661,1136,1068,9,1077,4
2020-09-19,Fresno,019,978130,30153,27668,357,28025,362
2020-09-19,Glenn,021,27897,569,547,0,547,3
2020-09-19,Humboldt,023,135768,493,471,1,472,5
2020-09-19,Imperial,025,180216,11705,10496,8,10504,284
2020-09-19,Inyo,027,18085,187,177,4,181,12
2020-09-19,Kern,029,883053,31636,30886,308,31194,379
2020-09-19,Kings,031,150075,7577,7130,33,7163,76
2020-09-19,Lake,033,64148,548,465,0,465,8
2020-09-19,Lassen,035,31185,745,731,2,733,0
2020-09-19,Los Angeles,037,10098052,262710,259801,1691,261492,6325
2020-09-19,Madera,039,155013,4466,4237,29,4266,47
2020-09-19,Marin,041,260295,6645,6513,15,6528,81
2020-09-19,Mariposa,043,17540,75,74,0,74,2
2020-09-19,Mendocino,045,87422,829,750,0,750,18
2020-09-19,Merced,047,269075,8793,8717,14,8731,128
2020-09-19,Modoc,049,8938,27,22,0,22,0
2020-09-19,Mono,051,14174,167,147,3,150,1
2020-09-19,Monterey,053,433212,9582,9237,20,9257,65
2020-09-19,Napa,055,140530,1681,1614,8,1622,11
2020-09-19,Nevada,057,99092,531,505,16,521,6
2020-09-19,Orange,059,3164182,53883,50999,1406,52405,1105
2020-09-19,Placer,061,380077,3575,3412,13,3425,40
2020-09-19,Plumas,063,18699,49,47,0,47,0
2020-09-19,Riverside,065,2383286,57909,56562,145,56707,1147
2020-09-19,Sacramento,067,1510023,21952,21297,25,21322,396
2020-09-19,San Benito,069,59416,1313,1276,0,1276,9
2020-09-19,San Bernardino,071,2135413,53014,51353,342,51695,971
2020-09-19,San Diego,073,3302833,46139,44295,831,45126,773
2020-09-19,San Francisco,075,870044,11011,10741,26,10767,95
2020-09-19,San Joaquin,077,732212,19960,19580,47,19627,424
2020-09-19,San Luis Obispo,079,281455,3638,3369,17,3386,27
2020-09-19,San Mateo,081,765935,9904,9158,10,9168,127
2020-09-19,Santa Barbara,083,443738,9016,8862,73,8935,106
2020-09-19,Santa Clara,085,1922200,21541,20170,40,20210,251
2020-09-19,Santa Cruz,087,273765,2348,2198,25,2223,8
2020-09-19,Shasta,089,179085,876,687,3,690,14
2020-09-19,Sierra,091,2930,6,6,0,6,0
2020-09-19,Siskiyou,093,43540,155,146,10,156,0
2020-09-19,Solano,095,438530,6188,5998,39,6037,46
2020-09-19,Sonoma,097,501317,7255,6905,20,6925,117
2020-09-19,Stanislaus,099,539301,16381,16109,489,16598,313
2020-09-19,Sutter,101,95872,1654,1602,1,1603,10
2020-09-19,Tehama,103,63373,529,498,2,500,2
2020-09-19,Trinity,105,12862,53,15,8,23,0
2020-09-19,Tulare,107,460477,16024,15485,101,15586,260
2020-09-19,Tuolumne,109,53932,232,217,6,223,1
2020-09-19,Ventura,111,848112,13028,12328,148,12476,133
2020-09-19,Yolo,113,214977,2784,2739,7,2746,54
2020-09-19,Yuba,115,75493,1055,1023,3,1026,1
2020-09-18,Alameda,001,1643700,20999,20222,155,20377,341
2020-09-18,Alpine,003,1148,2,2,0,2,0
2020-09-18,Amador,005,37829,290,285,0,285,16
2020-09-18,Butte,007,227075,2869,2738,52,2790,37
2020-09-18,Calaveras,009,45235,303,255,0,255,9
2020-09-18,Colusa,011,21464,526,504,0,504,6
2020-09-18,Contra Costa,013,1133247,16595,15667,79,15746,185
2020-09-18,Del Norte,015,27424,133,131,0,131,2
2020-09-18,El Dorado,017,186661,1123,1063,9,1072,4
2020-09-18,Fresno,019,978130,30088,27560,357,27917,359
2020-09-18,Glenn,021,27897,566,541,0,541,3
2020-09-18,Humboldt,023,135768,490,470,1,471,5
2020-09-18,Imperial,025,180216,11690,10460,8,10468,283
2020-09-18,Inyo,027,18085,187,177,4,181,12
2020-09-18,Kern,029,883053,31576,30742,305,31047,373
2020-09-18,Kings,031,150075,7567,7062,33,7095,74
2020-09-18,Lake,033,64148,542,458,0,458,8
2020-09-18,Lassen,035,31185,744,731,2,733,0
2020-09-18,Los Angeles,037,10098052,261948,258488,1673,260161,6324
2020-09-18,Madera,039,155013,4455,4211,29,4240,45
2020-09-18,Marin,041,260295,6629,6475,15,6490,81
2020-09-18,Mariposa,043,17540,75,74,0,74,2
2020-09-18,Mendocino,045,87422,821,739,0,739,18
2020-09-18,Merced,047,269075,8781,8691,13,8704,127
2020-09-18,Modoc,049,8938,27,22,0,22,0
2020-09-18,Mono,051,14174,165,147,3,150,1
2020-09-18,Monterey,053,433212,9541,9183,20,9203,64
2020-09-18,Napa,055,140530,1675,1604,8,1612,11
2020-09-18,Nevada,057,99092,528,504,16,520,6
2020-09-18,Orange,059,3164182,53737,50733,1394,52127,1107
2020-09-18,Placer,061,380077,3564,3389,13,3402,40
2020-09-18,Plumas,063,18699,49,45,0,45,0
2020-09-18,Riverside,065,2383286,57786,56248,140,56388,1143
2020-09-18,Sacramento,067,1510023,21868,21105,25,21130,391
2020-09-18,San Benito,069,59416,1305,1257,0,1257,8
2020-09-18,San Bernardino,071,2135413,52869,51106,339,51445,970
2020-09-18,San Diego,073,3302833,45889,44009,826,44835,757
2020-09-18,San Francisco,075,870044,10973,10644,25,10669,95
2020-09-18,San Joaquin,077,732212,19917,19531,46,19577,423
2020-09-18,San Luis Obispo,079,281455,3614,3328,17,3345,27
2020-09-18,San Mateo,081,765935,9864,9062,10,9072,127
2020-09-18,Santa Barbara,083,443738,8995,8824,73,8897,107
2020-09-18,Santa Clara,085,1922200,21444,20058,40,20098,252
2020-09-18,Santa Cruz,087,273765,2328,2180,24,2204,8
2020-09-18,Shasta,089,179085,841,668,3,671,14
2020-09-18,Sierra,091,2930,6,6,0,6,0
2020-09-18,Siskiyou,093,43540,154,146,10,156,0
2020-09-18,Solano,095,438530,6172,5961,39,6000,46
2020-09-18,Sonoma,097,501317,7207,6856,20,6876,114
2020-09-18,Stanislaus,099,539301,16351,16042,483,16525,277
2020-09-18,Sutter,101,95872,1647,1586,1,1587,10
2020-09-18,Tehama,103,63373,529,490,2,492,2
2020-09-18,Trinity,105,12862,53,15,7,22,0
2020-09-18,Tulare,107,460477,15991,15435,97,15532,259
2020-09-18,Tuolumne,109,53932,231,216,6,222,1
2020-09-18,Ventura,111,848112,12967,12236,144,12380,133
2020-09-18,Yolo,113,214977,2778,2732,7,2739,54
2020-09-18,Yuba,115,75493,1051,1020,3,1023,1
2020-09-17,Alameda,001,1643700,20900,20146,155,20301,339
2020-09-17,Alpine,003,1148,2,2,0,2,0
2020-09-17,Amador,005,37829,288,284,0,284,16
2020-09-17,Butte,007,227075,2852,2720,52,2772,38
2020-09-17,Calaveras,009,45235,303,254,0,254,9
2020-09-17,Colusa,011,21464,524,499,0,499,6
2020-09-17,Contra Costa,013,1133247,16509,15576,79,15655,184
2020-09-17,Del Norte,015,27424,133,131,0,131,2
2020-09-17,El Dorado,017,186661,1114,1057,9,1066,4
2020-09-17,Fresno,019,978130,29978,27487,352,27839,355
2020-09-17,Glenn,021,27897,565,541,0,541,3
2020-09-17,Humboldt,023,135768,484,466,1,467,5
2020-09-17,Imperial,025,180216,11673,10436,8,10444,281
2020-09-17,Inyo,027,18085,187,176,4,180,12
2020-09-17,Kern,029,883053,31516,30627,298,30925,372
2020-09-17,Kings,031,150075,7496,7015,33,7048,72
2020-09-17,Lake,033,64148,532,433,0,433,8
2020-09-17,Lassen,035,31185,742,731,2,733,0
2020-09-17,Los Angeles,037,10098052,261005,257246,1659,258905,6318
2020-09-17,Madera,039,155013,4421,4152,29,4181,45
2020-09-17,Marin,041,260295,6608,6457,15,6472,81
2020-09-17,Mariposa,043,17540,75,74,0,74,2
2020-09-17,Mendocino,045,87422,810,737,0,737,18
2020-09-17,Merced,047,269075,8762,8671,13,8684,119
2020-09-17,Modoc,049,8938,27,22,0,22,0
2020-09-17,Mono,051,14174,165,147,3,150,1
2020-09-17,Monterey,053,433212,9479,9113,20,9133,62
2020-09-17,Napa,055,140530,1664,1592,8,1600,11
2020-09-17,Nevada,057,99092,526,494,16,510,6
2020-09-17,Orange,059,3164182,53557,50537,1382,51919,1098
2020-09-17,Placer,061,380077,3544,3368,13,3381,40
2020-09-17,Plumas,063,18699,49,45,0,45,0
2020-09-17,Riverside,065,2383286,57561,56007,139,56146,1134
2020-09-17,Sacramento,067,1510023,21633,20895,25,20920,385
2020-09-17,San Benito,069,59416,1303,1252,0,1252,8
2020-09-17,San Bernardino,071,2135413,52665,50770,339,51109,904
2020-09-17,San Diego,073,3302833,45609,43621,814,44435,754
2020-09-17,San Francisco,075,870044,10879,10564,25,10589,95
2020-09-17,San Joaquin,077,732212,19858,19439,46,19485,416
2020-09-17,San Luis Obispo,079,281455,3584,3299,17,3316,27
2020-09-17,San Mateo,081,765935,9822,8984,10,8994,127
2020-09-17,Santa Barbara,083,443738,8971,8779,73,8852,107
2020-09-17,Santa Clara,085,1922200,21327,19825,40,19865,254
2020-09-17,Santa Cruz,087,273765,2312,2155,24,2179,7
2020-09-17,Shasta,089,179085,802,660,3,663,12
2020-09-17,Sierra,091,2930,6,6,0,6,0
2020-09-17,Siskiyou,093,43540,154,146,10,156,0
2020-09-17,Solano,095,438530,6149,5915,39,5954,44
2020-09-17,Sonoma,097,501317,7143,6754,20,6774,114
2020-09-17,Stanislaus,099,539301,16318,15984,479,16463,277
2020-09-17,Sutter,101,95872,1642,1572,1,1573,10
2020-09-17,Tehama,103,63373,516,487,2,489,2
2020-09-17,Trinity,105,12862,53,15,7,22,0
2020-09-17,Tulare,107,460477,15939,15344,95,15439,258
2020-09-17,Tuolumne,109,53932,230,214,6,220,1
2020-09-17,Ventura,111,848112,12880,12167,141,12308,130
2020-09-17,Yolo,113,214977,2769,2724,7,2731,53
2020-09-17,Yuba,115,75493,1047,1015,3,1018,1
2020-09-16,Alameda,001,1643700,20802,20009,153,20162,333
2020-09-16,Alpine,003,1148,2,2,0,2,0
2020-09-16,Amador,005,37829,288,284,0,284,16
2020-09-16,Butte,007,227075,2842,2704,51,2755,38
2020-09-16,Calaveras,009,45235,303,254,0,254,9
2020-09-16,Colusa,011,21464,522,497,0,497,6
2020-09-16,Contra Costa,013,1133247,16422,15473,79,15552,183
2020-09-16,Del Norte,015,27424,133,131,0,131,2
2020-09-16,El Dorado,017,186661,1106,1049,8,1057,4
2020-09-16,Fresno,019,978130,29871,27381,350,27731,343
2020-09-16,Glenn,021,27897,563,539,0,539,3
2020-09-16,Humboldt,023,135768,483,455,1,456,4
2020-09-16,Imperial,025,180216,11650,10401,8,10409,277
2020-09-16,Inyo,027,18085,186,176,4,180,12
2020-09-16,Kern,029,883053,31457,30570,297,30867,371
2020-09-16,Kings,031,150075,7471,7002,31,7033,71
2020-09-16,Lake,033,64148,521,417,0,417,6
2020-09-16,Lassen,035,31185,741,730,2,732,0
2020-09-16,Los Angeles,037,10098052,260024,256101,1642,257743,6299
2020-09-16,Madera,039,155013,4398,4138,29,4167,45
2020-09-16,Marin,041,260295,6580,6430,15,6445,77
2020-09-16,Mariposa,043,17540,75,74,0,74,2
2020-09-16,Mendocino,045,87422,801,727,0,727,18
2020-09-16,Merced,047,269075,8741,8646,13,8659,118
2020-09-16,Modoc,049,8938,27,22,0,22,0
2020-09-16,Mono,051,14174,165,147,3,150,1
2020-09-16,Monterey,053,433212,9425,8997,20,9017,62
2020-09-16,Napa,055,140530,1650,1587,8,1595,11
2020-09-16,Nevada,057,99092,521,495,15,510,6
2020-09-16,Orange,059,3164182,53356,50414,1373,51787,1096
2020-09-16,Placer,061,380077,3526,3351,13,3364,39
2020-09-16,Plumas,063,18699,49,45,0,45,0
2020-09-16,Riverside,065,2383286,57367,55811,131,55942,1127
2020-09-16,Sacramento,067,1510023,21540,20610,25,20635,377
2020-09-16,San Benito,069,59416,1295,1244,0,1244,8
2020-09-16,San Bernardino,071,2135413,52440,50509,338,50847,907
2020-09-16,San Diego,073,3302833,45317,43447,793,44240,748
2020-09-16,San Francisco,075,870044,10832,10502,25,10527,90
2020-09-16,San Joaquin,077,732212,19803,19377,45,19422,409
2020-09-16,San Luis Obispo,079,281455,3553,3285,17,3302,28
2020-09-16,San Mateo,081,765935,9757,8944,10,8954,127
2020-09-16,Santa Barbara,083,443738,8938,8764,73,8837,107
2020-09-16,Santa Clara,085,1922200,21208,19684,40,19724,253
2020-09-16,Santa Cruz,087,273765,2271,2089,23,2112,7
2020-09-16,Shasta,089,179085,776,635,3,638,11
2020-09-16,Sierra,091,2930,6,6,0,6,0
2020-09-16,Siskiyou,093,43540,153,145,10,155,0
2020-09-16,Solano,095,438530,6120,5899,39,5938,44
2020-09-16,Sonoma,097,501317,7081,6731,20,6751,104
2020-09-16,Stanislaus,099,539301,16270,15897,471,16368,263
2020-09-16,Sutter,101,95872,1629,1567,1,1568,10
2020-09-16,Tehama,103,63373,508,485,2,487,2
2020-09-16,Trinity,105,12862,53,15,7,22,0
2020-09-16,Tulare,107,460477,15895,15314,88,15402,258
2020-09-16,Tuolumne,109,53932,229,210,6,216,1
2020-09-16,Ventura,111,848112,12809,12073,139,12212,130
2020-09-16,Yolo,113,214977,2762,2709,7,2716,53
2020-09-16,Yuba,115,75493,1045,1000,3,1003,1
2020-09-15,Alameda,001,1643700,20696,19931,150,20081,327
2020-09-15,Alpine,003,1148,2,2,0,2,0
2020-09-15,Amador,005,37829,287,282,0,282,16
2020-09-15,Butte,007,227075,2829,2695,49,2744,38
2020-09-15,Calaveras,009,45235,303,248,0,248,5
2020-09-15,Colusa,011,21464,516,497,0,497,6
2020-09-15,Contra Costa,013,1133247,16316,15423,77,15500,180
2020-09-15,Del Norte,015,27424,133,129,0,129,2
2020-09-15,El Dorado,017,186661,1101,1046,8,1054,4
2020-09-15,Fresno,019,978130,29763,27312,345,27657,343
2020-09-15,Glenn,021,27897,562,531,0,531,3
2020-09-15,Humboldt,023,135768,481,456,1,457,4
2020-09-15,Imperial,025,180216,11625,10376,8,10384,277
2020-09-15,Inyo,027,18085,186,176,4,180,12
2020-09-15,Kern,029,883053,31344,30429,294,30723,368
2020-09-15,Kings,031,150075,7313,6977,31,7008,70
2020-09-15,Lake,033,64148,508,416,0,416,4
2020-09-15,Lassen,035,31185,737,719,2,721,0
2020-09-15,Los Angeles,037,10098052,258915,255048,1620,256668,6269
2020-09-15,Madera,039,155013,4379,4122,29,4151,45
2020-09-15,Marin,041,260295,6549,6423,15,6438,77
2020-09-15,Mariposa,043,17540,75,74,0,74,2
2020-09-15,Mendocino,045,87422,783,724,0,724,18
2020-09-15,Merced,047,269075,8711,8633,13,8646,114
2020-09-15,Modoc,049,8938,26,21,0,21,0
2020-09-15,Mono,051,14174,165,147,3,150,1
2020-09-15,Monterey,053,433212,9376,8943,20,8963,62
2020-09-15,Napa,055,140530,1636,1580,8,1588,11
2020-09-15,Nevada,057,99092,516,494,15,509,6
2020-09-15,Orange,059,3164182,53174,50294,1359,51653,1088
2020-09-15,Placer,061,380077,3502,3331,13,3344,38
2020-09-15,Plumas,063,18699,49,44,0,44,0
2020-09-15,Riverside,065,2383286,57073,55569,121,55690,1118
2020-09-15,Sacramento,067,1510023,21396,20487,25,20512,372
2020-09-15,San Benito,069,59416,1288,1237,0,1237,7
2020-09-15,San Bernardino,071,2135413,52225,50333,337,50670,904
2020-09-15,San Diego,073,3302833,44998,43183,773,43956,742
2020-09-15,San Francisco,075,870044,10774,10414,25,10439,90
2020-09-15,San Joaquin,077,732212,19751,19313,45,19358,401
2020-09-15,San Luis Obispo,079,281455,3533,3262,17,3279,28
2020-09-15,San Mateo,081,765935,9688,8895,10,8905,127
2020-09-15,Santa Barbara,083,443738,8913,8724,72,8796,104
2020-09-15,Santa Clara,085,1922200,21075,19610,40,19650,252
2020-09-15,Santa Cruz,087,273765,2245,2079,22,2101,7
2020-09-15,Shasta,089,179085,764,627,3,630,11
2020-09-15,Sierra,091,2930,6,6,0,6,0
2020-09-15,Siskiyou,093,43540,153,143,10,153,0
2020-09-15,Solano,095,438530,6086,5878,39,5917,45
2020-09-15,Sonoma,097,501317,7042,6701,20,6721,104
2020-09-15,Stanislaus,099,539301,16222,15880,469,16349,260
2020-09-15,Sutter,101,95872,1618,1556,1,1557,10
2020-09-15,Tehama,103,63373,496,484,2,486,2
2020-09-15,Trinity,105,12862,53,15,7,22,0
2020-09-15,Tulare,107,460477,15818,15203,86,15289,254
2020-09-15,Tuolumne,109,53932,229,209,6,215,1
2020-09-15,Ventura,111,848112,12756,11932,138,12070,128
2020-09-15,Yolo,113,214977,2758,2708,7,2715,53
2020-09-15,Yuba,115,75493,1039,991,3,994,1
2020-09-14,Alameda,001,1643700,20569,19851,149,20000,306
2020-09-14,Alpine,003,1148,2,2,0,2,0
2020-09-14,Amador,005,37829,285,281,0,281,16
2020-09-14,Butte,007,227075,2811,2642,49,2691,37
2020-09-14,Calaveras,009,45235,303,244,0,244,3
2020-09-14,Colusa,011,21464,515,486,0,486,6
2020-09-14,Contra Costa,013,1133247,16192,15354,76,15430,174
2020-09-14,Del Norte,015,27424,130,116,0,116,2
2020-09-14,El Dorado,017,186661,1097,1039,8,1047,3
2020-09-14,Fresno,019,978130,29679,27232,342,27574,344
2020-09-14,Glenn,021,27897,554,521,0,521,3
2020-09-14,Humboldt,023,135768,478,437,1,438,4
2020-09-14,Imperial,025,180216,11605,10340,8,10348,273
2020-09-14,Inyo,027,18085,186,176,4,180,12
2020-09-14,Kern,029,883053,31256,30344,293,30637,368
2020-09-14,Kings,031,150075,7232,6950,31,6981,70
2020-09-14,Lake,033,64148,487,407,0,407,4
2020-09-14,Lassen,035,31185,737,719,2,721,0
2020-09-14,Los Angeles,037,10098052,257886,254622,1595,256217,6226
2020-09-14,Madera,039,155013,4364,4104,29,4133,45
2020-09-14,Marin,041,260295,6529,6409,15,6424,70
2020-09-14,Mariposa,043,17540,75,74,0,74,2
2020-09-14,Mendocino,045,87422,766,710,0,710,17
2020-09-14,Merced,047,269075,8692,8593,13,8606,112
2020-09-14,Modoc,049,8938,26,21,0,21,0
2020-09-14,Mono,051,14174,165,147,3,150,1
2020-09-14,Monterey,053,433212,9305,8845,19,8864,61
2020-09-14,Napa,055,140530,1619,1576,8,1584,11
2020-09-14,Nevada,057,99092,511,489,15,504,6
2020-09-14,Orange,059,3164182,53013,50149,1343,51492,1079
2020-09-14,Placer,061,380077,3480,3302,13,3315,38
2020-09-14,Plumas,063,18699,48,42,0,42,0
2020-09-14,Riverside,065,2383286,56854,55488,117,55605,1113
2020-09-14,Sacramento,067,1510023,21201,20377,24,20401,367
2020-09-14,San Benito,069,59416,1273,1233,0,1233,7
2020-09-14,San Bernardino,071,2135413,52001,50163,336,50499,895
2020-09-14,San Diego,073,3302833,44687,42889,753,43642,734
2020-09-14,San Francisco,075,870044,10707,10255,23,10278,90
2020-09-14,San Joaquin,077,732212,19677,19111,44,19155,397
2020-09-14,San Luis Obispo,079,281455,3508,3248,17,3265,25
2020-09-14,San Mateo,081,765935,9627,8847,10,8857,127
2020-09-14,Santa Barbara,083,443738,8887,8692,72,8764,104
2020-09-14,Santa Clara,085,1922200,20887,19545,40,19585,247
2020-09-14,Santa Cruz,087,273765,2223,2016,21,2037,7
2020-09-14,Shasta,089,179085,741,584,3,587,10
2020-09-14,Sierra,091,2930,6,6,0,6,0
2020-09-14,Siskiyou,093,43540,152,143,10,153,0
2020-09-14,Solano,095,438530,6051,5834,39,5873,44
2020-09-14,Sonoma,097,501317,6980,6630,20,6650,102
2020-09-14,Stanislaus,099,539301,16177,15812,466,16278,253
2020-09-14,Sutter,101,95872,1607,1549,1,1550,10
2020-09-14,Tehama,103,63373,494,475,2,477,1
2020-09-14,Trinity,105,12862,52,14,7,21,0
2020-09-14,Tulare,107,460477,15749,15096,81,15177,254
2020-09-14,Tuolumne,109,53932,228,208,6,214,1
2020-09-14,Ventura,111,848112,12654,11903,135,12038,125
2020-09-14,Yolo,113,214977,2747,2687,7,2694,53
2020-09-14,Yuba,115,75493,1031,977,3,980,1
2020-09-13,Alameda,001,1643700,20463,19815,146,19961,306
2020-09-13,Alpine,003,1148,2,2,0,2,0
2020-09-13,Amador,005,37829,282,279,0,279,16
2020-09-13,Butte,007,227075,2789,2640,49,2689,37
2020-09-13,Calaveras,009,45235,302,246,0,246,3
2020-09-13,Colusa,011,21464,511,486,0,486,6
2020-09-13,Contra Costa,013,1133247,16085,15284,76,15360,172
2020-09-13,Del Norte,015,27424,127,116,0,116,1
2020-09-13,El Dorado,017,186661,1092,1035,8,1043,2
2020-09-13,Fresno,019,978130,29570,27196,333,27529,345
2020-09-13,Glenn,021,27897,550,517,0,517,3
2020-09-13,Humboldt,023,135768,478,434,1,435,4
2020-09-13,Imperial,025,180216,11568,10304,7,10311,273
2020-09-13,Inyo,027,18085,186,176,4,180,12
2020-09-13,Kern,029,883053,31160,30277,287,30564,368
2020-09-13,Kings,031,150075,7213,6937,31,6968,70
2020-09-13,Lake,033,64148,469,397,0,397,4
2020-09-13,Lassen,035,31185,734,719,2,721,0
2020-09-13,Los Angeles,037,10098052,256733,253950,1580,255530,6203
2020-09-13,Madera,039,155013,4307,4090,29,4119,45
2020-09-13,Marin,041,260295,6510,6395,15,6410,70
2020-09-13,Mariposa,043,17540,75,74,0,74,2
2020-09-13,Mendocino,045,87422,759,707,0,707,17
2020-09-13,Merced,047,269075,8658,8575,13,8588,112
2020-09-13,Modoc,049,8938,26,21,0,21,0
2020-09-13,Mono,051,14174,165,147,3,150,1
2020-09-13,Monterey,053,433212,9223,8826,18,8844,61
2020-09-13,Napa,055,140530,1612,1563,8,1571,11
2020-09-13,Nevada,057,99092,503,486,15,501,6
2020-09-13,Orange,059,3164182,52797,50061,1336,51397,1075
2020-09-13,Placer,061,380077,3451,3291,13,3304,38
2020-09-13,Plumas,063,18699,48,42,0,42,0
2020-09-13,Riverside,065,2383286,56647,55235,106,55341,1108
2020-09-13,Sacramento,067,1510023,20856,20279,24,20303,367
2020-09-13,San Benito,069,59416,1265,1217,0,1217,7
2020-09-13,San Bernardino,071,2135413,51714,49968,334,50302,895
2020-09-13,San Diego,073,3302833,44361,42681,719,43400,734
2020-09-13,San Francisco,075,870044,10629,10254,23,10277,90
2020-09-13,San Joaquin,077,732212,19606,19110,43,19153,396
2020-09-13,San Luis Obispo,079,281455,3471,3240,17,3257,24
2020-09-13,San Mateo,081,765935,9566,8811,10,8821,127
2020-09-13,Santa Barbara,083,443738,8850,8690,72,8762,104
2020-09-13,Santa Clara,085,1922200,20749,19456,39,19495,245
2020-09-13,Santa Cruz,087,273765,2189,2016,19,2035,7
2020-09-13,Shasta,089,179085,729,583,3,586,10
2020-09-13,Sierra,091,2930,6,6,0,6,0
2020-09-13,Siskiyou,093,43540,152,143,9,152,0
2020-09-13,Solano,095,438530,6005,5810,39,5849,43
2020-09-13,Sonoma,097,501317,6915,6592,20,6612,95
2020-09-13,Stanislaus,099,539301,16114,15759,454,16213,253
2020-09-13,Sutter,101,95872,1595,1539,1,1540,10
2020-09-13,Tehama,103,63373,490,476,2,478,1
2020-09-13,Trinity,105,12862,52,14,7,21,0
2020-09-13,Tulare,107,460477,15678,15098,80,15178,254
2020-09-13,Tuolumne,109,53932,224,208,6,214,1
2020-09-13,Ventura,111,848112,12546,11855,134,11989,123
2020-09-13,Yolo,113,214977,2735,2675,7,2682,53
2020-09-13,Yuba,115,75493,1026,967,3,970,1
2020-09-12,Alameda,001,1643700,20404,19758,146,19904,307
2020-09-12,Alpine,003,1148,2,2,0,2,0
2020-09-12,Amador,005,37829,281,278,0,278,16
2020-09-12,Butte,007,227075,2782,2629,48,2677,37
2020-09-12,Calaveras,009,45235,300,246,0,246,3
2020-09-12,Colusa,011,21464,507,486,0,486,6
2020-09-12,Contra Costa,013,1133247,16008,15135,75,15210,174
2020-09-12,Del Norte,015,27424,126,116,0,116,1
2020-09-12,El Dorado,017,186661,1085,1034,8,1042,2
2020-09-12,Fresno,019,978130,29500,27076,333,27409,345
2020-09-12,Glenn,021,27897,549,517,0,517,3
2020-09-12,Humboldt,023,135768,477,430,1,431,4
2020-09-12,Imperial,025,180216,11556,10305,7,10312,273
2020-09-12,Inyo,027,18085,186,177,4,181,12
2020-09-12,Kern,029,883053,31094,30202,287,30489,368
2020-09-12,Kings,031,150075,7203,6895,31,6926,70
2020-09-12,Lake,033,64148,461,393,0,393,4
2020-09-12,Lassen,035,31185,734,719,2,721,0
2020-09-12,Los Angeles,037,10098052,256176,253156,1559,254715,6193
2020-09-12,Madera,039,155013,4296,4058,29,4087,43
2020-09-12,Marin,041,260295,6501,6393,15,6408,69
2020-09-12,Mariposa,043,17540,75,72,0,72,2
2020-09-12,Mendocino,045,87422,756,700,0,700,17
2020-09-12,Merced,047,269075,8649,8533,13,8546,112
2020-09-12,Modoc,049,8938,25,21,0,21,0
2020-09-12,Mono,051,14174,165,147,3,150,1
2020-09-12,Monterey,053,433212,9187,8743,18,8761,61
2020-09-12,Napa,055,140530,1609,1556,8,1564,11
2020-09-12,Nevada,057,99092,502,482,15,497,6
2020-09-12,Orange,059,3164182,52682,49895,1333,51228,1078
2020-09-12,Placer,061,380077,3434,3280,13,3293,38
2020-09-12,Plumas,063,18699,48,42,0,42,0
2020-09-12,Riverside,065,2383286,56519,55058,102,55160,1108
2020-09-12,Sacramento,067,1510023,20788,20184,24,20208,367
2020-09-12,San Benito,069,59416,1262,1208,0,1208,7
2020-09-12,San Bernardino,071,2135413,51623,49945,332,50277,896
2020-09-12,San Diego,073,3302833,44166,42416,710,43126,747
2020-09-12,San Francisco,075,870044,10585,10257,23,10280,90
2020-09-12,San Joaquin,077,732212,19578,19108,43,19151,396
2020-09-12,San Luis Obispo,079,281455,3444,3220,17,3237,24
2020-09-12,San Mateo,081,765935,9521,8759,10,8769,127
2020-09-12,Santa Barbara,083,443738,8836,8642,72,8714,104
2020-09-12,Santa Clara,085,1922200,20662,19330,39,19369,237
2020-09-12,Santa Cruz,087,273765,2177,2016,19,2035,7
2020-09-12,Shasta,089,179085,717,569,3,572,10
2020-09-12,Sierra,091,2930,6,6,0,6,0
2020-09-12,Siskiyou,093,43540,152,141,9,150,0
2020-09-12,Solano,095,438530,5981,5772,39,5811,43
2020-09-12,Sonoma,097,501317,6890,6531,20,6551,95
2020-09-12,Stanislaus,099,539301,16082,15675,451,16126,253
2020-09-12,Sutter,101,95872,1589,1529,1,1530,10
2020-09-12,Tehama,103,63373,487,471,2,473,1
2020-09-12,Trinity,105,12862,52,15,7,22,0
2020-09-12,Tulare,107,460477,15633,15018,79,15097,254
2020-09-12,Tuolumne,109,53932,224,208,6,214,1
2020-09-12,Ventura,111,848112,12495,11759,132,11891,123
2020-09-12,Yolo,113,214977,2728,2646,7,2653,53
2020-09-12,Yuba,115,75493,1022,963,3,966,1
2020-09-11,Alameda,001,1643700,20349,19625,145,19770,298
2020-09-11,Alpine,003,1148,2,2,0,2,0
2020-09-11,Amador,005,37829,281,277,0,277,16
2020-09-11,Butte,007,227075,2770,2605,48,2653,37
2020-09-11,Calaveras,009,45235,299,242,0,242,1
2020-09-11,Colusa,011,21464,506,484,0,484,6
2020-09-11,Contra Costa,013,1133247,15950,15001,72,15073,173
2020-09-11,Del Norte,015,27424,126,115,0,115,1
2020-09-11,El Dorado,017,186661,1082,1024,8,1032,2
2020-09-11,Fresno,019,978130,29422,26917,332,27249,344
2020-09-11,Glenn,021,27897,544,515,0,515,3
2020-09-11,Humboldt,023,135768,475,426,1,427,4
2020-09-11,Imperial,025,180216,11538,10286,7,10293,273
2020-09-11,Inyo,027,18085,186,176,4,180,12
2020-09-11,Kern,029,883053,31026,30059,286,30345,365
2020-09-11,Kings,031,150075,7186,6770,31,6801,70
2020-09-11,Lake,033,64148,453,382,0,382,4
2020-09-11,Lassen,035,31185,734,719,2,721,0
2020-09-11,Los Angeles,037,10098052,255497,252057,1548,253605,6172
2020-09-11,Madera,039,155013,4277,4018,29,4047,43
2020-09-11,Marin,041,260295,6496,6364,15,6379,69
2020-09-11,Mariposa,043,17540,75,72,0,72,2
2020-09-11,Mendocino,045,87422,745,700,0,700,17
2020-09-11,Merced,047,269075,8628,8489,13,8502,109
2020-09-11,Modoc,049,8938,25,21,0,21,0
2020-09-11,Mono,051,14174,165,145,3,148,1
2020-09-11,Monterey,053,433212,9139,8595,18,8613,61
2020-09-11,Napa,055,140530,1598,1543,8,1551,11
2020-09-11,Nevada,057,99092,495,483,15,498,6
2020-09-11,Orange,059,3164182,52552,49755,1321,51076,1068
2020-09-11,Placer,061,380077,3419,3254,13,3267,37
2020-09-11,Plumas,063,18699,48,42,0,42,0
2020-09-11,Riverside,065,2383286,56384,54717,99,54816,1099
2020-09-11,Sacramento,067,1510023,20704,20012,24,20036,358
2020-09-11,San Benito,069,59416,1252,1202,0,1202,7
2020-09-11,San Bernardino,071,2135413,51524,49682,332,50014,871
2020-09-11,San Diego,073,3302833,43946,41971,704,42675,730
2020-09-11,San Francisco,075,870044,10537,10133,22,10155,89
2020-09-11,San Joaquin,077,732212,19530,19019,43,19062,391
2020-09-11,San Luis Obispo,079,281455,3426,3190,17,3207,24
2020-09-11,San Mateo,081,765935,9479,8611,10,8621,127
2020-09-11,Santa Barbara,083,443738,8803,8592,71,8663,103
2020-09-11,Santa Clara,085,1922200,20574,19065,39,19104,234
2020-09-11,Santa Cruz,087,273765,2160,1997,19,2016,7
2020-09-11,Shasta,089,179085,707,568,3,571,10
2020-09-11,Sierra,091,2930,6,6,0,6,0
2020-09-11,Siskiyou,093,43540,151,139,9,148,0
2020-09-11,Solano,095,438530,5963,5742,39,5781,42
2020-09-11,Sonoma,097,501317,6846,6469,20,6489,91
2020-09-11,Stanislaus,099,539301,16044,15613,448,16061,253
2020-09-11,Sutter,101,95872,1579,1505,1,1506,11
2020-09-11,Tehama,103,63373,484,466,2,468,1
2020-09-11,Trinity,105,12862,52,16,7,23,0
2020-09-11,Tulare,107,460477,15600,14932,76,15008,251
2020-09-11,Tuolumne,109,53932,224,208,6,214,1
2020-09-11,Ventura,111,848112,12441,11700,130,11830,123
2020-09-11,Yolo,113,214977,2718,2632,7,2639,53
2020-09-11,Yuba,115,75493,1014,946,3,949,1
2020-09-10,Alameda,001,1643700,20275,19509,145,19654,292
2020-09-10,Alpine,003,1148,2,2,0,2,0
2020-09-10,Amador,005,37829,280,277,0,277,16
2020-09-10,Butte,007,227075,2753,2590,48,2638,37
2020-09-10,Calaveras,009,45235,299,244,0,244,1
2020-09-10,Colusa,011,21464,504,482,0,482,6
2020-09-10,Contra Costa,013,1133247,15877,14909,72,14981,172
2020-09-10,Del Norte,015,27424,125,112,0,112,1
2020-09-10,El Dorado,017,186661,1079,1020,8,1028,2
2020-09-10,Fresno,019,978130,29301,26783,332,27115,338
2020-09-10,Glenn,021,27897,534,511,0,511,3
2020-09-10,Humboldt,023,135768,464,422,1,423,4
2020-09-10,Imperial,025,180216,11522,10251,7,10258,270
2020-09-10,Inyo,027,18085,185,176,4,180,11
2020-09-10,Kern,029,883053,30944,29988,282,30270,363
2020-09-10,Kings,031,150075,7156,6739,31,6770,70
2020-09-10,Lake,033,64148,447,377,0,377,4
2020-09-10,Lassen,035,31185,733,716,2,718,0
2020-09-10,Los Angeles,037,10098052,254519,251003,1527,252530,6132
2020-09-10,Madera,039,155013,4259,3979,29,4008,43
2020-09-10,Marin,041,260295,6484,6344,15,6359,68
2020-09-10,Mariposa,043,17540,75,72,0,72,2
2020-09-10,Mendocino,045,87422,735,697,0,697,16
2020-09-10,Merced,047,269075,8582,8461,13,8474,109
2020-09-10,Modoc,049,8938,25,21,0,21,0
2020-09-10,Mono,051,14174,165,145,3,148,1
2020-09-10,Monterey,053,433212,9069,8570,18,8588,59
2020-09-10,Napa,055,140530,1592,1536,8,1544,11
2020-09-10,Nevada,057,99092,491,478,15,493,6
2020-09-10,Orange,059,3164182,52389,49617,1314,50931,1057
2020-09-10,Placer,061,380077,3399,3233,13,3246,37
2020-09-10,Plumas,063,18699,48,42,0,42,0
2020-09-10,Riverside,065,2383286,56065,54417,96,54513,1091
2020-09-10,Sacramento,067,1510023,20584,19618,23,19641,354
2020-09-10,San Benito,069,59416,1246,1201,0,1201,5
2020-09-10,San Bernardino,071,2135413,51335,49467,330,49797,867
2020-09-10,San Diego,073,3302833,43680,41610,677,42287,725
2020-09-10,San Francisco,075,870044,10460,10082,22,10104,89
2020-09-10,San Joaquin,077,732212,19477,18854,43,18897,389
2020-09-10,San Luis Obispo,079,281455,3412,3161,16,3177,24
2020-09-10,San Mateo,081,765935,9433,8529,10,8539,125
2020-09-10,Santa Barbara,083,443738,8758,8552,71,8623,100
2020-09-10,Santa Clara,085,1922200,20459,18870,39,18909,231
2020-09-10,Santa Cruz,087,273765,2145,1986,17,2003,7
2020-09-10,Shasta,089,179085,696,566,3,569,10
2020-09-10,Sierra,091,2930,6,6,0,6,0
2020-09-10,Siskiyou,093,43540,151,137,9,146,0
2020-09-10,Solano,095,438530,5923,5696,39,5735,42
2020-09-10,Sonoma,097,501317,6797,6424,20,6444,91
2020-09-10,Stanislaus,099,539301,15991,15509,443,15952,243
2020-09-10,Sutter,101,95872,1569,1494,1,1495,11
2020-09-10,Tehama,103,63373,477,466,2,468,1
2020-09-10,Trinity,105,12862,52,15,7,22,0
2020-09-10,Tulare,107,460477,15547,14860,73,14933,250
2020-09-10,Tuolumne,109,53932,223,205,6,211,1
2020-09-10,Ventura,111,848112,12347,11600,123,11723,122
2020-09-10,Yolo,113,214977,2713,2612,7,2619,53
2020-09-10,Yuba,115,75493,1008,941,3,944,1
2020-09-09,Alameda,001,1643700,20196,19399,144,19543,289
2020-09-09,Alpine,003,1148,2,2,0,2,0
2020-09-09,Amador,005,37829,279,276,0,276,16
2020-09-09,Butte,007,227075,2736,2561,48,2609,37
2020-09-09,Calaveras,009,45235,299,242,0,242,1
2020-09-09,Colusa,011,21464,499,479,0,479,6
2020-09-09,Contra Costa,013,1133247,15790,14816,72,14888,171
2020-09-09,Del Norte,015,27424,121,109,0,109,1
2020-09-09,El Dorado,017,186661,1076,1020,8,1028,2
2020-09-09,Fresno,019,978130,29198,26724,327,27051,329
2020-09-09,Glenn,021,27897,531,508,0,508,3
2020-09-09,Humboldt,023,135768,462,420,1,421,4
2020-09-09,Imperial,025,180216,11502,10233,7,10240,268
2020-09-09,Inyo,027,18085,184,173,4,177,2
2020-09-09,Kern,029,883053,30846,29925,279,30204,355
2020-09-09,Kings,031,150075,7138,6721,31,6752,72
2020-09-09,Lake,033,64148,439,371,0,371,4
2020-09-09,Lassen,035,31185,732,714,2,716,0
2020-09-09,Los Angeles,037,10098052,253646,249876,1509,251385,6091
2020-09-09,Madera,039,155013,4233,3926,29,3955,43
2020-09-09,Marin,041,260295,6465,6321,15,6336,68
2020-09-09,Mariposa,043,17540,74,72,0,72,2
2020-09-09,Mendocino,045,87422,727,695,0,695,16
2020-09-09,Merced,047,269075,8556,8441,13,8454,107
2020-09-09,Modoc,049,8938,24,20,0,20,0
2020-09-09,Mono,051,14174,165,145,3,148,1
2020-09-09,Monterey,053,433212,8997,8527,18,8545,59
2020-09-09,Napa,055,140530,1582,1531,8,1539,11
2020-09-09,Nevada,057,99092,487,476,15,491,6
2020-09-09,Orange,059,3164182,52210,49394,1307,50701,1054
2020-09-09,Placer,061,380077,3379,3222,13,3235,36
2020-09-09,Plumas,063,18699,46,42,0,42,0
2020-09-09,Riverside,065,2383286,55835,54320,93,54413,1081
2020-09-09,Sacramento,067,1510023,20479,19474,22,19496,347
2020-09-09,San Benito,069,59416,1242,1199,0,1199,5
2020-09-09,San Bernardino,071,2135413,51136,49264,329,49593,866
2020-09-09,San Diego,073,3302833,43391,41326,665,41991,721
2020-09-09,San Francisco,075,870044,10410,9996,21,10017,86
2020-09-09,San Joaquin,077,732212,19414,18799,42,18841,388
2020-09-09,San Luis Obispo,079,281455,3394,3131,16,3147,24
2020-09-09,San Mateo,081,765935,9373,8478,10,8488,125
2020-09-09,Santa Barbara,083,443738,8715,8528,71,8599,97
2020-09-09,Santa Clara,085,1922200,20328,18759,39,18798,228
2020-09-09,Santa Cruz,087,273765,2122,1967,17,1984,7
2020-09-09,Shasta,089,179085,684,562,3,565,10
2020-09-09,Sierra,091,2930,6,6,0,6,0
2020-09-09,Siskiyou,093,43540,149,137,9,146,0
2020-09-09,Solano,095,438530,5891,5680,39,5719,36
2020-09-09,Sonoma,097,501317,6731,6397,20,6417,92
2020-09-09,Stanislaus,099,539301,15951,15469,432,15901,243
2020-09-09,Sutter,101,95872,1561,1487,1,1488,11
2020-09-09,Tehama,103,63373,474,462,2,464,1
2020-09-09,Trinity,105,12862,52,14,7,21,0
2020-09-09,Tulare,107,460477,15497,14787,68,14855,249
2020-09-09,Tuolumne,109,53932,222,204,5,209,1
2020-09-09,Ventura,111,848112,12256,11497,120,11617,121
2020-09-09,Yolo,113,214977,2702,2604,7,2611,53
2020-09-09,Yuba,115,75493,1003,936,3,939,1
2020-09-08,Alameda,001,1643700,20087,19293,144,19437,288
2020-09-08,Alpine,003,1148,2,2,0,2,0
2020-09-08,Amador,005,37829,279,276,0,276,16
2020-09-08,Butte,007,227075,2718,2453,48,2501,36
2020-09-08,Calaveras,009,45235,297,233,0,233,1
2020-09-08,Colusa,011,21464,497,475,0,475,6
2020-09-08,Contra Costa,013,1133247,15661,14740,69,14809,171
2020-09-08,Del Norte,015,27424,121,109,0,109,2
2020-09-08,El Dorado,017,186661,1073,1011,8,1019,2
2020-09-08,Fresno,019,978130,29079,26640,323,26963,329
2020-09-08,Glenn,021,27897,527,492,0,492,3
2020-09-08,Humboldt,023,135768,460,420,1,421,4
2020-09-08,Imperial,025,180216,11486,10198,7,10205,267
2020-09-08,Inyo,027,18085,184,169,4,173,2
2020-09-08,Kern,029,883053,30761,29850,276,30126,351
2020-09-08,Kings,031,150075,7100,6658,31,6689,72
2020-09-08,Lake,033,64148,428,370,0,370,4
2020-09-08,Lassen,035,31185,732,710,2,712,0
2020-09-08,Los Angeles,037,10098052,252714,249217,1480,250697,6034
2020-09-08,Madera,039,155013,4209,3904,29,3933,43
2020-09-08,Marin,041,260295,6434,6313,15,6328,68
2020-09-08,Mariposa,043,17540,74,72,0,72,2
2020-09-08,Mendocino,045,87422,720,690,0,690,16
2020-09-08,Merced,047,269075,8533,8381,13,8394,104
2020-09-08,Modoc,049,8938,24,20,0,20,0
2020-09-08,Mono,051,14174,165,145,3,148,1
2020-09-08,Monterey,053,433212,8912,8491,18,8509,59
2020-09-08,Napa,055,140530,1578,1518,8,1526,11
2020-09-08,Nevada,057,99092,487,470,15,485,6
2020-09-08,Orange,059,3164182,52068,49214,1303,50517,1044
2020-09-08,Placer,061,380077,3365,3205,13,3218,36
2020-09-08,Plumas,063,18699,46,42,0,42,0
2020-09-08,Riverside,065,2383286,55621,54168,90,54258,1069
2020-09-08,Sacramento,067,1510023,20244,19411,21,19432,347
2020-09-08,San Benito,069,59416,1235,1188,0,1188,5
2020-09-08,San Bernardino,071,2135413,50947,49034,327,49361,856
2020-09-08,San Diego,073,3302833,43075,41079,653,41732,709
2020-09-08,San Francisco,075,870044,10336,9821,21,9842,86
2020-09-08,San Joaquin,077,732212,19336,18550,42,18592,388
2020-09-08,San Luis Obispo,079,281455,3379,3120,16,3136,23
2020-09-08,San Mateo,081,765935,9297,8460,10,8470,125
2020-09-08,Santa Barbara,083,443738,8681,8488,70,8558,96
2020-09-08,Santa Clara,085,1922200,20151,18645,39,18684,228
2020-09-08,Santa Cruz,087,273765,2094,1903,17,1920,7
2020-09-08,Shasta,089,179085,676,556,3,559,10
2020-09-08,Sierra,091,2930,6,6,0,6,0
2020-09-08,Siskiyou,093,43540,147,136,9,145,0
2020-09-08,Solano,095,438530,5854,5654,39,5693,36
2020-09-08,Sonoma,097,501317,6662,6356,20,6376,92
2020-09-08,Stanislaus,099,539301,15887,15415,420,15835,238
2020-09-08,Sutter,101,95872,1545,1473,1,1474,11
2020-09-08,Tehama,103,63373,470,458,2,460,1
2020-09-08,Trinity,105,12862,51,13,7,20,0
2020-09-08,Tulare,107,460477,15417,14635,67,14702,249
2020-09-08,Tuolumne,109,53932,221,197,5,202,1
2020-09-08,Ventura,111,848112,12187,11475,117,11592,118
2020-09-08,Yolo,113,214977,2692,2580,7,2587,53
2020-09-08,Yuba,115,75493,991,923,3,926,1
2020-09-07,Alameda,001,1643700,19966,19188,138,19326,281
2020-09-07,Alpine,003,1148,2,2,0,2,0
2020-09-07,Amador,005,37829,279,276,0,276,16
2020-09-07,Butte,007,227075,2685,2450,47,2497,30
2020-09-07,Calaveras,009,45235,287,234,0,234,1
2020-09-07,Colusa,011,21464,496,475,0,475,6
2020-09-07,Contra Costa,013,1133247,15546,14637,66,14703,172
2020-09-07,Del Norte,015,27424,121,109,0,109,2
2020-09-07,El Dorado,017,186661,1062,1011,8,1019,2
2020-09-07,Fresno,019,978130,28985,26565,320,26885,329
2020-09-07,Glenn,021,27897,522,488,0,488,3
2020-09-07,Humboldt,023,135768,451,416,1,417,4
2020-09-07,Imperial,025,180216,11455,10199,7,10206,267
2020-09-07,Inyo,027,18085,184,169,4,173,2
2020-09-07,Kern,029,883053,30640,29790,271,30061,348
2020-09-07,Kings,031,150075,6976,6630,31,6661,72
2020-09-07,Lake,033,64148,405,367,0,367,2
2020-09-07,Lassen,035,31185,732,709,2,711,0
2020-09-07,Los Angeles,037,10098052,251667,248804,1459,250263,6030
2020-09-07,Madera,039,155013,4178,3889,28,3917,43
2020-09-07,Marin,041,260295,6404,6296,15,6311,67
2020-09-07,Mariposa,043,17540,74,72,0,72,2
2020-09-07,Mendocino,045,87422,712,687,0,687,16
2020-09-07,Merced,047,269075,8486,8381,13,8394,104
2020-09-07,Modoc,049,8938,23,20,0,20,0
2020-09-07,Mono,051,14174,165,145,3,148,1
2020-09-07,Monterey,053,433212,8833,8463,18,8481,57
2020-09-07,Napa,055,140530,1566,1514,8,1522,11
2020-09-07,Nevada,057,99092,485,469,15,484,6
2020-09-07,Orange,059,3164182,51894,49132,1299,50431,1042
2020-09-07,Placer,061,380077,3335,3188,12,3200,36
2020-09-07,Plumas,063,18699,45,42,0,42,0
2020-09-07,Riverside,065,2383286,55346,54178,84,54262,1069
2020-09-07,Sacramento,067,1510023,20002,19292,20,19312,345
2020-09-07,San Benito,069,59416,1229,1180,0,1180,4
2020-09-07,San Bernardino,071,2135413,50719,49043,325,49368,821
2020-09-07,San Diego,073,3302833,42675,40868,626,41494,708
2020-09-07,San Francisco,075,870044,10285,9813,20,9833,85
2020-09-07,San Joaquin,077,732212,19254,18552,40,18592,386
2020-09-07,San Luis Obispo,079,281455,3342,3116,16,3132,23
2020-09-07,San Mateo,081,765935,9215,8409,10,8419,125
2020-09-07,Santa Barbara,083,443738,8637,8479,70,8549,95
2020-09-07,Santa Clara,085,1922200,19995,18596,38,18634,226
2020-09-07,Santa Cruz,087,273765,2066,1902,17,1919,7
2020-09-07,Shasta,089,179085,666,556,3,559,10
2020-09-07,Sierra,091,2930,6,6,0,6,0
2020-09-07,Siskiyou,093,43540,146,133,9,142,0
2020-09-07,Solano,095,438530,5789,5640,39,5679,36
2020-09-07,Sonoma,097,501317,6596,6268,20,6288,85
2020-09-07,Stanislaus,099,539301,15822,15343,408,15751,236
2020-09-07,Sutter,101,95872,1528,1468,1,1469,11
2020-09-07,Tehama,103,63373,466,453,2,455,1
2020-09-07,Trinity,105,12862,51,13,7,20,0
2020-09-07,Tulare,107,460477,15310,14637,65,14702,249
2020-09-07,Tuolumne,109,53932,220,196,5,201,1
2020-09-07,Ventura,111,848112,12092,11463,114,11577,118
2020-09-07,Yolo,113,214977,2675,2565,6,2571,53
2020-09-07,Yuba,115,75493,975,923,3,926,1
2020-09-06,Alameda,001,1643700,19908,19029,136,19165,281
2020-09-06,Alpine,003,1148,2,2,0,2,0
2020-09-06,Amador,005,37829,277,275,0,275,16
2020-09-06,Butte,007,227075,2676,2446,47,2493,30
2020-09-06,Calaveras,009,45235,287,235,0,235,1
2020-09-06,Colusa,011,21464,492,475,0,475,6
2020-09-06,Contra Costa,013,1133247,15465,14565,65,14630,171
2020-09-06,Del Norte,015,27424,121,109,0,109,2
2020-09-06,El Dorado,017,186661,1060,1008,8,1016,2
2020-09-06,Fresno,019,978130,28922,26471,318,26789,329
2020-09-06,Glenn,021,27897,516,474,0,474,3
2020-09-06,Humboldt,023,135768,448,404,1,405,4
2020-09-06,Imperial,025,180216,11438,10152,7,10159,267
2020-09-06,Inyo,027,18085,184,169,4,173,2
2020-09-06,Kern,029,883053,30585,29699,267,29966,348
2020-09-06,Kings,031,150075,6956,6561,30,6591,72
2020-09-06,Lake,033,64148,402,362,0,362,2
2020-09-06,Lassen,035,31185,732,709,2,711,0
2020-09-06,Los Angeles,037,10098052,251034,248316,1445,249761,6004
2020-09-06,Madera,039,155013,4134,3867,28,3895,42
2020-09-06,Marin,041,260295,6392,6276,15,6291,67
2020-09-06,Mariposa,043,17540,74,72,0,72,2
2020-09-06,Mendocino,045,87422,711,672,0,672,16
2020-09-06,Merced,047,269075,8467,8327,13,8340,104
2020-09-06,Modoc,049,8938,23,20,0,20,0
2020-09-06,Mono,051,14174,164,145,3,148,1
2020-09-06,Monterey,053,433212,8793,8403,17,8420,56
2020-09-06,Napa,055,140530,1562,1501,6,1507,11
2020-09-06,Nevada,057,99092,485,467,14,481,6
2020-09-06,Orange,059,3164182,51781,48931,1295,50226,1042
2020-09-06,Placer,061,380077,3318,3169,12,3181,36
2020-09-06,Plumas,063,18699,44,42,0,42,0
2020-09-06,Riverside,065,2383286,55229,53970,82,54052,1069
2020-09-06,Sacramento,067,1510023,19906,19128,20,19148,340
2020-09-06,San Benito,069,59416,1227,1178,0,1178,4
2020-09-06,San Bernardino,071,2135413,50612,48923,325,49248,823
2020-09-06,San Diego,073,3302833,42427,40652,620,41272,707
2020-09-06,San Francisco,075,870044,10211,9813,20,9833,85
2020-09-06,San Joaquin,077,732212,19205,18558,40,18598,386
2020-09-06,San Luis Obispo,079,281455,3331,3101,16,3117,23
2020-09-06,San Mateo,081,765935,9162,8387,10,8397,125
2020-09-06,Santa Barbara,083,443738,8608,8434,70,8504,95
2020-09-06,Santa Clara,085,1922200,19893,18495,38,18533,207
2020-09-06,Santa Cruz,087,273765,2059,1902,17,1919,7
2020-09-06,Shasta,089,179085,660,550,3,553,10
2020-09-06,Sierra,091,2930,6,6,0,6,0
2020-09-06,Siskiyou,093,43540,146,132,9,141,0
2020-09-06,Solano,095,438530,5763,5619,39,5658,37
2020-09-06,Sonoma,097,501317,6567,6212,20,6232,85
2020-09-06,Stanislaus,099,539301,15778,15288,404,15692,236
2020-09-06,Sutter,101,95872,1515,1451,1,1452,11
2020-09-06,Tehama,103,63373,465,455,2,457,1
2020-09-06,Trinity,105,12862,50,13,7,20,0
2020-09-06,Tulare,107,460477,15267,14636,64,14700,249
2020-09-06,Tuolumne,109,53932,217,194,5,199,1
2020-09-06,Ventura,111,848112,12047,11315,114,11429,118
2020-09-06,Yolo,113,214977,2661,2556,6,2562,53
2020-09-06,Yuba,115,75493,966,913,3,916,1
2020-09-05,Alameda,001,1643700,19862,18973,134,19107,279
2020-09-05,Alpine,003,1148,2,2,0,2,0
2020-09-05,Amador,005,37829,277,274,0,274,16
2020-09-05,Butte,007,227075,2660,2406,46,2452,30
2020-09-05,Calaveras,009,45235,287,237,0,237,1
2020-09-05,Colusa,011,21464,488,472,0,472,6
2020-09-05,Contra Costa,013,1133247,15388,14456,63,14519,173
2020-09-05,Del Norte,015,27424,121,109,0,109,2
2020-09-05,El Dorado,017,186661,1060,1007,8,1015,2
2020-09-05,Fresno,019,978130,28855,26325,318,26643,331
2020-09-05,Glenn,021,27897,515,474,0,474,3
2020-09-05,Humboldt,023,135768,446,402,1,403,4
2020-09-05,Imperial,025,180216,11421,10151,7,10158,268
2020-09-05,Inyo,027,18085,184,169,4,173,2
2020-09-05,Kern,029,883053,30525,29645,263,29908,347
2020-09-05,Kings,031,150075,6947,6518,30,6548,66
2020-09-05,Lake,033,64148,399,359,0,359,2
2020-09-05,Lassen,035,31185,732,709,2,711,0
2020-09-05,Los Angeles,037,10098052,250499,247572,1433,249005,6001
2020-09-05,Madera,039,155013,4094,3851,28,3879,42
2020-09-05,Marin,041,260295,6384,6259,15,6274,66
2020-09-05,Mariposa,043,17540,74,72,0,72,2
2020-09-05,Mendocino,045,87422,710,658,0,658,16
2020-09-05,Merced,047,269075,8435,8297,11,8308,104
2020-09-05,Modoc,049,8938,23,19,0,19,0
2020-09-05,Mono,051,14174,164,145,3,148,1
2020-09-05,Monterey,053,433212,8763,8301,17,8318,56
2020-09-05,Napa,055,140530,1556,1484,6,1490,11
2020-09-05,Nevada,057,99092,482,461,14,475,6
2020-09-05,Orange,059,3164182,51680,48726,1290,50016,1039
2020-09-05,Placer,061,380077,3308,3141,12,3153,35
2020-09-05,Plumas,063,18699,44,42,0,42,0
2020-09-05,Riverside,065,2383286,55123,53780,82,53862,1066
2020-09-05,Sacramento,067,1510023,19816,18955,20,18975,339
2020-09-05,San Benito,069,59416,1225,1153,0,1153,4
2020-09-05,San Bernardino,071,2135413,50536,48800,324,49124,825
2020-09-05,San Diego,073,3302833,42234,40344,608,40952,717
2020-09-05,San Francisco,075,870044,10178,9812,19,9831,85
2020-09-05,San Joaquin,077,732212,19176,18557,40,18597,386
2020-09-05,San Luis Obispo,079,281455,3320,3083,16,3099,23
2020-09-05,San Mateo,081,765935,9117,8352,10,8362,124
2020-09-05,Santa Barbara,083,443738,8592,8404,70,8474,96
2020-09-05,Santa Clara,085,1922200,19812,18311,38,18349,207
2020-09-05,Santa Cruz,087,273765,2051,1904,17,1921,7
2020-09-05,Shasta,089,179085,659,544,3,547,10
2020-09-05,Sierra,091,2930,6,6,0,6,0
2020-09-05,Siskiyou,093,43540,145,131,9,140,0
2020-09-05,Solano,095,438530,5751,5579,39,5618,37
2020-09-05,Sonoma,097,501317,6534,6149,20,6169,85
2020-09-05,Stanislaus,099,539301,15730,15198,400,15598,236
2020-09-05,Sutter,101,95872,1508,1445,1,1446,11
2020-09-05,Tehama,103,63373,464,447,2,449,1
2020-09-05,Trinity,105,12862,50,13,7,20,0
2020-09-05,Tulare,107,460477,15209,14576,62,14638,249
2020-09-05,Tuolumne,109,53932,217,194,5,199,1
2020-09-05,Ventura,111,848112,12004,11254,114,11368,118
2020-09-05,Yolo,113,214977,2651,2534,6,2540,53
2020-09-05,Yuba,115,75493,960,902,3,905,1
2020-09-04,Alameda,001,1643700,19793,18843,133,18976,276
2020-09-04,Alpine,003,1148,2,2,0,2,0
2020-09-04,Amador,005,37829,276,274,0,274,16
2020-09-04,Butte,007,227075,2637,2325,46,2371,28
2020-09-04,Calaveras,009,45235,285,237,0,237,1
2020-09-04,Colusa,011,21464,486,467,0,467,6
2020-09-04,Contra Costa,013,1133247,15304,14355,62,14417,164
2020-09-04,Del Norte,015,27424,121,109,0,109,2
2020-09-04,El Dorado,017,186661,1056,992,8,1000,2
2020-09-04,Fresno,019,978130,28749,26147,317,26464,321
2020-09-04,Glenn,021,27897,507,463,0,463,3
2020-09-04,Humboldt,023,135768,441,390,1,391,4
2020-09-04,Imperial,025,180216,11412,10136,7,10143,267
2020-09-04,Inyo,027,18085,184,169,4,173,2
2020-09-04,Kern,029,883053,30457,29526,260,29786,345
2020-09-04,Kings,031,150075,6934,6259,30,6289,66
2020-09-04,Lake,033,64148,399,347,0,347,2
2020-09-04,Lassen,035,31185,732,708,2,710,0
2020-09-04,Los Angeles,037,10098052,249930,246396,1413,247809,5977
2020-09-04,Madera,039,155013,4081,3838,28,3866,42
2020-09-04,Marin,041,260295,6372,6251,15,6266,66
2020-09-04,Mariposa,043,17540,74,72,0,72,2
2020-09-04,Mendocino,045,87422,708,646,0,646,16
2020-09-04,Merced,047,269075,8415,8214,11,8225,104
2020-09-04,Modoc,049,8938,23,15,0,15,0
2020-09-04,Mono,051,14174,164,145,3,148,1
2020-09-04,Monterey,053,433212,8718,8208,17,8225,56
2020-09-04,Napa,055,140530,1547,1475,6,1481,11
2020-09-04,Nevada,057,99092,479,455,14,469,6
2020-09-04,Orange,059,3164182,51556,48488,1283,49771,1031
2020-09-04,Placer,061,380077,3296,3101,12,3113,35
2020-09-04,Plumas,063,18699,44,42,0,42,0
2020-09-04,Riverside,065,2383286,55010,53606,77,53683,1066
2020-09-04,Sacramento,067,1510023,19728,18765,20,18785,337
2020-09-04,San Benito,069,59416,1216,1137,0,1137,4
2020-09-04,San Bernardino,071,2135413,50443,48497,322,48819,800
2020-09-04,San Diego,073,3302833,42004,39901,599,40500,701
2020-09-04,San Francisco,075,870044,10138,9694,18,9712,85
2020-09-04,San Joaquin,077,732212,19122,18438,40,18478,376
2020-09-04,San Luis Obispo,079,281455,3305,3049,15,3064,21
2020-09-04,San Mateo,081,765935,9073,8275,10,8285,122
2020-09-04,Santa Barbara,083,443738,8562,8340,70,8410,96
2020-09-04,Santa Clara,085,1922200,19702,18074,38,18112,209
2020-09-04,Santa Cruz,087,273765,2034,1896,16,1912,7
2020-09-04,Shasta,089,179085,656,536,3,539,10
2020-09-04,Sierra,091,2930,6,6,0,6,0
2020-09-04,Siskiyou,093,43540,145,129,9,138,0
2020-09-04,Solano,095,438530,5738,5552,39,5591,37
2020-09-04,Sonoma,097,501317,6469,6050,20,6070,85
2020-09-04,Stanislaus,099,539301,15697,15074,391,15465,233
2020-09-04,Sutter,101,95872,1492,1425,1,1426,11
2020-09-04,Tehama,103,63373,460,442,2,444,1
2020-09-04,Trinity,105,12862,50,13,7,20,0
2020-09-04,Tulare,107,460477,15181,14501,59,14560,247
2020-09-04,Tuolumne,109,53932,217,193,5,198,1
2020-09-04,Ventura,111,848112,11962,11171,114,11285,114
2020-09-04,Yolo,113,214977,2637,2495,6,2501,53
2020-09-04,Yuba,115,75493,955,884,3,887,1
2020-09-03,Alameda,001,1643700,19690,18687,133,18820,275
2020-09-03,Alpine,003,1148,2,2,0,2,0
2020-09-03,Amador,005,37829,276,274,0,274,16
2020-09-03,Butte,007,227075,2593,2274,46,2320,27
2020-09-03,Calaveras,009,45235,284,238,0,238,1
2020-09-03,Colusa,011,21464,484,464,0,464,6
2020-09-03,Contra Costa,013,1133247,15196,14206,59,14265,159
2020-09-03,Del Norte,015,27424,118,109,0,109,2
2020-09-03,El Dorado,017,186661,1052,983,8,991,2
2020-09-03,Fresno,019,978130,28630,25978,312,26290,313
2020-09-03,Glenn,021,27897,503,460,0,460,3
2020-09-03,Humboldt,023,135768,436,390,1,391,4
2020-09-03,Imperial,025,180216,11391,10083,7,10090,255
2020-09-03,Inyo,027,18085,182,171,4,175,3
2020-09-03,Kern,029,883053,30365,29426,246,29672,340
2020-09-03,Kings,031,150075,6854,6200,30,6230,64
2020-09-03,Lake,033,64148,390,347,0,347,2
2020-09-03,Lassen,035,31185,732,707,2,709,0
2020-09-03,Los Angeles,037,10098052,249068,245026,1393,246419,5931
2020-09-03,Madera,039,155013,4062,3780,28,3808,43
2020-09-03,Marin,041,260295,6353,6175,15,6190,66
2020-09-03,Mariposa,043,17540,74,71,0,71,2
2020-09-03,Mendocino,045,87422,699,638,0,638,16
2020-09-03,Merced,047,269075,8373,8136,11,8147,105
2020-09-03,Modoc,049,8938,23,14,0,14,0
2020-09-03,Mono,051,14174,163,144,3,147,1
2020-09-03,Monterey,053,433212,8664,8128,17,8145,56
2020-09-03,Napa,055,140530,1540,1466,6,1472,10
2020-09-03,Nevada,057,99092,476,453,14,467,6
2020-09-03,Orange,059,3164182,51370,48226,1269,49495,1009
2020-09-03,Placer,061,380077,3278,3069,12,3081,34
2020-09-03,Plumas,063,18699,44,39,0,39,0
2020-09-03,Riverside,065,2383286,54830,53341,73,53414,1052
2020-09-03,Sacramento,067,1510023,19600,18553,19,18572,328
2020-09-03,San Benito,069,59416,1205,1121,0,1121,4
2020-09-03,San Bernardino,071,2135413,50277,48165,321,48486,800
2020-09-03,San Diego,073,3302833,41690,39448,583,40031,700
2020-09-03,San Francisco,075,870044,10073,9636,16,9652,84
2020-09-03,San Joaquin,077,732212,19044,18331,40,18371,371
2020-09-03,San Luis Obispo,079,281455,3288,3023,15,3038,21
2020-09-03,San Mateo,081,765935,8999,8211,10,8221,122
2020-09-03,Santa Barbara,083,443738,8515,8277,70,8347,96
2020-09-03,Santa Clara,085,1922200,19521,17879,38,17917,208
2020-09-03,Santa Cruz,087,273765,2019,1870,16,1886,7
2020-09-03,Shasta,089,179085,651,535,3,538,10
2020-09-03,Sierra,091,2930,6,6,0,6,0
2020-09-03,Siskiyou,093,43540,145,128,9,137,0
2020-09-03,Solano,095,438530,5718,5499,38,5537,36
2020-09-03,Sonoma,097,501317,6407,5997,20,6017,62
2020-09-03,Stanislaus,099,539301,15645,14985,387,15372,217
2020-09-03,Sutter,101,95872,1482,1412,1,1413,11
2020-09-03,Tehama,103,63373,456,436,2,438,1
2020-09-03,Trinity,105,12862,48,13,7,20,0
2020-09-03,Tulare,107,460477,15115,14408,58,14466,244
2020-09-03,Tuolumne,109,53932,217,193,5,198,1
2020-09-03,Ventura,111,848112,11844,11109,111,11220,112
2020-09-03,Yolo,113,214977,2621,2475,6,2481,53
2020-09-03,Yuba,115,75493,948,867,3,870,1
2020-09-02,Alameda,001,1643700,19572,18522,130,18652,260
2020-09-02,Alpine,003,1148,2,2,0,2,0
2020-09-02,Amador,005,37829,276,245,0,245,14
2020-09-02,Butte,007,227075,2547,2241,46,2287,27
2020-09-02,Calaveras,009,45235,283,235,0,235,1
2020-09-02,Colusa,011,21464,480,460,0,460,6
2020-09-02,Contra Costa,013,1133247,15107,14097,57,14154,159
2020-09-02,Del Norte,015,27424,117,109,0,109,2
2020-09-02,El Dorado,017,186661,1048,975,7,982,2
2020-09-02,Fresno,019,978130,28483,25785,309,26094,292
2020-09-02,Glenn,021,27897,498,457,0,457,3
2020-09-02,Humboldt,023,135768,433,381,1,382,4
2020-09-02,Imperial,025,180216,11375,9832,7,9839,255
2020-09-02,Inyo,027,18085,182,171,4,175,3
2020-09-02,Kern,029,883053,30273,29288,240,29528,335
2020-09-02,Kings,031,150075,6769,6142,30,6172,64
2020-09-02,Lake,033,64148,386,342,0,342,2
2020-09-02,Lassen,035,31185,730,706,2,708,0
2020-09-02,Los Angeles,037,10098052,248137,243999,1365,245364,5887
2020-09-02,Madera,039,155013,4042,3735,28,3763,41
2020-09-02,Marin,041,260295,6338,6131,15,6146,66
2020-09-02,Mariposa,043,17540,74,71,0,71,2
2020-09-02,Mendocino,045,87422,689,636,0,636,15
2020-09-02,Merced,047,269075,8342,8097,10,8107,103
2020-09-02,Modoc,049,8938,22,11,0,11,0
2020-09-02,Mono,051,14174,163,145,3,148,1
2020-09-02,Monterey,053,433212,8600,8070,17,8087,56
2020-09-02,Napa,055,140530,1528,1454,6,1460,10
2020-09-02,Nevada,057,99092,470,452,13,465,6
2020-09-02,Orange,059,3164182,51189,47871,1259,49130,994
2020-09-02,Placer,061,380077,3253,3047,11,3058,33
2020-09-02,Plumas,063,18699,44,39,0,39,0
2020-09-02,Riverside,065,2383286,54628,52923,70,52993,1032
2020-09-02,Sacramento,067,1510023,19365,18355,18,18373,316
2020-09-02,San Benito,069,59416,1192,1107,0,1107,4
2020-09-02,San Bernardino,071,2135413,50114,47766,318,48084,794
2020-09-02,San Diego,073,3302833,41370,39123,569,39692,695
2020-09-02,San Francisco,075,870044,10004,9587,16,9603,84
2020-09-02,San Joaquin,077,732212,18963,18194,39,18233,352
2020-09-02,San Luis Obispo,079,281455,3262,3002,14,3016,21
2020-09-02,San Mateo,081,765935,8942,8148,10,8158,122
2020-09-02,Santa Barbara,083,443738,8460,8206,69,8275,94
2020-09-02,Santa Clara,085,1922200,19365,17673,38,17711,206
2020-09-02,Santa Cruz,087,273765,1996,1850,16,1866,7
2020-09-02,Shasta,089,179085,650,531,3,534,10
2020-09-02,Sierra,091,2930,6,6,0,6,0
2020-09-02,Siskiyou,093,43540,144,127,9,136,0
2020-09-02,Solano,095,438530,5690,5463,38,5501,36
2020-09-02,Sonoma,097,501317,6345,5846,20,5866,62
2020-09-02,Stanislaus,099,539301,15575,14854,380,15234,220
2020-09-02,Sutter,101,95872,1467,1401,1,1402,10
2020-09-02,Tehama,103,63373,453,429,2,431,1
2020-09-02,Trinity,105,12862,48,13,7,20,0
2020-09-02,Tulare,107,460477,15049,14298,58,14356,244
2020-09-02,Tuolumne,109,53932,217,190,5,195,1
2020-09-02,Ventura,111,848112,11757,11031,110,11141,111
2020-09-02,Yolo,113,214977,2599,2449,6,2455,54
2020-09-02,Yuba,115,75493,941,856,3,859,1
2020-09-01,Alameda,001,1643700,19433,18382,127,18509,248
2020-09-01,Alpine,003,1148,2,2,0,2,0
2020-09-01,Amador,005,37829,275,244,0,244,13
2020-09-01,Butte,007,227075,2490,2146,45,2191,26
2020-09-01,Calaveras,009,45235,275,228,0,228,1
2020-09-01,Colusa,011,21464,476,454,0,454,6
2020-09-01,Contra Costa,013,1133247,15014,13998,55,14053,158
2020-09-01,Del Norte,015,27424,116,108,0,108,2
2020-09-01,El Dorado,017,186661,1040,972,7,979,2
2020-09-01,Fresno,019,978130,28339,25542,307,25849,290
2020-09-01,Glenn,021,27897,491,449,0,449,3
2020-09-01,Humboldt,023,135768,427,378,1,379,4
2020-09-01,Imperial,025,180216,11349,9782,7,9789,250
2020-09-01,Inyo,027,18085,182,171,4,175,3
2020-09-01,Kern,029,883053,30182,29162,235,29397,332
2020-09-01,Kings,031,150075,6738,6088,30,6118,62
2020-09-01,Lake,033,64148,383,341,0,341,2
2020-09-01,Lassen,035,31185,727,706,2,708,0
2020-09-01,Los Angeles,037,10098052,247047,242633,1342,243975,5832
2020-09-01,Madera,039,155013,4013,3703,27,3730,41
2020-09-01,Marin,041,260295,6323,6102,15,6117,67
2020-09-01,Mariposa,043,17540,73,72,0,72,2
2020-09-01,Mendocino,045,87422,674,626,0,626,15
2020-09-01,Merced,047,269075,8289,8046,9,8055,103
2020-09-01,Modoc,049,8938,20,10,0,10,0
2020-09-01,Mono,051,14174,163,145,3,148,1
2020-09-01,Monterey,053,433212,8494,7926,17,7943,56
2020-09-01,Napa,055,140530,1513,1446,6,1452,10
2020-09-01,Nevada,057,99092,464,450,13,463,6
2020-09-01,Orange,059,3164182,51025,47671,1240,48911,976
2020-09-01,Placer,061,380077,3231,3013,11,3024,33
2020-09-01,Plumas,063,18699,44,39,0,39,0
2020-09-01,Riverside,065,2383286,54411,52785,69,52854,1027
2020-09-01,Sacramento,067,1510023,19181,18217,17,18234,305
2020-09-01,San Benito,069,59416,1180,1089,0,1089,4
2020-09-01,San Bernardino,071,2135413,49907,47371,317,47688,786
2020-09-01,San Diego,073,3302833,41012,38873,531,39404,688
2020-09-01,San Francisco,075,870044,9935,9492,16,9508,83
2020-09-01,San Joaquin,077,732212,18882,17915,38,17953,341
2020-09-01,San Luis Obispo,079,281455,3236,2970,14,2984,21
2020-09-01,San Mateo,081,765935,8862,8132,10,8142,122
2020-09-01,Santa Barbara,083,443738,8410,8142,68,8210,93
2020-09-01,Santa Clara,085,1922200,19186,17319,38,17357,204
2020-09-01,Santa Cruz,087,273765,1972,1752,16,1768,7
2020-09-01,Shasta,089,179085,642,527,3,530,9
2020-09-01,Sierra,091,2930,6,6,0,6,0
2020-09-01,Siskiyou,093,43540,141,128,8,136,0
2020-09-01,Solano,095,438530,5664,5438,38,5476,34
2020-09-01,Sonoma,097,501317,6255,5733,20,5753,60
2020-09-01,Stanislaus,099,539301,15499,14784,370,15154,212
2020-09-01,Sutter,101,95872,1456,1389,1,1390,10
2020-09-01,Tehama,103,63373,450,422,2,424,1
2020-09-01,Trinity,105,12862,47,13,6,19,0
2020-09-01,Tulare,107,460477,14965,14156,58,14214,241
2020-09-01,Tuolumne,109,53932,211,183,5,188,1
2020-09-01,Ventura,111,848112,11679,10899,105,11004,108
2020-09-01,Yolo,113,214977,2583,2440,6,2446,51
2020-09-01,Yuba,115,75493,932,841,3,844,1
2020-08-31,Alameda,001,1643700,19286,18148,127,18275,248
2020-08-31,Alpine,003,1148,2,2,0,2,0
2020-08-31,Amador,005,37829,275,243,0,243,13
2020-08-31,Butte,007,227075,2426,2069,45,2114,26
2020-08-31,Calaveras,009,45235,270,212,0,212,1
2020-08-31,Colusa,011,21464,475,443,0,443,6
2020-08-31,Contra Costa,013,1133247,14888,13902,52,13954,153
2020-08-31,Del Norte,015,27424,116,108,0,108,2
2020-08-31,El Dorado,017,186661,1033,965,7,972,2
2020-08-31,Fresno,019,978130,28118,25185,301,25486,290
2020-08-31,Glenn,021,27897,479,437,0,437,3
2020-08-31,Humboldt,023,135768,425,374,1,375,4
2020-08-31,Imperial,025,180216,11318,9759,7,9766,250
2020-08-31,Inyo,027,18085,181,160,4,164,3
2020-08-31,Kern,029,883053,30084,29067,234,29301,318
2020-08-31,Kings,031,150075,6471,6037,30,6067,62
2020-08-31,Lake,033,64148,367,341,0,341,2
2020-08-31,Lassen,035,31185,724,706,2,708,0
2020-08-31,Los Angeles,037,10098052,245940,241793,1314,243107,5787
2020-08-31,Madera,039,155013,3990,3662,26,3688,35
2020-08-31,Marin,041,260295,6287,6074,15,6089,67
2020-08-31,Mariposa,043,17540,73,69,0,69,2
2020-08-31,Mendocino,045,87422,662,618,0,618,15
2020-08-31,Merced,047,269075,8227,7991,9,8000,79
2020-08-31,Modoc,049,8938,18,10,0,10,0
2020-08-31,Mono,051,14174,163,145,3,148,1
2020-08-31,Monterey,053,433212,8387,7839,17,7856,56
2020-08-31,Napa,055,140530,1505,1434,6,1440,10
2020-08-31,Nevada,057,99092,462,447,13,460,6
2020-08-31,Orange,059,3164182,50826,47392,1212,48604,965
2020-08-31,Placer,061,380077,3182,2989,11,3000,33
2020-08-31,Plumas,063,18699,43,39,0,39,0
2020-08-31,Riverside,065,2383286,54189,52508,67,52575,1020
2020-08-31,Sacramento,067,1510023,18940,17999,17,18016,303
2020-08-31,San Benito,069,59416,1164,1080,0,1080,4
2020-08-31,San Bernardino,071,2135413,49695,47370,316,47686,755
2020-08-31,San Diego,073,3302833,40645,38606,498,39104,682
2020-08-31,San Francisco,075,870044,9856,9293,13,9306,83
2020-08-31,San Joaquin,077,732212,18795,17807,37,17844,338
2020-08-31,San Luis Obispo,079,281455,3213,2951,13,2964,21
2020-08-31,San Mateo,081,765935,8792,8065,10,8075,122
2020-08-31,Santa Barbara,083,443738,8365,8124,68,8192,94
2020-08-31,Santa Clara,085,1922200,18998,17211,38,17249,202
2020-08-31,Santa Cruz,087,273765,1947,1742,16,1758,7
2020-08-31,Shasta,089,179085,637,528,3,531,9
2020-08-31,Sierra,091,2930,6,6,0,6,0
2020-08-31,Siskiyou,093,43540,140,127,8,135,0
2020-08-31,Solano,095,438530,5632,5302,37,5339,34
2020-08-31,Sonoma,097,501317,6180,5650,20,5670,60
2020-08-31,Stanislaus,099,539301,15425,14685,361,15046,213
2020-08-31,Sutter,101,95872,1441,1365,1,1366,10
2020-08-31,Tehama,103,63373,447,421,2,423,1
2020-08-31,Trinity,105,12862,47,13,6,19,0
2020-08-31,Tulare,107,460477,14878,13985,56,14041,237
2020-08-31,Tuolumne,109,53932,211,178,5,183,1
2020-08-31,Ventura,111,848112,11591,10866,104,10970,108
2020-08-31,Yolo,113,214977,2565,2423,5,2428,51
2020-08-31,Yuba,115,75493,918,830,3,833,1
2020-08-30,Alameda,001,1643700,19161,18099,125,18224,248
2020-08-30,Alpine,003,1148,2,2,0,2,0
2020-08-30,Amador,005,37829,274,240,0,240,13
2020-08-30,Butte,007,227075,2346,1988,45,2033,26
2020-08-30,Calaveras,009,45235,261,211,0,211,1
2020-08-30,Colusa,011,21464,474,440,0,440,6
2020-08-30,Contra Costa,013,1133247,14750,13780,52,13832,150
2020-08-30,Del Norte,015,27424,115,108,0,108,2
2020-08-30,El Dorado,017,186661,1023,962,7,969,2
2020-08-30,Fresno,019,978130,27992,24963,300,25263,291
2020-08-30,Glenn,021,27897,472,437,0,437,3
2020-08-30,Humboldt,023,135768,414,362,1,363,4
2020-08-30,Imperial,025,180216,11299,9703,7,9710,250
2020-08-30,Inyo,027,18085,181,160,4,164,3
2020-08-30,Kern,029,883053,29991,28987,234,29221,317
2020-08-30,Kings,031,150075,6425,6000,30,6030,62
2020-08-30,Lake,033,64148,362,334,0,334,2
2020-08-30,Lassen,035,31185,722,706,2,708,0
2020-08-30,Los Angeles,037,10098052,244802,240775,1282,242057,5772
2020-08-30,Madera,039,155013,3962,3626,26,3652,33
2020-08-30,Marin,041,260295,6257,6060,15,6075,66
2020-08-30,Mariposa,043,17540,73,69,0,69,2
2020-08-30,Mendocino,045,87422,656,611,0,611,13
2020-08-30,Merced,047,269075,8152,7960,9,7969,79
2020-08-30,Modoc,049,8938,13,10,0,10,0
2020-08-30,Mono,051,14174,163,145,3,148,1
2020-08-30,Monterey,053,433212,8303,7816,17,7833,54
2020-08-30,Napa,055,140530,1493,1423,6,1429,10
2020-08-30,Nevada,057,99092,459,445,13,458,6
2020-08-30,Orange,059,3164182,50629,47283,1198,48481,965
2020-08-30,Placer,061,380077,3149,2961,11,2972,32
2020-08-30,Plumas,063,18699,42,39,0,39,0
2020-08-30,Riverside,065,2383286,54010,52227,66,52293,1017
2020-08-30,Sacramento,067,1510023,18763,17751,17,17768,300
2020-08-30,San Benito,069,59416,1154,1071,0,1071,4
2020-08-30,San Bernardino,071,2135413,49438,47201,316,47517,755
2020-08-30,San Diego,073,3302833,40247,38302,477,38779,682
2020-08-30,San Francisco,075,870044,9759,9294,10,9304,83
2020-08-30,San Joaquin,077,732212,18678,17637,36,17673,338
2020-08-30,San Luis Obispo,079,281455,3188,2934,13,2947,21
2020-08-30,San Mateo,081,765935,8715,8013,10,8023,122
2020-08-30,Santa Barbara,083,443738,8306,8088,68,8156,93
2020-08-30,Santa Clara,085,1922200,18824,17045,38,17083,202
2020-08-30,Santa Cruz,087,273765,1921,1743,16,1759,7
2020-08-30,Shasta,089,179085,634,525,3,528,9
2020-08-30,Sierra,091,2930,6,6,0,6,0
2020-08-30,Siskiyou,093,43540,138,125,8,133,0
2020-08-30,Solano,095,438530,5589,5303,37,5340,34
2020-08-30,Sonoma,097,501317,6120,5590,20,5610,60
2020-08-30,Stanislaus,099,539301,15353,14580,352,14932,209
2020-08-30,Sutter,101,95872,1420,1351,1,1352,10
2020-08-30,Tehama,103,63373,437,419,2,421,1
2020-08-30,Trinity,105,12862,47,13,6,19,0
2020-08-30,Tulare,107,460477,14783,13985,55,14040,236
2020-08-30,Tuolumne,109,53932,207,178,5,183,1
2020-08-30,Ventura,111,848112,11478,10775,99,10874,108
2020-08-30,Yolo,113,214977,2537,2391,4,2395,51
2020-08-30,Yuba,115,75493,904,832,3,835,1
2020-08-29,Alameda,001,1643700,19094,17888,125,18013,250
2020-08-29,Alpine,003,1148,2,2,0,2,0
2020-08-29,Amador,005,37829,274,239,0,239,13
2020-08-29,Butte,007,227075,2315,1948,45,1993,26
2020-08-29,Calaveras,009,45235,257,211,0,211,1
2020-08-29,Colusa,011,21464,471,440,0,440,6
2020-08-29,Contra Costa,013,1133247,14677,13663,51,13714,159
2020-08-29,Del Norte,015,27424,115,108,0,108,1
2020-08-29,El Dorado,017,186661,1020,958,7,965,2
2020-08-29,Fresno,019,978130,27937,24821,300,25121,291
2020-08-29,Glenn,021,27897,466,437,0,437,3
2020-08-29,Humboldt,023,135768,411,363,1,364,4
2020-08-29,Imperial,025,180216,11284,9698,7,9705,250
2020-08-29,Inyo,027,18085,181,160,4,164,3
2020-08-29,Kern,029,883053,29951,28947,233,29180,317
2020-08-29,Kings,031,150075,6410,5906,30,5936,62
2020-08-29,Lake,033,64148,361,329,0,329,2
2020-08-29,Lassen,035,31185,722,706,2,708,0
2020-08-29,Los Angeles,037,10098052,244173,239815,1269,241084,5762
2020-08-29,Madera,039,155013,3953,3605,25,3630,33
2020-08-29,Marin,041,260295,6245,6007,15,6022,64
2020-08-29,Mariposa,043,17540,73,69,0,69,2
2020-08-29,Mendocino,045,87422,652,596,0,596,13
2020-08-29,Merced,047,269075,8122,7867,9,7876,79
2020-08-29,Modoc,049,8938,13,9,0,9,0
2020-08-29,Mono,051,14174,163,145,3,148,1
2020-08-29,Monterey,053,433212,8258,7680,17,7697,53
2020-08-29,Napa,055,140530,1490,1413,6,1419,10
2020-08-29,Nevada,057,99092,459,442,13,455,5
2020-08-29,Orange,059,3164182,50518,47007,1188,48195,960
2020-08-29,Placer,061,380077,3132,2935,11,2946,32
2020-08-29,Plumas,063,18699,41,39,0,39,0
2020-08-29,Riverside,065,2383286,53898,51918,64,51982,1016
2020-08-29,Sacramento,067,1510023,18692,17588,17,17605,291
2020-08-29,San Benito,069,59416,1145,1045,0,1045,4
2020-08-29,San Bernardino,071,2135413,49323,46849,316,47165,755
2020-08-29,San Diego,073,3302833,39981,38049,459,38508,694
2020-08-29,San Francisco,075,870044,9731,9291,9,9300,83
2020-08-29,San Joaquin,077,732212,18634,17493,36,17529,335
2020-08-29,San Luis Obispo,079,281455,3163,2917,13,2930,21
2020-08-29,San Mateo,081,765935,8673,7928,10,7938,122
2020-08-29,Santa Barbara,083,443738,8279,8052,67,8119,93
2020-08-29,Santa Clara,085,1922200,18724,16898,37,16935,202
2020-08-29,Santa Cruz,087,273765,1909,1746,16,1762,7
2020-08-29,Shasta,089,179085,626,522,3,525,9
2020-08-29,Sierra,091,2930,6,6,0,6,0
2020-08-29,Siskiyou,093,43540,138,121,8,129,0
2020-08-29,Solano,095,438530,5568,5303,37,5340,34
2020-08-29,Sonoma,097,501317,6085,5537,20,5557,60
2020-08-29,Stanislaus,099,539301,15304,14479,342,14821,208
2020-08-29,Sutter,101,95872,1415,1333,1,1334,9
2020-08-29,Tehama,103,63373,436,417,2,419,1
2020-08-29,Trinity,105,12862,46,11,6,17,0
2020-08-29,Tulare,107,460477,14745,13890,54,13944,236
2020-08-29,Tuolumne,109,53932,207,178,5,183,1
2020-08-29,Ventura,111,848112,11436,10705,99,10804,108
2020-08-29,Yolo,113,214977,2519,2357,4,2361,51
2020-08-29,Yuba,115,75493,895,822,3,825,1
2020-08-28,Alameda,001,1643700,19011,17729,124,17853,237
2020-08-28,Alpine,003,1148,2,2,0,2,0
2020-08-28,Amador,005,37829,274,234,0,234,13
2020-08-28,Butte,007,227075,2285,1886,45,1931,25
2020-08-28,Calaveras,009,45235,255,207,0,207,1
2020-08-28,Colusa,011,21464,470,441,0,441,6
2020-08-28,Contra Costa,013,1133247,14606,13522,50,13572,158
2020-08-28,Del Norte,015,27424,115,107,0,107,1
2020-08-28,El Dorado,017,186661,1014,949,7,956,2
2020-08-28,Fresno,019,978130,27802,24612,300,24912,282
2020-08-28,Glenn,021,27897,459,429,0,429,3
2020-08-28,Humboldt,023,135768,407,362,1,363,4
2020-08-28,Imperial,025,180216,11270,9656,7,9663,241
2020-08-28,Inyo,027,18085,180,160,4,164,2
2020-08-28,Kern,029,883053,29903,28744,233,28977,306
2020-08-28,Kings,031,150075,6403,5829,29,5858,62
2020-08-28,Lake,033,64148,356,320,0,320,2
2020-08-28,Lassen,035,31185,722,704,2,706,0
2020-08-28,Los Angeles,037,10098052,243359,238544,1244,239788,5740
2020-08-28,Madera,039,155013,3934,3552,25,3577,33
2020-08-28,Marin,041,260295,6223,5991,15,6006,63
2020-08-28,Mariposa,043,17540,73,67,0,67,2
2020-08-28,Mendocino,045,87422,647,588,0,588,11
2020-08-28,Merced,047,269075,8092,7803,9,7812,77
2020-08-28,Modoc,049,8938,13,6,0,6,0
2020-08-28,Mono,051,14174,163,145,3,148,1
2020-08-28,Monterey,053,433212,8201,7591,17,7608,53
2020-08-28,Napa,055,140530,1482,1403,5,1408,10
2020-08-28,Nevada,057,99092,458,438,13,451,5
2020-08-28,Orange,059,3164182,50418,46696,1173,47869,942
2020-08-28,Placer,061,380077,3122,2891,11,2902,32
2020-08-28,Plumas,063,18699,41,39,0,39,0
2020-08-28,Riverside,065,2383286,53767,51510,60,51570,1008
2020-08-28,Sacramento,067,1510023,18594,17119,17,17136,283
2020-08-28,San Benito,069,59416,1129,1016,0,1016,3
2020-08-28,San Bernardino,071,2135413,49204,46553,312,46865,754
2020-08-28,San Diego,073,3302833,39751,37786,444,38230,676
2020-08-28,San Francisco,075,870044,9679,9135,9,9144,83
2020-08-28,San Joaquin,077,732212,18581,17114,35,17149,314
2020-08-28,San Luis Obispo,079,281455,3146,2849,13,2862,20
2020-08-28,San Mateo,081,765935,8627,7783,9,7792,121
2020-08-28,Santa Barbara,083,443738,8247,8001,67,8068,92
2020-08-28,Santa Clara,085,1922200,18597,16696,37,16733,201
2020-08-28,Santa Cruz,087,273765,1897,1747,16,1763,7
2020-08-28,Shasta,089,179085,622,516,3,519,9
2020-08-28,Sierra,091,2930,6,6,0,6,0
2020-08-28,Siskiyou,093,43540,136,119,8,127,0
2020-08-28,Solano,095,438530,5549,5219,37,5256,34
2020-08-28,Sonoma,097,501317,6050,5425,19,5444,58
2020-08-28,Stanislaus,099,539301,15261,14176,338,14514,190
2020-08-28,Sutter,101,95872,1405,1308,1,1309,9
2020-08-28,Tehama,103,63373,431,410,2,412,1
2020-08-28,Trinity,105,12862,46,11,6,17,0
2020-08-28,Tulare,107,460477,14700,13776,54,13830,236
2020-08-28,Tuolumne,109,53932,207,176,5,181,1
2020-08-28,Ventura,111,848112,11400,10606,97,10703,103
2020-08-28,Yolo,113,214977,2510,2323,4,2327,51
2020-08-28,Yuba,115,75493,886,810,3,813,1
2020-08-27,Alameda,001,1643700,18866,17584,121,17705,234
2020-08-27,Alpine,003,1148,2,2,0,2,0
2020-08-27,Amador,005,37829,273,233,0,233,13
2020-08-27,Butte,007,227075,2219,1803,44,1847,25
2020-08-27,Calaveras,009,45235,250,204,0,204,1
2020-08-27,Colusa,011,21464,468,438,0,438,6
2020-08-27,Contra Costa,013,1133247,14506,13379,49,13428,158
2020-08-27,Del Norte,015,27424,115,107,0,107,1
2020-08-27,El Dorado,017,186661,1010,942,7,949,2
2020-08-27,Fresno,019,978130,27622,24367,295,24662,272
2020-08-27,Glenn,021,27897,451,429,0,429,3
2020-08-27,Humboldt,023,135768,399,358,1,359,4
2020-08-27,Imperial,025,180216,11243,9608,7,9615,235
2020-08-27,Inyo,027,18085,180,157,3,160,2
2020-08-27,Kern,029,883053,29832,28635,224,28859,294
2020-08-27,Kings,031,150075,6381,5759,29,5788,62
2020-08-27,Lake,033,64148,354,314,0,314,2
2020-08-27,Lassen,035,31185,722,703,2,705,0
2020-08-27,Los Angeles,037,10098052,242356,237103,1229,238332,5704
2020-08-27,Madera,039,155013,3908,3465,25,3490,33
2020-08-27,Marin,041,260295,6199,5929,15,5944,62
2020-08-27,Mariposa,043,17540,73,67,0,67,2
2020-08-27,Mendocino,045,87422,638,581,0,581,10
2020-08-27,Merced,047,269075,8048,7765,9,7774,75
2020-08-27,Modoc,049,8938,11,5,0,5,0
2020-08-27,Mono,051,14174,163,145,3,148,1
2020-08-27,Monterey,053,433212,8107,7501,17,7518,52
2020-08-27,Napa,055,140530,1476,1397,5,1402,10
2020-08-27,Nevada,057,99092,455,435,13,448,5
2020-08-27,Orange,059,3164182,50261,46449,1162,47611,935
2020-08-27,Placer,061,380077,3091,2869,11,2880,32
2020-08-27,Plumas,063,18699,40,39,0,39,0
2020-08-27,Riverside,065,2383286,53557,51306,57,51363,999
2020-08-27,Sacramento,067,1510023,18396,16875,17,16892,281
2020-08-27,San Benito,069,59416,1113,987,0,987,3
2020-08-27,San Bernardino,071,2135413,48980,46345,306,46651,751
2020-08-27,San Diego,073,3302833,39480,37501,424,37925,673
2020-08-27,San Francisco,075,870044,9613,9014,9,9023,83
2020-08-27,San Joaquin,077,732212,18501,16989,35,17024,314
2020-08-27,San Luis Obispo,079,281455,3121,2808,13,2821,20
2020-08-27,San Mateo,081,765935,8518,7728,9,7737,121
2020-08-27,Santa Barbara,083,443738,8209,7934,67,8001,92
2020-08-27,Santa Clara,085,1922200,18411,16495,37,16532,199
2020-08-27,Santa Cruz,087,273765,1880,1734,16,1750,7
2020-08-27,Shasta,089,179085,616,512,3,515,9
2020-08-27,Sierra,091,2930,6,6,0,6,0
2020-08-27,Siskiyou,093,43540,136,118,8,126,0
2020-08-27,Solano,095,438530,5511,5167,37,5204,34
2020-08-27,Sonoma,097,501317,5943,5357,19,5376,58
2020-08-27,Stanislaus,099,539301,15180,14080,335,14415,186
2020-08-27,Sutter,101,95872,1385,1296,1,1297,9
2020-08-27,Tehama,103,63373,427,398,2,400,1
2020-08-27,Trinity,105,12862,46,11,6,17,0
2020-08-27,Tulare,107,460477,14609,13666,54,13720,231
2020-08-27,Tuolumne,109,53932,202,174,5,179,1
2020-08-27,Ventura,111,848112,11337,10483,93,10576,102
2020-08-27,Yolo,113,214977,2486,2293,4,2297,51
2020-08-27,Yuba,115,75493,875,807,3,810,1
2020-08-26,Alameda,001,1643700,18703,17373,121,17494,233
2020-08-26,Alpine,003,1148,2,2,0,2,0
2020-08-26,Amador,005,37829,273,229,0,229,13
2020-08-26,Butte,007,227075,2151,1765,42,1807,25
2020-08-26,Calaveras,009,45235,242,201,0,201,1
2020-08-26,Colusa,011,21464,462,433,0,433,5
2020-08-26,Contra Costa,013,1133247,14369,13248,49,13297,157
2020-08-26,Del Norte,015,27424,114,86,0,86,1
2020-08-26,El Dorado,017,186661,1008,938,7,945,2
2020-08-26,Fresno,019,978130,27475,24071,293,24364,255
2020-08-26,Glenn,021,27897,449,429,0,429,3
2020-08-26,Humboldt,023,135768,387,357,1,358,4
2020-08-26,Imperial,025,180216,11221,9453,7,9460,227
2020-08-26,Inyo,027,18085,177,157,3,160,2
2020-08-26,Kern,029,883053,29693,28507,221,28728,286
2020-08-26,Kings,031,150075,6360,5720,29,5749,62
2020-08-26,Lake,033,64148,349,308,0,308,2
2020-08-26,Lassen,035,31185,722,702,2,704,0
2020-08-26,Los Angeles,037,10098052,241346,235499,1199,236698,5665
2020-08-26,Madera,039,155013,3879,3458,25,3483,32
2020-08-26,Marin,041,260295,6182,5887,15,5902,56
2020-08-26,Mariposa,043,17540,73,68,0,68,2
2020-08-26,Mendocino,045,87422,627,581,0,581,10
2020-08-26,Merced,047,269075,8015,7720,9,7729,74
2020-08-26,Modoc,049,8938,8,5,0,5,0
2020-08-26,Mono,051,14174,163,141,3,144,1
2020-08-26,Monterey,053,433212,8014,7439,17,7456,51
2020-08-26,Napa,055,140530,1463,1382,5,1387,10
2020-08-26,Nevada,057,99092,452,432,13,445,2
2020-08-26,Orange,059,3164182,50077,46157,1146,47303,905
2020-08-26,Placer,061,380077,3068,2846,9,2855,32
2020-08-26,Plumas,063,18699,39,39,0,39,0
2020-08-26,Riverside,065,2383286,53316,51138,57,51195,987
2020-08-26,Sacramento,067,1510023,18233,16708,17,16725,271
2020-08-26,San Benito,069,59416,1098,978,0,978,3
2020-08-26,San Bernardino,071,2135413,48773,45840,302,46142,743
2020-08-26,San Diego,073,3302833,39142,37224,397,37621,668
2020-08-26,San Francisco,075,870044,9539,8938,9,8947,81
2020-08-26,San Joaquin,077,732212,18412,16845,34,16879,309
2020-08-26,San Luis Obispo,079,281455,3093,2761,13,2774,20
2020-08-26,San Mateo,081,765935,8451,7655,9,7664,121
2020-08-26,Santa Barbara,083,443738,8175,7904,67,7971,90
2020-08-26,Santa Clara,085,1922200,18234,16283,37,16320,198
2020-08-26,Santa Cruz,087,273765,1869,1726,16,1742,7
2020-08-26,Shasta,089,179085,611,511,3,514,9
2020-08-26,Sierra,091,2930,6,6,0,6,0
2020-08-26,Siskiyou,093,43540,133,109,8,117,0
2020-08-26,Solano,095,438530,5487,5131,36,5167,34
2020-08-26,Sonoma,097,501317,5870,5283,19,5302,58
2020-08-26,Stanislaus,099,539301,15103,13964,329,14293,186
2020-08-26,Sutter,101,95872,1367,1275,1,1276,9
2020-08-26,Tehama,103,63373,424,396,2,398,1
2020-08-26,Trinity,105,12862,45,10,6,16,0
2020-08-26,Tulare,107,460477,14542,13568,54,13622,232
2020-08-26,Tuolumne,109,53932,201,172,5,177,1
2020-08-26,Ventura,111,848112,11265,10412,86,10498,100
2020-08-26,Yolo,113,214977,2465,2279,4,2283,49
2020-08-26,Yuba,115,75493,860,779,3,782,1
2020-08-25,Alameda,001,1643700,18546,17278,121,17399,232
2020-08-25,Alpine,003,1148,2,2,0,2,0
2020-08-25,Amador,005,37829,273,227,0,227,13
2020-08-25,Butte,007,227075,2084,1718,41,1759,24
2020-08-25,Calaveras,009,45235,240,196,0,196,1
2020-08-25,Colusa,011,21464,455,430,0,430,5
2020-08-25,Contra Costa,013,1133247,14231,13181,48,13229,156
2020-08-25,Del Norte,015,27424,113,83,0,83,1
2020-08-25,El Dorado,017,186661,1005,928,7,935,2
2020-08-25,Fresno,019,978130,27288,23932,292,24224,250
2020-08-25,Glenn,021,27897,446,429,0,429,3
2020-08-25,Humboldt,023,135768,382,342,1,343,4
2020-08-25,Imperial,025,180216,11193,9381,7,9388,217
2020-08-25,Inyo,027,18085,175,144,3,147,1
2020-08-25,Kern,029,883053,29556,28416,221,28637,285
2020-08-25,Kings,031,150075,6203,5702,29,5731,59
2020-08-25,Lake,033,64148,344,304,0,304,2
2020-08-25,Lassen,035,31185,721,692,2,694,0
2020-08-25,Los Angeles,037,10098052,240047,233961,1151,235112,5612
2020-08-25,Madera,039,155013,3864,3446,24,3470,32
2020-08-25,Marin,041,260295,6144,5860,15,5875,56
2020-08-25,Mariposa,043,17540,73,67,0,67,2
2020-08-25,Mendocino,045,87422,619,571,0,571,10
2020-08-25,Merced,047,269075,7948,7693,8,7701,69
2020-08-25,Modoc,049,8938,8,5,0,5,0
2020-08-25,Mono,051,14174,163,129,3,132,1
2020-08-25,Monterey,053,433212,7933,7333,17,7350,51
2020-08-25,Napa,055,140530,1456,1374,5,1379,10
2020-08-25,Nevada,057,99092,448,430,13,443,2
2020-08-25,Orange,059,3164182,49883,45737,1130,46867,902
2020-08-25,Placer,061,380077,3049,2829,6,2835,31
2020-08-25,Plumas,063,18699,39,39,0,39,0
2020-08-25,Riverside,065,2383286,53085,50889,57,50946,981
2020-08-25,Sacramento,067,1510023,18079,16601,17,16618,265
2020-08-25,San Benito,069,59416,1082,973,0,973,3
2020-08-25,San Bernardino,071,2135413,48538,45544,299,45843,727
2020-08-25,San Diego,073,3302833,38863,36996,375,37371,665
2020-08-25,San Francisco,075,870044,9462,8848,9,8857,81
2020-08-25,San Joaquin,077,732212,18284,16795,34,16829,306
2020-08-25,San Luis Obispo,079,281455,3034,2731,12,2743,20
2020-08-25,San Mateo,081,765935,8391,7636,8,7644,120
2020-08-25,Santa Barbara,083,443738,8123,7854,67,7921,90
2020-08-25,Santa Clara,085,1922200,18065,16199,37,16236,194
2020-08-25,Santa Cruz,087,273765,1850,1708,16,1724,7
2020-08-25,Shasta,089,179085,607,511,3,514,9
2020-08-25,Sierra,091,2930,6,6,0,6,0
2020-08-25,Siskiyou,093,43540,132,109,8,117,0
2020-08-25,Solano,095,438530,5426,5114,36,5150,34
2020-08-25,Sonoma,097,501317,5784,5148,19,5167,56
2020-08-25,Stanislaus,099,539301,14995,13886,318,14204,182
2020-08-25,Sutter,101,95872,1350,1259,1,1260,9
2020-08-25,Tehama,103,63373,421,394,2,396,1
2020-08-25,Trinity,105,12862,44,10,6,16,0
2020-08-25,Tulare,107,460477,14438,13514,53,13567,224
2020-08-25,Tuolumne,109,53932,199,172,5,177,1
2020-08-25,Ventura,111,848112,11180,10313,81,10394,99
2020-08-25,Yolo,113,214977,2452,2254,4,2258,50
2020-08-25,Yuba,115,75493,850,775,3,778,1
2020-08-24,Alameda,001,1643700,18351,16913,120,17033,231
2020-08-24,Alpine,003,1148,2,2,0,2,0
2020-08-24,Amador,005,37829,271,227,0,227,13
2020-08-24,Butte,007,227075,2001,1649,41,1690,23
2020-08-24,Calaveras,009,45235,231,187,0,187,1
2020-08-24,Colusa,011,21464,451,425,0,425,5
2020-08-24,Contra Costa,013,1133247,14114,12906,46,12952,153
2020-08-24,Del Norte,015,27424,113,80,0,80,1
2020-08-24,El Dorado,017,186661,997,908,7,915,2
2020-08-24,Fresno,019,978130,27099,23618,285,23903,235
2020-08-24,Glenn,021,27897,444,421,0,421,2
2020-08-24,Humboldt,023,135768,378,340,1,341,4
2020-08-24,Imperial,025,180216,11160,9323,7,9330,210
2020-08-24,Inyo,027,18085,171,144,3,147,2
2020-08-24,Kern,029,883053,29458,28157,215,28372,277
2020-08-24,Kings,031,150075,6115,5652,29,5681,60
2020-08-24,Lake,033,64148,329,302,0,302,2
2020-08-24,Lassen,035,31185,721,693,2,695,0
2020-08-24,Los Angeles,037,10098052,238682,233036,1135,234171,5562
2020-08-24,Madera,039,155013,3836,3418,24,3442,32
2020-08-24,Marin,041,260295,6079,5834,15,5849,56
2020-08-24,Mariposa,043,17540,71,66,0,66,2
2020-08-24,Mendocino,045,87422,604,550,0,550,10
2020-08-24,Merced,047,269075,7870,7605,8,7613,69
2020-08-24,Modoc,049,8938,8,5,0,5,0
2020-08-24,Mono,051,14174,163,129,3,132,1
2020-08-24,Monterey,053,433212,7824,7212,16,7228,50
2020-08-24,Napa,055,140530,1443,1358,5,1363,10
2020-08-24,Nevada,057,99092,443,423,13,436,2
2020-08-24,Orange,059,3164182,49690,45536,1121,46657,887
2020-08-24,Placer,061,380077,3002,2793,6,2799,31
2020-08-24,Plumas,063,18699,39,37,0,37,0
2020-08-24,Riverside,065,2383286,52807,50496,57,50553,975
2020-08-24,Sacramento,067,1510023,17883,16318,16,16334,249
2020-08-24,San Benito,069,59416,1061,961,0,961,3
2020-08-24,San Bernardino,071,2135413,48275,45199,297,45496,720
2020-08-24,San Diego,073,3302833,38575,36729,347,37076,660
2020-08-24,San Francisco,075,870044,9379,8621,9,8630,81
2020-08-24,San Joaquin,077,732212,18143,16565,33,16598,305
2020-08-24,San Luis Obispo,079,281455,3006,2705,12,2717,20
2020-08-24,San Mateo,081,765935,8324,7502,8,7510,120
2020-08-24,Santa Barbara,083,443738,8082,7784,67,7851,90
2020-08-24,Santa Clara,085,1922200,17861,16049,37,16086,192
2020-08-24,Santa Cruz,087,273765,1830,1627,15,1642,6
2020-08-24,Shasta,089,179085,605,505,3,508,9
2020-08-24,Sierra,091,2930,6,6,0,6,0
2020-08-24,Siskiyou,093,43540,128,107,8,115,0
2020-08-24,Solano,095,438530,5377,4979,34,5013,32
2020-08-24,Sonoma,097,501317,5680,5071,19,5090,56
2020-08-24,Stanislaus,099,539301,14897,13521,304,13825,171
2020-08-24,Sutter,101,95872,1331,1219,1,1220,9
2020-08-24,Tehama,103,63373,416,388,2,390,1
2020-08-24,Trinity,105,12862,44,10,6,16,0
2020-08-24,Tulare,107,460477,14330,13360,52,13412,223
2020-08-24,Tuolumne,109,53932,198,170,5,175,1
2020-08-24,Ventura,111,848112,11100,10261,77,10338,99
2020-08-24,Yolo,113,214977,2418,2239,4,2243,47
2020-08-24,Yuba,115,75493,833,750,3,753,1
2020-08-23,Alameda,001,1643700,18128,16786,119,16905,231
2020-08-23,Alpine,003,1148,2,2,0,2,0
2020-08-23,Amador,005,37829,268,227,0,227,13
2020-08-23,Butte,007,227075,1886,1637,41,1678,23
2020-08-23,Calaveras,009,45235,222,187,0,187,1
2020-08-23,Colusa,011,21464,444,424,0,424,5
2020-08-23,Contra Costa,013,1133247,13952,12642,46,12688,153
2020-08-23,Del Norte,015,27424,113,80,0,80,1
2020-08-23,El Dorado,017,186661,984,901,7,908,2
2020-08-23,Fresno,019,978130,26894,23414,282,23696,235
2020-08-23,Glenn,021,27897,437,421,0,421,2
2020-08-23,Humboldt,023,135768,376,341,1,342,4
2020-08-23,Imperial,025,180216,11131,9243,7,9250,210
2020-08-23,Inyo,027,18085,168,144,3,147,2
2020-08-23,Kern,029,883053,29309,28028,210,28238,277
2020-08-23,Kings,031,150075,6072,5628,29,5657,60
2020-08-23,Lake,033,64148,325,299,0,299,2
2020-08-23,Lassen,035,31185,720,693,2,695,0
2020-08-23,Los Angeles,037,10098052,237081,231833,1068,232901,5549
2020-08-23,Madera,039,155013,3805,3401,23,3424,32
2020-08-23,Marin,041,260295,6042,5807,14,5821,50
2020-08-23,Mariposa,043,17540,71,66,0,66,2
2020-08-23,Mendocino,045,87422,600,550,0,550,10
2020-08-23,Merced,047,269075,7801,7574,7,7581,69
2020-08-23,Modoc,049,8938,7,5,0,5,0
2020-08-23,Mono,051,14174,163,129,3,132,1
2020-08-23,Monterey,053,433212,7734,7173,16,7189,50
2020-08-23,Napa,055,140530,1431,1348,5,1353,10
2020-08-23,Nevada,057,99092,438,421,13,434,2
2020-08-23,Orange,059,3164182,49452,45267,1109,46376,887
2020-08-23,Placer,061,380077,2963,2772,6,2778,31
2020-08-23,Plumas,063,18699,39,37,0,37,0
2020-08-23,Riverside,065,2383286,52537,50293,55,50348,955
2020-08-23,Sacramento,067,1510023,17660,16084,15,16099,243
2020-08-23,San Benito,069,59416,1048,938,0,938,3
2020-08-23,San Bernardino,071,2135413,48007,45010,287,45297,719
2020-08-23,San Diego,073,3302833,38254,36542,320,36862,660
2020-08-23,San Francisco,075,870044,9285,8564,8,8572,80
2020-08-23,San Joaquin,077,732212,18010,16069,32,16101,305
2020-08-23,San Luis Obispo,079,281455,2964,2679,12,2691,20
2020-08-23,San Mateo,081,765935,8229,7450,8,7458,120
2020-08-23,Santa Barbara,083,443738,8014,7725,67,7792,90
2020-08-23,Santa Clara,085,1922200,17665,15912,35,15947,191
2020-08-23,Santa Cruz,087,273765,1804,1627,15,1642,6
2020-08-23,Shasta,089,179085,600,501,3,504,9
2020-08-23,Sierra,091,2930,6,6,0,6,0
2020-08-23,Siskiyou,093,43540,123,107,8,115,0
2020-08-23,Solano,095,438530,5319,4977,32,5009,32
2020-08-23,Sonoma,097,501317,5592,5018,19,5037,56
2020-08-23,Stanislaus,099,539301,14762,13483,281,13764,171
2020-08-23,Sutter,101,95872,1309,1203,1,1204,9
2020-08-23,Tehama,103,63373,406,381,2,383,1
2020-08-23,Trinity,105,12862,44,10,6,16,0
2020-08-23,Tulare,107,460477,14198,13303,49,13352,223
2020-08-23,Tuolumne,109,53932,195,164,5,169,1
2020-08-23,Ventura,111,848112,10999,10126,73,10199,99
2020-08-23,Yolo,113,214977,2390,2210,4,2214,47
2020-08-23,Yuba,115,75493,812,750,3,753,1
2020-08-22,Alameda,001,1643700,18034,16648,118,16766,231
2020-08-22,Alpine,003,1148,2,2,0,2,0
2020-08-22,Amador,005,37829,267,224,0,224,13
2020-08-22,Butte,007,227075,1835,1618,41,1659,22
2020-08-22,Calaveras,009,45235,218,187,0,187,1
2020-08-22,Colusa,011,21464,440,419,0,419,5
2020-08-22,Contra Costa,013,1133247,13865,12522,46,12568,153
2020-08-22,Del Norte,015,27424,112,80,0,80,1
2020-08-22,El Dorado,017,186661,982,900,7,907,2
2020-08-22,Fresno,019,978130,26796,23197,281,23478,235
2020-08-22,Glenn,021,27897,436,421,0,421,2
2020-08-22,Humboldt,023,135768,366,334,1,335,4
2020-08-22,Imperial,025,180216,11123,9244,7,9251,210
2020-08-22,Inyo,027,18085,168,144,3,147,1
2020-08-22,Kern,029,883053,29255,27807,210,28017,277
2020-08-22,Kings,031,150075,6063,5447,29,5476,60
2020-08-22,Lake,033,64148,323,291,0,291,2
2020-08-22,Lassen,035,31185,720,693,2,695,0
2020-08-22,Los Angeles,037,10098052,236420,230858,1052,231910,5540
2020-08-22,Madera,039,155013,3786,3330,23,3353,32
2020-08-22,Marin,041,260295,6030,5789,14,5803,49
2020-08-22,Mariposa,043,17540,71,66,0,66,2
2020-08-22,Mendocino,045,87422,597,529,0,529,10
2020-08-22,Merced,047,269075,7773,7493,7,7500,69
2020-08-22,Modoc,049,8938,7,5,0,5,0
2020-08-22,Mono,051,14174,163,129,3,132,1
2020-08-22,Monterey,053,433212,7686,7081,16,7097,50
2020-08-22,Napa,055,140530,1426,1328,5,1333,11
2020-08-22,Nevada,057,99092,438,411,13,424,2
2020-08-22,Orange,059,3164182,49311,45131,1103,46234,885
2020-08-22,Placer,061,380077,2949,2734,6,2740,30
2020-08-22,Plumas,063,18699,39,37,0,37,0
2020-08-22,Riverside,065,2383286,52389,49944,54,49998,953
2020-08-22,Sacramento,067,1510023,17548,15516,15,15531,239
2020-08-22,San Benito,069,59416,1032,912,0,912,3
2020-08-22,San Bernardino,071,2135413,47878,44803,283,45086,719
2020-08-22,San Diego,073,3302833,38071,36205,309,36514,673
2020-08-22,San Francisco,075,870044,9225,8568,8,8576,80
2020-08-22,San Joaquin,077,732212,17954,16068,32,16100,305
2020-08-22,San Luis Obispo,079,281455,2938,2660,12,2672,20
2020-08-22,San Mateo,081,765935,8182,7361,8,7369,120
2020-08-22,Santa Barbara,083,443738,7988,7685,67,7752,90
2020-08-22,Santa Clara,085,1922200,17557,15590,35,15625,190
2020-08-22,Santa Cruz,087,273765,1788,1628,14,1642,6
2020-08-22,Shasta,089,179085,598,493,3,496,9
2020-08-22,Sierra,091,2930,6,6,0,6,0
2020-08-22,Siskiyou,093,43540,123,106,8,114,0
2020-08-22,Solano,095,438530,5289,4944,31,4975,32
2020-08-22,Sonoma,097,501317,5546,4891,19,4910,57
2020-08-22,Stanislaus,099,539301,14712,13380,264,13644,170
2020-08-22,Sutter,101,95872,1302,1189,1,1190,8
2020-08-22,Tehama,103,63373,405,368,2,370,1
2020-08-22,Trinity,105,12862,44,8,6,14,0
2020-08-22,Tulare,107,460477,14131,13196,49,13245,222
2020-08-22,Tuolumne,109,53932,193,162,5,167,1
2020-08-22,Ventura,111,848112,10944,9959,71,10030,99
2020-08-22,Yolo,113,214977,2374,2188,4,2192,47
2020-08-22,Yuba,115,75493,800,738,3,741,1
2020-08-21,Alameda,001,1643700,17942,16413,118,16531,232
2020-08-21,Alpine,003,1148,2,2,0,2,0
2020-08-21,Amador,005,37829,266,223,0,223,11
2020-08-21,Butte,007,227075,1796,1582,41,1623,19
2020-08-21,Calaveras,009,45235,218,182,0,182,1
2020-08-21,Colusa,011,21464,438,418,0,418,5
2020-08-21,Contra Costa,013,1133247,13775,12333,45,12378,149
2020-08-21,Del Norte,015,27424,112,78,0,78,1
2020-08-21,El Dorado,017,186661,978,885,7,892,2
2020-08-21,Fresno,019,978130,26626,22840,280,23120,232
2020-08-21,Glenn,021,27897,432,418,0,418,2
2020-08-21,Humboldt,023,135768,363,331,1,332,4
2020-08-21,Imperial,025,180216,11107,9166,7,9173,204
2020-08-21,Inyo,027,18085,168,144,3,147,1
2020-08-21,Kern,029,883053,29196,27567,208,27775,269
2020-08-21,Kings,031,150075,6041,5391,29,5420,60
2020-08-21,Lake,033,64148,321,281,0,281,2
2020-08-21,Lassen,035,31185,720,693,2,695,0
2020-08-21,Los Angeles,037,10098052,235544,229235,1032,230267,5494
2020-08-21,Madera,039,155013,3756,3271,23,3294,31
2020-08-21,Marin,041,260295,6010,5762,14,5776,49
2020-08-21,Mariposa,043,17540,71,66,0,66,2
2020-08-21,Mendocino,045,87422,587,505,0,505,10
2020-08-21,Merced,047,269075,7744,7357,7,7364,69
2020-08-21,Modoc,049,8938,7,5,0,5,0
2020-08-21,Mono,051,14174,163,128,3,131,1
2020-08-21,Monterey,053,433212,7614,6974,16,6990,49
2020-08-21,Napa,055,140530,1417,1317,5,1322,10
2020-08-21,Nevada,057,99092,437,406,13,419,2
2020-08-21,Orange,059,3164182,49170,44625,1094,45719,875
2020-08-21,Placer,061,380077,2933,2698,6,2704,30
2020-08-21,Plumas,063,18699,39,36,0,36,0
2020-08-21,Riverside,065,2383286,52194,49409,54,49463,932
2020-08-21,Sacramento,067,1510023,17425,15247,15,15262,237
2020-08-21,San Benito,069,59416,1022,891,0,891,3
2020-08-21,San Bernardino,071,2135413,47759,44249,279,44528,668
2020-08-21,San Diego,073,3302833,37867,35914,292,36206,652
2020-08-21,San Francisco,075,870044,9175,8375,8,8383,80
2020-08-21,San Joaquin,077,732212,17872,15888,30,15918,301
2020-08-21,San Luis Obispo,079,281455,2915,2640,12,2652,19
2020-08-21,San Mateo,081,765935,8125,7253,8,7261,120
2020-08-21,Santa Barbara,083,443738,7947,7645,67,7712,86
2020-08-21,Santa Clara,085,1922200,17406,15399,35,15434,190
2020-08-21,Santa Cruz,087,273765,1776,1617,14,1631,6
2020-08-21,Shasta,089,179085,598,486,3,489,9
2020-08-21,Sierra,091,2930,6,6,0,6,0
2020-08-21,Siskiyou,093,43540,123,103,6,109,0
2020-08-21,Solano,095,438530,5266,4891,30,4921,32
2020-08-21,Sonoma,097,501317,5476,4816,19,4835,57
2020-08-21,Stanislaus,099,539301,14643,13282,250,13532,161
2020-08-21,Sutter,101,95872,1289,1173,1,1174,8
2020-08-21,Tehama,103,63373,403,357,2,359,1
2020-08-21,Trinity,105,12862,44,8,6,14,0
2020-08-21,Tulare,107,460477,14060,13002,47,13049,217
2020-08-21,Tuolumne,109,53932,185,161,5,166,1
2020-08-21,Ventura,111,848112,10879,9865,69,9934,98
2020-08-21,Yolo,113,214977,2359,2164,4,2168,46
2020-08-21,Yuba,115,75493,796,717,3,720,1
2020-08-20,Alameda,001,1643700,17782,16174,118,16292,229
2020-08-20,Alpine,003,1148,2,2,0,2,0
2020-08-20,Amador,005,37829,264,222,0,222,11
2020-08-20,Butte,007,227075,1747,1549,41,1590,18
2020-08-20,Calaveras,009,45235,215,179,0,179,1
2020-08-20,Colusa,011,21464,436,415,0,415,5
2020-08-20,Contra Costa,013,1133247,13648,12108,44,12152,144
2020-08-20,Del Norte,015,27424,112,78,0,78,1
2020-08-20,El Dorado,017,186661,974,881,7,888,2
2020-08-20,Fresno,019,978130,26445,22535,275,22810,228
2020-08-20,Glenn,021,27897,427,414,0,414,2
2020-08-20,Humboldt,023,135768,358,318,1,319,4
2020-08-20,Imperial,025,180216,11088,9086,7,9093,196
2020-08-20,Inyo,027,18085,167,144,3,147,1
2020-08-20,Kern,029,883053,29028,27337,197,27534,267
2020-08-20,Kings,031,150075,6001,5347,28,5375,59
2020-08-20,Lake,033,64148,316,280,0,280,2
2020-08-20,Lassen,035,31185,719,693,2,695,0
2020-08-20,Los Angeles,037,10098052,234309,227492,1013,228505,5445
2020-08-20,Madera,039,155013,3730,3197,23,3220,31
2020-08-20,Marin,041,260295,5992,5745,14,5759,47
2020-08-20,Mariposa,043,17540,71,67,0,67,2
2020-08-20,Mendocino,045,87422,577,497,0,497,10
2020-08-20,Merced,047,269075,7670,7173,7,7180,68
2020-08-20,Modoc,049,8938,7,5,0,5,0
2020-08-20,Mono,051,14174,163,128,3,131,1
2020-08-20,Monterey,053,433212,7543,6892,16,6908,47
2020-08-20,Napa,055,140530,1411,1306,5,1311,10
2020-08-20,Nevada,057,99092,436,401,13,414,2
2020-08-20,Orange,059,3164182,48943,44299,1084,45383,849
2020-08-20,Placer,061,380077,2917,2681,6,2687,30
2020-08-20,Plumas,063,18699,39,36,0,36,0
2020-08-20,Riverside,065,2383286,51975,48953,53,49006,927
2020-08-20,Sacramento,067,1510023,17182,14992,15,15007,231
2020-08-20,San Benito,069,59416,1009,866,0,866,3
2020-08-20,San Bernardino,071,2135413,47503,43627,275,43902,665
2020-08-20,San Diego,073,3302833,37647,35610,274,35884,644
2020-08-20,San Francisco,075,870044,9089,8262,8,8270,72
2020-08-20,San Joaquin,077,732212,17781,15778,30,15808,297
2020-08-20,San Luis Obispo,079,281455,2895,2590,12,2602,19
2020-08-20,San Mateo,081,765935,8060,7188,8,7196,120
2020-08-20,Santa Barbara,083,443738,7909,7571,67,7638,81
2020-08-20,Santa Clara,085,1922200,17234,15162,35,15197,190
2020-08-20,Santa Cruz,087,273765,1763,1581,14,1595,6
2020-08-20,Shasta,089,179085,597,478,3,481,9
2020-08-20,Sierra,091,2930,6,6,0,6,0
2020-08-20,Siskiyou,093,43540,122,102,1,103,0
2020-08-20,Solano,095,438530,5221,4843,30,4873,31
2020-08-20,Sonoma,097,501317,5404,4737,19,4756,54
2020-08-20,Stanislaus,099,539301,14547,13120,241,13361,161
2020-08-20,Sutter,101,95872,1265,1158,1,1159,8
2020-08-20,Tehama,103,63373,398,350,2,352,1
2020-08-20,Trinity,105,12862,44,8,6,14,0
2020-08-20,Tulare,107,460477,13952,12907,46,12953,217
2020-08-20,Tuolumne,109,53932,181,159,5,164,1
2020-08-20,Ventura,111,848112,10766,9744,68,9812,93
2020-08-20,Yolo,113,214977,2337,2150,4,2154,47
2020-08-20,Yuba,115,75493,779,709,3,712,1
2020-08-19,Alameda,001,1643700,17624,15874,117,15991,226
2020-08-19,Alpine,003,1148,2,2,0,2,0
2020-08-19,Amador,005,37829,263,219,0,219,9
2020-08-19,Butte,007,227075,1704,1517,41,1558,16
2020-08-19,Calaveras,009,45235,213,177,0,177,1
2020-08-19,Colusa,011,21464,435,415,0,415,5
2020-08-19,Contra Costa,013,1133247,13535,11895,43,11938,142
2020-08-19,Del Norte,015,27424,112,78,0,78,1
2020-08-19,El Dorado,017,186661,968,870,7,877,2
2020-08-19,Fresno,019,978130,26256,22167,266,22433,221
2020-08-19,Glenn,021,27897,425,414,0,414,2
2020-08-19,Humboldt,023,135768,355,316,1,317,4
2020-08-19,Imperial,025,180216,11060,9041,7,9048,192
2020-08-19,Inyo,027,18085,165,140,3,143,1
2020-08-19,Kern,029,883053,28911,27142,193,27335,263
2020-08-19,Kings,031,150075,5828,5301,26,5327,59
2020-08-19,Lake,033,64148,313,277,0,277,2
2020-08-19,Lassen,035,31185,711,693,2,695,0
2020-08-19,Los Angeles,037,10098052,233031,226006,973,226979,5399
2020-08-19,Madera,039,155013,3696,3158,21,3179,30
2020-08-19,Marin,041,260295,5969,5723,13,5736,46
2020-08-19,Mariposa,043,17540,71,64,0,64,2
2020-08-19,Mendocino,045,87422,560,495,0,495,8
2020-08-19,Merced,047,269075,7543,7082,4,7086,66
2020-08-19,Modoc,049,8938,7,5,0,5,0
2020-08-19,Mono,051,14174,163,128,3,131,1
2020-08-19,Monterey,053,433212,7443,6693,16,6709,45
2020-08-19,Napa,055,140530,1405,1293,5,1298,10
2020-08-19,Nevada,057,99092,429,398,13,411,2
2020-08-19,Orange,059,3164182,48738,43938,1081,45019,829
2020-08-19,Placer,061,380077,2895,2659,6,2665,28
2020-08-19,Plumas,063,18699,39,36,0,36,0
2020-08-19,Riverside,065,2383286,51725,48741,53,48794,922
2020-08-19,Sacramento,067,1510023,17002,14764,15,14779,229
2020-08-19,San Benito,069,59416,992,853,0,853,3
2020-08-19,San Bernardino,071,2135413,47207,43224,269,43493,661
2020-08-19,San Diego,073,3302833,37397,35378,259,35637,638
2020-08-19,San Francisco,075,870044,9025,8236,8,8244,72
2020-08-19,San Joaquin,077,732212,17659,15677,29,15706,296
2020-08-19,San Luis Obispo,079,281455,2855,2553,12,2565,19
2020-08-19,San Mateo,081,765935,7991,7146,8,7154,119
2020-08-19,Santa Barbara,083,443738,7860,7499,67,7566,80
2020-08-19,Santa Clara,085,1922200,17089,14994,35,15029,189
2020-08-19,Santa Cruz,087,273765,1737,1554,14,1568,6
2020-08-19,Shasta,089,179085,593,475,3,478,9
2020-08-19,Sierra,091,2930,6,6,0,6,0
2020-08-19,Siskiyou,093,43540,121,103,1,104,0
2020-08-19,Solano,095,438530,5180,4807,30,4837,31
2020-08-19,Sonoma,097,501317,5324,4614,19,4633,54
2020-08-19,Stanislaus,099,539301,14444,13084,219,13303,160
2020-08-19,Sutter,101,95872,1231,1146,1,1147,8
2020-08-19,Tehama,103,63373,392,342,2,344,1
2020-08-19,Trinity,105,12862,43,8,6,14,0
2020-08-19,Tulare,107,460477,13854,12756,46,12802,217
2020-08-19,Tuolumne,109,53932,178,159,5,164,1
2020-08-19,Ventura,111,848112,10674,9587,66,9653,91
2020-08-19,Yolo,113,214977,2315,2126,4,2130,47
2020-08-19,Yuba,115,75493,767,701,3,704,1
2020-08-18,Alameda,001,1643700,17446,15627,115,15742,223
2020-08-18,Alpine,003,1148,2,2,0,2,0
2020-08-18,Amador,005,37829,262,215,0,215,9
2020-08-18,Butte,007,227075,1671,1491,41,1532,16
2020-08-18,Calaveras,009,45235,210,174,0,174,1
2020-08-18,Colusa,011,21464,434,415,0,415,5
2020-08-18,Contra Costa,013,1133247,13414,11689,41,11730,141
2020-08-18,Del Norte,015,27424,111,78,0,78,0
2020-08-18,El Dorado,017,186661,963,866,7,873,2
2020-08-18,Fresno,019,978130,26034,21798,260,22058,212
2020-08-18,Glenn,021,27897,425,407,0,407,2
2020-08-18,Humboldt,023,135768,353,315,1,316,4
2020-08-18,Imperial,025,180216,11026,8968,7,8975,189
2020-08-18,Inyo,027,18085,164,140,3,143,1
2020-08-18,Kern,029,883053,28758,26978,189,27167,263
2020-08-18,Kings,031,150075,5793,5269,25,5294,58
2020-08-18,Lake,033,64148,310,274,0,274,2
2020-08-18,Lassen,035,31185,711,693,2,695,0
2020-08-18,Los Angeles,037,10098052,231763,224218,937,225155,5339
2020-08-18,Madera,039,155013,3668,3125,21,3146,28
2020-08-18,Marin,041,260295,5939,5708,13,5721,47
2020-08-18,Mariposa,043,17540,71,61,0,61,2
2020-08-18,Mendocino,045,87422,551,468,0,468,8
2020-08-18,Merced,047,269075,7495,6940,4,6944,66
2020-08-18,Modoc,049,8938,7,5,0,5,0
2020-08-18,Mono,051,14174,162,129,3,132,1
2020-08-18,Monterey,053,433212,7351,6691,15,6706,44
2020-08-18,Napa,055,140530,1401,1274,5,1279,10
2020-08-18,Nevada,057,99092,422,389,13,402,2
2020-08-18,Orange,059,3164182,48513,43659,1067,44726,809
2020-08-18,Placer,061,380077,2869,2644,5,2649,28
2020-08-18,Plumas,063,18699,39,34,0,34,0
2020-08-18,Riverside,065,2383286,51393,48447,53,48500,917
2020-08-18,Sacramento,067,1510023,16772,14610,14,14624,222
2020-08-18,San Benito,069,59416,972,836,0,836,3
2020-08-18,San Bernardino,071,2135413,46926,42827,263,43090,648
2020-08-18,San Diego,073,3302833,37104,35164,227,35391,633
2020-08-18,San Francisco,075,870044,8940,8016,8,8024,72
2020-08-18,San Joaquin,077,732212,17545,15509,28,15537,290
2020-08-18,San Luis Obispo,079,281455,2830,2535,11,2546,18
2020-08-18,San Mateo,081,765935,7930,7074,8,7082,119
2020-08-18,Santa Barbara,083,443738,7818,7472,67,7539,81
2020-08-18,Santa Clara,085,1922200,16920,14786,34,14820,184
2020-08-18,Santa Cruz,087,273765,1724,1509,14,1523,6
2020-08-18,Shasta,089,179085,589,468,3,471,9
2020-08-18,Sierra,091,2930,6,6,0,6,0
2020-08-18,Siskiyou,093,43540,120,103,1,104,0
2020-08-18,Solano,095,438530,5153,4700,30,4730,31
2020-08-18,Sonoma,097,501317,5255,4506,19,4525,48
2020-08-18,Stanislaus,099,539301,14346,12935,203,13138,149
2020-08-18,Sutter,101,95872,1212,1126,1,1127,8
2020-08-18,Tehama,103,63373,382,333,2,335,1
2020-08-18,Trinity,105,12862,41,8,6,14,0
2020-08-18,Tulare,107,460477,13724,12637,43,12680,212
2020-08-18,Tuolumne,109,53932,175,159,5,164,1
2020-08-18,Ventura,111,848112,10584,9536,61,9597,89
2020-08-18,Yolo,113,214977,2293,2102,4,2106,47
2020-08-18,Yuba,115,75493,759,679,3,682,1
2020-08-17,Alameda,001,1643700,17253,15454,114,15568,221
2020-08-17,Alpine,003,1148,2,2,0,2,0
2020-08-17,Amador,005,37829,262,215,0,215,9
2020-08-17,Butte,007,227075,1626,1463,41,1504,15
2020-08-17,Calaveras,009,45235,206,167,0,167,1
2020-08-17,Colusa,011,21464,431,408,0,408,5
2020-08-17,Contra Costa,013,1133247,13277,11442,41,11483,141
2020-08-17,Del Norte,015,27424,107,77,0,77,0
2020-08-17,El Dorado,017,186661,960,846,7,853,2
2020-08-17,Fresno,019,978130,25827,21316,253,21569,211
2020-08-17,Glenn,021,27897,424,402,0,402,2
2020-08-17,Humboldt,023,135768,349,302,1,303,4
2020-08-17,Imperial,025,180216,10985,8897,7,8904,188
2020-08-17,Inyo,027,18085,156,124,3,127,1
2020-08-17,Kern,029,883053,28611,26773,179,26952,249
2020-08-17,Kings,031,150075,5755,5249,25,5274,58
2020-08-17,Lake,033,64148,305,270,0,270,2
2020-08-17,Lassen,035,31185,711,666,2,668,0
2020-08-17,Los Angeles,037,10098052,230244,223418,893,224311,5282
2020-08-17,Madera,039,155013,3625,3050,20,3070,26
2020-08-17,Marin,041,260295,5916,5683,12,5695,46
2020-08-17,Mariposa,043,17540,71,61,0,61,2
2020-08-17,Mendocino,045,87422,533,454,0,454,8
2020-08-17,Merced,047,269075,7400,6814,4,6818,66
2020-08-17,Modoc,049,8938,7,5,0,5,0
2020-08-17,Mono,051,14174,162,126,3,129,1
2020-08-17,Monterey,053,433212,7251,6553,15,6568,44
2020-08-17,Napa,055,140530,1380,1255,5,1260,10
2020-08-17,Nevada,057,99092,417,383,13,396,2
2020-08-17,Orange,059,3164182,48303,43621,1054,44675,804
2020-08-17,Placer,061,380077,2844,2609,5,2614,28
2020-08-17,Plumas,063,18699,39,33,0,33,0
2020-08-17,Riverside,065,2383286,51059,48062,51,48113,916
2020-08-17,Sacramento,067,1510023,16552,14333,14,14347,219
2020-08-17,San Benito,069,59416,957,822,0,822,2
2020-08-17,San Bernardino,071,2135413,46582,42005,254,42259,604
2020-08-17,San Diego,073,3302833,36838,34962,213,35175,626
2020-08-17,San Francisco,075,870044,8869,7600,8,7608,72
2020-08-17,San Joaquin,077,732212,17383,15323,27,15350,280
2020-08-17,San Luis Obispo,079,281455,2797,2527,11,2538,18
2020-08-17,San Mateo,081,765935,7873,6987,7,6994,118
2020-08-17,Santa Barbara,083,443738,7776,7438,67,7505,80
2020-08-17,Santa Clara,085,1922200,16695,14546,34,14580,183
2020-08-17,Santa Cruz,087,273765,1708,1453,13,1466,6
2020-08-17,Shasta,089,179085,583,467,3,470,9
2020-08-17,Sierra,091,2930,6,6,0,6,0
2020-08-17,Siskiyou,093,43540,119,103,0,103,0
2020-08-17,Solano,095,438530,5096,4479,30,4509,31
2020-08-17,Sonoma,097,501317,5167,4402,17,4419,48
2020-08-17,Stanislaus,099,539301,14221,12745,196,12941,148
2020-08-17,Sutter,101,95872,1196,1071,1,1072,8
2020-08-17,Tehama,103,63373,372,324,2,326,1
2020-08-17,Trinity,105,12862,41,8,6,14,0
2020-08-17,Tulare,107,460477,13612,12487,42,12529,210
2020-08-17,Tuolumne,109,53932,172,157,5,162,1
2020-08-17,Ventura,111,848112,10461,9490,56,9546,89
2020-08-17,Yolo,113,214977,2266,2083,4,2087,47
2020-08-17,Yuba,115,75493,744,647,3,650,1
2020-08-16,Alameda,001,1643700,16962,15338,114,15452,221
2020-08-16,Alpine,003,1148,2,2,0,2,0
2020-08-16,Amador,005,37829,259,215,0,215,9
2020-08-16,Butte,007,227075,1588,1432,41,1473,15
2020-08-16,Calaveras,009,45235,199,167,0,167,1
2020-08-16,Colusa,011,21464,429,407,0,407,5
2020-08-16,Contra Costa,013,1133247,13091,11255,41,11296,140
2020-08-16,Del Norte,015,27424,103,77,0,77,0
2020-08-16,El Dorado,017,186661,948,843,7,850,2
2020-08-16,Fresno,019,978130,25606,21010,248,21258,211
2020-08-16,Glenn,021,27897,422,400,0,400,2
2020-08-16,Humboldt,023,135768,347,301,1,302,4
2020-08-16,Imperial,025,180216,10941,8883,7,8890,188
2020-08-16,Inyo,027,18085,149,125,2,127,1
2020-08-16,Kern,029,883053,28412,26520,171,26691,249
2020-08-16,Kings,031,150075,5724,5146,25,5171,58
2020-08-16,Lake,033,64148,301,269,0,269,2
2020-08-16,Lassen,035,31185,711,666,2,668,0
2020-08-16,Los Angeles,037,10098052,228674,222236,864,223100,5263
2020-08-16,Madera,039,155013,3580,3013,20,3033,26
2020-08-16,Marin,041,260295,5890,5664,12,5676,46
2020-08-16,Mariposa,043,17540,71,61,0,61,2
2020-08-16,Mendocino,045,87422,525,451,0,451,8
2020-08-16,Merced,047,269075,7318,6744,4,6748,66
2020-08-16,Modoc,049,8938,7,5,0,5,0
2020-08-16,Mono,051,14174,162,126,3,129,1
2020-08-16,Monterey,053,433212,7153,6516,14,6530,44
2020-08-16,Napa,055,140530,1362,1241,3,1244,10
2020-08-16,Nevada,057,99092,408,379,13,392,2
2020-08-16,Orange,059,3164182,48053,43303,1043,44346,803
2020-08-16,Placer,061,380077,2815,2583,4,2587,28
2020-08-16,Plumas,063,18699,39,33,0,33,0
2020-08-16,Riverside,065,2383286,50728,47669,50,47719,910
2020-08-16,Sacramento,067,1510023,16312,14210,14,14224,219
2020-08-16,San Benito,069,59416,928,815,0,815,2
2020-08-16,San Bernardino,071,2135413,46159,41724,246,41970,603
2020-08-16,San Diego,073,3302833,36574,34680,198,34878,626
2020-08-16,San Francisco,075,870044,8782,7602,8,7610,72
2020-08-16,San Joaquin,077,732212,17182,15288,27,15315,280
2020-08-16,San Luis Obispo,079,281455,2768,2494,11,2505,17
2020-08-16,San Mateo,081,765935,7799,6942,7,6949,118
2020-08-16,Santa Barbara,083,443738,7727,7368,67,7435,79
2020-08-16,Santa Clara,085,1922200,16495,14329,34,14363,183
2020-08-16,Santa Cruz,087,273765,1681,1449,12,1461,6
2020-08-16,Shasta,089,179085,576,465,3,468,9
2020-08-16,Sierra,091,2930,6,6,0,6,0
2020-08-16,Siskiyou,093,43540,118,102,0,102,0
2020-08-16,Solano,095,438530,5036,4479,30,4509,31
2020-08-16,Sonoma,097,501317,5063,4329,17,4346,46
2020-08-16,Stanislaus,099,539301,14063,12668,186,12854,148
2020-08-16,Sutter,101,95872,1178,1071,1,1072,8
2020-08-16,Tehama,103,63373,363,318,2,320,1
2020-08-16,Trinity,105,12862,38,8,6,14,0
2020-08-16,Tulare,107,460477,13480,12334,39,12373,211
2020-08-16,Tuolumne,109,53932,172,156,5,161,1
2020-08-16,Ventura,111,848112,10352,9408,51,9459,89
2020-08-16,Yolo,113,214977,2247,2057,4,2061,47
2020-08-16,Yuba,115,75493,735,647,2,649,1
2020-08-15,Alameda,001,1643700,16885,15165,114,15279,221
2020-08-15,Alpine,003,1148,2,2,0,2,0
2020-08-15,Amador,005,37829,259,210,0,210,9
2020-08-15,Butte,007,227075,1567,1409,41,1450,15
2020-08-15,Calaveras,009,45235,197,167,0,167,1
2020-08-15,Colusa,011,21464,428,401,0,401,5
2020-08-15,Contra Costa,013,1133247,12995,11106,41,11147,138
2020-08-15,Del Norte,015,27424,103,77,0,77,0
2020-08-15,El Dorado,017,186661,943,838,7,845,2
2020-08-15,Fresno,019,978130,25491,20603,246,20849,211
2020-08-15,Glenn,021,27897,422,398,0,398,2
2020-08-15,Humboldt,023,135768,346,301,1,302,4
2020-08-15,Imperial,025,180216,10921,8794,7,8801,188
2020-08-15,Inyo,027,18085,149,123,2,125,1
2020-08-15,Kern,029,883053,28324,26338,171,26509,249
2020-08-15,Kings,031,150075,5706,5039,25,5064,56
2020-08-15,Lake,033,64148,299,268,0,268,2
2020-08-15,Lassen,035,31185,711,666,2,668,0
2020-08-15,Los Angeles,037,10098052,227923,221043,854,221897,5252
2020-08-15,Madera,039,155013,3530,2950,20,2970,26
2020-08-15,Marin,041,260295,5883,5628,12,5640,46
2020-08-15,Mariposa,043,17540,71,61,0,61,2
2020-08-15,Mendocino,045,87422,521,444,0,444,8
2020-08-15,Merced,047,269075,7283,6656,4,6660,66
2020-08-15,Modoc,049,8938,7,5,0,5,0
2020-08-15,Mono,051,14174,162,126,3,129,1
2020-08-15,Monterey,053,433212,7108,6162,14,6176,44
2020-08-15,Napa,055,140530,1352,1232,3,1235,10
2020-08-15,Nevada,057,99092,408,376,13,389,2
2020-08-15,Orange,059,3164182,47940,42811,1032,43843,801
2020-08-15,Placer,061,380077,2794,2551,4,2555,27
2020-08-15,Plumas,063,18699,39,33,0,33,0
2020-08-15,Riverside,065,2383286,50577,46720,50,46770,910
2020-08-15,Sacramento,067,1510023,16202,14018,14,14032,219
2020-08-15,San Benito,069,59416,915,805,0,805,2
2020-08-15,San Bernardino,071,2135413,46007,41231,244,41475,602
2020-08-15,San Diego,073,3302833,36408,34346,184,34530,639
2020-08-15,San Francisco,075,870044,8720,7601,8,7609,69
2020-08-15,San Joaquin,077,732212,17108,15113,27,15140,280
2020-08-15,San Luis Obispo,079,281455,2751,2461,11,2472,17
2020-08-15,San Mateo,081,765935,7762,6860,7,6867,118
2020-08-15,Santa Barbara,083,443738,7699,7338,67,7405,79
2020-08-15,Santa Clara,085,1922200,16399,14105,34,14139,183
2020-08-15,Santa Cruz,087,273765,1660,1449,12,1461,6
2020-08-15,Shasta,089,179085,573,458,3,461,9
2020-08-15,Sierra,091,2930,6,6,0,6,0
2020-08-15,Siskiyou,093,43540,117,100,0,100,0
2020-08-15,Solano,095,438530,5014,4477,30,4507,31
2020-08-15,Sonoma,097,501317,5008,4134,17,4151,45
2020-08-15,Stanislaus,099,539301,13999,12541,185,12726,149
2020-08-15,Sutter,101,95872,1167,1046,1,1047,8
2020-08-15,Tehama,103,63373,362,312,2,314,1
2020-08-15,Trinity,105,12862,36,6,6,12,0
2020-08-15,Tulare,107,460477,13441,12262,39,12301,211
2020-08-15,Tuolumne,109,53932,172,155,5,160,1
2020-08-15,Ventura,111,848112,10293,9379,49,9428,89
2020-08-15,Yolo,113,214977,2235,2031,4,2035,46
2020-08-15,Yuba,115,75493,731,623,2,625,1
2020-08-14,Alameda,001,1643700,16745,14909,114,15023,221
2020-08-14,Alpine,003,1148,2,2,0,2,0
2020-08-14,Amador,005,37829,259,209,0,209,9
2020-08-14,Butte,007,227075,1559,1384,41,1425,15
2020-08-14,Calaveras,009,45235,193,165,0,165,1
2020-08-14,Colusa,011,21464,426,399,0,399,5
2020-08-14,Contra Costa,013,1133247,12883,10893,41,10934,137
2020-08-14,Del Norte,015,27424,103,76,0,76,0
2020-08-14,El Dorado,017,186661,935,827,7,834,2
2020-08-14,Fresno,019,978130,25356,19900,246,20146,208
2020-08-14,Glenn,021,27897,420,395,0,395,2
2020-08-14,Humboldt,023,135768,340,294,1,295,4
2020-08-14,Imperial,025,180216,10898,8756,7,8763,185
2020-08-14,Inyo,027,18085,148,115,2,117,1
2020-08-14,Kern,029,883053,28220,25893,170,26063,249
2020-08-14,Kings,031,150075,5692,4953,25,4978,56
2020-08-14,Lake,033,64148,290,267,0,267,2
2020-08-14,Lassen,035,31185,711,665,2,667,0
2020-08-14,Los Angeles,037,10098052,226749,219083,838,219921,5222
2020-08-14,Madera,039,155013,3500,2876,20,2896,26
2020-08-14,Marin,041,260295,5872,5601,12,5613,46
2020-08-14,Mariposa,043,17540,70,61,0,61,2
2020-08-14,Mendocino,045,87422,512,432,0,432,8
2020-08-14,Merced,047,269075,7253,6466,4,6470,67
2020-08-14,Modoc,049,8938,7,5,0,5,0
2020-08-14,Mono,051,14174,162,126,3,129,1
2020-08-14,Monterey,053,433212,7057,6121,14,6135,41
2020-08-14,Napa,055,140530,1342,1230,3,1233,10
2020-08-14,Nevada,057,99092,404,377,13,390,2
2020-08-14,Orange,059,3164182,47790,42399,1020,43419,798
2020-08-14,Placer,061,380077,2775,2546,4,2550,26
2020-08-14,Plumas,063,18699,38,33,0,33,0
2020-08-14,Riverside,065,2383286,50347,46456,50,46506,891
2020-08-14,Sacramento,067,1510023,16053,13645,14,13659,212
2020-08-14,San Benito,069,59416,898,783,0,783,2
2020-08-14,San Bernardino,071,2135413,45820,40442,241,40683,594
2020-08-14,San Diego,073,3302833,36214,34067,177,34244,622
2020-08-14,San Francisco,075,870044,8662,7467,8,7475,69
2020-08-14,San Joaquin,077,732212,17008,14925,27,14952,276
2020-08-14,San Luis Obispo,079,281455,2736,2422,11,2433,17
2020-08-14,San Mateo,081,765935,7703,6655,7,6662,118
2020-08-14,Santa Barbara,083,443738,7649,7302,67,7369,77
2020-08-14,Santa Clara,085,1922200,16229,13785,33,13818,183
2020-08-14,Santa Cruz,087,273765,1638,1418,11,1429,6
2020-08-14,Shasta,089,179085,568,446,3,449,9
2020-08-14,Sierra,091,2930,6,5,0,5,0
2020-08-14,Siskiyou,093,43540,117,98,0,98,0
2020-08-14,Solano,095,438530,4993,4421,30,4451,31
2020-08-14,Sonoma,097,501317,4949,4087,14,4101,45
2020-08-14,Stanislaus,099,539301,13921,12379,181,12560,140
2020-08-14,Sutter,101,95872,1159,1039,1,1040,8
2020-08-14,Tehama,103,63373,357,305,2,307,1
2020-08-14,Trinity,105,12862,36,6,6,12,0
2020-08-14,Tulare,107,460477,13364,12009,39,12048,211
2020-08-14,Tuolumne,109,53932,171,155,5,160,1
2020-08-14,Ventura,111,848112,10218,9313,49,9362,89
2020-08-14,Yolo,113,214977,2221,1991,4,1995,45
2020-08-14,Yuba,115,75493,715,606,2,608,1
2020-08-13,Alameda,001,1643700,16464,14385,114,14499,218
2020-08-13,Alpine,003,1148,2,2,0,2,0
2020-08-13,Amador,005,37829,259,198,0,198,8
2020-08-13,Butte,007,227075,1535,1345,41,1386,15
2020-08-13,Calaveras,009,45235,191,162,0,162,1
2020-08-13,Colusa,011,21464,426,395,0,395,5
2020-08-13,Contra Costa,013,1133247,12729,10545,40,10585,136
2020-08-13,Del Norte,015,27424,102,74,0,74,0
2020-08-13,El Dorado,017,186661,930,803,7,810,2
2020-08-13,Fresno,019,978130,25130,19157,240,19397,201
2020-08-13,Glenn,021,27897,416,392,0,392,1
2020-08-13,Humboldt,023,135768,332,281,1,282,4
2020-08-13,Imperial,025,180216,10866,8640,7,8647,170
2020-08-13,Inyo,027,18085,144,97,2,99,1
2020-08-13,Kern,029,883053,28053,25472,167,25639,242
2020-08-13,Kings,031,150075,5657,4824,25,4849,52
2020-08-13,Lake,033,64148,285,263,0,263,2
2020-08-13,Lassen,035,31185,711,652,2,654,0
2020-08-13,Los Angeles,037,10098052,225369,216497,816,217313,5179
2020-08-13,Madera,039,155013,3456,2675,19,2694,25
2020-08-13,Marin,041,260295,5856,5503,12,5515,44
2020-08-13,Mariposa,043,17540,69,61,0,61,2
2020-08-13,Mendocino,045,87422,507,401,0,401,8
2020-08-13,Merced,047,269075,7136,5945,4,5949,63
2020-08-13,Modoc,049,8938,7,5,0,5,0
2020-08-13,Mono,051,14174,162,124,3,127,1
2020-08-13,Monterey,053,433212,6974,5925,14,5939,38
2020-08-13,Napa,055,140530,1333,1179,3,1182,10
2020-08-13,Nevada,057,99092,400,362,13,375,1
2020-08-13,Orange,059,3164182,47551,42019,1008,43027,773
2020-08-13,Placer,061,380077,2752,2460,4,2464,26
2020-08-13,Plumas,063,18699,38,32,0,32,0
2020-08-13,Riverside,065,2383286,50051,45327,50,45377,885
2020-08-13,Sacramento,067,1510023,15849,13237,14,13251,197
2020-08-13,San Benito,069,59416,869,757,0,757,2
2020-08-13,San Bernardino,071,2135413,45423,39395,234,39629,591
2020-08-13,San Diego,073,3302833,35978,33661,159,33820,627
2020-08-13,San Francisco,075,870044,8568,7277,8,7285,69
2020-08-13,San Joaquin,077,732212,16852,14537,26,14563,261
2020-08-13,San Luis Obispo,079,281455,2714,2283,11,2294,16
2020-08-13,San Mateo,081,765935,7641,6503,7,6510,117
2020-08-13,Santa Barbara,083,443738,7604,7129,66,7195,74
2020-08-13,Santa Clara,085,1922200,16007,13257,33,13290,182
2020-08-13,Santa Cruz,087,273765,1613,1383,11,1394,6
2020-08-13,Shasta,089,179085,563,428,3,431,9
2020-08-13,Sierra,091,2930,6,5,0,5,0
2020-08-13,Siskiyou,093,43540,117,95,0,95,0
2020-08-13,Solano,095,438530,4956,4305,30,4335,31
2020-08-13,Sonoma,097,501317,4875,3902,14,3916,45
2020-08-13,Stanislaus,099,539301,13792,11953,165,12118,136
2020-08-13,Sutter,101,95872,1138,992,1,993,8
2020-08-13,Tehama,103,63373,348,302,2,304,1
2020-08-13,Trinity,105,12862,35,6,6,12,0
2020-08-13,Tulare,107,460477,13220,11692,36,11728,210
2020-08-13,Tuolumne,109,53932,170,152,5,157,1
2020-08-13,Ventura,111,848112,10129,9114,49,9163,90
2020-08-13,Yolo,113,214977,2194,1938,4,1942,44
2020-08-13,Yuba,115,75493,699,568,2,570,1
2020-08-12,Alameda,001,1643700,16251,14214,114,14328,215
2020-08-12,Alpine,003,1148,2,2,0,2,0
2020-08-12,Amador,005,37829,256,197,0,197,8
2020-08-12,Butte,007,227075,1506,1317,41,1358,15
2020-08-12,Calaveras,009,45235,188,157,0,157,1
2020-08-12,Colusa,011,21464,421,394,0,394,5
2020-08-12,Contra Costa,013,1133247,12584,10304,39,10343,134
2020-08-12,Del Norte,015,27424,101,74,0,74,0
2020-08-12,El Dorado,017,186661,912,794,7,801,2
2020-08-12,Fresno,019,978130,24898,18690,234,18924,194
2020-08-12,Glenn,021,27897,413,388,0,388,1
2020-08-12,Humboldt,023,135768,325,281,1,282,4
2020-08-12,Imperial,025,180216,10843,8566,7,8573,167
2020-08-12,Inyo,027,18085,127,97,2,99,1
2020-08-12,Kern,029,883053,27861,25191,165,25356,232
2020-08-12,Kings,031,150075,5618,4736,25,4761,50
2020-08-12,Lake,033,64148,283,253,0,253,2
2020-08-12,Lassen,035,31185,710,651,2,653,0
2020-08-12,Los Angeles,037,10098052,223970,214542,800,215342,5119
2020-08-12,Madera,039,155013,3422,2681,17,2698,23
2020-08-12,Marin,041,260295,5834,5423,12,5435,44
2020-08-12,Mariposa,043,17540,69,61,0,61,2
2020-08-12,Mendocino,045,87422,488,386,0,386,9
2020-08-12,Merced,047,269075,7074,5777,4,5781,66
2020-08-12,Modoc,049,8938,7,5,0,5,0
2020-08-12,Mono,051,14174,161,124,3,127,1
2020-08-12,Monterey,053,433212,6870,5919,14,5933,38
2020-08-12,Napa,055,140530,1323,1161,3,1164,10
2020-08-12,Nevada,057,99092,395,357,13,370,1
2020-08-12,Orange,059,3164182,47300,41576,984,42560,754
2020-08-12,Placer,061,380077,2720,2417,4,2421,25
2020-08-12,Plumas,063,18699,38,31,0,31,0
2020-08-12,Riverside,065,2383286,49703,44747,50,44797,867
2020-08-12,Sacramento,067,1510023,15637,12528,14,12542,189
2020-08-12,San Benito,069,59416,856,751,0,751,2
2020-08-12,San Bernardino,071,2135413,45080,38811,225,39036,589
2020-08-12,San Diego,073,3302833,35769,33395,139,33534,608
2020-08-12,San Francisco,075,870044,8485,7194,8,7202,66
2020-08-12,San Joaquin,077,732212,16704,14154,26,14180,253
2020-08-12,San Luis Obispo,079,281455,2689,2263,11,2274,15
2020-08-12,San Mateo,081,765935,7562,6427,7,6434,117
2020-08-12,Santa Barbara,083,443738,7544,7049,64,7113,74
2020-08-12,Santa Clara,085,1922200,15832,13002,33,13035,182
2020-08-12,Santa Cruz,087,273765,1584,1382,10,1392,6
2020-08-12,Shasta,089,179085,559,417,3,420,9
2020-08-12,Sierra,091,2930,5,4,0,4,0
2020-08-12,Siskiyou,093,43540,116,90,0,90,0
2020-08-12,Solano,095,438530,4911,4258,30,4288,31
2020-08-12,Sonoma,097,501317,4801,3847,14,3861,47
2020-08-12,Stanislaus,099,539301,13652,11682,158,11840,136
2020-08-12,Sutter,101,95872,1114,987,1,988,7
2020-08-12,Tehama,103,63373,338,289,2,291,1
2020-08-12,Trinity,105,12862,34,6,6,12,0
2020-08-12,Tulare,107,460477,13092,11460,36,11496,211
2020-08-12,Tuolumne,109,53932,169,150,5,155,1
2020-08-12,Ventura,111,848112,10042,9005,49,9054,87
2020-08-12,Yolo,113,214977,2170,1921,4,1925,44
2020-08-12,Yuba,115,75493,677,549,1,550,1
2020-08-11,Alameda,001,1643700,15990,13960,111,14071,204
2020-08-11,Alpine,003,1148,2,2,0,2,0
2020-08-11,Amador,005,37829,250,187,0,187,3
2020-08-11,Butte,007,227075,1478,1296,41,1337,15
2020-08-11,Calaveras,009,45235,186,161,0,161,1
2020-08-11,Colusa,011,21464,416,390,0,390,5
2020-08-11,Contra Costa,013,1133247,12396,10012,37,10049,131
2020-08-11,Del Norte,015,27424,100,73,0,73,0
2020-08-11,El Dorado,017,186661,905,786,6,792,2
2020-08-11,Fresno,019,978130,24577,18344,231,18575,187
2020-08-11,Glenn,021,27897,411,380,0,380,1
2020-08-11,Humboldt,023,135768,320,283,1,284,4
2020-08-11,Imperial,025,180216,10788,8518,7,8525,165
2020-08-11,Inyo,027,18085,122,97,2,99,1
2020-08-11,Kern,029,883053,27526,25042,163,25205,230
2020-08-11,Kings,031,150075,5427,4696,25,4721,50
2020-08-11,Lake,033,64148,280,243,0,243,2
2020-08-11,Lassen,035,31185,704,605,2,607,0
2020-08-11,Los Angeles,037,10098052,222469,212421,777,213198,5065
2020-08-11,Madera,039,155013,3368,2673,17,2690,22
2020-08-11,Marin,041,260295,5807,5287,11,5298,44
2020-08-11,Mariposa,043,17540,68,60,0,60,2
2020-08-11,Mendocino,045,87422,478,385,0,385,9
2020-08-11,Merced,047,269075,6979,5322,3,5325,65
2020-08-11,Modoc,049,8938,7,5,0,5,0
2020-08-11,Mono,051,14174,161,124,3,127,1
2020-08-11,Monterey,053,433212,6761,5624,14,5638,36
2020-08-11,Napa,055,140530,1312,1143,2,1145,11
2020-08-11,Nevada,057,99092,392,358,13,371,1
2020-08-11,Orange,059,3164182,47080,41205,963,42168,742
2020-08-11,Placer,061,380077,2688,2393,4,2397,24
2020-08-11,Plumas,063,18699,38,31,0,31,0
2020-08-11,Riverside,065,2383286,49346,44237,50,44287,836
2020-08-11,Sacramento,067,1510023,15346,12298,14,12312,182
2020-08-11,San Benito,069,59416,844,750,0,750,2
2020-08-11,San Bernardino,071,2135413,44740,38467,218,38685,584
2020-08-11,San Diego,073,3302833,35502,33159,120,33279,602
2020-08-11,San Francisco,075,870044,8389,6988,8,6996,66
2020-08-11,San Joaquin,077,732212,16526,13997,21,14018,251
2020-08-11,San Luis Obispo,079,281455,2632,2234,11,2245,15
2020-08-11,San Mateo,081,765935,7488,6339,7,6346,117
2020-08-11,Santa Barbara,083,443738,7495,6942,64,7006,70
2020-08-11,Santa Clara,085,1922200,15611,12920,33,12953,183
2020-08-11,Santa Cruz,087,273765,1561,1352,10,1362,4
2020-08-11,Shasta,089,179085,555,416,3,419,9
2020-08-11,Sierra,091,2930,5,4,0,4,0
2020-08-11,Siskiyou,093,43540,116,90,0,90,0
2020-08-11,Solano,095,438530,4863,4206,29,4235,31
2020-08-11,Sonoma,097,501317,4706,3752,14,3766,45
2020-08-11,Stanislaus,099,539301,13548,11592,146,11738,128
2020-08-11,Sutter,101,95872,1092,964,1,965,7
2020-08-11,Tehama,103,63373,334,289,2,291,1
2020-08-11,Trinity,105,12862,34,5,6,11,0
2020-08-11,Tulare,107,460477,12967,11392,35,11427,201
2020-08-11,Tuolumne,109,53932,165,146,5,151,1
2020-08-11,Ventura,111,848112,9974,8953,48,9001,88
2020-08-11,Yolo,113,214977,2148,1912,4,1916,44
2020-08-11,Yuba,115,75493,666,540,1,541,1
2020-08-10,Alameda,001,1643700,15750,13420,109,13529,203
2020-08-10,Alpine,003,1148,2,2,0,2,0
2020-08-10,Amador,005,37829,249,172,0,172,2
2020-08-10,Butte,007,227075,1454,1174,39,1213,15
2020-08-10,Calaveras,009,45235,175,121,0,121,1
2020-08-10,Colusa,011,21464,414,387,0,387,4
2020-08-10,Contra Costa,013,1133247,12242,9454,35,9489,130
2020-08-10,Del Norte,015,27424,98,69,0,69,0
2020-08-10,El Dorado,017,186661,893,771,6,777,2
2020-08-10,Fresno,019,978130,24296,17978,231,18209,183
2020-08-10,Glenn,021,27897,408,381,0,381,1
2020-08-10,Humboldt,023,135768,314,277,1,278,4
2020-08-10,Imperial,025,180216,10744,8465,7,8472,165
2020-08-10,Inyo,027,18085,122,97,2,99,1
2020-08-10,Kern,029,883053,27300,24499,162,24661,215
2020-08-10,Kings,031,150075,5321,4588,25,4613,50
2020-08-10,Lake,033,64148,273,239,0,239,2
2020-08-10,Lassen,035,31185,704,588,2,590,0
2020-08-10,Los Angeles,037,10098052,220891,211035,759,211794,5003
2020-08-10,Madera,039,155013,3335,2365,17,2382,22
2020-08-10,Marin,041,260295,5762,5242,10,5252,44
2020-08-10,Mariposa,043,17540,68,57,0,57,2
2020-08-10,Mendocino,045,87422,454,364,0,364,1
2020-08-10,Merced,047,269075,6897,4913,3,4916,51
2020-08-10,Modoc,049,8938,7,5,0,5,0
2020-08-10,Mono,051,14174,161,123,3,126,1
2020-08-10,Monterey,053,433212,6651,5358,14,5372,34
2020-08-10,Napa,055,140530,1294,1084,2,1086,8
2020-08-10,Nevada,057,99092,384,356,13,369,1
2020-08-10,Orange,059,3164182,46810,40445,945,41390,721
2020-08-10,Placer,061,380077,2649,2298,4,2302,21
2020-08-10,Plumas,063,18699,38,27,0,27,0
2020-08-10,Riverside,065,2383286,48961,43296,49,43345,830
2020-08-10,Sacramento,067,1510023,15035,12059,14,12073,168
2020-08-10,San Benito,069,59416,831,743,0,743,2
2020-08-10,San Bernardino,071,2135413,44364,37367,209,37576,579
2020-08-10,San Diego,073,3302833,35236,32977,104,33081,594
2020-08-10,San Francisco,075,870044,8299,6816,7,6823,66
2020-08-10,San Joaquin,077,732212,16342,13308,21,13329,240
2020-08-10,San Luis Obispo,079,281455,2533,2208,11,2219,15
2020-08-10,San Mateo,081,765935,7411,6222,7,6229,117
2020-08-10,Santa Barbara,083,443738,7440,6869,64,6933,66
2020-08-10,Santa Clara,085,1922200,15351,12615,32,12647,182
2020-08-10,Santa Cruz,087,273765,1541,1239,9,1248,4
2020-08-10,Shasta,089,179085,551,384,3,387,9
2020-08-10,Sierra,091,2930,5,3,0,3,0
2020-08-10,Siskiyou,093,43540,113,88,0,88,0
2020-08-10,Solano,095,438530,4803,4101,29,4130,31
2020-08-10,Sonoma,097,501317,4537,3640,10,3650,42
2020-08-10,Stanislaus,099,539301,13365,10855,130,10985,106
2020-08-10,Sutter,101,95872,1067,865,1,866,7
2020-08-10,Tehama,103,63373,327,282,2,284,1
2020-08-10,Trinity,105,12862,31,5,6,11,0
2020-08-10,Tulare,107,460477,12794,10750,33,10783,194
2020-08-10,Tuolumne,109,53932,165,143,4,147,1
2020-08-10,Ventura,111,848112,9890,8851,47,8898,85
2020-08-10,Yolo,113,214977,2125,1840,4,1844,45
2020-08-10,Yuba,115,75493,649,527,1,528,1
2020-08-09,Alameda,001,1643700,15468,13241,107,13348,203
2020-08-09,Alpine,003,1148,2,2,0,2,0
2020-08-09,Amador,005,37829,244,153,0,153,2
2020-08-09,Butte,007,227075,1411,1155,39,1194,15
2020-08-09,Calaveras,009,45235,170,122,0,122,1
2020-08-09,Colusa,011,21464,410,371,0,371,4
2020-08-09,Contra Costa,013,1133247,12014,9214,34,9248,130
2020-08-09,Del Norte,015,27424,98,69,0,69,0
2020-08-09,El Dorado,017,186661,885,748,6,754,2
2020-08-09,Fresno,019,978130,23986,17846,227,18073,183
2020-08-09,Glenn,021,27897,406,354,0,354,1
2020-08-09,Humboldt,023,135768,308,279,1,280,4
2020-08-09,Imperial,025,180216,10701,8310,6,8316,165
2020-08-09,Inyo,027,18085,117,86,1,87,1
2020-08-09,Kern,029,883053,27044,23680,162,23842,215
2020-08-09,Kings,031,150075,5278,4446,24,4470,50
2020-08-09,Lake,033,64148,266,225,0,225,2
2020-08-09,Lassen,035,31185,698,589,2,591,0
2020-08-09,Los Angeles,037,10098052,218829,208810,737,209547,4984
2020-08-09,Madera,039,155013,3277,2322,13,2335,22
2020-08-09,Marin,041,260295,5719,5204,10,5214,44
2020-08-09,Mariposa,043,17540,66,56,0,56,2
2020-08-09,Mendocino,045,87422,444,283,0,283,1
2020-08-09,Merced,047,269075,6800,4735,2,4737,51
2020-08-09,Modoc,049,8938,7,4,0,4,0
2020-08-09,Mono,051,14174,160,113,3,116,1
2020-08-09,Monterey,053,433212,6527,5199,14,5213,34
2020-08-09,Napa,055,140530,1275,1062,2,1064,8
2020-08-09,Nevada,057,99092,376,332,13,345,1
2020-08-09,Orange,059,3164182,46511,39244,930,40174,722
2020-08-09,Placer,061,380077,2620,2211,4,2215,20
2020-08-09,Plumas,063,18699,38,27,0,27,0
2020-08-09,Riverside,065,2383286,48614,41894,49,41943,828
2020-08-09,Sacramento,067,1510023,14756,11301,14,11315,167
2020-08-09,San Benito,069,59416,812,687,0,687,2
2020-08-09,San Bernardino,071,2135413,43887,36092,209,36301,579
2020-08-09,San Diego,073,3302833,34945,32749,93,32842,594
2020-08-09,San Francisco,075,870044,8184,6820,7,6827,66
2020-08-09,San Joaquin,077,732212,16137,12933,20,12953,240
2020-08-09,San Luis Obispo,079,281455,2497,2124,11,2135,15
2020-08-09,San Mateo,081,765935,7316,6094,7,6101,117
2020-08-09,Santa Barbara,083,443738,7352,6669,64,6733,66
2020-08-09,Santa Clara,085,1922200,15081,11878,32,11910,181
2020-08-09,Santa Cruz,087,273765,1517,1246,9,1255,4
2020-08-09,Shasta,089,179085,547,361,3,364,9
2020-08-09,Sierra,091,2930,5,3,0,3,0
2020-08-09,Siskiyou,093,43540,112,74,0,74,0
2020-08-09,Solano,095,438530,4750,3954,28,3982,31
2020-08-09,Sonoma,097,501317,4401,3531,8,3539,41
2020-08-09,Stanislaus,099,539301,13157,10264,117,10381,106
2020-08-09,Sutter,101,95872,1033,857,1,858,7
2020-08-09,Tehama,103,63373,319,265,2,267,1
2020-08-09,Trinity,105,12862,31,5,6,11,0
2020-08-09,Tulare,107,460477,12604,10630,30,10660,194
2020-08-09,Tuolumne,109,53932,161,143,4,147,1
2020-08-09,Ventura,111,848112,9742,8633,46,8679,85
2020-08-09,Yolo,113,214977,2094,1765,4,1769,44
2020-08-09,Yuba,115,75493,629,442,1,443,1
2020-08-08,Alameda,001,1643700,15358,13087,107,13194,204
2020-08-08,Alpine,003,1148,2,2,0,2,0
2020-08-08,Amador,005,37829,244,139,0,139,2
2020-08-08,Butte,007,227075,1393,1140,39,1179,15
2020-08-08,Calaveras,009,45235,169,122,0,122,1
2020-08-08,Colusa,011,21464,409,368,0,368,4
2020-08-08,Contra Costa,013,1133247,11905,9104,34,9138,129
2020-08-08,Del Norte,015,27424,97,69,0,69,0
2020-08-08,El Dorado,017,186661,878,734,6,740,2
2020-08-08,Fresno,019,978130,23849,17538,225,17763,183
2020-08-08,Glenn,021,27897,406,344,0,344,1
2020-08-08,Humboldt,023,135768,305,277,1,278,4
2020-08-08,Imperial,025,180216,10686,8213,6,8219,165
2020-08-08,Inyo,027,18085,113,86,1,87,1
2020-08-08,Kern,029,883053,26930,22803,162,22965,215
2020-08-08,Kings,031,150075,5264,4367,24,4391,49
2020-08-08,Lake,033,64148,264,221,0,221,2
2020-08-08,Lassen,035,31185,698,589,2,591,0
2020-08-08,Los Angeles,037,10098052,217945,206971,726,207697,4974
2020-08-08,Madera,039,155013,3246,2275,13,2288,22
2020-08-08,Marin,041,260295,5699,5118,10,5128,44
2020-08-08,Mariposa,043,17540,65,55,0,55,2
2020-08-08,Mendocino,045,87422,442,264,0,264,1
2020-08-08,Merced,047,269075,6760,4570,2,4572,51
2020-08-08,Modoc,049,8938,7,4,0,4,0
2020-08-08,Mono,051,14174,160,113,3,116,1
2020-08-08,Monterey,053,433212,6469,5101,14,5115,33
2020-08-08,Napa,055,140530,1267,1062,2,1064,8
2020-08-08,Nevada,057,99092,374,325,13,338,1
2020-08-08,Orange,059,3164182,46381,38688,921,39609,718
2020-08-08,Placer,061,380077,2604,2153,4,2157,20
2020-08-08,Plumas,063,18699,38,27,0,27,0
2020-08-08,Riverside,065,2383286,48409,41412,49,41461,823
2020-08-08,Sacramento,067,1510023,14626,11144,14,11158,166
2020-08-08,San Benito,069,59416,804,684,0,684,2
2020-08-08,San Bernardino,071,2135413,43693,35691,208,35899,531
2020-08-08,San Diego,073,3302833,34756,32332,84,32416,593
2020-08-08,San Francisco,075,870044,8118,6820,7,6827,66
2020-08-08,San Joaquin,077,732212,16057,12559,19,12578,240
2020-08-08,San Luis Obispo,079,281455,2474,2081,11,2092,15
2020-08-08,San Mateo,081,765935,7258,6021,7,6028,117
2020-08-08,Santa Barbara,083,443738,7314,6598,64,6662,66
2020-08-08,Santa Clara,085,1922200,14929,11615,32,11647,181
2020-08-08,Santa Cruz,087,273765,1503,1247,9,1256,4
2020-08-08,Shasta,089,179085,545,343,3,346,9
2020-08-08,Sierra,091,2930,5,3,0,3,0
2020-08-08,Siskiyou,093,43540,112,73,0,73,0
2020-08-08,Solano,095,438530,4729,3889,27,3916,31
2020-08-08,Sonoma,097,501317,4370,3399,8,3407,41
2020-08-08,Stanislaus,099,539301,13082,9963,112,10075,105
2020-08-08,Sutter,101,95872,1023,830,1,831,7
2020-08-08,Tehama,103,63373,318,251,2,253,1
2020-08-08,Trinity,105,12862,31,5,6,11,0
2020-08-08,Tulare,107,460477,12529,10505,30,10535,192
2020-08-08,Tuolumne,109,53932,161,143,4,147,1
2020-08-08,Ventura,111,848112,9687,8462,45,8507,85
2020-08-08,Yolo,113,214977,2081,1725,4,1729,44
2020-08-08,Yuba,115,75493,620,430,1,431,1
2020-08-07,Alameda,001,1643700,15248,12805,107,12912,204
2020-08-07,Alpine,003,1148,2,2,0,2,0
2020-08-07,Amador,005,37829,242,125,0,125,2
2020-08-07,Butte,007,227075,1375,1092,39,1131,13
2020-08-07,Calaveras,009,45235,169,119,0,119,1
2020-08-07,Colusa,011,21464,408,358,0,358,4
2020-08-07,Contra Costa,013,1133247,11757,8810,34,8844,126
2020-08-07,Del Norte,015,27424,97,69,0,69,0
2020-08-07,El Dorado,017,186661,873,724,6,730,2
2020-08-07,Fresno,019,978130,23689,17290,225,17515,171
2020-08-07,Glenn,021,27897,405,339,0,339,1
2020-08-07,Humboldt,023,135768,301,274,1,275,4
2020-08-07,Imperial,025,180216,10661,8085,6,8091,164
2020-08-07,Inyo,027,18085,112,81,1,82,1
2020-08-07,Kern,029,883053,26804,22143,160,22303,206
2020-08-07,Kings,031,150075,5247,4315,24,4339,48
2020-08-07,Lake,033,64148,262,215,0,215,1
2020-08-07,Lassen,035,31185,697,588,2,590,0
2020-08-07,Los Angeles,037,10098052,216478,204406,715,205121,4924
2020-08-07,Madera,039,155013,3214,2245,13,2258,20
2020-08-07,Marin,041,260295,5670,5094,10,5104,43
2020-08-07,Mariposa,043,17540,65,53,0,53,2
2020-08-07,Mendocino,045,87422,428,262,0,262,1
2020-08-07,Merced,047,269075,6717,4358,2,4360,30
2020-08-07,Modoc,049,8938,7,4,0,4,0
2020-08-07,Mono,051,14174,160,112,3,115,1
2020-08-07,Monterey,053,433212,6394,5041,14,5055,33
2020-08-07,Napa,055,140530,1262,1055,2,1057,8
2020-08-07,Nevada,057,99092,371,324,13,337,1
2020-08-07,Orange,059,3164182,46170,38459,904,39363,701
2020-08-07,Placer,061,380077,2586,2078,4,2082,20
2020-08-07,Plumas,063,18699,38,25,0,25,0
2020-08-07,Riverside,065,2383286,48145,40902,48,40950,810
2020-08-07,Sacramento,067,1510023,14481,10798,14,10812,160
2020-08-07,San Benito,069,59416,798,647,0,647,2
2020-08-07,San Bernardino,071,2135413,43446,35200,207,35407,524
2020-08-07,San Diego,073,3302833,34571,31781,81,31862,586
2020-08-07,San Francisco,075,870044,8040,6765,7,6772,66
2020-08-07,San Joaquin,077,732212,15970,12392,19,12411,223
2020-08-07,San Luis Obispo,079,281455,2443,2050,11,2061,14
2020-08-07,San Mateo,081,765935,7198,5948,7,5955,117
2020-08-07,Santa Barbara,083,443738,7263,6509,64,6573,66
2020-08-07,Santa Clara,085,1922200,14730,11409,32,11441,180
2020-08-07,Santa Cruz,087,273765,1485,1234,9,1243,5
2020-08-07,Shasta,089,179085,540,342,3,345,9
2020-08-07,Sierra,091,2930,5,3,0,3,0
2020-08-07,Siskiyou,093,43540,109,73,0,73,0
2020-08-07,Solano,095,438530,4697,3844,26,3870,31
2020-08-07,Sonoma,097,501317,4304,3329,8,3337,34
2020-08-07,Stanislaus,099,539301,12960,9665,102,9767,98
2020-08-07,Sutter,101,95872,1019,807,1,808,6
2020-08-07,Tehama,103,63373,314,246,2,248,1
2020-08-07,Trinity,105,12862,30,5,6,11,0
2020-08-07,Tulare,107,460477,12452,10292,30,10322,195
2020-08-07,Tuolumne,109,53932,160,136,4,140,1
2020-08-07,Ventura,111,848112,9627,8356,43,8399,84
2020-08-07,Yolo,113,214977,2054,1689,4,1693,37
2020-08-07,Yuba,115,75493,615,413,1,414,1
2020-08-06,Alameda,001,1643700,15026,12474,106,12580,200
2020-08-06,Alpine,003,1148,2,2,0,2,0
2020-08-06,Amador,005,37829,228,125,0,125,0
2020-08-06,Butte,007,227075,1356,1060,39,1099,13
2020-08-06,Calaveras,009,45235,167,117,0,117,1
2020-08-06,Colusa,011,21464,405,358,0,358,3
2020-08-06,Contra Costa,013,1133247,11563,8583,33,8616,124
2020-08-06,Del Norte,015,27424,97,69,0,69,0
2020-08-06,El Dorado,017,186661,862,703,6,709,1
2020-08-06,Fresno,019,978130,23392,17031,218,17249,161
2020-08-06,Glenn,021,27897,400,332,0,332,1
2020-08-06,Humboldt,023,135768,296,266,1,267,4
2020-08-06,Imperial,025,180216,10618,8064,6,8070,163
2020-08-06,Inyo,027,18085,104,83,1,84,1
2020-08-06,Kern,029,883053,26568,21843,159,22002,197
2020-08-06,Kings,031,150075,5185,4264,23,4287,47
2020-08-06,Lake,033,64148,259,209,0,209,1
2020-08-06,Lassen,035,31185,695,588,2,590,0
2020-08-06,Los Angeles,037,10098052,214405,201372,699,202071,4874
2020-08-06,Madera,039,155013,3166,2240,12,2252,19
2020-08-06,Marin,041,260295,5638,5058,10,5068,43
2020-08-06,Mariposa,043,17540,64,52,0,52,2
2020-08-06,Mendocino,045,87422,414,260,0,260,1
2020-08-06,Merced,047,269075,6615,4235,2,4237,30
2020-08-06,Modoc,049,8938,7,4,0,4,0
2020-08-06,Mono,051,14174,159,111,3,114,1
2020-08-06,Monterey,053,433212,6285,5001,13,5014,33
2020-08-06,Napa,055,140530,1248,1032,2,1034,8
2020-08-06,Nevada,057,99092,366,321,13,334,1
2020-08-06,Orange,059,3164182,45878,38399,899,39298,694
2020-08-06,Placer,061,380077,2560,2045,4,2049,20
2020-08-06,Plumas,063,18699,37,25,0,25,0
2020-08-06,Riverside,065,2383286,47751,40269,48,40317,781
2020-08-06,Sacramento,067,1510023,14253,10548,14,10562,153
2020-08-06,San Benito,069,59416,790,626,0,626,2
2020-08-06,San Bernardino,071,2135413,43041,34819,205,35024,516
2020-08-06,San Diego,073,3302833,34304,31129,74,31203,583
2020-08-06,San Francisco,075,870044,7947,6737,6,6743,60
2020-08-06,San Joaquin,077,732212,15811,12269,19,12288,203
2020-08-06,San Luis Obispo,079,281455,2419,2000,10,2010,13
2020-08-06,San Mateo,081,765935,7098,5885,7,5892,117
2020-08-06,Santa Barbara,083,443738,7203,6620,64,6684,65
2020-08-06,Santa Clara,085,1922200,14501,11280,32,11312,178
2020-08-06,Santa Cruz,087,273765,1464,1215,9,1224,4
2020-08-06,Shasta,089,179085,531,343,3,346,9
2020-08-06,Sierra,091,2930,5,3,0,3,0
2020-08-06,Siskiyou,093,43540,109,73,0,73,0
2020-08-06,Solano,095,438530,4653,3784,26,3810,29
2020-08-06,Sonoma,097,501317,4240,3259,8,3267,33
2020-08-06,Stanislaus,099,539301,12810,9566,86,9652,98
2020-08-06,Sutter,101,95872,988,797,1,798,6
2020-08-06,Tehama,103,63373,311,242,2,244,1
2020-08-06,Trinity,105,12862,27,5,6,11,0
2020-08-06,Tulare,107,460477,12292,10169,30,10199,195
2020-08-06,Tuolumne,109,53932,159,136,4,140,1
2020-08-06,Ventura,111,848112,9512,8245,40,8285,80
2020-08-06,Yolo,113,214977,2030,1662,4,1666,36
2020-08-06,Yuba,115,75493,606,407,0,407,1
2020-08-05,Alameda,001,1643700,14810,12140,106,12246,193
2020-08-05,Alpine,003,1148,2,2,0,2,0
2020-08-05,Amador,005,37829,218,123,0,123,0
2020-08-05,Butte,007,227075,1323,1038,37,1075,13
2020-08-05,Calaveras,009,45235,164,116,0,116,1
2020-08-05,Colusa,011,21464,401,354,0,354,3
2020-08-05,Contra Costa,013,1133247,11394,8362,33,8395,122
2020-08-05,Del Norte,015,27424,96,69,0,69,0
2020-08-05,El Dorado,017,186661,854,692,6,698,1
2020-08-05,Fresno,019,978130,23148,16625,213,16838,159
2020-08-05,Glenn,021,27897,397,330,0,330,1
2020-08-05,Humboldt,023,135768,294,249,1,250,4
2020-08-05,Imperial,025,180216,10583,8036,6,8042,163
2020-08-05,Inyo,027,18085,102,62,1,63,1
2020-08-05,Kern,029,883053,26380,21540,154,21694,194
2020-08-05,Kings,031,150075,5140,4192,22,4214,47
2020-08-05,Lake,033,64148,252,209,0,209,1
2020-08-05,Lassen,035,31185,648,557,2,559,0
2020-08-05,Los Angeles,037,10098052,212484,198355,679,199034,4832
2020-08-05,Madera,039,155013,3124,2172,12,2184,19
2020-08-05,Marin,041,260295,5606,5036,10,5046,43
2020-08-05,Mariposa,043,17540,64,52,0,52,2
2020-08-05,Mendocino,045,87422,402,248,0,248,1
2020-08-05,Merced,047,269075,6480,4119,2,4121,30
2020-08-05,Modoc,049,8938,7,3,0,3,0
2020-08-05,Mono,051,14174,159,104,3,107,1
2020-08-05,Monterey,053,433212,6170,4936,13,4949,32
2020-08-05,Napa,055,140530,1236,1020,2,1022,8
2020-08-05,Nevada,057,99092,357,327,13,340,2
2020-08-05,Orange,059,3164182,45569,37907,891,38798,663
2020-08-05,Placer,061,380077,2519,1989,4,1993,18
2020-08-05,Plumas,063,18699,36,25,0,25,0
2020-08-05,Riverside,065,2383286,47357,39454,46,39500,761
2020-08-05,Sacramento,067,1510023,14035,10261,13,10274,151
2020-08-05,San Benito,069,59416,781,613,0,613,2
2020-08-05,San Bernardino,071,2135413,42579,34442,200,34642,504
2020-08-05,San Diego,073,3302833,34080,30866,58,30924,578
2020-08-05,San Francisco,075,870044,7854,6701,6,6707,60
2020-08-05,San Joaquin,077,732212,15650,12148,19,12167,199
2020-08-05,San Luis Obispo,079,281455,2395,1928,10,1938,13
2020-08-05,San Mateo,081,765935,7003,5695,7,5702,116
2020-08-05,Santa Barbara,083,443738,7143,6597,64,6661,63
2020-08-05,Santa Clara,085,1922200,14267,11074,32,11106,176
2020-08-05,Santa Cruz,087,273765,1444,1192,7,1199,4
2020-08-05,Shasta,089,179085,525,338,3,341,9
2020-08-05,Sierra,091,2930,5,3,0,3,0
2020-08-05,Siskiyou,093,43540,105,72,0,72,0
2020-08-05,Solano,095,438530,4602,3750,25,3775,29
2020-08-05,Sonoma,097,501317,4157,3173,8,3181,33
2020-08-05,Stanislaus,099,539301,12651,9408,81,9489,97
2020-08-05,Sutter,101,95872,977,780,1,781,6
2020-08-05,Tehama,103,63373,308,231,2,233,1
2020-08-05,Trinity,105,12862,27,5,6,11,0
2020-08-05,Tulare,107,460477,12151,9924,30,9954,192
2020-08-05,Tuolumne,109,53932,159,137,4,141,0
2020-08-05,Ventura,111,848112,9396,8162,36,8198,75
2020-08-05,Yolo,113,214977,2002,1634,4,1638,36
2020-08-05,Yuba,115,75493,589,400,0,400,1
2020-08-04,Alameda,001,1643700,14593,11983,105,12088,192
2020-08-04,Alpine,003,1148,2,2,0,2,0
2020-08-04,Amador,005,37829,203,123,0,123,0
2020-08-04,Butte,007,227075,1299,1011,36,1047,10
2020-08-04,Calaveras,009,45235,160,116,0,116,1
2020-08-04,Colusa,011,21464,396,354,0,354,3
2020-08-04,Contra Costa,013,1133247,11227,8210,33,8243,122
2020-08-04,Del Norte,015,27424,94,69,0,69,0
2020-08-04,El Dorado,017,186661,844,668,6,674,1
2020-08-04,Fresno,019,978130,22862,16272,206,16478,154
2020-08-04,Glenn,021,27897,396,325,0,325,1
2020-08-04,Humboldt,023,135768,284,241,1,242,4
2020-08-04,Imperial,025,180216,10546,7974,6,7980,163
2020-08-04,Inyo,027,18085,88,59,1,60,1
2020-08-04,Kern,029,883053,26097,21403,154,21557,190
2020-08-04,Kings,031,150075,5075,4163,22,4185,47
2020-08-04,Lake,033,64148,252,206,0,206,1
2020-08-04,Lassen,035,31185,645,556,2,558,0
2020-08-04,Los Angeles,037,10098052,210543,196014,653,196667,4764
2020-08-04,Madera,039,155013,3081,2161,8,2169,19
2020-08-04,Marin,041,260295,5575,5020,9,5029,43
2020-08-04,Mariposa,043,17540,64,51,0,51,2
2020-08-04,Mendocino,045,87422,377,248,0,248,1
2020-08-04,Merced,047,269075,6367,4085,2,4087,30
2020-08-04,Modoc,049,8938,7,3,0,3,0
2020-08-04,Mono,051,14174,158,104,2,106,1
2020-08-04,Monterey,053,433212,6056,4892,13,4905,32
2020-08-04,Napa,055,140530,1223,994,0,994,8
2020-08-04,Nevada,057,99092,356,322,13,335,2
2020-08-04,Orange,059,3164182,45193,37844,885,38729,659
2020-08-04,Placer,061,380077,2482,1964,4,1968,17
2020-08-04,Plumas,063,18699,36,25,0,25,0
2020-08-04,Riverside,065,2383286,46971,38991,45,39036,743
2020-08-04,Sacramento,067,1510023,13816,10205,13,10218,146
2020-08-04,San Benito,069,59416,765,608,0,608,2
2020-08-04,San Bernardino,071,2135413,42029,34215,195,34410,495
2020-08-04,San Diego,073,3302833,33787,30518,46,30564,568
2020-08-04,San Francisco,075,870044,7766,6568,6,6574,60
2020-08-04,San Joaquin,077,732212,15522,12087,16,12103,189
2020-08-04,San Luis Obispo,079,281455,2365,1886,10,1896,13
2020-08-04,San Mateo,081,765935,6897,5690,7,5697,116
2020-08-04,Santa Barbara,083,443738,7083,6591,64,6655,61
2020-08-04,Santa Clara,085,1922200,13965,10986,31,11017,175
2020-08-04,Santa Cruz,087,273765,1425,1202,7,1209,4
2020-08-04,Shasta,089,179085,519,335,3,338,9
2020-08-04,Sierra,091,2930,5,1,0,1,0
2020-08-04,Siskiyou,093,43540,103,71,0,71,0
2020-08-04,Solano,095,438530,4531,3690,25,3715,29
2020-08-04,Sonoma,097,501317,4090,3108,8,3116,33
2020-08-04,Stanislaus,099,539301,12482,9359,74,9433,97
2020-08-04,Sutter,101,95872,963,761,1,762,6
2020-08-04,Tehama,103,63373,301,226,2,228,1
2020-08-04,Trinity,105,12862,27,5,6,11,0
2020-08-04,Tulare,107,460477,11971,9866,30,9896,192
2020-08-04,Tuolumne,109,53932,158,127,4,131,0
2020-08-04,Ventura,111,848112,9282,8134,34,8168,75
2020-08-04,Yolo,113,214977,1976,1626,4,1630,37
2020-08-04,Yuba,115,75493,574,398,0,398,1
2020-08-03,Alameda,001,1643700,14413,11817,102,11919,189
2020-08-03,Alpine,003,1148,2,2,0,2,0
2020-08-03,Amador,005,37829,199,119,0,119,0
2020-08-03,Butte,007,227075,1253,989,33,1022,9
2020-08-03,Calaveras,009,45235,157,117,0,117,1
2020-08-03,Colusa,011,21464,392,336,0,336,2
2020-08-03,Contra Costa,013,1133247,11030,8069,30,8099,120
2020-08-03,Del Norte,015,27424,90,68,0,68,0
2020-08-03,El Dorado,017,186661,833,645,6,651,1
2020-08-03,Fresno,019,978130,22568,15945,200,16145,151
2020-08-03,Glenn,021,27897,389,316,0,316,1
2020-08-03,Humboldt,023,135768,277,234,1,235,4
2020-08-03,Imperial,025,180216,10490,7953,6,7959,161
2020-08-03,Inyo,027,18085,85,57,1,58,1
2020-08-03,Kern,029,883053,25731,21285,147,21432,176
2020-08-03,Kings,031,150075,4963,4107,21,4128,47
2020-08-03,Lake,033,64148,245,201,0,201,1
2020-08-03,Lassen,035,31185,645,555,2,557,0
2020-08-03,Los Angeles,037,10098052,208505,194103,625,194728,4706
2020-08-03,Madera,039,155013,3032,2143,7,2150,18
2020-08-03,Marin,041,260295,5528,5001,9,5010,43
2020-08-03,Mariposa,043,17540,63,52,0,52,2
2020-08-03,Mendocino,045,87422,354,248,0,248,1
2020-08-03,Merced,047,269075,6245,4028,2,4030,29
2020-08-03,Modoc,049,8938,7,2,0,2,0
2020-08-03,Mono,051,14174,158,104,2,106,1
2020-08-03,Monterey,053,433212,5905,4806,10,4816,28
2020-08-03,Napa,055,140530,1209,973,0,973,8
2020-08-03,Nevada,057,99092,352,315,13,328,2
2020-08-03,Orange,059,3164182,44799,37705,875,38580,651
2020-08-03,Placer,061,380077,2426,1947,3,1950,16
2020-08-03,Plumas,063,18699,36,25,0,25,0
2020-08-03,Riverside,065,2383286,46503,38642,45,38687,740
2020-08-03,Sacramento,067,1510023,13621,10143,13,10156,142
2020-08-03,San Benito,069,59416,753,603,0,603,2
2020-08-03,San Bernardino,071,2135413,41504,33979,189,34168,444
2020-08-03,San Diego,073,3302833,33473,30228,36,30264,565
2020-08-03,San Francisco,075,870044,7672,6319,6,6325,60
2020-08-03,San Joaquin,077,732212,15325,12007,15,12022,189
2020-08-03,San Luis Obispo,079,281455,2323,1863,8,1871,14
2020-08-03,San Mateo,081,765935,6816,5661,7,5668,115
2020-08-03,Santa Barbara,083,443738,7039,6580,64,6644,59
2020-08-03,Santa Clara,085,1922200,13688,10747,31,10778,172
2020-08-03,Santa Cruz,087,273765,1405,1154,7,1161,4
2020-08-03,Shasta,089,179085,512,322,3,325,9
2020-08-03,Sierra,091,2930,5,1,0,1,0
2020-08-03,Siskiyou,093,43540,99,67,0,67,0
2020-08-03,Solano,095,438530,4462,3610,24,3634,29
2020-08-03,Sonoma,097,501317,3989,3079,7,3086,33
2020-08-03,Stanislaus,099,539301,12273,9308,66,9374,96
2020-08-03,Sutter,101,95872,939,713,1,714,6
2020-08-03,Tehama,103,63373,293,225,2,227,1
2020-08-03,Trinity,105,12862,27,5,6,11,0
2020-08-03,Tulare,107,460477,11787,9703,30,9733,188
2020-08-03,Tuolumne,109,53932,158,123,4,127,0
2020-08-03,Ventura,111,848112,9191,8084,31,8115,74
2020-08-03,Yolo,113,214977,1941,1598,3,1601,37
2020-08-03,Yuba,115,75493,550,393,0,393,1
2020-08-02,Alameda,001,1643700,14167,11696,90,11786,188
2020-08-02,Alpine,003,1148,2,2,0,2,0
2020-08-02,Amador,005,37829,194,117,0,117,0
2020-08-02,Butte,007,227075,1218,987,32,1019,9
2020-08-02,Calaveras,009,45235,154,116,0,116,1
2020-08-02,Colusa,011,21464,387,335,0,335,2
2020-08-02,Contra Costa,013,1133247,10791,7995,30,8025,118
2020-08-02,Del Norte,015,27424,89,68,0,68,0
2020-08-02,El Dorado,017,186661,823,643,6,649,1
2020-08-02,Fresno,019,978130,22294,15759,194,15953,151
2020-08-02,Glenn,021,27897,388,315,0,315,1
2020-08-02,Humboldt,023,135768,272,232,1,233,4
2020-08-02,Imperial,025,180216,10427,7919,6,7925,157
2020-08-02,Inyo,027,18085,84,45,1,46,1
2020-08-02,Kern,029,883053,25433,21162,145,21307,176
2020-08-02,Kings,031,150075,4901,3964,20,3984,47
2020-08-02,Lake,033,64148,240,201,0,201,1
2020-08-02,Lassen,035,31185,645,555,2,557,0
2020-08-02,Los Angeles,037,10098052,206414,192480,607,193087,4698
2020-08-02,Madera,039,155013,2966,2123,5,2128,18
2020-08-02,Marin,041,260295,5493,4985,9,4994,43
2020-08-02,Mariposa,043,17540,61,52,0,52,2
2020-08-02,Mendocino,045,87422,344,247,0,247,1
2020-08-02,Merced,047,269075,6104,4011,2,4013,29
2020-08-02,Modoc,049,8938,7,2,0,2,0
2020-08-02,Mono,051,14174,151,104,2,106,1
2020-08-02,Monterey,053,433212,5779,4698,10,4708,28
2020-08-02,Napa,055,140530,1195,956,0,956,8
2020-08-02,Nevada,057,99092,349,314,13,327,2
2020-08-02,Orange,059,3164182,44418,37266,864,38130,651
2020-08-02,Placer,061,380077,2387,1920,3,1923,15
2020-08-02,Plumas,063,18699,36,25,0,25,0
2020-08-02,Riverside,065,2383286,46070,38507,44,38551,735
2020-08-02,Sacramento,067,1510023,13342,10099,13,10112,142
2020-08-02,San Benito,069,59416,739,599,0,599,2
2020-08-02,San Bernardino,071,2135413,40902,33643,185,33828,443
2020-08-02,San Diego,073,3302833,33133,29885,27,29912,565
2020-08-02,San Francisco,075,870044,7554,6297,6,6303,60
2020-08-02,San Joaquin,077,732212,15044,11937,13,11950,189
2020-08-02,San Luis Obispo,079,281455,2260,1821,8,1829,14
2020-08-02,San Mateo,081,765935,6701,5618,7,5625,115
2020-08-02,Santa Barbara,083,443738,6949,6532,64,6596,59
2020-08-02,Santa Clara,085,1922200,13468,10577,31,10608,172
2020-08-02,Santa Cruz,087,273765,1385,1162,7,1169,4
2020-08-02,Shasta,089,179085,508,318,3,321,9
2020-08-02,Sierra,091,2930,4,1,0,1,0
2020-08-02,Siskiyou,093,43540,99,65,0,65,0
2020-08-02,Solano,095,438530,4403,3609,24,3633,29
2020-08-02,Sonoma,097,501317,3904,3005,7,3012,33
2020-08-02,Stanislaus,099,539301,12058,9277,61,9338,96
2020-08-02,Sutter,101,95872,904,714,1,715,6
2020-08-02,Tehama,103,63373,287,222,2,224,1
2020-08-02,Trinity,105,12862,27,5,6,11,0
2020-08-02,Tulare,107,460477,11578,9593,30,9623,188
2020-08-02,Tuolumne,109,53932,155,123,4,127,0
2020-08-02,Ventura,111,848112,9044,8014,31,8045,73
2020-08-02,Yolo,113,214977,1916,1588,3,1591,37
2020-08-02,Yuba,115,75493,530,393,0,393,1
2020-08-01,Alameda,001,1643700,14055,11590,90,11680,188
2020-08-01,Alpine,003,1148,2,2,0,2,0
2020-08-01,Amador,005,37829,190,109,0,109,0
2020-08-01,Butte,007,227075,1204,976,32,1008,9
2020-08-01,Calaveras,009,45235,150,116,0,116,1
2020-08-01,Colusa,011,21464,386,327,0,327,2
2020-08-01,Contra Costa,013,1133247,10658,7867,29,7896,116
2020-08-01,Del Norte,015,27424,89,68,0,68,0
2020-08-01,El Dorado,017,186661,820,637,6,643,1
2020-08-01,Fresno,019,978130,22157,15448,194,15642,149
2020-08-01,Glenn,021,27897,387,311,0,311,1
2020-08-01,Humboldt,023,135768,271,232,1,233,4
2020-08-01,Imperial,025,180216,10391,7919,6,7925,156
2020-08-01,Inyo,027,18085,82,45,1,46,1
2020-08-01,Kern,029,883053,25275,20796,141,20937,176
2020-08-01,Kings,031,150075,4875,3948,20,3968,47
2020-08-01,Lake,033,64148,238,194,0,194,1
2020-08-01,Lassen,035,31185,644,555,2,557,0
2020-08-01,Los Angeles,037,10098052,205522,191023,580,191603,4674
2020-08-01,Madera,039,155013,2927,2103,5,2108,18
2020-08-01,Marin,041,260295,5478,4945,9,4954,43
2020-08-01,Mariposa,043,17540,61,50,0,50,2
2020-08-01,Mendocino,045,87422,337,243,0,243,1
2020-08-01,Merced,047,269075,6056,3972,2,3974,29
2020-08-01,Modoc,049,8938,7,2,0,2,0
2020-08-01,Mono,051,14174,150,104,2,106,1
2020-08-01,Monterey,053,433212,5712,4611,9,4620,28
2020-08-01,Napa,055,140530,1186,923,0,923,8
2020-08-01,Nevada,057,99092,345,305,13,318,2
2020-08-01,Orange,059,3164182,44191,36703,858,37561,648
2020-08-01,Placer,061,380077,2353,1891,3,1894,14
2020-08-01,Plumas,063,18699,35,25,0,25,0
2020-08-01,Riverside,065,2383286,45858,38216,42,38258,704
2020-08-01,Sacramento,067,1510023,13191,10044,13,10057,141
2020-08-01,San Benito,069,59416,728,579,0,579,2
2020-08-01,San Bernardino,071,2135413,40666,32947,184,33131,440
2020-08-01,San Diego,073,3302833,32916,29579,19,29598,565
2020-08-01,San Francisco,075,870044,7493,6296,6,6302,60
2020-08-01,San Joaquin,077,732212,14969,11807,12,11819,189
2020-08-01,San Luis Obispo,079,281455,2231,1798,8,1806,13
2020-08-01,San Mateo,081,765935,6647,5520,7,5527,115
2020-08-01,Santa Barbara,083,443738,6909,6465,64,6529,59
2020-08-01,Santa Clara,085,1922200,13317,10281,30,10311,171
2020-08-01,Santa Cruz,087,273765,1369,1164,7,1171,4
2020-08-01,Shasta,089,179085,503,312,3,315,9
2020-08-01,Sierra,091,2930,3,1,0,1,0
2020-08-01,Siskiyou,093,43540,99,64,0,64,0
2020-08-01,Solano,095,438530,4369,3591,23,3614,29
2020-08-01,Sonoma,097,501317,3858,2890,7,2897,29
2020-08-01,Stanislaus,099,539301,11940,9221,54,9275,96
2020-08-01,Sutter,101,95872,900,714,1,715,6
2020-08-01,Tehama,103,63373,284,220,2,222,1
2020-08-01,Trinity,105,12862,27,5,6,11,0
2020-08-01,Tulare,107,460477,11510,9520,30,9550,188
2020-08-01,Tuolumne,109,53932,155,123,4,127,0
2020-08-01,Ventura,111,848112,8998,7819,31,7850,73
2020-08-01,Yolo,113,214977,1906,1557,3,1560,37
2020-08-01,Yuba,115,75493,525,387,0,387,1
2020-07-31,Alameda,001,1643700,13926,11441,90,11531,187
2020-07-31,Alpine,003,1148,2,2,0,2,0
2020-07-31,Amador,005,37829,189,98,0,98,0
2020-07-31,Butte,007,227075,1181,925,32,957,7
2020-07-31,Calaveras,009,45235,150,112,0,112,1
2020-07-31,Colusa,011,21464,376,319,0,319,2
2020-07-31,Contra Costa,013,1133247,10511,7697,28,7725,113
2020-07-31,Del Norte,015,27424,88,68,0,68,0
2020-07-31,El Dorado,017,186661,809,616,6,622,1
2020-07-31,Fresno,019,978130,21937,15083,194,15277,133
2020-07-31,Glenn,021,27897,380,304,0,304,1
2020-07-31,Humboldt,023,135768,264,229,1,230,4
2020-07-31,Imperial,025,180216,10359,7886,5,7891,155
2020-07-31,Inyo,027,18085,72,45,1,46,1
2020-07-31,Kern,029,883053,25034,20061,137,20198,173
2020-07-31,Kings,031,150075,4847,3807,20,3827,45
2020-07-31,Lake,033,64148,237,191,0,191,1
2020-07-31,Lassen,035,31185,639,544,2,546,0
2020-07-31,Los Angeles,037,10098052,203923,188688,567,189255,4628
2020-07-31,Madera,039,155013,2880,2036,5,2041,19
2020-07-31,Marin,041,260295,5434,4885,6,4891,43
2020-07-31,Mariposa,043,17540,61,49,0,49,2
2020-07-31,Mendocino,045,87422,322,232,0,232,1
2020-07-31,Merced,047,269075,5973,3789,2,3791,30
2020-07-31,Modoc,049,8938,6,0,0,0,0
2020-07-31,Mono,051,14174,149,104,2,106,1
2020-07-31,Monterey,053,433212,5620,4493,9,4502,24
2020-07-31,Napa,055,140530,1174,897,0,897,7
2020-07-31,Nevada,057,99092,343,302,13,315,2
2020-07-31,Orange,059,3164182,43892,36196,841,37037,620
2020-07-31,Placer,061,380077,2328,1853,3,1856,14
2020-07-31,Plumas,063,18699,34,25,0,25,0
2020-07-31,Riverside,065,2383286,45468,37612,41,37653,694
2020-07-31,Sacramento,067,1510023,13013,9872,13,9885,132
2020-07-31,San Benito,069,59416,720,567,0,567,2
2020-07-31,San Bernardino,071,2135413,40336,32332,182,32514,434
2020-07-31,San Diego,073,3302833,32682,29050,11,29061,561
2020-07-31,San Francisco,075,870044,7393,6126,6,6132,60
2020-07-31,San Joaquin,077,732212,14829,11561,12,11573,177
2020-07-31,San Luis Obispo,079,281455,2162,1746,8,1754,12
2020-07-31,San Mateo,081,765935,6575,5416,7,5423,115
2020-07-31,Santa Barbara,083,443738,6842,6375,64,6439,58
2020-07-31,Santa Clara,085,1922200,13096,9863,30,9893,171
2020-07-31,Santa Cruz,087,273765,1346,1118,7,1125,4
2020-07-31,Shasta,089,179085,493,305,3,308,9
2020-07-31,Sierra,091,2930,3,1,0,1,0
2020-07-31,Siskiyou,093,43540,97,61,0,61,0
2020-07-31,Solano,095,438530,4321,3510,22,3532,29
2020-07-31,Sonoma,097,501317,3800,2745,7,2752,27
2020-07-31,Stanislaus,099,539301,11834,9061,49,9110,94
2020-07-31,Sutter,101,95872,895,714,1,715,6
2020-07-31,Tehama,103,63373,281,213,2,215,1
2020-07-31,Trinity,105,12862,27,5,6,11,0
2020-07-31,Tulare,107,460477,11389,9365,30,9395,184
2020-07-31,Tuolumne,109,53932,155,120,4,124,0
2020-07-31,Ventura,111,848112,8923,7521,31,7552,71
2020-07-31,Yolo,113,214977,1880,1522,3,1525,38
2020-07-31,Yuba,115,75493,516,369,0,369,1
2020-07-30,Alameda,001,1643700,13721,11303,52,11355,185
2020-07-30,Alpine,003,1148,2,2,0,2,0
2020-07-30,Amador,005,37829,171,97,0,97,0
2020-07-30,Butte,007,227075,1165,915,32,947,7
2020-07-30,Calaveras,009,45235,146,111,0,111,1
2020-07-30,Colusa,011,21464,373,315,0,315,2
2020-07-30,Contra Costa,013,1133247,10327,7615,27,7642,112
2020-07-30,Del Norte,015,27424,88,68,0,68,0
2020-07-30,El Dorado,017,186661,802,608,6,614,1
2020-07-30,Fresno,019,978130,21603,14793,188,14981,133
2020-07-30,Glenn,021,27897,373,297,0,297,1
2020-07-30,Humboldt,023,135768,262,228,1,229,4
2020-07-30,Imperial,025,180216,10300,7849,5,7854,151
2020-07-30,Inyo,027,18085,68,44,1,45,1
2020-07-30,Kern,029,883053,24741,19552,133,19685,171
2020-07-30,Kings,031,150075,4743,3785,20,3805,43
2020-07-30,Lake,033,64148,231,181,0,181,1
2020-07-30,Lassen,035,31185,636,544,2,546,0
2020-07-30,Los Angeles,037,10098052,201895,186177,537,186714,4564
2020-07-30,Madera,039,155013,2810,2007,5,2012,18
2020-07-30,Marin,041,260295,5392,4835,5,4840,39
2020-07-30,Mariposa,043,17540,61,49,0,49,1
2020-07-30,Mendocino,045,87422,315,232,0,232,1
2020-07-30,Merced,047,269075,5809,3695,2,3697,30
2020-07-30,Modoc,049,8938,6,0,0,0,0
2020-07-30,Mono,051,14174,148,104,2,106,1
2020-07-30,Monterey,053,433212,5508,4352,9,4361,24
2020-07-30,Napa,055,140530,1157,874,0,874,7
2020-07-30,Nevada,057,99092,338,292,13,305,2
2020-07-30,Orange,059,3164182,43477,36105,817,36922,607
2020-07-30,Placer,061,380077,2277,1821,3,1824,14
2020-07-30,Plumas,063,18699,33,25,0,25,0
2020-07-30,Riverside,065,2383286,44926,37308,41,37349,685
2020-07-30,Sacramento,067,1510023,12794,9704,13,9717,126
2020-07-30,San Benito,069,59416,707,558,0,558,2
2020-07-30,San Bernardino,071,2135413,39812,32010,182,32192,427
2020-07-30,San Diego,073,3302833,32335,28670,9,28679,558
2020-07-30,San Francisco,075,870044,7292,6107,6,6113,59
2020-07-30,San Joaquin,077,732212,14633,11435,12,11447,161
2020-07-30,San Luis Obispo,079,281455,2126,1703,8,1711,12
2020-07-30,San Mateo,081,765935,6480,5369,7,5376,115
2020-07-30,Santa Barbara,083,443738,6762,6273,64,6337,52
2020-07-30,Santa Clara,085,1922200,12863,9708,29,9737,170
2020-07-30,Santa Cruz,087,273765,1318,1087,7,1094,4
2020-07-30,Shasta,089,179085,489,306,3,309,8
2020-07-30,Sierra,091,2930,3,1,0,1,0
2020-07-30,Siskiyou,093,43540,96,60,0,60,0
2020-07-30,Solano,095,438530,4270,3463,22,3485,29
2020-07-30,Sonoma,097,501317,3729,2684,7,2691,25
2020-07-30,Stanislaus,099,539301,11621,8890,41,8931,94
2020-07-30,Sutter,101,95872,876,698,1,699,6
2020-07-30,Tehama,103,63373,278,208,2,210,1
2020-07-30,Trinity,105,12862,26,4,6,10,0
2020-07-30,Tulare,107,460477,11260,9167,30,9197,177
2020-07-30,Tuolumne,109,53932,154,119,4,123,0
2020-07-30,Ventura,111,848112,8811,7304,29,7333,69
2020-07-30,Yolo,113,214977,1860,1511,3,1514,37
2020-07-30,Yuba,115,75493,503,362,0,362,1
2020-07-29,Alameda,001,1643700,13500,11177,47,11224,180
2020-07-29,Alpine,003,1148,2,2,0,2,0
2020-07-29,Amador,005,37829,163,80,0,80,0
2020-07-29,Butte,007,227075,1139,889,30,919,7
2020-07-29,Calaveras,009,45235,139,107,0,107,1
2020-07-29,Colusa,011,21464,369,302,0,302,2
2020-07-29,Contra Costa,013,1133247,10123,7520,27,7547,108
2020-07-29,Del Norte,015,27424,88,68,0,68,0
2020-07-29,El Dorado,017,186661,792,588,6,594,1
2020-07-29,Fresno,019,978130,21311,14312,188,14500,125
2020-07-29,Glenn,021,27897,366,294,0,294,1
2020-07-29,Humboldt,023,135768,259,221,1,222,4
2020-07-29,Imperial,025,180216,10252,7825,5,7830,147
2020-07-29,Inyo,027,18085,63,44,1,45,1
2020-07-29,Kern,029,883053,24402,19073,130,19203,162
2020-07-29,Kings,031,150075,4695,3755,20,3775,43
2020-07-29,Lake,033,64148,229,179,0,179,1
2020-07-29,Lassen,035,31185,621,513,2,515,0
2020-07-29,Los Angeles,037,10098052,199869,183600,520,184120,4523
2020-07-29,Madera,039,155013,2756,1941,5,1946,18
2020-07-29,Marin,041,260295,5354,4747,5,4752,34
2020-07-29,Mariposa,043,17540,60,47,0,47,1
2020-07-29,Mendocino,045,87422,307,228,0,228,0
2020-07-29,Merced,047,269075,5669,3605,2,3607,25
2020-07-29,Modoc,049,8938,5,0,0,0,0
2020-07-29,Mono,051,14174,145,102,2,104,1
2020-07-29,Monterey,053,433212,5408,4252,9,4261,24
2020-07-29,Napa,055,140530,1129,866,0,866,7
2020-07-29,Nevada,057,99092,334,288,13,301,1
2020-07-29,Orange,059,3164182,43043,35339,806,36145,589
2020-07-29,Placer,061,380077,2245,1798,3,1801,14
2020-07-29,Plumas,063,18699,33,25,0,25,0
2020-07-29,Riverside,065,2383286,44335,36968,41,37009,678
2020-07-29,Sacramento,067,1510023,12548,9538,13,9551,122
2020-07-29,San Benito,069,59416,692,537,0,537,2
2020-07-29,San Bernardino,071,2135413,39323,31168,171,31339,417
2020-07-29,San Diego,073,3302833,32010,28289,8,28297,552
2020-07-29,San Francisco,075,870044,7198,6041,6,6047,56
2020-07-29,San Joaquin,077,732212,14384,11249,9,11258,154
2020-07-29,San Luis Obispo,079,281455,2105,1673,8,1681,11
2020-07-29,San Mateo,081,765935,6392,5305,7,5312,114
2020-07-29,Santa Barbara,083,443738,6695,6215,64,6279,31
2020-07-29,Santa Clara,085,1922200,12657,9567,29,9596,165
2020-07-29,Santa Cruz,087,273765,1294,1051,7,1058,4
2020-07-29,Shasta,089,179085,477,297,3,300,8
2020-07-29,Sierra,091,2930,2,1,0,1,0
2020-07-29,Siskiyou,093,43540,94,58,0,58,0
2020-07-29,Solano,095,438530,4216,3380,22,3402,29
2020-07-29,Sonoma,097,501317,3651,2598,7,2605,26
2020-07-29,Stanislaus,099,539301,11400,8745,35,8780,94
2020-07-29,Sutter,101,95872,848,678,1,679,6
2020-07-29,Tehama,103,63373,274,206,2,208,1
2020-07-29,Trinity,105,12862,26,4,6,10,0
2020-07-29,Tulare,107,460477,11089,9028,30,9058,156
2020-07-29,Tuolumne,109,53932,154,118,4,122,0
2020-07-29,Ventura,111,848112,8706,7161,29,7190,68
2020-07-29,Yolo,113,214977,1834,1488,3,1491,36
2020-07-29,Yuba,115,75493,487,350,0,350,1
2020-07-28,Alameda,001,1643700,13270,10875,46,10921,180
2020-07-28,Alpine,003,1148,2,2,0,2,0
2020-07-28,Amador,005,37829,153,77,0,77,0
2020-07-28,Butte,007,227075,1104,857,30,887,7
2020-07-28,Calaveras,009,45235,138,105,0,105,1
2020-07-28,Colusa,011,21464,363,290,0,290,2
2020-07-28,Contra Costa,013,1133247,9901,7426,27,7453,107
2020-07-28,Del Norte,015,27424,87,68,0,68,0
2020-07-28,El Dorado,017,186661,777,558,6,564,1
2020-07-28,Fresno,019,978130,20977,13933,182,14115,125
2020-07-28,Glenn,021,27897,364,289,0,289,1
2020-07-28,Humboldt,023,135768,258,218,1,219,4
2020-07-28,Imperial,025,180216,10216,7804,5,7809,145
2020-07-28,Inyo,027,18085,61,43,1,44,1
2020-07-28,Kern,029,883053,24039,18834,124,18958,155
2020-07-28,Kings,031,150075,4649,3721,20,3741,41
2020-07-28,Lake,033,64148,225,179,0,179,1
2020-07-28,Lassen,035,31185,615,508,2,510,0
2020-07-28,Los Angeles,037,10098052,197637,179107,499,179606,4435
2020-07-28,Madera,039,155013,2690,1889,5,1894,18
2020-07-28,Marin,041,260295,5285,4698,5,4703,23
2020-07-28,Mariposa,043,17540,58,45,0,45,1
2020-07-28,Mendocino,045,87422,296,222,0,222,0
2020-07-28,Merced,047,269075,5524,3446,2,3448,23
2020-07-28,Modoc,049,8938,4,0,0,0,0
2020-07-28,Mono,051,14174,144,102,2,104,1
2020-07-28,Monterey,053,433212,5288,4047,9,4056,22
2020-07-28,Napa,055,140530,1107,824,0,824,6
2020-07-28,Nevada,057,99092,329,278,13,291,1
2020-07-28,Orange,059,3164182,42585,34832,792,35624,582
2020-07-28,Placer,061,380077,2209,1759,3,1762,14
2020-07-28,Plumas,063,18699,33,22,0,22,0
2020-07-28,Riverside,065,2383286,43734,36458,41,36499,668
2020-07-28,Sacramento,067,1510023,12289,9429,12,9441,117
2020-07-28,San Benito,069,59416,682,503,0,503,2
2020-07-28,San Bernardino,071,2135413,38800,30493,167,30660,412
2020-07-28,San Diego,073,3302833,31660,28007,6,28013,547
2020-07-28,San Francisco,075,870044,7085,5888,6,5894,56
2020-07-28,San Joaquin,077,732212,14102,10958,6,10964,141
2020-07-28,San Luis Obispo,079,281455,2072,1636,8,1644,9
2020-07-28,San Mateo,081,765935,6319,5171,7,5178,114
2020-07-28,Santa Barbara,083,443738,6631,6110,62,6172,31
2020-07-28,Santa Clara,085,1922200,12423,9307,29,9336,165
2020-07-28,Santa Cruz,087,273765,1267,1018,7,1025,4
2020-07-28,Shasta,089,179085,465,275,3,278,8
2020-07-28,Sierra,091,2930,2,1,0,1,0
2020-07-28,Siskiyou,093,43540,90,57,0,57,0
2020-07-28,Solano,095,438530,4169,3292,21,3313,29
2020-07-28,Sonoma,097,501317,3576,2553,7,2560,20
2020-07-28,Stanislaus,099,539301,11178,8492,27,8519,92
2020-07-28,Sutter,101,95872,811,653,0,653,2
2020-07-28,Tehama,103,63373,269,199,2,201,1
2020-07-28,Trinity,105,12862,26,3,6,9,0
2020-07-28,Tulare,107,460477,10902,8787,30,8817,96
2020-07-28,Tuolumne,109,53932,153,116,4,120,0
2020-07-28,Ventura,111,848112,8580,7045,28,7073,68
2020-07-28,Yolo,113,214977,1806,1459,3,1462,36
2020-07-28,Yuba,115,75493,470,333,0,333,1
2020-07-27,Alameda,001,1643700,13042,10645,43,10688,176
2020-07-27,Alpine,003,1148,2,2,0,2,0
2020-07-27,Amador,005,37829,148,72,0,72,0
2020-07-27,Butte,007,227075,1077,843,30,873,7
2020-07-27,Calaveras,009,45235,134,103,0,103,1
2020-07-27,Colusa,011,21464,356,271,0,271,2
2020-07-27,Contra Costa,013,1133247,9678,7256,27,7283,104
2020-07-27,Del Norte,015,27424,86,67,0,67,0
2020-07-27,El Dorado,017,186661,765,548,6,554,1
2020-07-27,Fresno,019,978130,20628,13485,176,13661,117
2020-07-27,Glenn,021,27897,362,277,0,277,1
2020-07-27,Humboldt,023,135768,253,218,1,219,4
2020-07-27,Imperial,025,180216,10166,7789,5,7794,144
2020-07-27,Inyo,027,18085,61,43,1,44,1
2020-07-27,Kern,029,883053,23537,17994,118,18112,148
2020-07-27,Kings,031,150075,4400,3685,20,3705,39
2020-07-27,Lake,033,64148,221,176,0,176,1
2020-07-27,Lassen,035,31185,615,503,2,505,0
2020-07-27,Los Angeles,037,10098052,195210,176351,481,176832,4379
2020-07-27,Madera,039,155013,2625,1793,5,1798,17
2020-07-27,Marin,041,260295,5197,4669,5,4674,22
2020-07-27,Mariposa,043,17540,58,43,0,43,1
2020-07-27,Mendocino,045,87422,282,209,0,209,0
2020-07-27,Merced,047,269075,5384,3292,2,3294,23
2020-07-27,Modoc,049,8938,3,0,0,0,0
2020-07-27,Mono,051,14174,140,99,2,101,1
2020-07-27,Monterey,053,433212,5099,3960,9,3969,21
2020-07-27,Napa,055,140530,1092,769,0,769,6
2020-07-27,Nevada,057,99092,325,268,13,281,1
2020-07-27,Orange,059,3164182,42145,34649,776,35425,566
2020-07-27,Placer,061,380077,2159,1679,3,1682,12
2020-07-27,Plumas,063,18699,33,22,0,22,0
2020-07-27,Riverside,065,2383286,43055,35822,41,35863,667
2020-07-27,Sacramento,067,1510023,11996,9091,12,9103,114
2020-07-27,San Benito,069,59416,667,498,0,498,2
2020-07-27,San Bernardino,071,2135413,38208,29928,157,30085,401
2020-07-27,San Diego,073,3302833,31286,27509,5,27514,533
2020-07-27,San Francisco,075,870044,6998,5825,6,5831,55
2020-07-27,San Joaquin,077,732212,13814,10728,6,10734,129
2020-07-27,San Luis Obispo,079,281455,2026,1612,8,1620,9
2020-07-27,San Mateo,081,765935,6210,5108,7,5115,113
2020-07-27,Santa Barbara,083,443738,6552,6026,60,6086,30
2020-07-27,Santa Clara,085,1922200,12154,9157,28,9185,166
2020-07-27,Santa Cruz,087,273765,1243,984,7,991,4
2020-07-27,Shasta,089,179085,458,275,3,278,8
2020-07-27,Sierra,091,2930,2,1,0,1,0
2020-07-27,Siskiyou,093,43540,88,54,0,54,0
2020-07-27,Solano,095,438530,4102,3198,20,3218,29
2020-07-27,Sonoma,097,501317,3485,2504,7,2511,20
2020-07-27,Stanislaus,099,539301,10953,8288,19,8307,84
2020-07-27,Sutter,101,95872,785,620,0,620,2
2020-07-27,Tehama,103,63373,261,192,2,194,1
2020-07-27,Trinity,105,12862,26,3,6,9,0
2020-07-27,Tulare,107,460477,10684,8462,30,8492,172
2020-07-27,Tuolumne,109,53932,150,115,4,119,0
2020-07-27,Ventura,111,848112,8452,6998,27,7025,68
2020-07-27,Yolo,113,214977,1761,1439,3,1442,33
2020-07-27,Yuba,115,75493,450,328,0,328,1
2020-07-26,Alameda,001,1643700,12803,10489,42,10531,176
2020-07-26,Alpine,003,1148,2,2,0,2,0
2020-07-26,Amador,005,37829,142,67,0,67,0
2020-07-26,Butte,007,227075,1040,822,29,851,5
2020-07-26,Calaveras,009,45235,131,103,0,103,1
2020-07-26,Colusa,011,21464,347,270,0,270,2
2020-07-26,Contra Costa,013,1133247,9440,7095,27,7122,104
2020-07-26,Del Norte,015,27424,84,67,0,67,0
2020-07-26,El Dorado,017,186661,747,539,6,545,1
2020-07-26,Fresno,019,978130,20237,13209,168,13377,117
2020-07-26,Glenn,021,27897,354,265,0,265,1
2020-07-26,Humboldt,023,135768,247,214,1,215,4
2020-07-26,Imperial,025,180216,10094,7781,5,7786,144
2020-07-26,Inyo,027,18085,56,43,1,44,1
2020-07-26,Kern,029,883053,23012,17394,115,17509,148
2020-07-26,Kings,031,150075,4341,3591,20,3611,39
2020-07-26,Lake,033,64148,213,174,0,174,1
2020-07-26,Lassen,035,31185,574,503,2,505,0
2020-07-26,Los Angeles,037,10098052,192641,174322,463,174785,4364
2020-07-26,Madera,039,155013,2538,1744,5,1749,17
2020-07-26,Marin,041,260295,5151,4595,5,4600,22
2020-07-26,Mariposa,043,17540,56,43,0,43,1
2020-07-26,Mendocino,045,87422,273,206,0,206,0
2020-07-26,Merced,047,269075,5204,3251,2,3253,23
2020-07-26,Modoc,049,8938,3,0,0,0,0
2020-07-26,Mono,051,14174,136,82,2,84,1
2020-07-26,Monterey,053,433212,4933,3901,9,3910,21
2020-07-26,Napa,055,140530,1073,769,0,769,6
2020-07-26,Nevada,057,99092,322,261,13,274,1
2020-07-26,Orange,059,3164182,41620,34352,745,35097,564
2020-07-26,Placer,061,380077,2095,1628,3,1631,12
2020-07-26,Plumas,063,18699,33,22,0,22,0
2020-07-26,Riverside,065,2383286,42495,35636,41,35677,665
2020-07-26,Sacramento,067,1510023,11690,8972,12,8984,114
2020-07-26,San Benito,069,59416,655,495,0,495,2
2020-07-26,San Bernardino,071,2135413,37567,29545,149,29694,400
2020-07-26,San Diego,073,3302833,30890,26986,4,26990,533
2020-07-26,San Francisco,075,870044,6892,5823,6,5829,55
2020-07-26,San Joaquin,077,732212,13522,10637,6,10643,129
2020-07-26,San Luis Obispo,079,281455,1984,1565,8,1573,8
2020-07-26,San Mateo,081,765935,6105,5078,7,5085,113
2020-07-26,Santa Barbara,083,443738,6451,5939,60,5999,30
2020-07-26,Santa Clara,085,1922200,11925,8986,28,9014,166
2020-07-26,Santa Cruz,087,273765,1216,970,7,977,4
2020-07-26,Shasta,089,179085,451,265,3,268,8
2020-07-26,Sierra,091,2930,2,1,0,1,0
2020-07-26,Siskiyou,093,43540,86,54,0,54,0
2020-07-26,Solano,095,438530,4023,3197,18,3215,29
2020-07-26,Sonoma,097,501317,3396,2503,6,2509,20
2020-07-26,Stanislaus,099,539301,10690,8228,18,8246,84
2020-07-26,Sutter,101,95872,771,612,0,612,2
2020-07-26,Tehama,103,63373,254,175,2,177,1
2020-07-26,Trinity,105,12862,26,3,6,9,0
2020-07-26,Tulare,107,460477,10478,8392,30,8422,172
2020-07-26,Tuolumne,109,53932,145,113,4,117,0
2020-07-26,Ventura,111,848112,8245,6844,27,6871,67
2020-07-26,Yolo,113,214977,1730,1408,3,1411,33
2020-07-26,Yuba,115,75493,431,313,0,313,1
2020-07-25,Alameda,001,1643700,12706,10361,40,10401,176
2020-07-25,Alpine,003,1148,2,2,0,2,0
2020-07-25,Amador,005,37829,139,67,0,67,0
2020-07-25,Butte,007,227075,1031,810,29,839,5
2020-07-25,Calaveras,009,45235,128,103,0,103,1
2020-07-25,Colusa,011,21464,340,265,0,265,2
2020-07-25,Contra Costa,013,1133247,9297,6920,27,6947,104
2020-07-25,Del Norte,015,27424,84,67,0,67,0
2020-07-25,El Dorado,017,186661,736,528,6,534,1
2020-07-25,Fresno,019,978130,20050,12866,168,13034,117
2020-07-25,Glenn,021,27897,352,260,0,260,1
2020-07-25,Humboldt,023,135768,244,212,1,213,4
2020-07-25,Imperial,025,180216,10068,7727,5,7732,144
2020-07-25,Inyo,027,18085,55,43,1,44,1
2020-07-25,Kern,029,883053,22794,16910,114,17024,148
2020-07-25,Kings,031,150075,4324,3516,20,3536,39
2020-07-25,Lake,033,64148,211,173,0,173,1
2020-07-25,Lassen,035,31185,574,503,2,505,0
2020-07-25,Los Angeles,037,10098052,191506,172611,457,173068,4357
2020-07-25,Madera,039,155013,2506,1724,5,1729,17
2020-07-25,Marin,041,260295,5135,4562,5,4567,22
2020-07-25,Mariposa,043,17540,55,43,0,43,1
2020-07-25,Mendocino,045,87422,267,190,0,190,0
2020-07-25,Merced,047,269075,5125,3176,2,3178,23
2020-07-25,Modoc,049,8938,3,0,0,0,0
2020-07-25,Mono,051,14174,136,82,2,84,1
2020-07-25,Monterey,053,433212,4856,3805,9,3814,21
2020-07-25,Napa,055,140530,1060,746,0,746,6
2020-07-25,Nevada,057,99092,320,257,13,270,1
2020-07-25,Orange,059,3164182,41401,33978,724,34702,561
2020-07-25,Placer,061,380077,2079,1596,3,1599,12
2020-07-25,Plumas,063,18699,33,22,0,22,0
2020-07-25,Riverside,065,2383286,42226,34921,41,34962,655
2020-07-25,Sacramento,067,1510023,11544,8674,11,8685,113
2020-07-25,San Benito,069,59416,639,492,0,492,2
2020-07-25,San Bernardino,071,2135413,37289,29265,146,29411,394
2020-07-25,San Diego,073,3302833,30629,26703,3,26706,533
2020-07-25,San Francisco,075,870044,6834,5644,6,5650,55
2020-07-25,San Joaquin,077,732212,13396,10347,5,10352,129
2020-07-25,San Luis Obispo,079,281455,1964,1530,7,1537,8
2020-07-25,San Mateo,081,765935,6042,5023,7,5030,113
2020-07-25,Santa Barbara,083,443738,6416,5880,60,5940,30
2020-07-25,Santa Clara,085,1922200,11791,8767,28,8795,166
2020-07-25,Santa Cruz,087,273765,1199,939,7,946,4
2020-07-25,Shasta,089,179085,446,263,1,264,8
2020-07-25,Sierra,091,2930,2,1,0,1,0
2020-07-25,Siskiyou,093,43540,84,54,0,54,0
2020-07-25,Solano,095,438530,3983,3107,16,3123,29
2020-07-25,Sonoma,097,501317,3357,2412,6,2418,20
2020-07-25,Stanislaus,099,539301,10587,7994,14,8008,84
2020-07-25,Sutter,101,95872,752,603,0,603,2
2020-07-25,Tehama,103,63373,253,169,2,171,1
2020-07-25,Trinity,105,12862,26,3,6,9,0
2020-07-25,Tulare,107,460477,10378,8310,30,8340,172
2020-07-25,Tuolumne,109,53932,144,99,4,103,0
2020-07-25,Ventura,111,848112,8172,6662,27,6689,62
2020-07-25,Yolo,113,214977,1714,1357,3,1360,35
2020-07-25,Yuba,115,75493,425,312,0,312,1
2020-07-24,Alameda,001,1643700,12565,10216,37,10253,176
2020-07-24,Alpine,003,1148,2,2,0,2,0
2020-07-24,Amador,005,37829,137,66,0,66,0
2020-07-24,Butte,007,227075,1019,751,29,780,5
2020-07-24,Calaveras,009,45235,124,102,0,102,0
2020-07-24,Colusa,011,21464,337,255,0,255,2
2020-07-24,Contra Costa,013,1133247,9152,6814,27,6841,100
2020-07-24,Del Norte,015,27424,84,66,0,66,0
2020-07-24,El Dorado,017,186661,714,516,6,522,1
2020-07-24,Fresno,019,978130,19825,12564,168,12732,115
2020-07-24,Glenn,021,27897,349,251,0,251,1
2020-07-24,Humboldt,023,135768,241,210,1,211,4
2020-07-24,Imperial,025,180216,10046,7686,5,7691,141
2020-07-24,Inyo,027,18085,55,41,1,42,1
2020-07-24,Kern,029,883053,22553,16124,114,16238,143
2020-07-24,Kings,031,150075,4294,3471,20,3491,39
2020-07-24,Lake,033,64148,209,167,0,167,1
2020-07-24,Lassen,035,31185,574,503,2,505,0
2020-07-24,Los Angeles,037,10098052,189481,169078,446,169524,4302
2020-07-24,Madera,039,155013,2473,1679,5,1684,16
2020-07-24,Marin,041,260295,5108,4517,5,4522,22
2020-07-24,Mariposa,043,17540,55,41,0,41,1
2020-07-24,Mendocino,045,87422,260,188,0,188,0
2020-07-24,Merced,047,269075,5040,3100,2,3102,23
2020-07-24,Modoc,049,8938,3,0,0,0,0
2020-07-24,Mono,051,14174,135,82,2,84,1
2020-07-24,Monterey,053,433212,4784,3748,9,3757,21
2020-07-24,Napa,055,140530,1047,741,0,741,6
2020-07-24,Nevada,057,99092,317,255,13,268,1
2020-07-24,Orange,059,3164182,41114,33530,708,34238,557
2020-07-24,Placer,061,380077,2048,1551,3,1554,12
2020-07-24,Plumas,063,18699,33,22,0,22,0
2020-07-24,Riverside,065,2383286,41802,34513,40,34553,631
2020-07-24,Sacramento,067,1510023,11356,8570,11,8581,110
2020-07-24,San Benito,069,59416,632,485,0,485,2
2020-07-24,San Bernardino,071,2135413,36918,28990,141,29131,386
2020-07-24,San Diego,073,3302833,30329,26100,3,26103,524
2020-07-24,San Francisco,075,870044,6740,5611,6,5617,55
2020-07-24,San Joaquin,077,732212,13247,10190,5,10195,118
2020-07-24,San Luis Obispo,079,281455,1940,1476,7,1483,8
2020-07-24,San Mateo,081,765935,5979,4954,7,4961,112
2020-07-24,Santa Barbara,083,443738,6363,5776,58,5834,30
2020-07-24,Santa Clara,085,1922200,11626,8658,28,8686,165
2020-07-24,Santa Cruz,087,273765,1179,930,7,937,4
2020-07-24,Shasta,089,179085,438,262,1,263,8
2020-07-24,Sierra,091,2930,2,1,0,1,0
2020-07-24,Siskiyou,093,43540,84,53,0,53,0
2020-07-24,Solano,095,438530,3947,3062,13,3075,29
2020-07-24,Sonoma,097,501317,3305,2345,6,2351,20
2020-07-24,Stanislaus,099,539301,10415,7861,12,7873,82
2020-07-24,Sutter,101,95872,741,593,0,593,2
2020-07-24,Tehama,103,63373,245,170,2,172,1
2020-07-24,Trinity,105,12862,25,3,6,9,0
2020-07-24,Tulare,107,460477,10284,8167,28,8195,167
2020-07-24,Tuolumne,109,53932,140,99,4,103,0
2020-07-24,Ventura,111,848112,8087,6553,27,6580,60
2020-07-24,Yolo,113,214977,1700,1329,3,1332,35
2020-07-24,Yuba,115,75493,410,307,0,307,1
2020-07-23,Alameda,001,1643700,12322,9924,37,9961,171
2020-07-23,Alpine,003,1148,2,2,0,2,0
2020-07-23,Amador,005,37829,120,61,0,61,0
2020-07-23,Butte,007,227075,1004,726,28,754,5
2020-07-23,Calaveras,009,45235,117,102,0,102,0
2020-07-23,Colusa,011,21464,329,242,0,242,2
2020-07-23,Contra Costa,013,1133247,8953,6619,25,6644,98
2020-07-23,Del Norte,015,27424,84,66,0,66,0
2020-07-23,El Dorado,017,186661,703,491,6,497,1
2020-07-23,Fresno,019,978130,19468,12164,165,12329,112
2020-07-23,Glenn,021,27897,344,246,0,246,1
2020-07-23,Humboldt,023,135768,240,208,1,209,4
2020-07-23,Imperial,025,180216,9995,7604,5,7609,138
2020-07-23,Inyo,027,18085,53,38,1,39,1
2020-07-23,Kern,029,883053,22146,14491,110,14601,128
2020-07-23,Kings,031,150075,4182,3371,20,3391,39
2020-07-23,Lake,033,64148,200,160,0,160,1
2020-07-23,Lassen,035,31185,571,503,2,505,0
2020-07-23,Los Angeles,037,10098052,186932,167198,420,167618,4265
2020-07-23,Madera,039,155013,2407,1659,4,1663,13
2020-07-23,Marin,041,260295,5056,4423,5,4428,22
2020-07-23,Mariposa,043,17540,55,40,0,40,1
2020-07-23,Mendocino,045,87422,250,178,0,178,0
2020-07-23,Merced,047,269075,4883,2972,2,2974,22
2020-07-23,Modoc,049,8938,3,0,0,0,0
2020-07-23,Mono,051,14174,131,82,2,84,1
2020-07-23,Monterey,053,433212,4667,3655,9,3664,21
2020-07-23,Napa,055,140530,1023,713,0,713,5
2020-07-23,Nevada,057,99092,314,247,13,260,1
2020-07-23,Orange,059,3164182,40618,32863,678,33541,544
2020-07-23,Placer,061,380077,2004,1519,3,1522,12
2020-07-23,Plumas,063,18699,32,21,0,21,0
2020-07-23,Riverside,065,2383286,41197,33833,40,33873,630
2020-07-23,Sacramento,067,1510023,11123,8222,11,8233,108
2020-07-23,San Benito,069,59416,618,478,0,478,2
2020-07-23,San Bernardino,071,2135413,36399,28121,135,28256,369
2020-07-23,San Diego,073,3302833,29955,25109,3,25112,505
2020-07-23,San Francisco,075,870044,6639,5543,6,5549,55
2020-07-23,San Joaquin,077,732212,13028,9861,5,9866,111
2020-07-23,San Luis Obispo,079,281455,1911,1438,7,1445,7
2020-07-23,San Mateo,081,765935,5874,4895,7,4902,113
2020-07-23,Santa Barbara,083,443738,6290,5628,58,5686,30
2020-07-23,Santa Clara,085,1922200,11407,8458,28,8486,165
2020-07-23,Santa Cruz,087,273765,1143,887,7,894,3
2020-07-23,Shasta,089,179085,427,254,1,255,9
2020-07-23,Sierra,091,2930,2,1,0,1,0
2020-07-23,Siskiyou,093,43540,82,53,0,53,0
2020-07-23,Solano,095,438530,3883,2962,11,2973,29
2020-07-23,Sonoma,097,501317,3229,2289,6,2295,18
2020-07-23,Stanislaus,099,539301,10173,7603,12,7615,71
2020-07-23,Sutter,101,95872,708,570,0,570,2
2020-07-23,Tehama,103,63373,239,158,2,160,1
2020-07-23,Trinity,105,12862,24,3,6,9,0
2020-07-23,Tulare,107,460477,10095,7898,28,7926,168
2020-07-23,Tuolumne,109,53932,140,93,4,97,0
2020-07-23,Ventura,111,848112,7963,6303,27,6330,56
2020-07-23,Yolo,113,214977,1682,1279,3,1282,35
2020-07-23,Yuba,115,75493,390,297,0,297,1
2020-07-22,Alameda,001,1643700,12105,9678,36,9714,169
2020-07-22,Alpine,003,1148,2,2,0,2,0
2020-07-22,Amador,005,37829,118,58,0,58,0
2020-07-22,Butte,007,227075,968,694,28,722,5
2020-07-22,Calaveras,009,45235,117,98,0,98,0
2020-07-22,Colusa,011,21464,322,236,0,236,0
2020-07-22,Contra Costa,013,1133247,8727,6401,25,6426,98
2020-07-22,Del Norte,015,27424,84,66,0,66,0
2020-07-22,El Dorado,017,186661,690,466,6,472,1
2020-07-22,Fresno,019,978130,19104,11756,159,11915,110
2020-07-22,Glenn,021,27897,338,236,0,236,1
2020-07-22,Humboldt,023,135768,238,201,1,202,4
2020-07-22,Imperial,025,180216,9936,7533,5,7538,134
2020-07-22,Inyo,027,18085,49,38,1,39,1
2020-07-22,Kern,029,883053,21714,13513,102,13615,127
2020-07-22,Kings,031,150075,4126,3271,20,3291,38
2020-07-22,Lake,033,64148,197,160,0,160,1
2020-07-22,Lassen,035,31185,568,500,2,502,0
2020-07-22,Los Angeles,037,10098052,184281,165242,399,165641,4218
2020-07-22,Madera,039,155013,2332,1578,4,1582,10
2020-07-22,Marin,041,260295,5000,4373,5,4378,23
2020-07-22,Mariposa,043,17540,55,38,0,38,1
2020-07-22,Mendocino,045,87422,243,166,0,166,0
2020-07-22,Merced,047,269075,4757,2828,2,2830,15
2020-07-22,Modoc,049,8938,3,0,0,0,0
2020-07-22,Mono,051,14174,128,82,2,84,1
2020-07-22,Monterey,053,433212,4566,3533,9,3542,20
2020-07-22,Napa,055,140530,1001,687,0,687,5
2020-07-22,Nevada,057,99092,308,239,12,251,1
2020-07-22,Orange,059,3164182,40119,32047,669,32716,522
2020-07-22,Placer,061,380077,1948,1469,3,1472,12
2020-07-22,Plumas,063,18699,31,20,0,20,0
2020-07-22,Riverside,065,2383286,40561,33093,40,33133,612
2020-07-22,Sacramento,067,1510023,10861,8028,11,8039,106
2020-07-22,San Benito,069,59416,604,465,0,465,2
2020-07-22,San Bernardino,071,2135413,35877,26820,124,26944,348
2020-07-22,San Diego,073,3302833,29567,25109,2,25111,505
2020-07-22,San Francisco,075,870044,6535,5473,5,5478,53
2020-07-22,San Joaquin,077,732212,12750,9628,5,9633,102
2020-07-22,San Luis Obispo,079,281455,1865,1373,7,1380,7
2020-07-22,San Mateo,081,765935,5785,4796,7,4803,112
2020-07-22,Santa Barbara,083,443738,6206,5508,56,5564,29
2020-07-22,Santa Clara,085,1922200,11164,8266,28,8294,166
2020-07-22,Santa Cruz,087,273765,1119,866,7,873,3
2020-07-22,Shasta,089,179085,417,246,1,247,9
2020-07-22,Sierra,091,2930,1,1,0,1,0
2020-07-22,Siskiyou,093,43540,81,52,0,52,0
2020-07-22,Solano,095,438530,3822,2839,10,2849,29
2020-07-22,Sonoma,097,501317,3152,2255,6,2261,17
2020-07-22,Stanislaus,099,539301,10002,7401,12,7413,71
2020-07-22,Sutter,101,95872,684,551,0,551,2
2020-07-22,Tehama,103,63373,231,155,2,157,1
2020-07-22,Trinity,105,12862,23,3,6,9,0
2020-07-22,Tulare,107,460477,9862,7640,28,7668,167
2020-07-22,Tuolumne,109,53932,136,91,4,95,0
2020-07-22,Ventura,111,848112,7835,6223,25,6248,56
2020-07-22,Yolo,113,214977,1640,1233,3,1236,34
2020-07-22,Yuba,115,75493,375,288,0,288,1
2020-07-21,Alameda,001,1643700,11891,9390,36,9426,166
2020-07-21,Alpine,003,1148,2,2,0,2,0
2020-07-21,Amador,005,37829,113,55,0,55,0
2020-07-21,Butte,007,227075,923,659,27,686,5
2020-07-21,Calaveras,009,45235,111,96,0,96,0
2020-07-21,Colusa,011,21464,298,227,0,227,0
2020-07-21,Contra Costa,013,1133247,8485,6210,25,6235,98
2020-07-21,Del Norte,015,27424,84,66,0,66,0
2020-07-21,El Dorado,017,186661,682,440,6,446,1
2020-07-21,Fresno,019,978130,18704,11412,153,11565,107
2020-07-21,Glenn,021,27897,331,229,0,229,1
2020-07-21,Humboldt,023,135768,236,198,1,199,4
2020-07-21,Imperial,025,180216,9886,7458,5,7463,128
2020-07-21,Inyo,027,18085,48,38,1,39,1
2020-07-21,Kern,029,883053,21292,11998,96,12094,119
2020-07-21,Kings,031,150075,4061,3187,19,3206,38
2020-07-21,Lake,033,64148,197,157,0,157,1
2020-07-21,Lassen,035,31185,566,474,2,476,0
2020-07-21,Los Angeles,037,10098052,181291,162205,375,162580,4159
2020-07-21,Madera,039,155013,2267,1508,3,1511,10
2020-07-21,Marin,041,260295,4928,4318,5,4323,21
2020-07-21,Mariposa,043,17540,54,37,0,37,1
2020-07-21,Mendocino,045,87422,232,160,0,160,0
2020-07-21,Merced,047,269075,4578,2725,2,2727,15
2020-07-21,Modoc,049,8938,3,0,0,0,0
2020-07-21,Mono,051,14174,124,79,2,81,1
2020-07-21,Monterey,053,433212,4434,3404,8,3412,20
2020-07-21,Napa,055,140530,974,660,0,660,5
2020-07-21,Nevada,057,99092,306,228,10,238,1
2020-07-21,Orange,059,3164182,39623,31356,637,31993,515
2020-07-21,Placer,061,380077,1907,1413,3,1416,11
2020-07-21,Plumas,063,18699,31,19,0,19,0
2020-07-21,Riverside,065,2383286,39859,32231,40,32271,583
2020-07-21,Sacramento,067,1510023,10589,7789,10,7799,102
2020-07-21,San Benito,069,59416,593,444,0,444,2
2020-07-21,San Bernardino,071,2135413,35230,25323,117,25440,343
2020-07-21,San Diego,073,3302833,29118,24522,2,24524,487
2020-07-21,San Francisco,075,870044,6426,5377,5,5382,53
2020-07-21,San Joaquin,077,732212,12422,9150,5,9155,99
2020-07-21,San Luis Obispo,079,281455,1816,1338,7,1345,7
2020-07-21,San Mateo,081,765935,5693,4733,7,4740,111
2020-07-21,Santa Barbara,083,443738,6126,5422,55,5477,29
2020-07-21,Santa Clara,085,1922200,10901,7989,28,8017,164
2020-07-21,Santa Cruz,087,273765,1086,835,7,842,3
2020-07-21,Shasta,089,179085,409,241,1,242,9
2020-07-21,Sierra,091,2930,1,1,0,1,0
2020-07-21,Siskiyou,093,43540,81,48,0,48,0
2020-07-21,Solano,095,438530,3750,2727,10,2737,27
2020-07-21,Sonoma,097,501317,3095,2200,6,2206,17
2020-07-21,Stanislaus,099,539301,9740,6984,12,6996,69
2020-07-21,Sutter,101,95872,668,533,0,533,2
2020-07-21,Tehama,103,63373,221,150,2,152,1
2020-07-21,Trinity,105,12862,23,2,6,8,0
2020-07-21,Tulare,107,460477,9660,7447,28,7475,167
2020-07-21,Tuolumne,109,53932,134,75,4,79,0
2020-07-21,Ventura,111,848112,7703,6131,25,6156,55
2020-07-21,Yolo,113,214977,1586,1204,3,1207,34
2020-07-21,Yuba,115,75493,369,269,0,269,1
2020-07-20,Alameda,001,1643700,11636,9244,35,9279,162
2020-07-20,Alpine,003,1148,2,2,0,2,0
2020-07-20,Amador,005,37829,110,53,0,53,0
2020-07-20,Butte,007,227075,886,586,27,613,4
2020-07-20,Calaveras,009,45235,108,90,0,90,0
2020-07-20,Colusa,011,21464,287,217,0,217,0
2020-07-20,Contra Costa,013,1133247,8277,5823,25,5848,97
2020-07-20,Del Norte,015,27424,84,61,0,61,0
2020-07-20,El Dorado,017,186661,659,407,6,413,0
2020-07-20,Fresno,019,978130,18262,10891,152,11043,106
2020-07-20,Glenn,021,27897,323,225,0,225,1
2020-07-20,Humboldt,023,135768,229,194,1,195,4
2020-07-20,Imperial,025,180216,9845,7337,5,7342,124
2020-07-20,Inyo,027,18085,46,38,1,39,1
2020-07-20,Kern,029,883053,20782,10908,92,11000,118
2020-07-20,Kings,031,150075,4011,3093,19,3112,37
2020-07-20,Lake,033,64148,194,147,0,147,1
2020-07-20,Lassen,035,31185,564,474,2,476,0
2020-07-20,Los Angeles,037,10098052,178327,159202,348,159550,4108
2020-07-20,Madera,039,155013,2192,1433,3,1436,10
2020-07-20,Marin,041,260295,4845,4255,5,4260,21
2020-07-20,Mariposa,043,17540,53,36,0,36,1
2020-07-20,Mendocino,045,87422,219,153,0,153,0
2020-07-20,Merced,047,269075,4408,2584,2,2586,15
2020-07-20,Modoc,049,8938,3,0,0,0,0
2020-07-20,Mono,051,14174,118,78,2,80,1
2020-07-20,Monterey,053,433212,4328,3205,8,3213,19
2020-07-20,Napa,055,140530,939,632,0,632,5
2020-07-20,Nevada,057,99092,298,218,10,228,1
2020-07-20,Orange,059,3164182,39013,30337,607,30944,507
2020-07-20,Placer,061,380077,1856,1364,3,1367,11
2020-07-20,Plumas,063,18699,30,17,0,17,0
2020-07-20,Riverside,065,2383286,39027,31163,40,31203,581
2020-07-20,Sacramento,067,1510023,10261,7369,10,7379,99
2020-07-20,San Benito,069,59416,575,433,0,433,2
2020-07-20,San Bernardino,071,2135413,34422,24226,113,24339,338
2020-07-20,San Diego,073,3302833,28676,24137,2,24139,478
2020-07-20,San Francisco,075,870044,6305,5090,5,5095,53
2020-07-20,San Joaquin,077,732212,12066,8583,5,8588,97
2020-07-20,San Luis Obispo,079,281455,1774,1282,7,1289,6
2020-07-20,San Mateo,081,765935,5593,4609,7,4616,111
2020-07-20,Santa Barbara,083,443738,6016,5266,53,5319,29
2020-07-20,Santa Clara,085,1922200,10673,7711,27,7738,164
2020-07-20,Santa Cruz,087,273765,1054,758,7,765,3
2020-07-20,Shasta,089,179085,394,233,1,234,9
2020-07-20,Sierra,091,2930,1,1,0,1,0
2020-07-20,Siskiyou,093,43540,77,42,0,42,0
2020-07-20,Solano,095,438530,3667,2537,10,2547,26
2020-07-20,Sonoma,097,501317,2989,2148,6,2154,17
2020-07-20,Stanislaus,099,539301,9456,6835,12,6847,58
2020-07-20,Sutter,101,95872,635,507,0,507,2
2020-07-20,Tehama,103,63373,211,146,2,148,1
2020-07-20,Trinity,105,12862,23,2,6,8,0
2020-07-20,Tulare,107,460477,9426,6974,28,7002,166
2020-07-20,Tuolumne,109,53932,133,75,4,79,0
2020-07-20,Ventura,111,848112,7569,5912,25,5937,52
2020-07-20,Yolo,113,214977,1545,1155,3,1158,30
2020-07-20,Yuba,115,75493,349,258,0,258,1
2020-07-19,Alameda,001,1643700,11395,9227,29,9256,162
2020-07-19,Alpine,003,1148,2,2,0,2,0
2020-07-19,Amador,005,37829,103,51,0,51,0
2020-07-19,Butte,007,227075,861,555,23,578,4
2020-07-19,Calaveras,009,45235,106,89,0,89,0
2020-07-19,Colusa,011,21464,279,187,0,187,0
2020-07-19,Contra Costa,013,1133247,7986,5691,23,5714,95
2020-07-19,Del Norte,015,27424,83,61,0,61,0
2020-07-19,El Dorado,017,186661,641,385,6,391,0
2020-07-19,Fresno,019,978130,17739,10639,140,10779,106
2020-07-19,Glenn,021,27897,309,215,0,215,0
2020-07-19,Humboldt,023,135768,221,195,1,196,4
2020-07-19,Imperial,025,180216,9754,7280,5,7285,124
2020-07-19,Inyo,027,18085,42,38,1,39,1
2020-07-19,Kern,029,883053,20165,10094,84,10178,115
2020-07-19,Kings,031,150075,3925,3035,19,3054,37
2020-07-19,Lake,033,64148,189,144,0,144,1
2020-07-19,Lassen,035,31185,545,474,2,476,0
2020-07-19,Los Angeles,037,10098052,174881,156039,325,156364,4100
2020-07-19,Madera,039,155013,2115,1301,3,1304,10
2020-07-19,Marin,041,260295,4790,4172,5,4177,21
2020-07-19,Mariposa,043,17540,49,35,0,35,1
2020-07-19,Mendocino,045,87422,214,137,0,137,0
2020-07-19,Merced,047,269075,4201,2460,2,2462,15
2020-07-19,Modoc,049,8938,3,0,0,0,0
2020-07-19,Mono,051,14174,107,63,2,65,1
2020-07-19,Monterey,053,433212,4209,3079,8,3087,18
2020-07-19,Napa,055,140530,910,612,0,612,5
2020-07-19,Nevada,057,99092,292,210,10,220,1
2020-07-19,Orange,059,3164182,38449,29941,594,30535,505
2020-07-19,Placer,061,380077,1809,1246,3,1249,11
2020-07-19,Plumas,063,18699,30,17,0,17,0
2020-07-19,Riverside,065,2383286,38322,30340,40,30380,581
2020-07-19,Sacramento,067,1510023,9868,6985,10,6995,97
2020-07-19,San Benito,069,59416,559,412,0,412,2
2020-07-19,San Bernardino,071,2135413,33649,23928,101,24029,337
2020-07-19,San Diego,073,3302833,28175,23684,2,23686,478
2020-07-19,San Francisco,075,870044,6159,5094,5,5099,52
2020-07-19,San Joaquin,077,732212,11659,8308,5,8313,93
2020-07-19,San Luis Obispo,079,281455,1730,1262,7,1269,6
2020-07-19,San Mateo,081,765935,5489,4522,7,4529,110
2020-07-19,Santa Barbara,083,443738,5914,5145,50,5195,29
2020-07-19,Santa Clara,085,1922200,10429,7403,27,7430,164
2020-07-19,Santa Cruz,087,273765,1010,753,7,760,3
2020-07-19,Shasta,089,179085,381,218,1,219,9
2020-07-19,Sierra,091,2930,1,1,0,1,0
2020-07-19,Siskiyou,093,43540,75,42,0,42,0
2020-07-19,Solano,095,438530,3562,2551,10,2561,26
2020-07-19,Sonoma,097,501317,2889,2074,6,2080,17
2020-07-19,Stanislaus,099,539301,9160,6508,12,6520,58
2020-07-19,Sutter,101,95872,604,480,0,480,2
2020-07-19,Tehama,103,63373,207,138,2,140,1
2020-07-19,Trinity,105,12862,23,2,6,8,0
2020-07-19,Tulare,107,460477,9178,6856,28,6884,166
2020-07-19,Tuolumne,109,53932,128,75,4,79,0
2020-07-19,Ventura,111,848112,7379,5706,25,5731,52
2020-07-19,Yolo,113,214977,1505,1127,3,1130,30
2020-07-19,Yuba,115,75493,329,240,0,240,1
2020-07-18,Alameda,001,1643700,11258,9089,28,9117,162
2020-07-18,Alpine,003,1148,2,2,0,2,0
2020-07-18,Amador,005,37829,99,49,0,49,0
2020-07-18,Butte,007,227075,852,551,22,573,4
2020-07-18,Calaveras,009,45235,102,89,0,89,0
2020-07-18,Colusa,011,21464,274,182,0,182,0
2020-07-18,Contra Costa,013,1133247,7852,5617,23,5640,95
2020-07-18,Del Norte,015,27424,83,61,0,61,0
2020-07-18,El Dorado,017,186661,638,385,6,391,0
2020-07-18,Fresno,019,978130,17490,10381,138,10519,106
2020-07-18,Glenn,021,27897,303,212,0,212,0
2020-07-18,Humboldt,023,135768,218,189,1,190,4
2020-07-18,Imperial,025,180216,9724,7268,5,7273,124
2020-07-18,Inyo,027,18085,42,38,1,39,1
2020-07-18,Kern,029,883053,19862,9250,81,9331,114
2020-07-18,Kings,031,150075,3885,2996,18,3014,37
2020-07-18,Lake,033,64148,186,142,0,142,1
2020-07-18,Lassen,035,31185,544,474,2,476,0
2020-07-18,Los Angeles,037,10098052,173435,153265,315,153580,4088
2020-07-18,Madera,039,155013,2069,1260,3,1263,9
2020-07-18,Marin,041,260295,4761,4089,5,4094,21
2020-07-18,Mariposa,043,17540,49,35,0,35,1
2020-07-18,Mendocino,045,87422,208,137,0,137,0
2020-07-18,Merced,047,269075,4083,2424,2,2426,15
2020-07-18,Modoc,049,8938,3,0,0,0,0
2020-07-18,Mono,051,14174,105,54,2,56,1
2020-07-18,Monterey,053,433212,4141,3020,8,3028,17
2020-07-18,Napa,055,140530,899,609,0,609,5
2020-07-18,Nevada,057,99092,288,204,9,213,1
2020-07-18,Orange,059,3164182,38130,29603,574,30177,493
2020-07-18,Placer,061,380077,1786,1233,3,1236,11
2020-07-18,Plumas,063,18699,30,17,0,17,0
2020-07-18,Riverside,065,2383286,37968,30245,39,30284,581
2020-07-18,Sacramento,067,1510023,9623,6739,10,6749,95
2020-07-18,San Benito,069,59416,544,407,0,407,2
2020-07-18,San Bernardino,071,2135413,33189,23680,94,23774,336
2020-07-18,San Diego,073,3302833,27872,23116,2,23118,478
2020-07-18,San Francisco,075,870044,6057,5051,5,5056,52
2020-07-18,San Joaquin,077,732212,11446,8118,5,8123,93
2020-07-18,San Luis Obispo,079,281455,1695,1234,7,1241,6
2020-07-18,San Mateo,081,765935,5429,4488,7,4495,110
2020-07-18,Santa Barbara,083,443738,5854,5110,48,5158,29
2020-07-18,Santa Clara,085,1922200,10280,7255,26,7281,164
2020-07-18,Santa Cruz,087,273765,993,751,7,758,3
2020-07-18,Shasta,089,179085,372,216,1,217,9
2020-07-18,Sierra,091,2930,1,1,0,1,0
2020-07-18,Siskiyou,093,43540,71,42,0,42,0
2020-07-18,Solano,095,438530,3521,2503,10,2513,26
2020-07-18,Sonoma,097,501317,2838,2019,6,2025,15
2020-07-18,Stanislaus,099,539301,9025,6344,12,6356,58
2020-07-18,Sutter,101,95872,598,473,0,473,2
2020-07-18,Tehama,103,63373,202,136,2,138,1
2020-07-18,Trinity,105,12862,23,2,6,8,0
2020-07-18,Tulare,107,460477,9087,6810,27,6837,167
2020-07-18,Tuolumne,109,53932,125,75,4,79,0
2020-07-18,Ventura,111,848112,7297,5630,25,5655,52
2020-07-18,Yolo,113,214977,1477,1077,3,1080,30
2020-07-18,Yuba,115,75493,318,237,0,237,1
2020-07-17,Alameda,001,1643700,11116,8893,27,8920,160
2020-07-17,Alpine,003,1148,2,1,0,1,0
2020-07-17,Amador,005,37829,97,48,0,48,0
2020-07-17,Butte,007,227075,838,497,22,519,4
2020-07-17,Calaveras,009,45235,99,86,0,86,0
2020-07-17,Colusa,011,21464,272,146,0,146,0
2020-07-17,Contra Costa,013,1133247,7704,5483,23,5506,93
2020-07-17,Del Norte,015,27424,82,60,0,60,0
2020-07-17,El Dorado,017,186661,622,368,6,374,0
2020-07-17,Fresno,019,978130,17192,9954,138,10092,104
2020-07-17,Glenn,021,27897,296,203,0,203,0
2020-07-17,Humboldt,023,135768,217,185,1,186,4
2020-07-17,Imperial,025,180216,9702,7193,5,7198,120
2020-07-17,Inyo,027,18085,42,38,1,39,1
2020-07-17,Kern,029,883053,19542,8291,80,8371,113
2020-07-17,Kings,031,150075,3846,2978,18,2996,37
2020-07-17,Lake,033,64148,184,139,0,139,1
2020-07-17,Lassen,035,31185,525,391,2,393,0
2020-07-17,Los Angeles,037,10098052,171062,150481,302,150783,4052
2020-07-17,Madera,039,155013,2025,1214,3,1217,9
2020-07-17,Marin,041,260295,4724,3839,5,3844,21
2020-07-17,Mariposa,043,17540,47,35,0,35,1
2020-07-17,Mendocino,045,87422,200,126,0,126,0
2020-07-17,Merced,047,269075,4007,2328,2,2330,12
2020-07-17,Modoc,049,8938,2,0,0,0,0
2020-07-17,Mono,051,14174,100,54,2,56,1
2020-07-17,Monterey,053,433212,4012,2922,8,2930,18
2020-07-17,Napa,055,140530,885,598,0,598,5
2020-07-17,Nevada,057,99092,281,200,9,209,1
2020-07-17,Orange,059,3164182,37667,28962,541,29503,485
2020-07-17,Placer,061,380077,1757,1207,3,1210,11
2020-07-17,Plumas,063,18699,27,16,0,16,0
2020-07-17,Riverside,065,2383286,37368,29639,39,29678,580
2020-07-17,Sacramento,067,1510023,9379,6563,10,6573,95
2020-07-17,San Benito,069,59416,529,399,0,399,2
2020-07-17,San Bernardino,071,2135413,32670,23057,91,23148,322
2020-07-17,San Diego,073,3302833,27484,22491,2,22493,472
2020-07-17,San Francisco,075,870044,5963,4967,5,4972,52
2020-07-17,San Joaquin,077,732212,11202,7925,5,7930,86
2020-07-17,San Luis Obispo,079,281455,1658,1190,7,1197,6
2020-07-17,San Mateo,081,765935,5332,4407,7,4414,110
2020-07-17,Santa Barbara,083,443738,5782,5001,47,5048,29
2020-07-17,Santa Clara,085,1922200,10062,7080,26,7106,164
2020-07-17,Santa Cruz,087,273765,971,716,7,723,3
2020-07-17,Shasta,089,179085,360,213,1,214,8
2020-07-17,Sierra,091,2930,1,1,0,1,0
2020-07-17,Siskiyou,093,43540,70,40,0,40,0
2020-07-17,Solano,095,438530,3472,2452,10,2462,26
2020-07-17,Sonoma,097,501317,2789,1982,6,1988,15
2020-07-17,Stanislaus,099,539301,8851,6220,12,6232,56
2020-07-17,Sutter,101,95872,585,458,0,458,2
2020-07-17,Tehama,103,63373,198,128,2,130,1
2020-07-17,Trinity,105,12862,23,2,6,8,0
2020-07-17,Tulare,107,460477,8951,6671,27,6698,166
2020-07-17,Tuolumne,109,53932,124,73,4,77,0
2020-07-17,Ventura,111,848112,7214,5451,25,5476,51
2020-07-17,Yolo,113,214977,1453,1055,3,1058,30
2020-07-17,Yuba,115,75493,308,231,0,231,1
2020-07-16,Alameda,001,1643700,10883,8719,22,8741,153
2020-07-16,Alpine,003,1148,2,1,0,1,0
2020-07-16,Amador,005,37829,94,46,0,46,0
2020-07-16,Butte,007,227075,801,465,21,486,4
2020-07-16,Calaveras,009,45235,97,82,0,82,0
2020-07-16,Colusa,011,21464,263,140,0,140,0
2020-07-16,Contra Costa,013,1133247,7492,5338,17,5355,91
2020-07-16,Del Norte,015,27424,82,60,0,60,0
2020-07-16,El Dorado,017,186661,605,357,6,363,0
2020-07-16,Fresno,019,978130,16681,9481,129,9610,101
2020-07-16,Glenn,021,27897,287,190,0,190,0
2020-07-16,Humboldt,023,135768,215,184,1,185,4
2020-07-16,Imperial,025,180216,9608,7148,5,7153,113
2020-07-16,Inyo,027,18085,42,38,1,39,1
2020-07-16,Kern,029,883053,19020,7435,78,7513,112
2020-07-16,Kings,031,150075,3680,2937,18,2955,37
2020-07-16,Lake,033,64148,179,128,0,128,1
2020-07-16,Lassen,035,31185,524,355,2,357,0
2020-07-16,Los Angeles,037,10098052,167840,147759,277,148036,3994
2020-07-16,Madera,039,155013,1961,1192,3,1195,8
2020-07-16,Marin,041,260295,4651,3546,5,3551,21
2020-07-16,Mariposa,043,17540,45,34,0,34,1
2020-07-16,Mendocino,045,87422,195,121,0,121,0
2020-07-16,Merced,047,269075,3848,2228,2,2230,12
2020-07-16,Modoc,049,8938,1,0,0,0,0
2020-07-16,Mono,051,14174,97,53,2,55,1
2020-07-16,Monterey,053,433212,3907,2857,7,2864,18
2020-07-16,Napa,055,140530,856,581,0,581,5
2020-07-16,Nevada,057,99092,278,191,9,200,1
2020-07-16,Orange,059,3164182,36964,28525,505,29030,471
2020-07-16,Placer,061,380077,1709,1168,3,1171,11
2020-07-16,Plumas,063,18699,25,16,0,16,0
2020-07-16,Riverside,065,2383286,36621,28904,37,28941,577
2020-07-16,Sacramento,067,1510023,9066,6440,9,6449,91
2020-07-16,San Benito,069,59416,512,389,0,389,2
2020-07-16,San Bernardino,071,2135413,31809,22355,73,22428,321
2020-07-16,San Diego,073,3302833,26997,21857,2,21859,465
2020-07-16,San Francisco,075,870044,5822,4838,5,4843,52
2020-07-16,San Joaquin,077,732212,10839,7713,5,7718,82
2020-07-16,San Luis Obispo,079,281455,1614,1146,7,1153,6
2020-07-16,San Mateo,081,765935,5228,4336,7,4343,110
2020-07-16,Santa Barbara,083,443738,5687,4872,46,4918,28
2020-07-16,Santa Clara,085,1922200,9782,6990,24,7014,164
2020-07-16,Santa Cruz,087,273765,930,698,7,705,3
2020-07-16,Shasta,089,179085,345,208,1,209,7
2020-07-16,Sierra,091,2930,1,1,0,1,0
2020-07-16,Siskiyou,093,43540,67,39,0,39,0
2020-07-16,Solano,095,438530,3378,2372,10,2382,25
2020-07-16,Sonoma,097,501317,2699,1954,6,1960,14
2020-07-16,Stanislaus,099,539301,8568,6077,11,6088,56
2020-07-16,Sutter,101,95872,569,444,0,444,2
2020-07-16,Tehama,103,63373,188,126,2,128,1
2020-07-16,Trinity,105,12862,23,2,5,7,0
2020-07-16,Tulare,107,460477,8737,6467,26,6493,163
2020-07-16,Tuolumne,109,53932,117,71,4,75,0
2020-07-16,Ventura,111,848112,7052,5231,25,5256,50
2020-07-16,Yolo,113,214977,1411,1034,3,1037,29
2020-07-16,Yuba,115,75493,290,221,0,221,1
2020-07-15,Alameda,001,1643700,10678,8615,17,8632,153
2020-07-15,Alpine,003,1148,2,1,0,1,0
2020-07-15,Amador,005,37829,73,44,0,44,0
2020-07-15,Butte,007,227075,759,420,21,441,4
2020-07-15,Calaveras,009,45235,97,75,0,75,0
2020-07-15,Colusa,011,21464,258,135,0,135,0
2020-07-15,Contra Costa,013,1133247,7261,5246,17,5263,90
2020-07-15,Del Norte,015,27424,81,60,0,60,0
2020-07-15,El Dorado,017,186661,581,339,6,345,0
2020-07-15,Fresno,019,978130,16209,9124,123,9247,101
2020-07-15,Glenn,021,27897,278,184,0,184,0
2020-07-15,Humboldt,023,135768,213,181,1,182,4
2020-07-15,Imperial,025,180216,9541,7110,5,7115,110
2020-07-15,Inyo,027,18085,42,36,1,37,1
2020-07-15,Kern,029,883053,18400,7155,74,7229,108
2020-07-15,Kings,031,150075,3618,2906,18,2924,37
2020-07-15,Lake,033,64148,177,122,0,122,1
2020-07-15,Lassen,035,31185,520,319,2,321,0
2020-07-15,Los Angeles,037,10098052,164373,143343,262,143605,3946
2020-07-15,Madera,039,155013,1892,1147,3,1150,4
2020-07-15,Marin,041,260295,4596,3458,5,3463,21
2020-07-15,Mariposa,043,17540,45,34,0,34,1
2020-07-15,Mendocino,045,87422,192,119,0,119,0
2020-07-15,Merced,047,269075,3702,2156,2,2158,12
2020-07-15,Modoc,049,8938,1,0,0,0,0
2020-07-15,Mono,051,14174,95,52,2,54,1
2020-07-15,Monterey,053,433212,3795,2780,7,2787,18
2020-07-15,Napa,055,140530,830,573,0,573,5
2020-07-15,Nevada,057,99092,274,185,7,192,1
2020-07-15,Orange,059,3164182,36165,27718,471,28189,454
2020-07-15,Placer,061,380077,1651,1145,3,1148,11
2020-07-15,Plumas,063,18699,25,16,0,16,0
2020-07-15,Riverside,065,2383286,35839,28492,35,28527,568
2020-07-15,Sacramento,067,1510023,8686,6217,9,6226,91
2020-07-15,San Benito,069,59416,503,388,0,388,2
2020-07-15,San Bernardino,071,2135413,31019,21508,57,21565,317
2020-07-15,San Diego,073,3302833,26530,21448,2,21450,448
2020-07-15,San Francisco,075,870044,5708,4757,5,4762,50
2020-07-15,San Joaquin,077,732212,10408,7381,4,7385,75
2020-07-15,San Luis Obispo,079,281455,1571,1097,7,1104,6
2020-07-15,San Mateo,081,765935,5115,4258,7,4265,109
2020-07-15,Santa Barbara,083,443738,5573,4733,46,4779,28
2020-07-15,Santa Clara,085,1922200,9479,6900,24,6924,164
2020-07-15,Santa Cruz,087,273765,894,660,6,666,3
2020-07-15,Shasta,089,179085,336,193,1,194,7
2020-07-15,Sierra,091,2930,1,1,0,1,0
2020-07-15,Siskiyou,093,43540,66,38,0,38,0
2020-07-15,Solano,095,438530,3283,2343,10,2353,25
2020-07-15,Sonoma,097,501317,2601,1920,6,1926,14
2020-07-15,Stanislaus,099,539301,8271,5777,11,5788,56
2020-07-15,Sutter,101,95872,543,433,0,433,2
2020-07-15,Tehama,103,63373,180,126,2,128,1
2020-07-15,Trinity,105,12862,22,2,5,7,0
2020-07-15,Tulare,107,460477,8526,6320,26,6346,156
2020-07-15,Tuolumne,109,53932,110,68,4,72,0
2020-07-15,Ventura,111,848112,6875,5087,25,5112,50
2020-07-15,Yolo,113,214977,1378,1002,3,1005,27
2020-07-15,Yuba,115,75493,278,221,0,221,1
2020-07-14,Alameda,001,1643700,10337,8388,11,8399,151
2020-07-14,Alpine,003,1148,2,1,0,1,0
2020-07-14,Amador,005,37829,69,44,0,44,0
2020-07-14,Butte,007,227075,713,382,21,403,4
2020-07-14,Calaveras,009,45235,95,74,0,74,0
2020-07-14,Colusa,011,21464,248,128,0,128,0
2020-07-14,Contra Costa,013,1133247,7024,5110,15,5125,90
2020-07-14,Del Norte,015,27424,80,60,0,60,0
2020-07-14,El Dorado,017,186661,566,324,6,330,0
2020-07-14,Fresno,019,978130,15787,8941,118,9059,98
2020-07-14,Glenn,021,27897,268,177,0,177,0
2020-07-14,Humboldt,023,135768,210,175,1,176,4
2020-07-14,Imperial,025,180216,9415,7095,5,7100,109
2020-07-14,Inyo,027,18085,42,35,1,36,1
2020-07-14,Kern,029,883053,17641,6979,61,7040,107
2020-07-14,Kings,031,150075,3551,2867,17,2884,37
2020-07-14,Lake,033,64148,171,120,0,120,1
2020-07-14,Lassen,035,31185,503,263,2,265,0
2020-07-14,Los Angeles,037,10098052,161241,140632,233,140865,3900
2020-07-14,Madera,039,155013,1818,1118,3,1121,4
2020-07-14,Marin,041,260295,4482,3451,5,3456,21
2020-07-14,Mariposa,043,17540,41,32,0,32,1
2020-07-14,Mendocino,045,87422,184,110,0,110,0
2020-07-14,Merced,047,269075,3523,2084,2,2086,12
2020-07-14,Modoc,049,8938,1,0,0,0,0
2020-07-14,Mono,051,14174,85,48,2,50,1
2020-07-14,Monterey,053,433212,3682,2724,7,2731,18
2020-07-14,Napa,055,140530,774,557,0,557,4
2020-07-14,Nevada,057,99092,257,180,6,186,1
2020-07-14,Orange,059,3164182,35283,26915,423,27338,432
2020-07-14,Placer,061,380077,1593,1122,3,1125,11
2020-07-14,Plumas,063,18699,24,14,0,14,0
2020-07-14,Riverside,065,2383286,35082,27850,34,27884,547
2020-07-14,Sacramento,067,1510023,8332,5978,9,5987,87
2020-07-14,San Benito,069,59416,484,360,0,360,2
2020-07-14,San Bernardino,071,2135413,30167,20489,47,20536,316
2020-07-14,San Diego,073,3302833,25910,20887,2,20889,436
2020-07-14,San Francisco,075,870044,5557,4659,4,4663,50
2020-07-14,San Joaquin,077,732212,9981,7143,4,7147,75
2020-07-14,San Luis Obispo,079,281455,1533,1060,7,1067,5
2020-07-14,San Mateo,081,765935,5022,4173,7,4180,108
2020-07-14,Santa Barbara,083,443738,5449,4641,44,4685,28
2020-07-14,Santa Clara,085,1922200,9151,6686,21,6707,164
2020-07-14,Santa Cruz,087,273765,855,639,6,645,3
2020-07-14,Shasta,089,179085,327,190,1,191,7
2020-07-14,Sierra,091,2930,1,1,0,1,0
2020-07-14,Siskiyou,093,43540,65,38,0,38,0
2020-07-14,Solano,095,438530,3184,2266,9,2275,25
2020-07-14,Sonoma,097,501317,2508,1866,6,1872,14
2020-07-14,Stanislaus,099,539301,7896,5631,10,5641,53
2020-07-14,Sutter,101,95872,524,405,0,405,2
2020-07-14,Tehama,103,63373,168,123,2,125,1
2020-07-14,Trinity,105,12862,21,2,5,7,0
2020-07-14,Tulare,107,460477,8280,6199,26,6225,156
2020-07-14,Tuolumne,109,53932,105,68,4,72,0
2020-07-14,Ventura,111,848112,6714,4950,25,4975,50
2020-07-14,Yolo,113,214977,1331,966,3,969,27
2020-07-14,Yuba,115,75493,261,210,0,210,1
2020-07-13,Alameda,001,1643700,10028,8115,11,8126,148
2020-07-13,Alpine,003,1148,2,1,0,1,0
2020-07-13,Amador,005,37829,65,42,0,42,0
2020-07-13,Butte,007,227075,677,354,21,375,4
2020-07-13,Calaveras,009,45235,87,63,0,63,0
2020-07-13,Colusa,011,21464,242,116,0,116,0
2020-07-13,Contra Costa,013,1133247,6754,4882,13,4895,88
2020-07-13,Del Norte,015,27424,74,59,0,59,0
2020-07-13,El Dorado,017,186661,535,298,6,304,0
2020-07-13,Fresno,019,978130,15357,8666,113,8779,95
2020-07-13,Glenn,021,27897,261,168,0,168,0
2020-07-13,Humboldt,023,135768,205,174,1,175,4
2020-07-13,Imperial,025,180216,9328,7052,5,7057,109
2020-07-13,Inyo,027,18085,41,35,1,36,1
2020-07-13,Kern,029,883053,16956,6808,55,6863,107
2020-07-13,Kings,031,150075,3500,2824,17,2841,37
2020-07-13,Lake,033,64148,166,118,0,118,1
2020-07-13,Lassen,035,31185,498,237,2,239,0
2020-07-13,Los Angeles,037,10098052,158006,136368,219,136587,3829
2020-07-13,Madera,039,155013,1749,1059,3,1062,4
2020-07-13,Marin,041,260295,4378,3402,5,3407,21
2020-07-13,Mariposa,043,17540,40,31,0,31,1
2020-07-13,Mendocino,045,87422,180,87,0,87,0
2020-07-13,Merced,047,269075,3374,2007,2,2009,12
2020-07-13,Modoc,049,8938,1,0,0,0,0
2020-07-13,Mono,051,14174,81,47,1,48,1
2020-07-13,Monterey,053,433212,3559,2613,5,2618,18
2020-07-13,Napa,055,140530,738,534,0,534,4
2020-07-13,Nevada,057,99092,243,172,6,178,1
2020-07-13,Orange,059,3164182,34417,25978,391,26369,423
2020-07-13,Placer,061,380077,1548,1096,3,1099,11
2020-07-13,Plumas,063,18699,22,14,0,14,0
2020-07-13,Riverside,065,2383286,34155,27136,32,27168,545
2020-07-13,Sacramento,067,1510023,8035,5747,9,5756,85
2020-07-13,San Benito,069,59416,471,343,0,343,2
2020-07-13,San Bernardino,071,2135413,29292,19610,40,19650,313
2020-07-13,San Diego,073,3302833,25343,20348,2,20350,422
2020-07-13,San Francisco,075,870044,5430,4534,3,4537,50
2020-07-13,San Joaquin,077,732212,9566,6927,4,6931,71
2020-07-13,San Luis Obispo,079,281455,1502,989,7,996,5
2020-07-13,San Mateo,081,765935,4891,4057,7,4064,108
2020-07-13,Santa Barbara,083,443738,5335,4441,43,4484,28
2020-07-13,Santa Clara,085,1922200,8828,6488,20,6508,164
2020-07-13,Santa Cruz,087,273765,817,574,6,580,3
2020-07-13,Shasta,089,179085,316,185,1,186,6
2020-07-13,Sierra,091,2930,1,1,0,1,0
2020-07-13,Siskiyou,093,43540,61,37,0,37,0
2020-07-13,Solano,095,438530,3072,2046,9,2055,23
2020-07-13,Sonoma,097,501317,2397,1818,6,1824,14
2020-07-13,Stanislaus,099,539301,7593,5324,9,5333,53
2020-07-13,Sutter,101,95872,486,379,0,379,2
2020-07-13,Tehama,103,63373,155,112,2,114,1
2020-07-13,Trinity,105,12862,21,2,5,7,0
2020-07-13,Tulare,107,460477,8019,5930,24,5954,147
2020-07-13,Tuolumne,109,53932,97,56,4,60,0
2020-07-13,Ventura,111,848112,6524,4800,22,4822,50
2020-07-13,Yolo,113,214977,1285,941,3,944,27
2020-07-13,Yuba,115,75493,246,194,0,194,1
2020-07-12,Alameda,001,1643700,9758,8056,11,8067,148
2020-07-12,Alpine,003,1148,2,1,0,1,0
2020-07-12,Amador,005,37829,55,40,0,40,0
2020-07-12,Butte,007,227075,627,341,20,361,4
2020-07-12,Calaveras,009,45235,87,62,0,62,0
2020-07-12,Colusa,011,21464,208,116,0,116,0
2020-07-12,Contra Costa,013,1133247,6486,4708,11,4719,88
2020-07-12,Del Norte,015,27424,63,59,0,59,0
2020-07-12,El Dorado,017,186661,513,290,6,296,0
2020-07-12,Fresno,019,978130,14934,8407,108,8515,95
2020-07-12,Glenn,021,27897,248,166,0,166,0
2020-07-12,Humboldt,023,135768,201,174,1,175,4
2020-07-12,Imperial,025,180216,9213,6999,5,7004,109
2020-07-12,Inyo,027,18085,39,35,1,36,1
2020-07-12,Kern,029,883053,16213,6662,51,6713,105
2020-07-12,Kings,031,150075,3438,2779,17,2796,34
2020-07-12,Lake,033,64148,157,114,0,114,1
2020-07-12,Lassen,035,31185,491,237,2,239,0
2020-07-12,Los Angeles,037,10098052,154583,133830,190,134020,3816
2020-07-12,Madera,039,155013,1693,1025,3,1028,4
2020-07-12,Marin,041,260295,4302,3358,5,3363,21
2020-07-12,Mariposa,043,17540,39,31,0,31,1
2020-07-12,Mendocino,045,87422,161,88,0,88,0
2020-07-12,Merced,047,269075,3244,1908,2,1910,12
2020-07-12,Modoc,049,8938,1,0,0,0,0
2020-07-12,Mono,051,14174,71,45,1,46,1
2020-07-12,Monterey,053,433212,3444,2521,5,2526,18
2020-07-12,Napa,055,140530,707,519,0,519,4
2020-07-12,Nevada,057,99092,233,166,6,172,1
2020-07-12,Orange,059,3164182,33538,25399,382,25781,422
2020-07-12,Placer,061,380077,1491,1058,3,1061,11
2020-07-12,Plumas,063,18699,21,14,0,14,0
2020-07-12,Riverside,065,2383286,33397,26404,31,26435,542
2020-07-12,Sacramento,067,1510023,7723,5515,7,5522,85
2020-07-12,San Benito,069,59416,456,324,0,324,2
2020-07-12,San Bernardino,071,2135413,28380,19042,36,19078,312
2020-07-12,San Diego,073,3302833,24713,19929,2,19931,422
2020-07-12,San Francisco,075,870044,5281,4535,3,4538,50
2020-07-12,San Joaquin,077,732212,9203,6703,4,6707,71
2020-07-12,San Luis Obispo,079,281455,1455,972,7,979,5
2020-07-12,San Mateo,081,765935,4773,3988,7,3995,108
2020-07-12,Santa Barbara,083,443738,5205,4353,42,4395,28
2020-07-12,Santa Clara,085,1922200,8590,6252,19,6271,164
2020-07-12,Santa Cruz,087,273765,775,573,5,578,3
2020-07-12,Shasta,089,179085,310,173,1,174,6
2020-07-12,Sierra,091,2930,1,1,0,1,0
2020-07-12,Siskiyou,093,43540,59,36,0,36,0
2020-07-12,Solano,095,438530,2947,2037,9,2046,23
2020-07-12,Sonoma,097,501317,2303,1743,6,1749,13
2020-07-12,Stanislaus,099,539301,7289,5177,9,5186,53
2020-07-12,Sutter,101,95872,468,362,0,362,2
2020-07-12,Tehama,103,63373,148,111,2,113,1
2020-07-12,Trinity,105,12862,21,2,5,7,0
2020-07-12,Tulare,107,460477,7763,5864,23,5887,146
2020-07-12,Tuolumne,109,53932,90,52,4,56,0
2020-07-12,Ventura,111,848112,6308,4724,21,4745,50
2020-07-12,Yolo,113,214977,1244,889,3,892,27
2020-07-12,Yuba,115,75493,235,188,0,188,1
2020-07-11,Alameda,001,1643700,9655,7845,11,7856,148
2020-07-11,Alpine,003,1148,2,1,0,1,0
2020-07-11,Amador,005,37829,51,37,0,37,0
2020-07-11,Butte,007,227075,611,325,20,345,4
2020-07-11,Calaveras,009,45235,84,62,0,62,0
2020-07-11,Colusa,011,21464,203,110,0,110,0
2020-07-11,Contra Costa,013,1133247,6371,4650,11,4661,87
2020-07-11,Del Norte,015,27424,63,59,0,59,0
2020-07-11,El Dorado,017,186661,502,283,6,289,0
2020-07-11,Fresno,019,978130,14673,8086,105,8191,95
2020-07-11,Glenn,021,27897,240,161,0,161,0
2020-07-11,Humboldt,023,135768,200,174,1,175,4
2020-07-11,Imperial,025,180216,9174,6884,5,6889,109
2020-07-11,Inyo,027,18085,39,35,1,36,1
2020-07-11,Kern,029,883053,15856,6509,50,6559,103
2020-07-11,Kings,031,150075,3411,2753,17,2770,33
2020-07-11,Lake,033,64148,156,110,0,110,1
2020-07-11,Lassen,035,31185,490,237,2,239,0
2020-07-11,Los Angeles,037,10098052,152864,130479,180,130659,3802
2020-07-11,Madera,039,155013,1652,988,3,991,4
2020-07-11,Marin,041,260295,4274,3191,5,3196,21
2020-07-11,Mariposa,043,17540,39,31,0,31,1
2020-07-11,Mendocino,045,87422,157,88,0,88,0
2020-07-11,Merced,047,269075,3164,1851,2,1853,12
2020-07-11,Modoc,049,8938,1,0,0,0,0
2020-07-11,Mono,051,14174,68,45,1,46,1
2020-07-11,Monterey,053,433212,3355,2376,5,2381,18
2020-07-11,Napa,055,140530,695,509,0,509,4
2020-07-11,Nevada,057,99092,224,163,5,168,1
2020-07-11,Orange,059,3164182,33161,24430,368,24798,422
2020-07-11,Placer,061,380077,1457,1029,3,1032,11
2020-07-11,Plumas,063,18699,21,12,0,12,0
2020-07-11,Riverside,065,2383286,33006,25994,31,26025,538
2020-07-11,Sacramento,067,1510023,7549,5367,7,5374,84
2020-07-11,San Benito,069,59416,441,314,0,314,2
2020-07-11,San Bernardino,071,2135413,27943,18907,34,18941,310
2020-07-11,San Diego,073,3302833,24321,19371,2,19373,422
2020-07-11,San Francisco,075,870044,5185,4430,2,4432,50
2020-07-11,San Joaquin,077,732212,9025,6518,4,6522,72
2020-07-11,San Luis Obispo,079,281455,1407,930,7,937,4
2020-07-11,San Mateo,081,765935,4705,3956,7,3963,108
2020-07-11,Santa Barbara,083,443738,5136,4283,41,4324,28
2020-07-11,Santa Clara,085,1922200,8430,5959,19,5978,164
2020-07-11,Santa Cruz,087,273765,744,571,5,576,3
2020-07-11,Shasta,089,179085,303,168,1,169,6
2020-07-11,Sierra,091,2930,1,1,0,1,0
2020-07-11,Siskiyou,093,43540,59,36,0,36,0
2020-07-11,Solano,095,438530,2906,2034,9,2043,23
2020-07-11,Sonoma,097,501317,2265,1690,6,1696,13
2020-07-11,Stanislaus,099,539301,7149,4911,9,4920,51
2020-07-11,Sutter,101,95872,452,352,0,352,2
2020-07-11,Tehama,103,63373,146,111,2,113,1
2020-07-11,Trinity,105,12862,21,2,5,7,0
2020-07-11,Tulare,107,460477,7657,5780,23,5803,149
2020-07-11,Tuolumne,109,53932,87,50,4,54,0
2020-07-11,Ventura,111,848112,6212,4545,20,4565,49
2020-07-11,Yolo,113,214977,1215,833,3,836,27
2020-07-11,Yuba,115,75493,225,175,0,175,1
2020-07-10,Alameda,001,1643700,9498,7551,11,7562,147
2020-07-10,Alpine,003,1148,2,1,0,1,0
2020-07-10,Amador,005,37829,47,37,0,37,0
2020-07-10,Butte,007,227075,600,318,20,338,4
2020-07-10,Calaveras,009,45235,84,61,0,61,0
2020-07-10,Colusa,011,21464,197,103,0,103,0
2020-07-10,Contra Costa,013,1133247,6232,4482,11,4493,86
2020-07-10,Del Norte,015,27424,63,57,0,57,0
2020-07-10,El Dorado,017,186661,484,266,6,272,0
2020-07-10,Fresno,019,978130,14341,7760,102,7862,93
2020-07-10,Glenn,021,27897,235,157,0,157,0
2020-07-10,Humboldt,023,135768,199,168,1,169,4
2020-07-10,Imperial,025,180216,9128,6878,4,6882,98
2020-07-10,Inyo,027,18085,39,35,1,36,1
2020-07-10,Kern,029,883053,15424,6344,49,6393,102
2020-07-10,Kings,031,150075,3375,2707,17,2724,33
2020-07-10,Lake,033,64148,149,104,0,104,1
2020-07-10,Lassen,035,31185,489,235,2,237,0
2020-07-10,Los Angeles,037,10098052,150441,127503,174,127677,3750
2020-07-10,Madera,039,155013,1606,914,3,917,4
2020-07-10,Marin,041,260295,4211,3101,5,3106,21
2020-07-10,Mariposa,043,17540,38,31,0,31,1
2020-07-10,Mendocino,045,87422,149,88,0,88,0
2020-07-10,Merced,047,269075,3087,1802,2,1804,12
2020-07-10,Modoc,049,8938,1,0,0,0,0
2020-07-10,Mono,051,14174,67,45,1,46,1
2020-07-10,Monterey,053,433212,3277,2285,5,2290,18
2020-07-10,Napa,055,140530,684,496,0,496,4
2020-07-10,Nevada,057,99092,219,161,5,166,1
2020-07-10,Orange,059,3164182,32575,23692,365,24057,416
2020-07-10,Placer,061,380077,1415,1002,3,1005,11
2020-07-10,Plumas,063,18699,19,12,0,12,0
2020-07-10,Riverside,065,2383286,32488,25481,31,25512,533
2020-07-10,Sacramento,067,1510023,7294,5181,7,5188,81
2020-07-10,San Benito,069,59416,432,302,0,302,2
2020-07-10,San Bernardino,071,2135413,27419,18242,31,18273,308
2020-07-10,San Diego,073,3302833,23937,18862,2,18864,420
2020-07-10,San Francisco,075,870044,5094,4305,2,4307,50
2020-07-10,San Joaquin,077,732212,8792,6225,4,6229,67
2020-07-10,San Luis Obispo,079,281455,1369,891,7,898,4
2020-07-10,San Mateo,081,765935,4640,3844,7,3851,107
2020-07-10,Santa Barbara,083,443738,5039,4177,40,4217,28
2020-07-10,Santa Clara,085,1922200,8206,5819,19,5838,164
2020-07-10,Santa Cruz,087,273765,716,540,5,545,3
2020-07-10,Shasta,089,179085,299,158,1,159,6
2020-07-10,Sierra,091,2930,1,1,0,1,0
2020-07-10,Siskiyou,093,43540,59,31,0,31,0
2020-07-10,Solano,095,438530,2859,1950,9,1959,23
2020-07-10,Sonoma,097,501317,2218,1606,5,1611,13
2020-07-10,Stanislaus,099,539301,6979,4781,9,4790,46
2020-07-10,Sutter,101,95872,445,338,0,338,2
2020-07-10,Tehama,103,63373,145,107,2,109,1
2020-07-10,Trinity,105,12862,21,2,5,7,0
2020-07-10,Tulare,107,460477,7520,5677,23,5700,150
2020-07-10,Tuolumne,109,53932,86,49,4,53,0
2020-07-10,Ventura,111,848112,6098,4416,20,4436,48
2020-07-10,Yolo,113,214977,1191,794,3,797,27
2020-07-10,Yuba,115,75493,211,164,0,164,1
2020-07-09,Alameda,001,1643700,9268,7433,11,7444,146
2020-07-09,Alpine,003,1148,2,1,0,1,0
2020-07-09,Amador,005,37829,44,36,0,36,0
2020-07-09,Butte,007,227075,568,295,19,314,4
2020-07-09,Calaveras,009,45235,83,59,0,59,0
2020-07-09,Colusa,011,21464,189,97,0,97,0
2020-07-09,Contra Costa,013,1133247,5991,4388,11,4399,86
2020-07-09,Del Norte,015,27424,63,57,0,57,0
2020-07-09,El Dorado,017,186661,459,255,5,260,0
2020-07-09,Fresno,019,978130,13886,7385,99,7484,90
2020-07-09,Glenn,021,27897,225,150,0,150,0
2020-07-09,Humboldt,023,135768,196,166,1,167,4
2020-07-09,Imperial,025,180216,9030,6778,4,6782,87
2020-07-09,Inyo,027,18085,37,35,1,36,1
2020-07-09,Kern,029,883053,14778,6100,47,6147,95
2020-07-09,Kings,031,150075,3312,2686,17,2703,33
2020-07-09,Lake,033,64148,146,99,0,99,1
2020-07-09,Lassen,035,31185,433,221,2,223,0
2020-07-09,Los Angeles,037,10098052,147182,125062,151,125213,3698
2020-07-09,Madera,039,155013,1529,850,3,853,4
2020-07-09,Marin,041,260295,4061,2975,4,2979,20
2020-07-09,Mariposa,043,17540,38,32,0,32,1
2020-07-09,Mendocino,045,87422,145,88,0,88,0
2020-07-09,Merced,047,269075,2955,1728,2,1730,11
2020-07-09,Modoc,049,8938,1,0,0,0,0
2020-07-09,Mono,051,14174,63,45,1,46,1
2020-07-09,Monterey,053,433212,3152,2223,5,2228,17
2020-07-09,Napa,055,140530,667,468,0,468,4
2020-07-09,Nevada,057,99092,213,156,5,161,1
2020-07-09,Orange,059,3164182,31600,22960,347,23307,407
2020-07-09,Placer,061,380077,1373,982,3,985,11
2020-07-09,Plumas,063,18699,19,12,0,12,0
2020-07-09,Riverside,065,2383286,31595,24980,30,25010,529
2020-07-09,Sacramento,067,1510023,6967,4950,7,4957,81
2020-07-09,San Benito,069,59416,416,295,0,295,2
2020-07-09,San Bernardino,071,2135413,26549,17339,25,17364,307
2020-07-09,San Diego,073,3302833,23345,18404,2,18406,415
2020-07-09,San Francisco,075,870044,4962,4143,2,4145,50
2020-07-09,San Joaquin,077,732212,8433,6004,4,6008,66
2020-07-09,San Luis Obispo,079,281455,1328,869,7,876,3
2020-07-09,San Mateo,081,765935,4514,3792,7,3799,106
2020-07-09,Santa Barbara,083,443738,4907,4068,40,4108,28
2020-07-09,Santa Clara,085,1922200,7945,5638,19,5657,164
2020-07-09,Santa Cruz,087,273765,689,526,5,531,3
2020-07-09,Shasta,089,179085,293,155,1,156,5
2020-07-09,Sierra,091,2930,1,1,0,1,0
2020-07-09,Siskiyou,093,43540,55,31,0,31,0
2020-07-09,Solano,095,438530,2761,1892,9,1901,23
2020-07-09,Sonoma,097,501317,2132,1584,5,1589,13
2020-07-09,Stanislaus,099,539301,6664,4633,8,4641,46
2020-07-09,Sutter,101,95872,428,321,0,321,2
2020-07-09,Tehama,103,63373,140,102,2,104,1
2020-07-09,Trinity,105,12862,21,2,5,7,0
2020-07-09,Tulare,107,460477,7301,5501,22,5523,146
2020-07-09,Tuolumne,109,53932,85,47,4,51,0
2020-07-09,Ventura,111,848112,5930,4278,20,4298,47
2020-07-09,Yolo,113,214977,1143,764,3,767,27
2020-07-09,Yuba,115,75493,194,152,0,152,1
2020-07-08,Alameda,001,1643700,8978,7335,11,7346,142
2020-07-08,Alpine,003,1148,2,1,0,1,0
2020-07-08,Amador,005,37829,41,35,0,35,0
2020-07-08,Butte,007,227075,531,281,19,300,3
2020-07-08,Calaveras,009,45235,78,58,0,58,0
2020-07-08,Colusa,011,21464,176,90,0,90,0
2020-07-08,Contra Costa,013,1133247,5745,4268,9,4277,84
2020-07-08,Del Norte,015,27424,61,57,0,57,0
2020-07-08,El Dorado,017,186661,437,248,5,253,0
2020-07-08,Fresno,019,978130,13471,7102,91,7193,86
2020-07-08,Glenn,021,27897,214,146,0,146,0
2020-07-08,Humboldt,023,135768,193,162,1,163,4
2020-07-08,Imperial,025,180216,8943,6727,4,6731,76
2020-07-08,Inyo,027,18085,37,35,1,36,1
2020-07-08,Kern,029,883053,14200,5873,45,5918,91
2020-07-08,Kings,031,150075,3253,2629,14,2643,33
2020-07-08,Lake,033,64148,139,97,0,97,1
2020-07-08,Lassen,035,31185,337,221,2,223,0
2020-07-08,Los Angeles,037,10098052,143976,123462,123,123585,3650
2020-07-08,Madera,039,155013,1459,828,3,831,4
2020-07-08,Marin,041,260295,3962,2756,4,2760,17
2020-07-08,Mariposa,043,17540,38,31,0,31,1
2020-07-08,Mendocino,045,87422,132,84,0,84,0
2020-07-08,Merced,047,269075,2833,1578,2,1580,11
2020-07-08,Modoc,049,8938,1,0,0,0,0
2020-07-08,Mono,051,14174,60,45,0,45,1
2020-07-08,Monterey,053,433212,3034,2182,4,2186,17
2020-07-08,Napa,055,140530,645,468,0,468,4
2020-07-08,Nevada,057,99092,204,156,5,161,1
2020-07-08,Orange,059,3164182,30643,22088,342,22430,378
2020-07-08,Placer,061,380077,1326,948,3,951,11
2020-07-08,Plumas,063,18699,19,12,0,12,0
2020-07-08,Riverside,065,2383286,30631,24042,29,24071,508
2020-07-08,Sacramento,067,1510023,6678,4799,7,4806,80
2020-07-08,San Benito,069,59416,399,282,0,282,2
2020-07-08,San Bernardino,071,2135413,25695,16510,21,16531,296
2020-07-08,San Diego,073,3302833,22775,17844,2,17846,406
2020-07-08,San Francisco,075,870044,4873,4093,2,4095,50
2020-07-08,San Joaquin,077,732212,8090,5759,4,5763,61
2020-07-08,San Luis Obispo,079,281455,1276,825,7,832,2
2020-07-08,San Mateo,081,765935,4394,3733,7,3740,106
2020-07-08,Santa Barbara,083,443738,4788,3985,40,4025,28
2020-07-08,Santa Clara,085,1922200,7711,5510,19,5529,164
2020-07-08,Santa Cruz,087,273765,656,509,4,513,3
2020-07-08,Shasta,089,179085,284,148,1,149,6
2020-07-08,Sierra,091,2930,1,1,0,1,0
2020-07-08,Siskiyou,093,43540,55,31,0,31,0
2020-07-08,Solano,095,438530,2645,1821,9,1830,23
2020-07-08,Sonoma,097,501317,2056,1495,5,1500,9
2020-07-08,Stanislaus,099,539301,6364,4344,8,4352,46
2020-07-08,Sutter,101,95872,403,298,0,298,2
2020-07-08,Tehama,103,63373,134,100,2,102,1
2020-07-08,Trinity,105,12862,20,2,5,7,0
2020-07-08,Tulare,107,460477,7109,5307,17,5324,138
2020-07-08,Tuolumne,109,53932,81,42,4,46,0
2020-07-08,Ventura,111,848112,5765,4139,20,4159,47
2020-07-08,Yolo,113,214977,1099,727,3,730,26
2020-07-08,Yuba,115,75493,181,145,0,145,1
2020-07-07,Alameda,001,1643700,8658,7097,10,7107,141
2020-07-07,Alpine,003,1148,2,1,0,1,0
2020-07-07,Amador,005,37829,41,33,0,33,0
2020-07-07,Butte,007,227075,488,269,19,288,3
2020-07-07,Calaveras,009,45235,76,58,0,58,0
2020-07-07,Colusa,011,21464,143,84,0,84,0
2020-07-07,Contra Costa,013,1133247,5507,4131,8,4139,84
2020-07-07,Del Norte,015,27424,61,57,0,57,0
2020-07-07,El Dorado,017,186661,417,244,5,249,0
2020-07-07,Fresno,019,978130,13017,6738,91,6829,84
2020-07-07,Glenn,021,27897,205,145,0,145,0
2020-07-07,Humboldt,023,135768,190,150,1,151,4
2020-07-07,Imperial,025,180216,8845,6678,4,6682,51
2020-07-07,Inyo,027,18085,36,32,1,33,1
2020-07-07,Kern,029,883053,13501,5645,41,5686,88
2020-07-07,Kings,031,150075,3190,2623,13,2636,33
2020-07-07,Lake,033,64148,129,94,0,94,1
2020-07-07,Lassen,035,31185,266,219,2,221,0
2020-07-07,Los Angeles,037,10098052,140396,121026,116,121142,3588
2020-07-07,Madera,039,155013,1415,794,3,797,4
2020-07-07,Marin,041,260295,3870,2627,4,2631,17
2020-07-07,Mariposa,043,17540,38,31,0,31,1
2020-07-07,Mendocino,045,87422,124,82,0,82,0
2020-07-07,Merced,047,269075,2663,1531,2,1533,10
2020-07-07,Modoc,049,8938,1,0,0,0,0
2020-07-07,Mono,051,14174,59,42,0,42,1
2020-07-07,Monterey,053,433212,2891,2166,4,2170,17
2020-07-07,Napa,055,140530,626,459,0,459,4
2020-07-07,Nevada,057,99092,198,150,5,155,1
2020-07-07,Orange,059,3164182,29623,21741,329,22070,373
2020-07-07,Placer,061,380077,1285,930,3,933,11
2020-07-07,Plumas,063,18699,17,12,0,12,0
2020-07-07,Riverside,065,2383286,29616,23279,29,23308,499
2020-07-07,Sacramento,067,1510023,6336,4592,7,4599,76
2020-07-07,San Benito,069,59416,381,274,0,274,2
2020-07-07,San Bernardino,071,2135413,24825,16004,19,16023,277
2020-07-07,San Diego,073,3302833,22056,17580,2,17582,399
2020-07-07,San Francisco,075,870044,4781,4045,1,4046,50
2020-07-07,San Joaquin,077,732212,7748,5547,4,5551,59
2020-07-07,San Luis Obispo,079,281455,1215,795,7,802,2
2020-07-07,San Mateo,081,765935,4279,3691,7,3698,106
2020-07-07,Santa Barbara,083,443738,4660,3866,39,3905,27
2020-07-07,Santa Clara,085,1922200,7442,5438,19,5457,164
2020-07-07,Santa Cruz,087,273765,622,502,3,505,2
2020-07-07,Shasta,089,179085,271,144,1,145,6
2020-07-07,Sierra,091,2930,1,1,0,1,0
2020-07-07,Siskiyou,093,43540,54,30,0,30,0
2020-07-07,Solano,095,438530,2534,1776,8,1784,22
2020-07-07,Sonoma,097,501317,1986,1473,5,1478,8
2020-07-07,Stanislaus,099,539301,6026,4101,8,4109,46
2020-07-07,Sutter,101,95872,377,273,0,273,2
2020-07-07,Tehama,103,63373,125,95,2,97,1
2020-07-07,Trinity,105,12862,20,2,5,7,0
2020-07-07,Tulare,107,460477,6929,5189,16,5205,137
2020-07-07,Tuolumne,109,53932,75,40,4,44,0
2020-07-07,Ventura,111,848112,5596,3992,18,4010,46
2020-07-07,Yolo,113,214977,1031,706,3,709,26
2020-07-07,Yuba,115,75493,161,138,0,138,1
2020-07-06,Alameda,001,1643700,8423,6970,10,6980,141
2020-07-06,Alpine,003,1148,1,1,0,1,0
2020-07-06,Amador,005,37829,39,33,0,33,0
2020-07-06,Butte,007,227075,432,257,16,273,2
2020-07-06,Calaveras,009,45235,73,45,0,45,0
2020-07-06,Colusa,011,21464,134,80,0,80,0
2020-07-06,Contra Costa,013,1133247,5279,3901,7,3908,83
2020-07-06,Del Norte,015,27424,60,57,0,57,0
2020-07-06,El Dorado,017,186661,402,232,4,236,0
2020-07-06,Fresno,019,978130,12548,6364,85,6449,82
2020-07-06,Glenn,021,27897,197,129,0,129,0
2020-07-06,Humboldt,023,135768,188,148,1,149,3
2020-07-06,Imperial,025,180216,8728,6443,4,6447,47
2020-07-06,Inyo,027,18085,36,32,1,33,1
2020-07-06,Kern,029,883053,12695,5491,40,5531,82
2020-07-06,Kings,031,150075,3139,2583,9,2592,33
2020-07-06,Lake,033,64148,122,93,0,93,1
2020-07-06,Lassen,035,31185,264,219,2,221,0
2020-07-06,Los Angeles,037,10098052,136796,116707,103,116810,3541
2020-07-06,Madera,039,155013,1345,734,3,737,4
2020-07-06,Marin,041,260295,3630,2136,4,2140,17
2020-07-06,Mariposa,043,17540,36,31,0,31,1
2020-07-06,Mendocino,045,87422,107,72,0,72,0
2020-07-06,Merced,047,269075,2508,1396,2,1398,10
2020-07-06,Modoc,049,8938,1,0,0,0,0
2020-07-06,Mono,051,14174,58,40,0,40,1
2020-07-06,Monterey,053,433212,2802,2078,4,2082,15
2020-07-06,Napa,055,140530,608,454,0,454,4
2020-07-06,Nevada,057,99092,192,146,5,151,1
2020-07-06,Orange,059,3164182,28558,20167,292,20459,372
2020-07-06,Placer,061,380077,1222,904,3,907,11
2020-07-06,Plumas,063,18699,17,11,0,11,0
2020-07-06,Riverside,065,2383286,28561,22485,28,22513,477
2020-07-06,Sacramento,067,1510023,5985,4420,7,4427,71
2020-07-06,San Benito,069,59416,366,264,0,264,2
2020-07-06,San Bernardino,071,2135413,23972,15346,16,15362,272
2020-07-06,San Diego,073,3302833,21324,17002,2,17004,387
2020-07-06,San Francisco,075,870044,4660,3861,1,3862,50
2020-07-06,San Joaquin,077,732212,7377,5104,4,5108,57
2020-07-06,San Luis Obispo,079,281455,1157,751,7,758,2
2020-07-06,San Mateo,081,765935,4187,3650,6,3656,106
2020-07-06,Santa Barbara,083,443738,4523,3763,38,3801,27
2020-07-06,Santa Clara,085,1922200,7170,5369,19,5388,165
2020-07-06,Santa Cruz,087,273765,600,466,2,468,2
2020-07-06,Shasta,089,179085,261,143,1,144,6
2020-07-06,Sierra,091,2930,1,1,0,1,0
2020-07-06,Siskiyou,093,43540,50,30,0,30,0
2020-07-06,Solano,095,438530,2398,1668,8,1676,22
2020-07-06,Sonoma,097,501317,1922,1369,5,1374,8
2020-07-06,Stanislaus,099,539301,5624,3983,8,3991,46
2020-07-06,Sutter,101,95872,350,250,0,250,2
2020-07-06,Tehama,103,63373,122,95,2,97,1
2020-07-06,Trinity,105,12862,19,2,5,7,0
2020-07-06,Tulare,107,460477,6724,5039,14,5053,136
2020-07-06,Tuolumne,109,53932,72,30,4,34,0
2020-07-06,Ventura,111,848112,5403,3912,18,3930,44
2020-07-06,Yolo,113,214977,975,685,3,688,26
2020-07-06,Yuba,115,75493,147,124,0,124,1
2020-07-05,Alameda,001,1643700,8173,6861,10,6871,141
2020-07-05,Alpine,003,1148,1,1,0,1,0
2020-07-05,Amador,005,37829,37,31,0,31,0
2020-07-05,Butte,007,227075,397,248,16,264,2
2020-07-05,Calaveras,009,45235,69,45,0,45,0
2020-07-05,Colusa,011,21464,124,79,0,79,0
2020-07-05,Contra Costa,013,1133247,5032,3665,6,3671,80
2020-07-05,Del Norte,015,27424,60,57,0,57,0
2020-07-05,El Dorado,017,186661,384,227,4,231,0
2020-07-05,Fresno,019,978130,11981,6186,84,6270,82
2020-07-05,Glenn,021,27897,194,129,0,129,0
2020-07-05,Humboldt,023,135768,184,147,1,148,3
2020-07-05,Imperial,025,180216,8591,6441,4,6445,47
2020-07-05,Inyo,027,18085,35,32,1,33,1
2020-07-05,Kern,029,883053,11987,5351,40,5391,82
2020-07-05,Kings,031,150075,3056,2546,8,2554,31
2020-07-05,Lake,033,64148,122,92,0,92,1
2020-07-05,Lassen,035,31185,258,219,2,221,0
2020-07-05,Los Angeles,037,10098052,133565,115133,97,115230,3495
2020-07-05,Madera,039,155013,1268,564,3,567,4
2020-07-05,Marin,041,260295,3448,2080,4,2084,17
2020-07-05,Mariposa,043,17540,36,31,0,31,1
2020-07-05,Mendocino,045,87422,104,72,0,72,0
2020-07-05,Merced,047,269075,2362,1340,2,1342,10
2020-07-05,Modoc,049,8938,1,0,0,0,0
2020-07-05,Mono,051,14174,54,39,0,39,1
2020-07-05,Monterey,053,433212,2699,1994,4,1998,15
2020-07-05,Napa,055,140530,578,450,0,450,4
2020-07-05,Nevada,057,99092,186,141,5,146,1
2020-07-05,Orange,059,3164182,27611,19430,279,19709,372
2020-07-05,Placer,061,380077,1165,855,3,858,11
2020-07-05,Plumas,063,18699,16,11,0,11,0
2020-07-05,Riverside,065,2383286,27703,21511,28,21539,474
2020-07-05,Sacramento,067,1510023,5670,4265,6,4271,71
2020-07-05,San Benito,069,59416,348,258,0,258,2
2020-07-05,San Bernardino,071,2135413,23094,15026,16,15042,270
2020-07-05,San Diego,073,3302833,20633,16728,2,16730,387
2020-07-05,San Francisco,075,870044,4543,3861,1,3862,50
2020-07-05,San Joaquin,077,732212,7058,5015,4,5019,57
2020-07-05,San Luis Obispo,079,281455,1078,730,7,737,2
2020-07-05,San Mateo,081,765935,4077,3575,6,3581,106
2020-07-05,Santa Barbara,083,443738,4376,3671,35,3706,27
2020-07-05,Santa Clara,085,1922200,6874,5237,19,5256,162
2020-07-05,Santa Cruz,087,273765,582,467,0,467,2
2020-07-05,Shasta,089,179085,255,138,1,139,6
2020-07-05,Sierra,091,2930,1,1,0,1,0
2020-07-05,Siskiyou,093,43540,46,30,0,30,0
2020-07-05,Solano,095,438530,2277,1547,8,1555,22
2020-07-05,Sonoma,097,501317,1841,1369,5,1374,8
2020-07-05,Stanislaus,099,539301,5294,3777,7,3784,45
2020-07-05,Sutter,101,95872,322,241,0,241,2
2020-07-05,Tehama,103,63373,120,95,2,97,1
2020-07-05,Trinity,105,12862,19,2,5,7,0
2020-07-05,Tulare,107,460477,6465,4981,12,4993,135
2020-07-05,Tuolumne,109,53932,67,30,3,33,0
2020-07-05,Ventura,111,848112,5200,3866,18,3884,44
2020-07-05,Yolo,113,214977,935,644,3,647,26
2020-07-05,Yuba,115,75493,137,115,0,115,1
2020-07-04,Alameda,001,1643700,8061,6737,10,6747,141
2020-07-04,Alpine,003,1148,1,1,0,1,0
2020-07-04,Amador,005,37829,36,31,0,31,0
2020-07-04,Butte,007,227075,379,224,16,240,2
2020-07-04,Calaveras,009,45235,69,45,0,45,0
2020-07-04,Colusa,011,21464,123,76,0,76,0
2020-07-04,Contra Costa,013,1133247,4886,3583,6,3589,80
2020-07-04,Del Norte,015,27424,60,50,0,50,0
2020-07-04,El Dorado,017,186661,365,211,4,215,0
2020-07-04,Fresno,019,978130,11664,5999,82,6081,82
2020-07-04,Glenn,021,27897,187,128,0,128,0
2020-07-04,Humboldt,023,135768,177,144,1,145,3
2020-07-04,Imperial,025,180216,8542,6441,4,6445,47
2020-07-04,Inyo,027,18085,35,32,1,33,1
2020-07-04,Kern,029,883053,11683,5231,40,5271,81
2020-07-04,Kings,031,150075,3013,2509,8,2517,31
2020-07-04,Lake,033,64148,115,86,0,86,1
2020-07-04,Lassen,035,31185,258,219,2,221,0
2020-07-04,Los Angeles,037,10098052,131749,107256,86,107342,3462
2020-07-04,Madera,039,155013,1222,568,3,571,4
2020-07-04,Marin,041,260295,3419,1962,4,1966,17
2020-07-04,Mariposa,043,17540,36,28,0,28,1
2020-07-04,Mendocino,045,87422,104,72,0,72,0
2020-07-04,Merced,047,269075,2263,1252,2,1254,10
2020-07-04,Modoc,049,8938,1,0,0,0,0
2020-07-04,Mono,051,14174,54,37,0,37,1
2020-07-04,Monterey,053,433212,2619,1878,4,1882,15
2020-07-04,Napa,055,140530,569,426,0,426,4
2020-07-04,Nevada,057,99092,183,125,5,130,1
2020-07-04,Orange,059,3164182,27174,19247,266,19513,372
2020-07-04,Placer,061,380077,1130,796,3,799,11
2020-07-04,Plumas,063,18699,16,11,0,11,0
2020-07-04,Riverside,065,2383286,27337,21508,28,21536,474
2020-07-04,Sacramento,067,1510023,5499,4039,6,4045,71
2020-07-04,San Benito,069,59416,335,255,0,255,2
2020-07-04,San Bernardino,071,2135413,22668,14636,14,14650,270
2020-07-04,San Diego,073,3302833,20173,16166,2,16168,387
2020-07-04,San Francisco,075,870044,4451,3861,1,3862,50
2020-07-04,San Joaquin,077,732212,6846,4807,4,4811,57
2020-07-04,San Luis Obispo,079,281455,1038,699,7,706,2
2020-07-04,San Mateo,081,765935,4014,3532,6,3538,106
2020-07-04,Santa Barbara,083,443738,4301,3520,33,3553,27
2020-07-04,Santa Clara,085,1922200,6683,5045,18,5063,161
2020-07-04,Santa Cruz,087,273765,572,466,0,466,2
2020-07-04,Shasta,089,179085,252,135,1,136,6
2020-07-04,Sierra,091,2930,1,1,0,1,0
2020-07-04,Siskiyou,093,43540,39,30,0,30,0
2020-07-04,Solano,095,438530,2241,1548,8,1556,22
2020-07-04,Sonoma,097,501317,1815,1370,5,1375,8
2020-07-04,Stanislaus,099,539301,5136,3572,7,3579,44
2020-07-04,Sutter,101,95872,303,225,0,225,2
2020-07-04,Tehama,103,63373,117,92,2,94,1
2020-07-04,Trinity,105,12862,19,2,5,7,0
2020-07-04,Tulare,107,460477,6353,4802,12,4814,135
2020-07-04,Tuolumne,109,53932,63,30,3,33,0
2020-07-04,Ventura,111,848112,5076,3687,18,3705,44
2020-07-04,Yolo,113,214977,910,615,3,618,26
2020-07-04,Yuba,115,75493,130,102,0,102,1
2020-07-03,Alameda,001,1643700,7940,6486,10,6496,141
2020-07-03,Alpine,003,1148,1,1,0,1,0
2020-07-03,Amador,005,37829,36,25,0,25,0
2020-07-03,Butte,007,227075,367,212,16,228,2
2020-07-03,Calaveras,009,45235,69,44,0,44,0
2020-07-03,Colusa,011,21464,117,70,0,70,0
2020-07-03,Contra Costa,013,1133247,4750,3447,6,3453,78
2020-07-03,Del Norte,015,27424,60,50,0,50,0
2020-07-03,El Dorado,017,186661,353,201,4,205,0
2020-07-03,Fresno,019,978130,11359,5783,80,5863,81
2020-07-03,Glenn,021,27897,182,122,0,122,0
2020-07-03,Humboldt,023,135768,173,143,1,144,3
2020-07-03,Imperial,025,180216,8494,6345,4,6349,47
2020-07-03,Inyo,027,18085,35,32,1,33,1
2020-07-03,Kern,029,883053,11421,5213,40,5253,81
2020-07-03,Kings,031,150075,2977,2492,8,2500,31
2020-07-03,Lake,033,64148,108,83,0,83,0
2020-07-03,Lassen,035,31185,258,219,2,221,0
2020-07-03,Los Angeles,037,10098052,130236,107236,82,107318,3461
2020-07-03,Madera,039,155013,1178,565,3,568,4
2020-07-03,Marin,041,260295,3390,1776,4,1780,17
2020-07-03,Mariposa,043,17540,36,28,0,28,1
2020-07-03,Mendocino,045,87422,103,72,0,72,0
2020-07-03,Merced,047,269075,2196,1188,2,1190,10
2020-07-03,Modoc,049,8938,1,0,0,0,0
2020-07-03,Mono,051,14174,54,37,0,37,1
2020-07-03,Monterey,053,433212,2549,1804,4,1808,15
2020-07-03,Napa,055,140530,551,388,0,388,4
2020-07-03,Nevada,057,99092,182,125,5,130,1
2020-07-03,Orange,059,3164182,26783,18819,258,19077,366
2020-07-03,Placer,061,380077,1103,745,3,748,11
2020-07-03,Plumas,063,18699,16,11,0,11,0
2020-07-03,Riverside,065,2383286,27031,21171,28,21199,472
2020-07-03,Sacramento,067,1510023,5365,3711,6,3717,71
2020-07-03,San Benito,069,59416,328,243,0,243,2
2020-07-03,San Bernardino,071,2135413,22280,14040,14,14054,269
2020-07-03,San Diego,073,3302833,19718,15698,2,15700,387
2020-07-03,San Francisco,075,870044,4405,3781,1,3782,50
2020-07-03,San Joaquin,077,732212,6708,4416,3,4419,56
2020-07-03,San Luis Obispo,079,281455,1003,676,7,683,2
2020-07-03,San Mateo,081,765935,3957,3439,6,3445,106
2020-07-03,Santa Barbara,083,443738,4214,3406,32,3438,27
2020-07-03,Santa Clara,085,1922200,6571,4820,18,4838,161
2020-07-03,Santa Cruz,087,273765,558,436,0,436,2
2020-07-03,Shasta,089,179085,244,113,1,114,6
2020-07-03,Sierra,091,2930,1,1,0,1,0
2020-07-03,Siskiyou,093,43540,36,30,0,30,0
2020-07-03,Solano,095,438530,2197,1496,7,1503,22
2020-07-03,Sonoma,097,501317,1767,1282,5,1287,8
2020-07-03,Stanislaus,099,539301,5012,3021,7,3028,43
2020-07-03,Sutter,101,95872,293,205,0,205,2
2020-07-03,Tehama,103,63373,115,89,2,91,1
2020-07-03,Trinity,105,12862,19,2,5,7,0
2020-07-03,Tulare,107,460477,6238,4656,12,4668,134
2020-07-03,Tuolumne,109,53932,61,27,3,30,0
2020-07-03,Ventura,111,848112,4980,3536,18,3554,44
2020-07-03,Yolo,113,214977,876,586,3,589,25
2020-07-03,Yuba,115,75493,125,96,0,96,1
2020-07-02,Alameda,001,1643700,7814,6386,10,6396,139
2020-07-02,Alpine,003,1148,1,1,0,1,0
2020-07-02,Amador,005,37829,35,23,0,23,0
2020-07-02,Butte,007,227075,350,199,16,215,2
2020-07-02,Calaveras,009,45235,65,42,0,42,0
2020-07-02,Colusa,011,21464,109,60,0,60,0
2020-07-02,Contra Costa,013,1133247,4568,3347,6,3353,77
2020-07-02,Del Norte,015,27424,59,50,0,50,0
2020-07-02,El Dorado,017,186661,342,193,4,197,0
2020-07-02,Fresno,019,978130,10898,5402,80,5482,78
2020-07-02,Glenn,021,27897,176,114,0,114,0
2020-07-02,Humboldt,023,135768,169,138,1,139,3
2020-07-02,Imperial,025,180216,8393,6236,4,6240,47
2020-07-02,Inyo,027,18085,35,29,1,30,1
2020-07-02,Kern,029,883053,10886,5036,38,5074,78
2020-07-02,Kings,031,150075,2926,2419,8,2427,31
2020-07-02,Lake,033,64148,104,81,0,81,0
2020-07-02,Lassen,035,31185,256,218,2,220,0
2020-07-02,Los Angeles,037,10098052,128219,107144,59,107203,3458
2020-07-02,Madera,039,155013,1110,548,3,551,4
2020-07-02,Marin,041,260295,3304,1706,4,1710,17
2020-07-02,Mariposa,043,17540,35,28,0,28,1
2020-07-02,Mendocino,045,87422,99,71,0,71,0
2020-07-02,Merced,047,269075,2094,1122,2,1124,10
2020-07-02,Modoc,049,8938,1,0,0,0,0
2020-07-02,Mono,051,14174,54,37,0,37,1
2020-07-02,Monterey,053,433212,2489,1796,4,1800,15
2020-07-02,Napa,055,140530,534,352,0,352,4
2020-07-02,Nevada,057,99092,176,118,4,122,1
2020-07-02,Orange,059,3164182,26015,17056,245,17301,360
2020-07-02,Placer,061,380077,1079,740,3,743,11
2020-07-02,Plumas,063,18699,15,8,0,8,0
2020-07-02,Riverside,065,2383286,26457,20253,28,20281,458
2020-07-02,Sacramento,067,1510023,5138,3587,6,3593,70
2020-07-02,San Benito,069,59416,320,236,0,236,2
2020-07-02,San Bernardino,071,2135413,21744,13185,14,13199,260
2020-07-02,San Diego,073,3302833,19253,15208,2,15210,377
2020-07-02,San Francisco,075,870044,4310,3676,1,3677,50
2020-07-02,San Joaquin,077,732212,6361,4243,3,4246,56
2020-07-02,San Luis Obispo,079,281455,958,659,7,666,2
2020-07-02,San Mateo,081,765935,3877,3390,6,3396,107
2020-07-02,Santa Barbara,083,443738,4114,3385,30,3415,27
2020-07-02,Santa Clara,085,1922200,6444,4722,18,4740,160
2020-07-02,Santa Cruz,087,273765,535,414,0,414,2
2020-07-02,Shasta,089,179085,241,110,1,111,5
2020-07-02,Sierra,091,2930,1,1,0,1,0
2020-07-02,Siskiyou,093,43540,36,30,0,30,0
2020-07-02,Solano,095,438530,2114,1429,7,1436,21
2020-07-02,Sonoma,097,501317,1709,1244,5,1249,6
2020-07-02,Stanislaus,099,539301,4840,2850,7,2857,41
2020-07-02,Sutter,101,95872,282,195,0,195,2
2020-07-02,Tehama,103,63373,113,86,2,88,1
2020-07-02,Trinity,105,12862,19,2,5,7,0
2020-07-02,Tulare,107,460477,6071,4559,11,4570,132
2020-07-02,Tuolumne,109,53932,58,23,2,25,0
2020-07-02,Ventura,111,848112,4824,3394,18,3412,42
2020-07-02,Yolo,113,214977,844,554,3,557,24
2020-07-02,Yuba,115,75493,115,93,0,93,1
2020-07-01,Alameda,001,1643700,7596,6125,10,6135,137
2020-07-01,Alpine,003,1148,1,1,0,1,0
2020-07-01,Amador,005,37829,34,22,0,22,0
2020-07-01,Butte,007,227075,325,185,16,201,2
2020-07-01,Calaveras,009,45235,63,37,0,37,0
2020-07-01,Colusa,011,21464,103,53,0,53,0
2020-07-01,Contra Costa,013,1133247,4355,3259,6,3265,76
2020-07-01,Del Norte,015,27424,59,50,0,50,0
2020-07-01,El Dorado,017,186661,315,183,4,187,0
2020-07-01,Fresno,019,978130,10464,5111,77,5188,76
2020-07-01,Glenn,021,27897,170,110,0,110,0
2020-07-01,Humboldt,023,135768,164,134,0,134,3
2020-07-01,Imperial,025,180216,8296,6150,4,6154,46
2020-07-01,Inyo,027,18085,34,30,1,31,1
2020-07-01,Kern,029,883053,10252,4853,37,4890,78
2020-07-01,Kings,031,150075,2858,2360,8,2368,30
2020-07-01,Lake,033,64148,103,75,0,75,0
2020-07-01,Lassen,035,31185,255,217,2,219,0
2020-07-01,Los Angeles,037,10098052,125021,105325,50,105375,3408
2020-07-01,Madera,039,155013,1069,519,3,522,4
2020-07-01,Marin,041,260295,3147,1636,4,1640,17
2020-07-01,Mariposa,043,17540,35,29,0,29,1
2020-07-01,Mendocino,045,87422,95,70,0,70,0
2020-07-01,Merced,047,269075,1995,1052,2,1054,10
2020-07-01,Modoc,049,8938,1,0,0,0,0
2020-07-01,Mono,051,14174,51,37,0,37,1
2020-07-01,Monterey,053,433212,2381,1703,3,1706,15
2020-07-01,Napa,055,140530,511,347,0,347,4
2020-07-01,Nevada,057,99092,166,115,4,119,1
2020-07-01,Orange,059,3164182,25122,15662,224,15886,343
2020-07-01,Placer,061,380077,1032,713,3,716,11
2020-07-01,Plumas,063,18699,13,8,0,8,0
2020-07-01,Riverside,065,2383286,25614,19537,27,19564,457
2020-07-01,Sacramento,067,1510023,4883,3425,6,3431,64
2020-07-01,San Benito,069,59416,311,219,0,219,2
2020-07-01,San Bernardino,071,2135413,20850,12712,11,12723,253
2020-07-01,San Diego,073,3302833,18685,14624,2,14626,372
2020-07-01,San Francisco,075,870044,4217,3626,1,3627,50
2020-07-01,San Joaquin,077,732212,6003,3990,3,3993,54
2020-07-01,San Luis Obispo,079,281455,931,613,7,620,1
2020-07-01,San Mateo,081,765935,3815,3326,6,3332,84
2020-07-01,Santa Barbara,083,443738,3994,3268,29,3297,27
2020-07-01,Santa Clara,085,1922200,6258,4547,17,4564,159
2020-07-01,Santa Cruz,087,273765,511,398,0,398,2
2020-07-01,Shasta,089,179085,236,104,1,105,5
2020-07-01,Sierra,091,2930,1,1,0,1,0
2020-07-01,Siskiyou,093,43540,36,28,0,28,0
2020-07-01,Solano,095,438530,2022,1350,7,1357,21
2020-07-01,Sonoma,097,501317,1614,1178,5,1183,6
2020-07-01,Stanislaus,099,539301,4562,2619,7,2626,41
2020-07-01,Sutter,101,95872,269,188,0,188,2
2020-07-01,Tehama,103,63373,106,80,2,82,1
2020-07-01,Trinity,105,12862,19,2,4,6,0
2020-07-01,Tulare,107,460477,5894,4359,11,4370,128
2020-07-01,Tuolumne,109,53932,55,17,2,19,0
2020-07-01,Ventura,111,848112,4682,3224,16,3240,41
2020-07-01,Yolo,113,214977,793,526,3,529,24
2020-07-01,Yuba,115,75493,110,57,0,57,1
2020-06-30,Alameda,001,1643700,7349,5959,8,5967,137
2020-06-30,Alpine,003,1148,1,1,0,1,0
2020-06-30,Amador,005,37829,34,21,0,21,0
2020-06-30,Butte,007,227075,308,163,15,178,2
2020-06-30,Calaveras,009,45235,59,31,0,31,0
2020-06-30,Colusa,011,21464,94,33,0,33,0
2020-06-30,Contra Costa,013,1133247,4144,3140,6,3146,75
2020-06-30,Del Norte,015,27424,59,48,0,48,0
2020-06-30,El Dorado,017,186661,302,175,4,179,0
2020-06-30,Fresno,019,978130,10019,4826,72,4898,75
2020-06-30,Glenn,021,27897,165,96,0,96,0
2020-06-30,Humboldt,023,135768,160,132,0,132,3
2020-06-30,Imperial,025,180216,8197,5968,4,5972,45
2020-06-30,Inyo,027,18085,34,30,1,31,1
2020-06-30,Kern,029,883053,9605,4721,34,4755,75
2020-06-30,Kings,031,150075,2809,2315,5,2320,30
2020-06-30,Lake,033,64148,95,56,0,56,0
2020-06-30,Lassen,035,31185,248,215,2,217,0
2020-06-30,Los Angeles,037,10098052,121438,103640,47,103687,3378
2020-06-30,Madera,039,155013,1012,475,3,478,4
2020-06-30,Marin,041,260295,3076,1614,4,1618,17
2020-06-30,Mariposa,043,17540,34,27,0,27,1
2020-06-30,Mendocino,045,87422,90,65,0,65,0
2020-06-30,Merced,047,269075,1859,970,2,972,10
2020-06-30,Modoc,049,8938,1,0,0,0,0
2020-06-30,Mono,051,14174,49,36,0,36,1
2020-06-30,Monterey,053,433212,2284,1657,3,1660,15
2020-06-30,Napa,055,140530,486,342,0,342,4
2020-06-30,Nevada,057,99092,158,113,4,117,1
2020-06-30,Orange,059,3164182,24184,14354,214,14568,335
2020-06-30,Placer,061,380077,1005,667,3,670,11
2020-06-30,Plumas,063,18699,12,8,0,8,0
2020-06-30,Riverside,065,2383286,24896,18656,26,18682,449
2020-06-30,Sacramento,067,1510023,4594,3246,6,3252,64
2020-06-30,San Benito,069,59416,300,200,0,200,2
2020-06-30,San Bernardino,071,2135413,19868,12375,10,12385,249
2020-06-30,San Diego,073,3302833,17980,14150,2,14152,365
2020-06-30,San Francisco,075,870044,4112,3555,1,3556,50
2020-06-30,San Joaquin,077,732212,5629,3744,3,3747,52
2020-06-30,San Luis Obispo,079,281455,891,583,7,590,1
2020-06-30,San Mateo,081,765935,3737,3268,6,3274,84
2020-06-30,Santa Barbara,083,443738,3878,3102,29,3131,25
2020-06-30,Santa Clara,085,1922200,6055,4346,17,4363,157
2020-06-30,Santa Cruz,087,273765,485,379,0,379,2
2020-06-30,Shasta,089,179085,220,100,1,101,5
2020-06-30,Sierra,091,2930,1,1,0,1,0
2020-06-30,Siskiyou,093,43540,35,26,0,26,0
2020-06-30,Solano,095,438530,1930,1256,7,1263,21
2020-06-30,Sonoma,097,501317,1551,1122,5,1127,6
2020-06-30,Stanislaus,099,539301,4265,2578,7,2585,41
2020-06-30,Sutter,101,95872,246,168,0,168,2
2020-06-30,Tehama,103,63373,104,75,2,77,1
2020-06-30,Trinity,105,12862,19,2,4,6,0
2020-06-30,Tulare,107,460477,5685,4207,11,4218,117
2020-06-30,Tuolumne,109,53932,51,16,2,18,0
2020-06-30,Ventura,111,848112,4548,3030,16,3046,40
2020-06-30,Yolo,113,214977,755,515,3,518,24
2020-06-30,Yuba,115,75493,106,55,0,55,1
2020-06-29,Alameda,001,1643700,7141,5766,8,5774,135
2020-06-29,Alpine,003,1148,1,1,0,1,0
2020-06-29,Amador,005,37829,31,20,0,20,0
2020-06-29,Butte,007,227075,287,157,15,172,2
2020-06-29,Calaveras,009,45235,56,30,0,30,0
2020-06-29,Colusa,011,21464,89,17,0,17,0
2020-06-29,Contra Costa,013,1133247,3980,2976,5,2981,75
2020-06-29,Del Norte,015,27424,59,47,0,47,0
2020-06-29,El Dorado,017,186661,288,163,2,165,0
2020-06-29,Fresno,019,978130,9672,4531,71,4602,74
2020-06-29,Glenn,021,27897,156,77,0,77,0
2020-06-29,Humboldt,023,135768,159,128,0,128,3
2020-06-29,Imperial,025,180216,8067,5512,4,5516,45
2020-06-29,Inyo,027,18085,33,29,0,29,1
2020-06-29,Kern,029,883053,8942,4613,32,4645,73
2020-06-29,Kings,031,150075,2744,2280,5,2285,20
2020-06-29,Lake,033,64148,88,53,0,53,0
2020-06-29,Lassen,035,31185,240,77,2,79,0
2020-06-29,Los Angeles,037,10098052,118400,100846,41,100887,3337
2020-06-29,Madera,039,155013,955,422,3,425,4
2020-06-29,Marin,041,260295,3000,1517,4,1521,17
2020-06-29,Mariposa,043,17540,32,25,0,25,1
2020-06-29,Mendocino,045,87422,87,63,0,63,0
2020-06-29,Merced,047,269075,1752,848,2,850,10
2020-06-29,Modoc,049,8938,1,0,0,0,0
2020-06-29,Mono,051,14174,47,35,0,35,1
2020-06-29,Monterey,053,433212,2212,1614,3,1617,14
2020-06-29,Napa,055,140530,464,317,0,317,4
2020-06-29,Nevada,057,99092,155,107,3,110,1
2020-06-29,Orange,059,3164182,23185,13682,199,13881,324
2020-06-29,Placer,061,380077,969,628,3,631,11
2020-06-29,Plumas,063,18699,12,6,0,6,0
2020-06-29,Riverside,065,2383286,23862,17683,26,17709,432
2020-06-29,Sacramento,067,1510023,4307,2985,6,2991,62
2020-06-29,San Benito,069,59416,285,193,0,193,2
2020-06-29,San Bernardino,071,2135413,18905,11643,10,11653,245
2020-06-29,San Diego,073,3302833,17402,13834,2,13836,361
2020-06-29,San Francisco,075,870044,4035,3389,1,3390,50
2020-06-29,San Joaquin,077,732212,5271,3202,3,3205,52
2020-06-29,San Luis Obispo,079,281455,857,544,7,551,1
2020-06-29,San Mateo,081,765935,3683,3170,6,3176,84
2020-06-29,Santa Barbara,083,443738,3769,2933,28,2961,25
2020-06-29,Santa Clara,085,1922200,5885,4231,17,4248,157
2020-06-29,Santa Cruz,087,273765,467,348,0,348,2
2020-06-29,Shasta,089,179085,212,94,1,95,5
2020-06-29,Sierra,091,2930,1,1,0,1,0
2020-06-29,Siskiyou,093,43540,35,25,0,25,0
2020-06-29,Solano,095,438530,1827,1077,7,1084,21
2020-06-29,Sonoma,097,501317,1479,1103,5,1108,5
2020-06-29,Stanislaus,099,539301,4060,2400,6,2406,36
2020-06-29,Sutter,101,95872,224,152,0,152,2
2020-06-29,Tehama,103,63373,100,63,2,65,1
2020-06-29,Trinity,105,12862,18,2,4,6,0
2020-06-29,Tulare,107,460477,5531,3906,10,3916,117
2020-06-29,Tuolumne,109,53932,47,16,2,18,0
2020-06-29,Ventura,111,848112,4401,2794,16,2810,40
2020-06-29,Yolo,113,214977,722,483,3,486,24
2020-06-29,Yuba,115,75493,93,55,0,55,1
2020-06-28,Alameda,001,1643700,6880,5698,8,5706,135
2020-06-28,Alpine,003,1148,1,1,0,1,0
2020-06-28,Amador,005,37829,29,20,0,20,0
2020-06-28,Butte,007,227075,268,150,14,164,2
2020-06-28,Calaveras,009,45235,51,30,0,30,0
2020-06-28,Colusa,011,21464,74,17,0,17,0
2020-06-28,Contra Costa,013,1133247,3790,2803,4,2807,73
2020-06-28,Del Norte,015,27424,58,47,0,47,0
2020-06-28,El Dorado,017,186661,276,162,2,164,0
2020-06-28,Fresno,019,978130,9309,4365,71,4436,74
2020-06-28,Glenn,021,27897,148,77,0,77,0
2020-06-28,Humboldt,023,135768,156,127,0,127,3
2020-06-28,Imperial,025,180216,7877,5513,4,5517,45
2020-06-28,Inyo,027,18085,33,29,0,29,1
2020-06-28,Kern,029,883053,8391,4541,29,4570,72
2020-06-28,Kings,031,150075,2684,2234,5,2239,18
2020-06-28,Lake,033,64148,84,53,0,53,0
2020-06-28,Lassen,035,31185,240,77,2,79,0
2020-06-28,Los Angeles,037,10098052,115196,98003,37,98040,3316
2020-06-28,Madera,039,155013,907,424,3,427,4
2020-06-28,Marin,041,260295,2654,1473,4,1477,17
2020-06-28,Mariposa,043,17540,32,24,0,24,1
2020-06-28,Mendocino,045,87422,85,63,0,63,0
2020-06-28,Merced,047,269075,1637,814,2,816,10
2020-06-28,Modoc,049,8938,1,0,0,0,0
2020-06-28,Mono,051,14174,47,35,0,35,1
2020-06-28,Monterey,053,433212,2130,1560,3,1563,13
2020-06-28,Napa,055,140530,430,307,0,307,4
2020-06-28,Nevada,057,99092,144,102,3,105,1
2020-06-28,Orange,059,3164182,22203,13213,181,13394,324
2020-06-28,Placer,061,380077,930,618,3,621,11
2020-06-28,Plumas,063,18699,11,6,0,6,0
2020-06-28,Riverside,065,2383286,23033,16848,25,16873,432
2020-06-28,Sacramento,067,1510023,4079,2803,6,2809,63
2020-06-28,San Benito,069,59416,274,190,0,190,2
2020-06-28,San Bernardino,071,2135413,18153,11344,9,11353,245
2020-06-28,San Diego,073,3302833,16857,13333,2,13335,361
2020-06-28,San Francisco,075,870044,3957,3388,1,3389,50
2020-06-28,San Joaquin,077,732212,4934,3201,3,3204,52
2020-06-28,San Luis Obispo,079,281455,818,531,6,537,1
2020-06-28,San Mateo,081,765935,3606,3124,5,3129,84
2020-06-28,Santa Barbara,083,443738,3624,2872,28,2900,25
2020-06-28,Santa Clara,085,1922200,5723,4131,17,4148,156
2020-06-28,Santa Cruz,087,273765,444,349,0,349,2
2020-06-28,Shasta,089,179085,199,89,0,89,5
2020-06-28,Sierra,091,2930,1,1,0,1,0
2020-06-28,Siskiyou,093,43540,35,25,0,25,0
2020-06-28,Solano,095,438530,1752,1077,7,1084,21
2020-06-28,Sonoma,097,501317,1425,1084,5,1089,5
2020-06-28,Stanislaus,099,539301,3854,2376,6,2382,36
2020-06-28,Sutter,101,95872,198,145,0,145,2
2020-06-28,Tehama,103,63373,93,63,2,65,1
2020-06-28,Trinity,105,12862,17,2,4,6,0
2020-06-28,Tulare,107,460477,5363,3812,10,3822,117
2020-06-28,Tuolumne,109,53932,42,14,2,16,0
2020-06-28,Ventura,111,848112,4243,2650,16,2666,40
2020-06-28,Yolo,113,214977,687,468,3,471,24
2020-06-28,Yuba,115,75493,89,39,0,39,1
2020-06-27,Alameda,001,1643700,6784,5581,8,5589,135
2020-06-27,Alpine,003,1148,1,1,0,1,0
2020-06-27,Amador,005,37829,27,20,0,20,0
2020-06-27,Butte,007,227075,260,137,13,150,2
2020-06-27,Calaveras,009,45235,49,30,0,30,0
2020-06-27,Colusa,011,21464,68,17,0,17,0
2020-06-27,Contra Costa,013,1133247,3696,2717,3,2720,72
2020-06-27,Del Norte,015,27424,58,47,0,47,0
2020-06-27,El Dorado,017,186661,270,159,2,161,0
2020-06-27,Fresno,019,978130,9062,4238,71,4309,74
2020-06-27,Glenn,021,27897,144,77,0,77,0
2020-06-27,Humboldt,023,135768,154,127,0,127,3
2020-06-27,Imperial,025,180216,7816,5513,4,5517,45
2020-06-27,Inyo,027,18085,33,29,0,29,1
2020-06-27,Kern,029,883053,8128,4411,28,4439,70
2020-06-27,Kings,031,150075,2658,2187,5,2192,18
2020-06-27,Lake,033,64148,81,42,0,42,0
2020-06-27,Lassen,035,31185,240,33,2,35,0
2020-06-27,Los Angeles,037,10098052,113454,95341,34,95375,3291
2020-06-27,Madera,039,155013,864,427,2,429,4
2020-06-27,Marin,041,260295,2609,1423,4,1427,17
2020-06-27,Mariposa,043,17540,31,22,0,22,1
2020-06-27,Mendocino,045,87422,85,63,0,63,0
2020-06-27,Merced,047,269075,1577,807,1,808,10
2020-06-27,Modoc,049,8938,1,0,0,0,0
2020-06-27,Mono,051,14174,46,35,0,35,1
2020-06-27,Monterey,053,433212,2066,1455,3,1458,12
2020-06-27,Napa,055,140530,420,282,0,282,3
2020-06-27,Nevada,057,99092,140,102,2,104,1
2020-06-27,Orange,059,3164182,21692,12951,176,13127,320
2020-06-27,Placer,061,380077,909,584,3,587,10
2020-06-27,Plumas,063,18699,11,6,0,6,0
2020-06-27,Riverside,065,2383286,22643,16209,25,16234,432
2020-06-27,Sacramento,067,1510023,3962,2685,6,2691,63
2020-06-27,San Benito,069,59416,267,182,0,182,2
2020-06-27,San Bernardino,071,2135413,17778,11238,9,11247,243
2020-06-27,San Diego,073,3302833,16492,12836,2,12838,360
2020-06-27,San Francisco,075,870044,3902,3332,1,3333,49
2020-06-27,San Joaquin,077,732212,4768,2995,3,2998,52
2020-06-27,San Luis Obispo,079,281455,795,505,6,511,1
2020-06-27,San Mateo,081,765935,3549,3083,5,3088,83
2020-06-27,Santa Barbara,083,443738,3552,2799,28,2827,25
2020-06-27,Santa Clara,085,1922200,5617,4006,17,4023,157
2020-06-27,Santa Cruz,087,273765,437,347,0,347,2
2020-06-27,Shasta,089,179085,193,87,0,87,5
2020-06-27,Sierra,091,2930,1,1,0,1,0
2020-06-27,Siskiyou,093,43540,35,25,0,25,0
2020-06-27,Solano,095,438530,1719,1076,7,1083,21
2020-06-27,Sonoma,097,501317,1392,1004,5,1009,5
2020-06-27,Stanislaus,099,539301,3754,2164,6,2170,36
2020-06-27,Sutter,101,95872,191,141,0,141,2
2020-06-27,Tehama,103,63373,90,63,2,65,1
2020-06-27,Trinity,105,12862,17,2,4,6,0
2020-06-27,Tulare,107,460477,5266,3810,10,3820,117
2020-06-27,Tuolumne,109,53932,41,13,2,15,0
2020-06-27,Ventura,111,848112,4144,2471,16,2487,40
2020-06-27,Yolo,113,214977,663,432,3,435,24
2020-06-27,Yuba,115,75493,81,39,0,39,1
2020-06-26,Alameda,001,1643700,6698,5502,7,5509,132
2020-06-26,Alpine,003,1148,1,1,0,1,0
2020-06-26,Amador,005,37829,26,20,0,20,0
2020-06-26,Butte,007,227075,245,135,13,148,2
2020-06-26,Calaveras,009,45235,47,30,0,30,0
2020-06-26,Colusa,011,21464,63,17,0,17,0
2020-06-26,Contra Costa,013,1133247,3583,2676,3,2679,72
2020-06-26,Del Norte,015,27424,57,47,0,47,0
2020-06-26,El Dorado,017,186661,262,159,2,161,0
2020-06-26,Fresno,019,978130,8837,4166,71,4237,74
2020-06-26,Glenn,021,27897,137,71,0,71,0
2020-06-26,Humboldt,023,135768,152,126,0,126,3
2020-06-26,Imperial,025,180216,7753,5400,4,5404,44
2020-06-26,Inyo,027,18085,32,29,0,29,1
2020-06-26,Kern,029,883053,7798,4366,28,4394,70
2020-06-26,Kings,031,150075,2626,2176,4,2180,18
2020-06-26,Lake,033,64148,80,42,0,42,0
2020-06-26,Lassen,035,31185,239,30,2,32,0
2020-06-26,Los Angeles,037,10098052,111290,93328,34,93362,3275
2020-06-26,Madera,039,155013,832,409,2,411,4
2020-06-26,Marin,041,260295,2572,1406,4,1410,17
2020-06-26,Mariposa,043,17540,30,21,0,21,1
2020-06-26,Mendocino,045,87422,82,63,0,63,0
2020-06-26,Merced,047,269075,1530,797,1,798,10
2020-06-26,Modoc,049,8938,1,0,0,0,0
2020-06-26,Mono,051,14174,45,35,0,35,1
2020-06-26,Monterey,053,433212,2014,1449,3,1452,12
2020-06-26,Napa,055,140530,410,277,0,277,3
2020-06-26,Nevada,057,99092,136,101,1,102,1
2020-06-26,Orange,059,3164182,21013,12659,173,12832,320
2020-06-26,Placer,061,380077,880,584,3,587,10
2020-06-26,Plumas,063,18699,11,6,0,6,0
2020-06-26,Riverside,065,2383286,22180,15858,25,15883,430
2020-06-26,Sacramento,067,1510023,3797,2687,6,2693,63
2020-06-26,San Benito,069,59416,263,176,0,176,2
2020-06-26,San Bernardino,071,2135413,17400,11111,9,11120,243
2020-06-26,San Diego,073,3302833,16127,12402,2,12404,358
2020-06-26,San Francisco,075,870044,3847,3330,1,3331,49
2020-06-26,San Joaquin,077,732212,4554,2943,3,2946,52
2020-06-26,San Luis Obispo,079,281455,780,498,6,504,1
2020-06-26,San Mateo,081,765935,3497,3055,5,3060,83
2020-06-26,Santa Barbara,083,443738,3462,2784,26,2810,25
2020-06-26,Santa Clara,085,1922200,5517,3968,17,3985,156
2020-06-26,Santa Cruz,087,273765,430,344,0,344,2
2020-06-26,Shasta,089,179085,186,86,0,86,5
2020-06-26,Sierra,091,2930,1,1,0,1,0
2020-06-26,Siskiyou,093,43540,34,24,0,24,0
2020-06-26,Solano,095,438530,1677,1068,7,1075,21
2020-06-26,Sonoma,097,501317,1361,977,5,982,5
2020-06-26,Stanislaus,099,539301,3641,2157,6,2163,36
2020-06-26,Sutter,101,95872,184,138,0,138,2
2020-06-26,Tehama,103,63373,87,63,2,65,1
2020-06-26,Trinity,105,12862,17,2,4,6,0
2020-06-26,Tulare,107,460477,5177,3720,10,3730,117
2020-06-26,Tuolumne,109,53932,39,10,2,12,0
2020-06-26,Ventura,111,848112,4058,2444,16,2460,40
2020-06-26,Yolo,113,214977,640,418,3,421,24
2020-06-26,Yuba,115,75493,75,38,0,38,1
2020-06-25,Alameda,001,1643700,6509,5398,7,5405,130
2020-06-25,Alpine,003,1148,1,1,0,1,0
2020-06-25,Amador,005,37829,25,18,0,18,0
2020-06-25,Butte,007,227075,240,127,13,140,1
2020-06-25,Calaveras,009,45235,42,26,0,26,0
2020-06-25,Colusa,011,21464,53,14,0,14,0
2020-06-25,Contra Costa,013,1133247,3398,2591,3,2594,71
2020-06-25,Del Norte,015,27424,55,47,0,47,0
2020-06-25,El Dorado,017,186661,254,150,2,152,0
2020-06-25,Fresno,019,978130,8524,3938,70,4008,71
2020-06-25,Glenn,021,27897,132,59,0,59,0
2020-06-25,Humboldt,023,135768,151,121,0,121,3
2020-06-25,Imperial,025,180216,7624,5192,4,5196,44
2020-06-25,Inyo,027,18085,29,27,0,27,1
2020-06-25,Kern,029,883053,7374,4236,25,4261,69
2020-06-25,Kings,031,150075,2574,2110,4,2114,17
2020-06-25,Lake,033,64148,79,42,0,42,0
2020-06-25,Lassen,035,31185,233,13,2,15,0
2020-06-25,Los Angeles,037,10098052,108522,91524,34,91558,3239
2020-06-25,Madera,039,155013,788,380,2,382,4
2020-06-25,Marin,041,260295,2470,1321,4,1325,17
2020-06-25,Mariposa,043,17540,29,20,0,20,1
2020-06-25,Mendocino,045,87422,79,61,0,61,0
2020-06-25,Merced,047,269075,1442,747,1,748,10
2020-06-25,Modoc,049,8938,1,0,0,0,0
2020-06-25,Mono,051,14174,44,35,0,35,1
2020-06-25,Monterey,053,433212,1926,1426,3,1429,12
2020-06-25,Napa,055,140530,392,260,0,260,3
2020-06-25,Nevada,057,99092,128,92,1,93,1
2020-06-25,Orange,059,3164182,20087,12221,171,12392,311
2020-06-25,Placer,061,380077,826,574,3,577,10
2020-06-25,Plumas,063,18699,10,6,0,6,0
2020-06-25,Riverside,065,2383286,21425,15224,25,15249,427
2020-06-25,Sacramento,067,1510023,3574,2519,6,2525,62
2020-06-25,San Benito,069,59416,255,174,0,174,2
2020-06-25,San Bernardino,071,2135413,16649,10590,9,10599,242
2020-06-25,San Diego,073,3302833,15588,11963,2,11965,352
2020-06-25,San Francisco,075,870044,3781,3252,1,3253,48
2020-06-25,San Joaquin,077,732212,4282,2803,3,2806,50
2020-06-25,San Luis Obispo,079,281455,748,473,6,479,1
2020-06-25,San Mateo,081,765935,3429,2996,4,3000,82
2020-06-25,Santa Barbara,083,443738,3357,2622,25,2647,25
2020-06-25,Santa Clara,085,1922200,5367,3871,17,3888,156
2020-06-25,Santa Cruz,087,273765,418,335,0,335,2
2020-06-25,Shasta,089,179085,176,84,0,84,5
2020-06-25,Sierra,091,2930,1,1,0,1,0
2020-06-25,Siskiyou,093,43540,33,24,0,24,0
2020-06-25,Solano,095,438530,1624,1034,7,1041,21
2020-06-25,Sonoma,097,501317,1312,953,4,957,5
2020-06-25,Stanislaus,099,539301,3429,2130,6,2136,36
2020-06-25,Sutter,101,95872,172,126,0,126,2
2020-06-25,Tehama,103,63373,83,59,2,61,1
2020-06-25,Trinity,105,12862,17,2,4,6,0
2020-06-25,Tulare,107,460477,5046,3656,10,3666,117
2020-06-25,Tuolumne,109,53932,38,10,1,11,0
2020-06-25,Ventura,111,848112,3876,2346,15,2361,40
2020-06-25,Yolo,113,214977,611,397,3,400,24
2020-06-25,Yuba,115,75493,64,38,0,38,1
2020-06-24,Alameda,001,1643700,6347,5242,7,5249,123
2020-06-24,Alpine,003,1148,1,1,0,1,0
2020-06-24,Amador,005,37829,23,16,0,16,0
2020-06-24,Butte,007,227075,224,119,12,131,1
2020-06-24,Calaveras,009,45235,40,26,0,26,0
2020-06-24,Colusa,011,21464,44,11,0,11,0
2020-06-24,Contra Costa,013,1133247,3243,2520,3,2523,66
2020-06-24,Del Norte,015,27424,49,47,0,47,0
2020-06-24,El Dorado,017,186661,238,149,2,151,0
2020-06-24,Fresno,019,978130,8193,3765,70,3835,71
2020-06-24,Glenn,021,27897,124,54,0,54,0
2020-06-24,Humboldt,023,135768,151,117,0,117,3
2020-06-24,Imperial,025,180216,7506,5138,4,5142,38
2020-06-24,Inyo,027,18085,29,28,0,28,1
2020-06-24,Kern,029,883053,6981,4155,23,4178,67
2020-06-24,Kings,031,150075,2510,2063,4,2067,16
2020-06-24,Lake,033,64148,66,40,0,40,0
2020-06-24,Lassen,035,31185,232,9,2,11,0
2020-06-24,Los Angeles,037,10098052,105761,89566,34,89600,3186
2020-06-24,Madera,039,155013,766,373,2,375,4
2020-06-24,Marin,041,260295,2242,1261,4,1265,17
2020-06-24,Mariposa,043,17540,28,19,0,19,1
2020-06-24,Mendocino,045,87422,79,60,0,60,0
2020-06-24,Merced,047,269075,1355,696,1,697,8
2020-06-24,Modoc,049,8938,1,0,0,0,0
2020-06-24,Mono,051,14174,42,35,0,35,1
2020-06-24,Monterey,053,433212,1850,1407,3,1410,12
2020-06-24,Napa,055,140530,375,258,0,258,3
2020-06-24,Nevada,057,99092,122,92,1,93,1
2020-06-24,Orange,059,3164182,19089,11804,153,11957,303
2020-06-24,Placer,061,380077,787,548,3,551,10
2020-06-24,Plumas,063,18699,10,6,0,6,0
2020-06-24,Riverside,065,2383286,20577,14946,25,14971,410
2020-06-24,Sacramento,067,1510023,3370,2446,5,2451,62
2020-06-24,San Benito,069,59416,251,171,0,171,2
2020-06-24,San Bernardino,071,2135413,15835,10211,9,10220,239
2020-06-24,San Diego,073,3302833,15085,11628,2,11630,347
2020-06-24,San Francisco,075,870044,3718,3216,1,3217,48
2020-06-24,San Joaquin,077,732212,4061,2680,3,2683,49
2020-06-24,San Luis Obispo,079,281455,717,461,5,466,1
2020-06-24,San Mateo,081,765935,3372,2964,4,2968,82
2020-06-24,Santa Barbara,083,443738,3238,2569,23,2592,22
2020-06-24,Santa Clara,085,1922200,5236,3812,17,3829,155
2020-06-24,Santa Cruz,087,273765,406,329,0,329,2
2020-06-24,Shasta,089,179085,168,83,0,83,5
2020-06-24,Sierra,091,2930,1,1,0,1,0
2020-06-24,Siskiyou,093,43540,32,24,0,24,0
2020-06-24,Solano,095,438530,1535,979,6,985,21
2020-06-24,Sonoma,097,501317,1263,933,4,937,4
2020-06-24,Stanislaus,099,539301,3250,2039,6,2045,36
2020-06-24,Sutter,101,95872,159,118,0,118,2
2020-06-24,Tehama,103,63373,81,55,2,57,1
2020-06-24,Trinity,105,12862,16,2,3,5,0
2020-06-24,Tulare,107,460477,4891,3541,10,3551,116
2020-06-24,Tuolumne,109,53932,33,9,1,10,0
2020-06-24,Ventura,111,848112,3535,2314,15,2329,42
2020-06-24,Yolo,113,214977,576,376,3,379,24
2020-06-24,Yuba,115,75493,58,37,0,37,1
2020-06-23,Alameda,001,1643700,6167,5159,7,5166,121
2020-06-23,Alpine,003,1148,1,1,0,1,0
2020-06-23,Amador,005,37829,22,13,0,13,0
2020-06-23,Butte,007,227075,206,111,12,123,1
2020-06-23,Calaveras,009,45235,40,26,0,26,0
2020-06-23,Colusa,011,21464,40,7,0,7,0
2020-06-23,Contra Costa,013,1133247,3116,2453,3,2456,60
2020-06-23,Del Norte,015,27424,48,46,0,46,0
2020-06-23,El Dorado,017,186661,229,142,2,144,0
2020-06-23,Fresno,019,978130,7543,3569,68,3637,67
2020-06-23,Glenn,021,27897,120,47,0,47,0
2020-06-23,Humboldt,023,135768,151,110,0,110,3
2020-06-23,Imperial,025,180216,7342,5025,4,5029,38
2020-06-23,Inyo,027,18085,29,26,0,26,1
2020-06-23,Kern,029,883053,6614,4087,20,4107,64
2020-06-23,Kings,031,150075,2445,1727,4,1731,16
2020-06-23,Lake,033,64148,60,40,0,40,0
2020-06-23,Lassen,035,31185,228,9,2,11,0
2020-06-23,Los Angeles,037,10098052,102817,88433,33,88466,3152
2020-06-23,Madera,039,155013,727,369,2,371,4
2020-06-23,Marin,041,260295,1974,1139,4,1143,17
2020-06-23,Mariposa,043,17540,26,18,0,18,1
2020-06-23,Mendocino,045,87422,78,61,0,61,0
2020-06-23,Merced,047,269075,1258,656,1,657,8
2020-06-23,Modoc,049,8938,1,0,0,0,0
2020-06-23,Mono,051,14174,42,35,0,35,1
2020-06-23,Monterey,053,433212,1780,1346,3,1349,12
2020-06-23,Napa,055,140530,360,230,0,230,3
2020-06-23,Nevada,057,99092,116,81,1,82,1
2020-06-23,Orange,059,3164182,18112,11071,150,11221,278
2020-06-23,Placer,061,380077,761,525,3,528,10
2020-06-23,Plumas,063,18699,9,6,0,6,0
2020-06-23,Riverside,065,2383286,19558,14469,25,14494,406
2020-06-23,Sacramento,067,1510023,3191,2374,5,2379,62
2020-06-23,San Benito,069,59416,237,167,0,167,2
2020-06-23,San Bernardino,071,2135413,15053,9771,9,9780,229
2020-06-23,San Diego,073,3302833,14565,11296,2,11298,341
2020-06-23,San Francisco,075,870044,3645,3177,1,3178,48
2020-06-23,San Joaquin,077,732212,3802,2502,3,2505,48
2020-06-23,San Luis Obispo,079,281455,686,445,5,450,1
2020-06-23,San Mateo,081,765935,3307,2907,4,2911,81
2020-06-23,Santa Barbara,083,443738,3143,2498,23,2521,22
2020-06-23,Santa Clara,085,1922200,5091,3700,17,3717,155
2020-06-23,Santa Cruz,087,273765,396,313,0,313,2
2020-06-23,Shasta,089,179085,159,81,0,81,5
2020-06-23,Sierra,091,2930,1,1,0,1,0
2020-06-23,Siskiyou,093,43540,30,24,0,24,0
2020-06-23,Solano,095,438530,1478,941,5,946,21
2020-06-23,Sonoma,097,501317,1210,912,4,916,4
2020-06-23,Stanislaus,099,539301,3073,1850,6,1856,35
2020-06-23,Sutter,101,95872,149,112,0,112,2
2020-06-23,Tehama,103,63373,79,50,2,52,1
2020-06-23,Trinity,105,12862,16,2,3,5,0
2020-06-23,Tulare,107,460477,4769,3456,10,3466,111
2020-06-23,Tuolumne,109,53932,28,9,0,9,0
2020-06-23,Ventura,111,848112,3375,2209,14,2223,40
2020-06-23,Yolo,113,214977,549,350,0,350,24
2020-06-23,Yuba,115,75493,55,35,0,35,1
2020-06-22,Alameda,001,1643700,6016,4944,7,4951,121
2020-06-22,Alpine,003,1148,1,1,0,1,0
2020-06-22,Amador,005,37829,19,12,0,12,0
2020-06-22,Butte,007,227075,187,104,12,116,1
2020-06-22,Calaveras,009,45235,38,20,0,20,0
2020-06-22,Colusa,011,21464,37,7,0,7,0
2020-06-22,Contra Costa,013,1133247,2975,2363,3,2366,60
2020-06-22,Del Norte,015,27424,48,46,0,46,0
2020-06-22,El Dorado,017,186661,220,137,2,139,0
2020-06-22,Fresno,019,978130,7012,3425,68,3493,67
2020-06-22,Glenn,021,27897,111,40,0,40,0
2020-06-22,Humboldt,023,135768,148,110,0,110,3
2020-06-22,Imperial,025,180216,7185,4700,4,4704,38
2020-06-22,Inyo,027,18085,29,26,0,26,1
2020-06-22,Kern,029,883053,6262,3982,18,4000,60
2020-06-22,Kings,031,150075,2396,1513,4,1517,13
2020-06-22,Lake,033,64148,54,37,0,37,0
2020-06-22,Lassen,035,31185,118,7,2,9,0
2020-06-22,Los Angeles,037,10098052,99916,85925,32,85957,3117
2020-06-22,Madera,039,155013,702,333,2,335,4
2020-06-22,Marin,041,260295,1717,1029,4,1033,17
2020-06-22,Mariposa,043,17540,25,18,0,18,1
2020-06-22,Mendocino,045,87422,73,48,0,48,0
2020-06-22,Merced,047,269075,1171,619,1,620,8
2020-06-22,Modoc,049,8938,1,0,0,0,0
2020-06-22,Mono,051,14174,42,34,0,34,1
2020-06-22,Monterey,053,433212,1719,1293,3,1296,12
2020-06-22,Napa,055,140530,336,222,0,222,3
2020-06-22,Nevada,057,99092,111,79,1,80,1
2020-06-22,Orange,059,3164182,17176,10711,147,10858,275
2020-06-22,Placer,061,380077,735,512,3,515,9
2020-06-22,Plumas,063,18699,7,6,0,6,0
2020-06-22,Riverside,065,2383286,18586,13948,25,13973,403
2020-06-22,Sacramento,067,1510023,2975,2243,4,2247,62
2020-06-22,San Benito,069,59416,228,164,0,164,2
2020-06-22,San Bernardino,071,2135413,14280,9133,9,9142,229
2020-06-22,San Diego,073,3302833,14073,11098,2,11100,338
2020-06-22,San Francisco,075,870044,3552,3000,1,3001,47
2020-06-22,San Joaquin,077,732212,3554,2332,3,2335,48
2020-06-22,San Luis Obispo,079,281455,653,422,5,427,1
2020-06-22,San Mateo,081,765935,3233,2813,3,2816,81
2020-06-22,Santa Barbara,083,443738,3051,2447,23,2470,21
2020-06-22,Santa Clara,085,1922200,4929,3580,17,3597,155
2020-06-22,Santa Cruz,087,273765,383,290,0,290,3
2020-06-22,Shasta,089,179085,156,77,0,77,5
2020-06-22,Sierra,091,2930,1,1,0,1,0
2020-06-22,Siskiyou,093,43540,30,23,0,23,0
2020-06-22,Solano,095,438530,1400,784,4,788,21
2020-06-22,Sonoma,097,501317,1166,860,2,862,4
2020-06-22,Stanislaus,099,539301,2888,1784,6,1790,35
2020-06-22,Sutter,101,95872,140,100,0,100,2
2020-06-22,Tehama,103,63373,75,38,2,40,1
2020-06-22,Trinity,105,12862,16,2,3,5,0
2020-06-22,Tulare,107,460477,4632,3185,10,3195,111
2020-06-22,Tuolumne,109,53932,19,8,0,8,0
2020-06-22,Ventura,111,848112,3227,2065,14,2079,39
2020-06-22,Yolo,113,214977,523,333,0,333,24
2020-06-22,Yuba,115,75493,50,36,0,36,1
2020-06-21,Alameda,001,1643700,5822,4835,7,4842,121
2020-06-21,Alpine,003,1148,1,1,0,1,0
2020-06-21,Amador,005,37829,14,12,0,12,0
2020-06-21,Butte,007,227075,173,97,12,109,1
2020-06-21,Calaveras,009,45235,38,20,0,20,0
2020-06-21,Colusa,011,21464,29,7,0,7,0
2020-06-21,Contra Costa,013,1133247,2848,2282,3,2285,60
2020-06-21,Del Norte,015,27424,47,46,0,46,0
2020-06-21,El Dorado,017,186661,211,132,2,134,0
2020-06-21,Fresno,019,978130,6441,3296,67,3363,67
2020-06-21,Glenn,021,27897,102,40,0,40,0
2020-06-21,Humboldt,023,135768,143,108,0,108,3
2020-06-21,Imperial,025,180216,7002,4701,4,4705,38
2020-06-21,Inyo,027,18085,27,26,0,26,1
2020-06-21,Kern,029,883053,5970,3918,16,3934,60
2020-06-21,Kings,031,150075,2332,1334,4,1338,11
2020-06-21,Lake,033,64148,49,36,0,36,0
2020-06-21,Lassen,035,31185,25,7,2,9,0
2020-06-21,Los Angeles,037,10098052,97025,83383,31,83414,3101
2020-06-21,Madera,039,155013,668,319,2,321,4
2020-06-21,Marin,041,260295,1560,907,4,911,17
2020-06-21,Mariposa,043,17540,22,18,0,18,1
2020-06-21,Mendocino,045,87422,70,48,0,48,0
2020-06-21,Merced,047,269075,1076,577,1,578,8
2020-06-21,Modoc,049,8938,1,0,0,0,0
2020-06-21,Mono,051,14174,42,34,0,34,1
2020-06-21,Monterey,053,433212,1646,1227,3,1230,12
2020-06-21,Napa,055,140530,321,218,0,218,3
2020-06-21,Nevada,057,99092,108,79,1,80,1
2020-06-21,Orange,059,3164182,16338,10563,144,10707,275
2020-06-21,Placer,061,380077,695,498,3,501,9
2020-06-21,Plumas,063,18699,7,6,0,6,0
2020-06-21,Riverside,065,2383286,17879,13528,24,13552,402
2020-06-21,Sacramento,067,1510023,2774,2156,3,2159,62
2020-06-21,San Benito,069,59416,214,151,0,151,2
2020-06-21,San Bernardino,071,2135413,13505,8925,8,8933,229
2020-06-21,San Diego,073,3302833,13527,10796,2,10798,338
2020-06-21,San Francisco,075,870044,3446,3000,1,3001,47
2020-06-21,San Joaquin,077,732212,3318,2188,3,2191,48
2020-06-21,San Luis Obispo,079,281455,627,418,5,423,1
2020-06-21,San Mateo,081,765935,3175,2781,3,2784,81
2020-06-21,Santa Barbara,083,443738,2944,2430,22,2452,21
2020-06-21,Santa Clara,085,1922200,4792,3514,17,3531,154
2020-06-21,Santa Cruz,087,273765,373,290,0,290,3
2020-06-21,Shasta,089,179085,146,75,0,75,5
2020-06-21,Sierra,091,2930,1,1,0,1,0
2020-06-21,Siskiyou,093,43540,30,23,0,23,0
2020-06-21,Solano,095,438530,1300,783,4,787,21
2020-06-21,Sonoma,097,501317,1116,836,2,838,4
2020-06-21,Stanislaus,099,539301,2702,1688,6,1694,35
2020-06-21,Sutter,101,95872,132,96,0,96,2
2020-06-21,Tehama,103,63373,64,35,2,37,1
2020-06-21,Trinity,105,12862,15,2,3,5,0
2020-06-21,Tulare,107,460477,4463,3173,10,3183,111
2020-06-21,Tuolumne,109,53932,17,8,0,8,0
2020-06-21,Ventura,111,848112,3049,2021,14,2035,39
2020-06-21,Yolo,113,214977,491,323,0,323,24
2020-06-21,Yuba,115,75493,46,35,0,35,1
2020-06-20,Alameda,001,1643700,5760,4758,7,4765,119
2020-06-20,Alpine,003,1148,1,1,0,1,0
2020-06-20,Amador,005,37829,14,12,0,12,0
2020-06-20,Butte,007,227075,166,94,12,106,1
2020-06-20,Calaveras,009,45235,38,20,0,20,0
2020-06-20,Colusa,011,21464,26,7,0,7,0
2020-06-20,Contra Costa,013,1133247,2789,2231,3,2234,54
2020-06-20,Del Norte,015,27424,47,46,0,46,0
2020-06-20,El Dorado,017,186661,206,130,2,132,0
2020-06-20,Fresno,019,978130,6315,3222,64,3286,67
2020-06-20,Glenn,021,27897,97,40,0,40,0
2020-06-20,Humboldt,023,135768,143,108,0,108,3
2020-06-20,Imperial,025,180216,6922,4616,4,4620,37
2020-06-20,Inyo,027,18085,27,26,0,26,1
2020-06-20,Kern,029,883053,5805,3836,16,3852,59
2020-06-20,Kings,031,150075,2308,1331,4,1335,9
2020-06-20,Lake,033,64148,49,37,0,37,0
2020-06-20,Lassen,035,31185,24,7,2,9,0
2020-06-20,Los Angeles,037,10098052,95451,81604,30,81634,3093
2020-06-20,Madera,039,155013,635,321,2,323,4
2020-06-20,Marin,041,260295,1540,879,4,883,17
2020-06-20,Mariposa,043,17540,22,18,0,18,1
2020-06-20,Mendocino,045,87422,69,48,0,48,0
2020-06-20,Merced,047,269075,1038,566,1,567,8
2020-06-20,Modoc,049,8938,1,0,0,0,0
2020-06-20,Mono,051,14174,42,34,0,34,1
2020-06-20,Monterey,053,433212,1610,1181,3,1184,12
2020-06-20,Napa,055,140530,312,212,0,212,3
2020-06-20,Nevada,057,99092,105,73,1,74,1
2020-06-20,Orange,059,3164182,15987,10284,140,10424,273
2020-06-20,Placer,061,380077,670,483,3,486,9
2020-06-20,Plumas,063,18699,6,6,0,6,0
2020-06-20,Riverside,065,2383286,17579,13021,24,13045,402
2020-06-20,Sacramento,067,1510023,2703,2069,3,2072,63
2020-06-20,San Benito,069,59416,210,139,0,139,2
2020-06-20,San Bernardino,071,2135413,13141,8718,8,8726,229
2020-06-20,San Diego,073,3302833,13204,10486,2,10488,338
2020-06-20,San Francisco,075,870044,3402,2999,1,3000,47
2020-06-20,San Joaquin,077,732212,3236,2046,3,2049,48
2020-06-20,San Luis Obispo,079,281455,613,405,5,410,1
2020-06-20,San Mateo,081,765935,3127,2755,3,2758,81
2020-06-20,Santa Barbara,083,443738,2887,2358,21,2379,21
2020-06-20,Santa Clara,085,1922200,4718,3435,17,3452,154
2020-06-20,Santa Cruz,087,273765,371,287,0,287,3
2020-06-20,Shasta,089,179085,140,66,0,66,5
2020-06-20,Sierra,091,2930,1,1,0,1,0
2020-06-20,Siskiyou,093,43540,29,22,0,22,0
2020-06-20,Solano,095,438530,1276,784,4,788,21
2020-06-20,Sonoma,097,501317,1080,806,2,808,4
2020-06-20,Stanislaus,099,539301,2594,1598,6,1604,35
2020-06-20,Sutter,101,95872,130,89,0,89,2
2020-06-20,Tehama,103,63373,62,35,2,37,1
2020-06-20,Trinity,105,12862,15,2,3,5,0
2020-06-20,Tulare,107,460477,4390,3172,10,3182,111
2020-06-20,Tuolumne,109,53932,14,8,0,8,0
2020-06-20,Ventura,111,848112,2983,1946,14,1960,37
2020-06-20,Yolo,113,214977,475,309,0,309,24
2020-06-20,Yuba,115,75493,44,34,0,34,1
2020-06-19,Alameda,001,1643700,5687,4646,7,4653,119
2020-06-19,Alpine,003,1148,1,1,0,1,0
2020-06-19,Amador,005,37829,14,12,0,12,0
2020-06-19,Butte,007,227075,161,91,12,103,1
2020-06-19,Calaveras,009,45235,37,20,0,20,0
2020-06-19,Colusa,011,21464,24,7,0,7,0
2020-06-19,Contra Costa,013,1133247,2709,2106,3,2109,54
2020-06-19,Del Norte,015,27424,47,46,0,46,0
2020-06-19,El Dorado,017,186661,198,124,2,126,0
2020-06-19,Fresno,019,978130,6152,3109,63,3172,61
2020-06-19,Glenn,021,27897,91,40,0,40,0
2020-06-19,Humboldt,023,135768,141,106,0,106,3
2020-06-19,Imperial,025,180216,6830,4504,4,4508,36
2020-06-19,Inyo,027,18085,27,26,0,26,1
2020-06-19,Kern,029,883053,5582,3742,15,3757,57
2020-06-19,Kings,031,150075,2287,1285,4,1289,9
2020-06-19,Lake,033,64148,46,36,0,36,0
2020-06-19,Lassen,035,31185,23,7,2,9,0
2020-06-19,Los Angeles,037,10098052,93462,79572,29,79601,3047
2020-06-19,Madera,039,155013,616,300,2,302,4
2020-06-19,Marin,041,260295,1511,829,4,833,17
2020-06-19,Mariposa,043,17540,21,18,0,18,1
2020-06-19,Mendocino,045,87422,68,48,0,48,0
2020-06-19,Merced,047,269075,993,529,1,530,8
2020-06-19,Modoc,049,8938,1,0,0,0,0
2020-06-19,Mono,051,14174,42,34,0,34,1
2020-06-19,Monterey,053,433212,1581,1159,3,1162,12
2020-06-19,Napa,055,140530,302,209,0,209,3
2020-06-19,Nevada,057,99092,102,71,1,72,1
2020-06-19,Orange,059,3164182,15453,9972,133,10105,260
2020-06-19,Placer,061,380077,652,464,3,467,9
2020-06-19,Plumas,063,18699,6,5,0,5,0
2020-06-19,Riverside,065,2383286,17174,12710,24,12734,398
2020-06-19,Sacramento,067,1510023,2620,1976,3,1979,64
2020-06-19,San Benito,069,59416,209,136,0,136,2
2020-06-19,San Bernardino,071,2135413,12736,8454,7,8461,226
2020-06-19,San Diego,073,3302833,12841,10352,2,10354,332
2020-06-19,San Francisco,075,870044,3347,2968,1,2969,47
2020-06-19,San Joaquin,077,732212,3113,1969,3,1972,48
2020-06-19,San Luis Obispo,079,281455,597,392,5,397,1
2020-06-19,San Mateo,081,765935,3088,2713,3,2716,81
2020-06-19,Santa Barbara,083,443738,2814,2284,19,2303,21
2020-06-19,Santa Clara,085,1922200,4645,3376,17,3393,154
2020-06-19,Santa Cruz,087,273765,361,283,0,283,3
2020-06-19,Shasta,089,179085,137,58,0,58,5
2020-06-19,Sierra,091,2930,1,1,0,1,0
2020-06-19,Siskiyou,093,43540,29,21,0,21,0
2020-06-19,Solano,095,438530,1238,755,4,759,21
2020-06-19,Sonoma,097,501317,1053,803,2,805,4
2020-06-19,Stanislaus,099,539301,2484,1549,6,1555,35
2020-06-19,Sutter,101,95872,129,89,0,89,2
2020-06-19,Tehama,103,63373,61,35,2,37,1
2020-06-19,Trinity,105,12862,15,2,3,5,0
2020-06-19,Tulare,107,460477,4320,3053,10,3063,107
2020-06-19,Tuolumne,109,53932,13,8,0,8,0
2020-06-19,Ventura,111,848112,2899,1865,14,1879,37
2020-06-19,Yolo,113,214977,456,303,0,303,24
2020-06-19,Yuba,115,75493,43,33,0,33,1
2020-06-18,Alameda,001,1643700,5558,4589,7,4596,118
2020-06-18,Alpine,003,1148,1,1,0,1,0
2020-06-18,Amador,005,37829,13,12,0,12,0
2020-06-18,Butte,007,227075,156,88,12,100,1
2020-06-18,Calaveras,009,45235,37,20,0,20,0
2020-06-18,Colusa,011,21464,20,7,0,7,0
2020-06-18,Contra Costa,013,1133247,2602,2072,3,2075,53
2020-06-18,Del Norte,015,27424,47,46,0,46,0
2020-06-18,El Dorado,017,186661,194,121,2,123,0
2020-06-18,Fresno,019,978130,5886,2947,62,3009,57
2020-06-18,Glenn,021,27897,82,35,0,35,0
2020-06-18,Humboldt,023,135768,140,106,0,106,3
2020-06-18,Imperial,025,180216,6680,4366,4,4370,36
2020-06-18,Inyo,027,18085,26,25,0,25,1
2020-06-18,Kern,029,883053,5364,3634,14,3648,57
2020-06-18,Kings,031,150075,2228,1141,4,1145,8
2020-06-18,Lake,033,64148,45,36,0,36,0
2020-06-18,Lassen,035,31185,22,5,2,7,0
2020-06-18,Los Angeles,037,10098052,91192,78244,29,78273,3009
2020-06-18,Madera,039,155013,581,288,2,290,4
2020-06-18,Marin,041,260295,1448,819,4,823,17
2020-06-18,Mariposa,043,17540,19,18,0,18,1
2020-06-18,Mendocino,045,87422,64,45,0,45,0
2020-06-18,Merced,047,269075,942,486,1,487,7
2020-06-18,Modoc,049,8938,1,0,0,0,0
2020-06-18,Mono,051,14174,42,34,0,34,1
2020-06-18,Monterey,053,433212,1513,1127,3,1130,12
2020-06-18,Napa,055,140530,287,205,0,205,3
2020-06-18,Nevada,057,99092,98,68,1,69,1
2020-06-18,Orange,059,3164182,14796,9597,114,9711,255
2020-06-18,Placer,061,380077,629,457,3,460,9
2020-06-18,Plumas,063,18699,6,5,0,5,0
2020-06-18,Riverside,065,2383286,16557,12410,24,12434,392
2020-06-18,Sacramento,067,1510023,2504,1938,3,1941,63
2020-06-18,San Benito,069,59416,203,134,0,134,2
2020-06-18,San Bernardino,071,2135413,12096,8141,7,8148,226
2020-06-18,San Diego,073,3302833,12419,10094,2,10096,331
2020-06-18,San Francisco,075,870044,3298,2951,1,2952,47
2020-06-18,San Joaquin,077,732212,2961,1908,3,1911,47
2020-06-18,San Luis Obispo,079,281455,576,378,5,383,1
2020-06-18,San Mateo,081,765935,3049,2674,3,2677,78
2020-06-18,Santa Barbara,083,443738,2740,2201,19,2220,19
2020-06-18,Santa Clara,085,1922200,4542,3338,17,3355,152
2020-06-18,Santa Cruz,087,273765,344,275,0,275,3
2020-06-18,Shasta,089,179085,126,51,0,51,4
2020-06-18,Sierra,091,2930,1,1,0,1,0
2020-06-18,Siskiyou,093,43540,29,18,0,18,0
2020-06-18,Solano,095,438530,1200,735,4,739,21
2020-06-18,Sonoma,097,501317,1011,789,2,791,4
2020-06-18,Stanislaus,099,539301,2351,1495,6,1501,35
2020-06-18,Sutter,101,95872,125,85,0,85,2
2020-06-18,Tehama,103,63373,56,31,2,33,1
2020-06-18,Trinity,105,12862,15,2,3,5,0
2020-06-18,Tulare,107,460477,4197,3005,10,3015,107
2020-06-18,Tuolumne,109,53932,12,8,0,8,0
2020-06-18,Ventura,111,848112,2773,1781,14,1795,37
2020-06-18,Yolo,113,214977,423,294,0,294,24
2020-06-18,Yuba,115,75493,42,32,0,32,1
2020-06-17,Alameda,001,1643700,5435,4485,7,4492,117
2020-06-17,Alpine,003,1148,1,1,0,1,0
2020-06-17,Amador,005,37829,12,10,0,10,0
2020-06-17,Butte,007,227075,147,81,12,93,1
2020-06-17,Calaveras,009,45235,37,20,0,20,0
2020-06-17,Colusa,011,21464,19,7,0,7,0
2020-06-17,Contra Costa,013,1133247,2505,2020,3,2023,45
2020-06-17,Del Norte,015,27424,47,45,0,45,0
2020-06-17,El Dorado,017,186661,187,116,2,118,0
2020-06-17,Fresno,019,978130,5660,2801,61,2862,56
2020-06-17,Glenn,021,27897,75,31,0,31,0
2020-06-17,Humboldt,023,135768,138,105,0,105,3
2020-06-17,Imperial,025,180216,6506,4108,4,4112,36
2020-06-17,Inyo,027,18085,25,25,0,25,1
2020-06-17,Kern,029,883053,5163,3547,14,3561,56
2020-06-17,Kings,031,150075,2198,1097,4,1101,7
2020-06-17,Lake,033,64148,44,32,0,32,0
2020-06-17,Lassen,035,31185,18,5,2,7,0
2020-06-17,Los Angeles,037,10098052,88884,77166,28,77194,2973
2020-06-17,Madera,039,155013,559,258,2,260,4
2020-06-17,Marin,041,260295,1256,771,3,774,17
2020-06-17,Mariposa,043,17540,18,18,0,18,1
2020-06-17,Mendocino,045,87422,62,42,0,42,0
2020-06-17,Merced,047,269075,869,460,1,461,7
2020-06-17,Modoc,049,8938,1,0,0,0,0
2020-06-17,Mono,051,14174,42,34,0,34,1
2020-06-17,Monterey,053,433212,1461,1077,3,1080,12
2020-06-17,Napa,055,140530,272,202,0,202,3
2020-06-17,Nevada,057,99092,94,57,1,58,1
2020-06-17,Orange,059,3164182,14185,9278,108,9386,230
2020-06-17,Placer,061,380077,609,427,3,430,9
2020-06-17,Plumas,063,18699,6,5,0,5,0
2020-06-17,Riverside,065,2383286,15921,11859,24,11883,370
2020-06-17,Sacramento,067,1510023,2397,1889,3,1892,63
2020-06-17,San Benito,069,59416,198,116,0,116,2
2020-06-17,San Bernardino,071,2135413,11547,7670,7,7677,225
2020-06-17,San Diego,073,3302833,12040,9856,2,9858,327
2020-06-17,San Francisco,075,870044,3259,2906,1,2907,46
2020-06-17,San Joaquin,077,732212,2788,1825,3,1828,46
2020-06-17,San Luis Obispo,079,281455,557,362,5,367,1
2020-06-17,San Mateo,081,765935,3002,2649,3,2652,78
2020-06-17,Santa Barbara,083,443738,2668,2147,17,2164,19
2020-06-17,Santa Clara,085,1922200,4449,3264,16,3280,148
2020-06-17,Santa Cruz,087,273765,338,265,0,265,2
2020-06-17,Shasta,089,179085,124,51,0,51,4
2020-06-17,Sierra,091,2930,1,1,0,1,0
2020-06-17,Siskiyou,093,43540,28,16,0,16,0
2020-06-17,Solano,095,438530,1150,722,4,726,21
2020-06-17,Sonoma,097,501317,986,748,2,750,4
2020-06-17,Stanislaus,099,539301,2227,1387,6,1393,35
2020-06-17,Sutter,101,95872,119,79,0,79,2
2020-06-17,Tehama,103,63373,41,24,2,26,1
2020-06-17,Trinity,105,12862,14,2,3,5,0
2020-06-17,Tulare,107,460477,4087,2882,10,2892,106
2020-06-17,Tuolumne,109,53932,12,7,0,7,0
2020-06-17,Ventura,111,848112,2673,1729,14,1743,37
2020-06-17,Yolo,113,214977,403,277,0,277,24
2020-06-17,Yuba,115,75493,41,30,0,30,1
2020-06-16,Alameda,001,1643700,5317,4428,7,4435,113
2020-06-16,Alpine,003,1148,1,1,0,1,0
2020-06-16,Amador,005,37829,12,10,0,10,0
2020-06-16,Butte,007,227075,143,79,12,91,1
2020-06-16,Calaveras,009,45235,34,19,0,19,0
2020-06-16,Colusa,011,21464,16,7,0,7,0
2020-06-16,Contra Costa,013,1133247,2413,1971,2,1973,45
2020-06-16,Del Norte,015,27424,47,45,0,45,0
2020-06-16,El Dorado,017,186661,181,115,2,117,0
2020-06-16,Fresno,019,978130,5421,2731,59,2790,50
2020-06-16,Glenn,021,27897,71,30,0,30,0
2020-06-16,Humboldt,023,135768,135,105,0,105,3
2020-06-16,Imperial,025,180216,6347,3939,4,3943,36
2020-06-16,Inyo,027,18085,25,24,0,24,1
2020-06-16,Kern,029,883053,4939,3496,14,3510,55
2020-06-16,Kings,031,150075,2152,1044,4,1048,6
2020-06-16,Lake,033,64148,44,31,0,31,0
2020-06-16,Lassen,035,31185,15,5,2,7,0
2020-06-16,Los Angeles,037,10098052,86562,75051,28,75079,2942
2020-06-16,Madera,039,155013,533,239,2,241,3
2020-06-16,Marin,041,260295,1203,725,3,728,17
2020-06-16,Mariposa,043,17540,18,17,0,17,1
2020-06-16,Mendocino,045,87422,61,35,0,35,0
2020-06-16,Merced,047,269075,822,436,1,437,7
2020-06-16,Modoc,049,8938,1,0,0,0,0
2020-06-16,Mono,051,14174,42,34,0,34,1
2020-06-16,Monterey,053,433212,1413,1019,3,1022,12
2020-06-16,Napa,055,140530,257,196,0,196,3
2020-06-16,Nevada,057,99092,91,53,1,54,1
2020-06-16,Orange,059,3164182,13600,9163,102,9265,223
2020-06-16,Placer,061,380077,577,392,3,395,9
2020-06-16,Plumas,063,18699,6,5,0,5,0
2020-06-16,Riverside,065,2383286,15246,11638,24,11662,364
2020-06-16,Sacramento,067,1510023,2287,1825,3,1828,60
2020-06-16,San Benito,069,59416,190,110,0,110,2
2020-06-16,San Bernardino,071,2135413,11003,7463,7,7470,225
2020-06-16,San Diego,073,3302833,11678,9732,1,9733,323
2020-06-16,San Francisco,075,870044,3208,2893,1,2894,46
2020-06-16,San Joaquin,077,732212,2635,1718,3,1721,47
2020-06-16,San Luis Obispo,079,281455,533,343,5,348,1
2020-06-16,San Mateo,081,765935,2948,2618,3,2621,77
2020-06-16,Santa Barbara,083,443738,2601,2090,17,2107,16
2020-06-16,Santa Clara,085,1922200,4338,3228,15,3243,148
2020-06-16,Santa Cruz,087,273765,322,257,0,257,2
2020-06-16,Shasta,089,179085,115,51,0,51,4
2020-06-16,Sierra,091,2930,1,1,0,1,0
2020-06-16,Siskiyou,093,43540,27,15,0,15,0
2020-06-16,Solano,095,438530,1060,694,4,698,19
2020-06-16,Sonoma,097,501317,954,739,2,741,4
2020-06-16,Stanislaus,099,539301,2073,1278,6,1284,36
2020-06-16,Sutter,101,95872,112,73,0,73,2
2020-06-16,Tehama,103,63373,37,24,2,26,1
2020-06-16,Trinity,105,12862,14,2,3,5,0
2020-06-16,Tulare,107,460477,3969,2802,10,2812,96
2020-06-16,Tuolumne,109,53932,12,7,0,7,0
2020-06-16,Ventura,111,848112,2573,1676,14,1690,37
2020-06-16,Yolo,113,214977,380,262,0,262,24
2020-06-16,Yuba,115,75493,39,29,0,29,1
2020-06-15,Alameda,001,1643700,5190,4323,7,4330,112
2020-06-15,Alpine,003,1148,1,1,0,1,0
2020-06-15,Amador,005,37829,12,10,0,10,0
2020-06-15,Butte,007,227075,135,78,12,90,1
2020-06-15,Calaveras,009,45235,34,18,0,18,0
2020-06-15,Colusa,011,21464,14,7,0,7,0
2020-06-15,Contra Costa,013,1133247,2337,1918,2,1920,43
2020-06-15,Del Norte,015,27424,47,45,0,45,0
2020-06-15,El Dorado,017,186661,171,114,2,116,0
2020-06-15,Fresno,019,978130,5209,2616,58,2674,48
2020-06-15,Glenn,021,27897,66,21,0,21,0
2020-06-15,Humboldt,023,135768,133,105,0,105,3
2020-06-15,Imperial,025,180216,6172,3726,4,3730,36
2020-06-15,Inyo,027,18085,25,23,0,23,1
2020-06-15,Kern,029,883053,4716,3417,14,3431,55
2020-06-15,Kings,031,150075,2076,1022,4,1026,6
2020-06-15,Lake,033,64148,44,31,0,31,0
2020-06-15,Lassen,035,31185,15,5,2,7,0
2020-06-15,Los Angeles,037,10098052,84375,73705,28,73733,2908
2020-06-15,Madera,039,155013,511,203,2,205,3
2020-06-15,Marin,041,260295,1036,708,3,711,17
2020-06-15,Mariposa,043,17540,18,17,0,17,1
2020-06-15,Mendocino,045,87422,52,33,0,33,0
2020-06-15,Merced,047,269075,775,414,1,415,7
2020-06-15,Modoc,049,8938,1,0,0,0,0
2020-06-15,Mono,051,14174,42,34,0,34,1
2020-06-15,Monterey,053,433212,1347,998,3,1001,12
2020-06-15,Napa,055,140530,249,187,0,187,3
2020-06-15,Nevada,057,99092,85,52,1,53,1
2020-06-15,Orange,059,3164182,13032,8944,94,9038,212
2020-06-15,Placer,061,380077,555,386,3,389,9
2020-06-15,Plumas,063,18699,6,4,0,4,0
2020-06-15,Riverside,065,2383286,14628,11376,23,11399,364
2020-06-15,Sacramento,067,1510023,2171,1791,3,1794,60
2020-06-15,San Benito,069,59416,184,108,0,108,2
2020-06-15,San Bernardino,071,2135413,10500,7189,7,7196,224
2020-06-15,San Diego,073,3302833,11338,9612,1,9613,320
2020-06-15,San Francisco,075,870044,3164,2833,1,2834,45
2020-06-15,San Joaquin,077,732212,2499,1667,3,1670,43
2020-06-15,San Luis Obispo,079,281455,518,332,5,337,1
2020-06-15,San Mateo,081,765935,2901,2591,3,2594,75
2020-06-15,Santa Barbara,083,443738,2533,2054,17,2071,16
2020-06-15,Santa Clara,085,1922200,4238,3204,15,3219,148
2020-06-15,Santa Cruz,087,273765,311,254,0,254,2
2020-06-15,Shasta,089,179085,109,50,0,50,4
2020-06-15,Sierra,091,2930,1,1,0,1,0
2020-06-15,Siskiyou,093,43540,26,14,0,14,0
2020-06-15,Solano,095,438530,1000,638,4,642,19
2020-06-15,Sonoma,097,501317,925,726,2,728,4
2020-06-15,Stanislaus,099,539301,1956,1253,6,1259,35
2020-06-15,Sutter,101,95872,102,71,0,71,2
2020-06-15,Tehama,103,63373,37,17,2,19,1
2020-06-15,Trinity,105,12862,13,2,3,5,0
2020-06-15,Tulare,107,460477,3855,2662,10,2672,96
2020-06-15,Tuolumne,109,53932,11,7,0,7,0
2020-06-15,Ventura,111,848112,2492,1656,14,1670,37
2020-06-15,Yolo,113,214977,360,255,0,255,24
2020-06-15,Yuba,115,75493,39,28,0,28,1
2020-06-14,Alameda,001,1643700,5043,4271,7,4278,112
2020-06-14,Alpine,003,1148,1,1,0,1,0
2020-06-14,Amador,005,37829,12,10,0,10,0
2020-06-14,Butte,007,227075,127,78,12,90,1
2020-06-14,Calaveras,009,45235,33,18,0,18,0
2020-06-14,Colusa,011,21464,13,7,0,7,0
2020-06-14,Contra Costa,013,1133247,2269,1893,2,1895,43
2020-06-14,Del Norte,015,27424,47,45,0,45,0
2020-06-14,El Dorado,017,186661,167,110,2,112,0
2020-06-14,Fresno,019,978130,5024,2585,57,2642,48
2020-06-14,Glenn,021,27897,51,21,0,21,0
2020-06-14,Humboldt,023,135768,129,105,0,105,3
2020-06-14,Imperial,025,180216,5941,3730,4,3734,36
2020-06-14,Inyo,027,18085,24,23,0,23,1
2020-06-14,Kern,029,883053,4505,3328,14,3342,55
2020-06-14,Kings,031,150075,2025,1022,3,1025,6
2020-06-14,Lake,033,64148,41,31,0,31,0
2020-06-14,Lassen,035,31185,15,5,2,7,0
2020-06-14,Los Angeles,037,10098052,82055,72932,26,72958,2887
2020-06-14,Madera,039,155013,492,203,2,205,3
2020-06-14,Marin,041,260295,871,689,2,691,17
2020-06-14,Mariposa,043,17540,18,16,0,16,1
2020-06-14,Mendocino,045,87422,49,33,0,33,0
2020-06-14,Merced,047,269075,723,403,1,404,7
2020-06-14,Modoc,049,8938,1,0,0,0,0
2020-06-14,Mono,051,14174,42,34,0,34,1
2020-06-14,Monterey,053,433212,1286,949,3,952,12
2020-06-14,Napa,055,140530,227,181,0,181,3
2020-06-14,Nevada,057,99092,81,52,1,53,1
2020-06-14,Orange,059,3164182,12601,8744,90,8834,211
2020-06-14,Placer,061,380077,529,369,3,372,9
2020-06-14,Plumas,063,18699,5,4,0,4,0
2020-06-14,Riverside,065,2383286,14185,11218,23,11241,364
2020-06-14,Sacramento,067,1510023,2084,1750,3,1753,60
2020-06-14,San Benito,069,59416,173,104,0,104,2
2020-06-14,San Bernardino,071,2135413,9961,7015,7,7022,224
2020-06-14,San Diego,073,3302833,10963,9442,1,9443,319
2020-06-14,San Francisco,075,870044,3124,2834,1,2835,45
2020-06-14,San Joaquin,077,732212,2348,1603,3,1606,43
2020-06-14,San Luis Obispo,079,281455,503,330,5,335,1
2020-06-14,San Mateo,081,765935,2843,2571,3,2574,75
2020-06-14,Santa Barbara,083,443738,2456,2049,17,2066,17
2020-06-14,Santa Clara,085,1922200,4143,3178,15,3193,148
2020-06-14,Santa Cruz,087,273765,297,254,0,254,2
2020-06-14,Shasta,089,179085,103,48,0,48,4
2020-06-14,Sierra,091,2930,1,1,0,1,0
2020-06-14,Siskiyou,093,43540,25,13,0,13,0
2020-06-14,Solano,095,438530,951,638,4,642,19
2020-06-14,Sonoma,097,501317,897,724,2,726,4
2020-06-14,Stanislaus,099,539301,1807,1159,6,1165,35
2020-06-14,Sutter,101,95872,97,63,0,63,2
2020-06-14,Tehama,103,63373,34,17,2,19,1
2020-06-14,Trinity,105,12862,13,2,3,5,0
2020-06-14,Tulare,107,460477,3721,2646,10,2656,96
2020-06-14,Tuolumne,109,53932,11,7,0,7,0
2020-06-14,Ventura,111,848112,2393,1610,13,1623,37
2020-06-14,Yolo,113,214977,344,254,0,254,24
2020-06-14,Yuba,115,75493,38,28,0,28,1
2020-06-13,Alameda,001,1643700,4979,4196,7,4203,112
2020-06-13,Alpine,003,1148,1,1,0,1,0
2020-06-13,Amador,005,37829,11,10,0,10,0
2020-06-13,Butte,007,227075,118,72,12,84,1
2020-06-13,Calaveras,009,45235,31,18,0,18,0
2020-06-13,Colusa,011,21464,12,7,0,7,0
2020-06-13,Contra Costa,013,1133247,2233,1868,2,1870,43
2020-06-13,Del Norte,015,27424,47,45,0,45,0
2020-06-13,El Dorado,017,186661,163,110,2,112,0
2020-06-13,Fresno,019,978130,4926,2499,57,2556,48
2020-06-13,Glenn,021,27897,49,21,0,21,0
2020-06-13,Humboldt,023,135768,128,104,0,104,3
2020-06-13,Imperial,025,180216,5868,3646,4,3650,36
2020-06-13,Inyo,027,18085,24,23,0,23,1
2020-06-13,Kern,029,883053,4396,3239,14,3253,55
2020-06-13,Kings,031,150075,2005,1023,3,1026,6
2020-06-13,Lake,033,64148,40,29,0,29,0
2020-06-13,Lassen,035,31185,15,5,2,7,0
2020-06-13,Los Angeles,037,10098052,81014,71938,26,71964,2874
2020-06-13,Madera,039,155013,488,203,2,205,3
2020-06-13,Marin,041,260295,840,677,2,679,17
2020-06-13,Mariposa,043,17540,18,16,0,16,1
2020-06-13,Mendocino,045,87422,49,33,0,33,0
2020-06-13,Merced,047,269075,704,376,1,377,7
2020-06-13,Modoc,049,8938,1,0,0,0,0
2020-06-13,Mono,051,14174,42,35,0,35,1
2020-06-13,Monterey,053,433212,1248,900,3,903,11
2020-06-13,Napa,055,140530,224,171,0,171,3
2020-06-13,Nevada,057,99092,79,52,1,53,1
2020-06-13,Orange,059,3164182,12356,8581,87,8668,211
2020-06-13,Placer,061,380077,512,346,3,349,9
2020-06-13,Plumas,063,18699,5,4,0,4,0
2020-06-13,Riverside,065,2383286,13906,10931,23,10954,364
2020-06-13,Sacramento,067,1510023,2029,1713,3,1716,60
2020-06-13,San Benito,069,59416,166,99,0,99,2
2020-06-13,San Bernardino,071,2135413,9738,6885,7,6892,224
2020-06-13,San Diego,073,3302833,10791,9316,1,9317,319
2020-06-13,San Francisco,075,870044,3104,2834,1,2835,44
2020-06-13,San Joaquin,077,732212,2267,1461,3,1464,43
2020-06-13,San Luis Obispo,079,281455,492,326,5,331,1
2020-06-13,San Mateo,081,765935,2820,2551,3,2554,75
2020-06-13,Santa Barbara,083,443738,2398,1999,17,2016,15
2020-06-13,Santa Clara,085,1922200,4100,3141,15,3156,148
2020-06-13,Santa Cruz,087,273765,291,254,0,254,2
2020-06-13,Shasta,089,179085,101,48,0,48,4
2020-06-13,Sierra,091,2930,1,1,0,1,0
2020-06-13,Siskiyou,093,43540,25,13,0,13,0
2020-06-13,Solano,095,438530,923,637,4,641,19
2020-06-13,Sonoma,097,501317,882,711,2,713,4
2020-06-13,Stanislaus,099,539301,1750,1122,6,1128,33
2020-06-13,Sutter,101,95872,96,62,0,62,2
2020-06-13,Tehama,103,63373,33,17,2,19,1
2020-06-13,Trinity,105,12862,13,2,3,5,0
2020-06-13,Tulare,107,460477,3689,2626,10,2636,96
2020-06-13,Tuolumne,109,53932,10,7,0,7,0
2020-06-13,Ventura,111,848112,2347,1567,13,1580,37
2020-06-13,Yolo,113,214977,324,251,0,251,24
2020-06-13,Yuba,115,75493,38,28,0,28,1
2020-06-12,Alameda,001,1643700,4906,4167,7,4174,109
2020-06-12,Alpine,003,1148,1,1,0,1,0
2020-06-12,Amador,005,37829,11,10,0,10,0
2020-06-12,Butte,007,227075,114,71,11,82,1
2020-06-12,Calaveras,009,45235,28,18,0,18,0
2020-06-12,Colusa,011,21464,12,7,0,7,0
2020-06-12,Contra Costa,013,1133247,2196,1827,2,1829,43
2020-06-12,Del Norte,015,27424,47,45,0,45,0
2020-06-12,El Dorado,017,186661,163,110,2,112,0
2020-06-12,Fresno,019,978130,4788,2428,57,2485,47
2020-06-12,Glenn,021,27897,46,21,0,21,0
2020-06-12,Humboldt,023,135768,126,105,0,105,3
2020-06-12,Imperial,025,180216,5784,3543,4,3547,36
2020-06-12,Inyo,027,18085,24,23,0,23,1
2020-06-12,Kern,029,883053,4279,3152,14,3166,54
2020-06-12,Kings,031,150075,1992,987,3,990,6
2020-06-12,Lake,033,64148,39,29,0,29,0
2020-06-12,Lassen,035,31185,15,5,2,7,0
2020-06-12,Los Angeles,037,10098052,79608,70385,26,70411,2814
2020-06-12,Madera,039,155013,463,187,2,189,3
2020-06-12,Marin,041,260295,837,649,2,651,17
2020-06-12,Mariposa,043,17540,18,16,0,16,1
2020-06-12,Mendocino,045,87422,49,33,0,33,0
2020-06-12,Merced,047,269075,673,372,1,373,7
2020-06-12,Modoc,049,8938,1,0,0,0,0
2020-06-12,Mono,051,14174,39,35,0,35,1
2020-06-12,Monterey,053,433212,1207,864,2,866,11
2020-06-12,Napa,055,140530,221,162,0,162,3
2020-06-12,Nevada,057,99092,73,52,1,53,1
2020-06-12,Orange,059,3164182,12050,8440,86,8526,203
2020-06-12,Placer,061,380077,495,333,3,336,9
2020-06-12,Plumas,063,18699,5,4,0,4,0
2020-06-12,Riverside,065,2383286,13569,10616,23,10639,364
2020-06-12,Sacramento,067,1510023,1974,1702,3,1705,60
2020-06-12,San Benito,069,59416,159,96,0,96,2
2020-06-12,San Bernardino,071,2135413,9469,6707,7,6714,223
2020-06-12,San Diego,073,3302833,10621,9132,1,9133,313
2020-06-12,San Francisco,075,870044,3070,2823,1,2824,44
2020-06-12,San Joaquin,077,732212,2187,1406,3,1409,43
2020-06-12,San Luis Obispo,079,281455,476,321,5,326,1
2020-06-12,San Mateo,081,765935,2785,2533,3,2536,75
2020-06-12,Santa Barbara,083,443738,2344,1969,17,1986,14
2020-06-12,Santa Clara,085,1922200,4056,3099,15,3114,149
2020-06-12,Santa Cruz,087,273765,283,251,0,251,2
2020-06-12,Shasta,089,179085,94,48,0,48,5
2020-06-12,Sierra,091,2930,1,1,0,1,0
2020-06-12,Siskiyou,093,43540,25,13,0,13,0
2020-06-12,Solano,095,438530,909,620,4,624,19
2020-06-12,Sonoma,097,501317,863,696,2,698,4
2020-06-12,Stanislaus,099,539301,1691,1092,6,1098,33
2020-06-12,Sutter,101,95872,95,56,0,56,2
2020-06-12,Tehama,103,63373,32,13,2,15,1
2020-06-12,Trinity,105,12862,13,2,3,5,0
2020-06-12,Tulare,107,460477,3635,2552,10,2562,95
2020-06-12,Tuolumne,109,53932,10,7,0,7,0
2020-06-12,Ventura,111,848112,2295,1534,13,1547,35
2020-06-12,Yolo,113,214977,312,243,0,243,24
2020-06-12,Yuba,115,75493,36,27,0,27,1
2020-06-11,Alameda,001,1643700,4777,4073,6,4079,108
2020-06-11,Alpine,003,1148,1,1,0,1,0
2020-06-11,Amador,005,37829,10,10,0,10,0
2020-06-11,Butte,007,227075,108,72,11,83,1
2020-06-11,Calaveras,009,45235,27,16,0,16,0
2020-06-11,Colusa,011,21464,12,7,0,7,0
2020-06-11,Contra Costa,013,1133247,2143,1797,2,1799,43
2020-06-11,Del Norte,015,27424,47,45,0,45,0
2020-06-11,El Dorado,017,186661,155,109,2,111,0
2020-06-11,Fresno,019,978130,4635,2338,57,2395,45
2020-06-11,Glenn,021,27897,42,21,0,21,0
2020-06-11,Humboldt,023,135768,122,113,0,113,3
2020-06-11,Imperial,025,180216,5626,3463,4,3467,36
2020-06-11,Inyo,027,18085,22,23,0,23,1
2020-06-11,Kern,029,883053,4127,3047,12,3059,54
2020-06-11,Kings,031,150075,1959,963,3,966,6
2020-06-11,Lake,033,64148,39,28,0,28,0
2020-06-11,Lassen,035,31185,15,5,2,7,0
2020-06-11,Los Angeles,037,10098052,77942,68807,25,68832,2800
2020-06-11,Madera,039,155013,445,178,2,180,3
2020-06-11,Marin,041,260295,789,637,2,639,17
2020-06-11,Mariposa,043,17540,18,16,0,16,1
2020-06-11,Mendocino,045,87422,40,35,0,35,0
2020-06-11,Merced,047,269075,633,370,1,371,7
2020-06-11,Modoc,049,8938,1,0,0,0,0
2020-06-11,Mono,051,14174,39,35,0,35,1
2020-06-11,Monterey,053,433212,1160,813,2,815,11
2020-06-11,Napa,055,140530,212,162,0,162,3
2020-06-11,Nevada,057,99092,67,50,1,51,1
2020-06-11,Orange,059,3164182,11741,8304,85,8389,188
2020-06-11,Placer,061,380077,476,321,3,324,9
2020-06-11,Plumas,063,18699,5,4,0,4,0
2020-06-11,Riverside,065,2383286,13216,10014,23,10037,361
2020-06-11,Sacramento,067,1510023,1926,1669,3,1672,60
2020-06-11,San Benito,069,59416,153,94,0,94,2
2020-06-11,San Bernardino,071,2135413,9172,6509,7,6516,221
2020-06-11,San Diego,073,3302833,10391,9000,0,9000,308
2020-06-11,San Francisco,075,870044,3041,2766,1,2767,44
2020-06-11,San Joaquin,077,732212,2075,1351,3,1354,43
2020-06-11,San Luis Obispo,079,281455,462,307,5,312,1
2020-06-11,San Mateo,081,765935,2747,2499,3,2502,74
2020-06-11,Santa Barbara,083,443738,2283,1895,17,1912,14
2020-06-11,Santa Clara,085,1922200,3989,3049,15,3064,149
2020-06-11,Santa Cruz,087,273765,279,247,0,247,2
2020-06-11,Shasta,089,179085,87,47,0,47,5
2020-06-11,Sierra,091,2930,1,1,0,1,0
2020-06-11,Siskiyou,093,43540,25,14,0,14,0
2020-06-11,Solano,095,438530,883,616,4,620,19
2020-06-11,Sonoma,097,501317,841,682,2,684,4
2020-06-11,Stanislaus,099,539301,1600,1062,6,1068,30
2020-06-11,Sutter,101,95872,92,56,0,56,2
2020-06-11,Tehama,103,63373,27,10,2,12,1
2020-06-11,Trinity,105,12862,11,2,3,5,0
2020-06-11,Tulare,107,460477,3536,2473,10,2483,95
2020-06-11,Tuolumne,109,53932,10,7,0,7,0
2020-06-11,Ventura,111,848112,2218,1491,12,1503,34
2020-06-11,Yolo,113,214977,304,230,0,230,24
2020-06-11,Yuba,115,75493,36,27,0,27,1
2020-06-10,Alameda,001,1643700,4677,4027,6,4033,107
2020-06-10,Alpine,003,1148,1,1,0,1,0
2020-06-10,Amador,005,37829,10,10,0,10,0
2020-06-10,Butte,007,227075,104,71,11,82,1
2020-06-10,Calaveras,009,45235,27,16,0,16,0
2020-06-10,Colusa,011,21464,11,7,0,7,0
2020-06-10,Contra Costa,013,1133247,2099,1778,2,1780,43
2020-06-10,Del Norte,015,27424,47,45,0,45,0
2020-06-10,El Dorado,017,186661,152,109,2,111,0
2020-06-10,Fresno,019,978130,4459,2324,57,2381,45
2020-06-10,Glenn,021,27897,39,21,0,21,0
2020-06-10,Humboldt,023,135768,118,112,0,112,3
2020-06-10,Imperial,025,180216,5479,3454,4,3458,36
2020-06-10,Inyo,027,18085,22,23,0,23,1
2020-06-10,Kern,029,883053,4002,3000,11,3011,54
2020-06-10,Kings,031,150075,1913,952,2,954,6
2020-06-10,Lake,033,64148,39,28,0,28,0
2020-06-10,Lassen,035,31185,15,5,2,7,0
2020-06-10,Los Angeles,037,10098052,76427,67018,25,67043,2752
2020-06-10,Madera,039,155013,431,176,1,177,3
2020-06-10,Marin,041,260295,757,633,2,635,17
2020-06-10,Mariposa,043,17540,17,16,0,16,1
2020-06-10,Mendocino,045,87422,39,35,0,35,0
2020-06-10,Merced,047,269075,607,370,1,371,7
2020-06-10,Modoc,049,8938,1,0,0,0,0
2020-06-10,Mono,051,14174,39,35,0,35,1
2020-06-10,Monterey,053,433212,1106,791,2,793,11
2020-06-10,Napa,055,140530,209,159,0,159,3
2020-06-10,Nevada,057,99092,65,50,1,51,1
2020-06-10,Orange,059,3164182,11464,8222,81,8303,184
2020-06-10,Placer,061,380077,451,309,3,312,9
2020-06-10,Plumas,063,18699,5,4,0,4,0
2020-06-10,Riverside,065,2383286,12893,9857,23,9880,361
2020-06-10,Sacramento,067,1510023,1887,1643,2,1645,59
2020-06-10,San Benito,069,59416,144,94,0,94,2
2020-06-10,San Bernardino,071,2135413,8879,6438,7,6445,219
2020-06-10,San Diego,073,3302833,10227,8839,0,8839,305
2020-06-10,San Francisco,075,870044,3016,2774,1,2775,44
2020-06-10,San Joaquin,077,732212,1946,1282,3,1285,41
2020-06-10,San Luis Obispo,079,281455,442,306,5,311,1
2020-06-10,San Mateo,081,765935,2707,2492,3,2495,74
2020-06-10,Santa Barbara,083,443738,2227,1878,17,1895,13
2020-06-10,Santa Clara,085,1922200,3938,3032,15,3047,149
2020-06-10,Santa Cruz,087,273765,275,242,0,242,2
2020-06-10,Shasta,089,179085,82,45,0,45,5
2020-06-10,Sierra,091,2930,1,1,0,1,0
2020-06-10,Siskiyou,093,43540,25,14,0,14,0
2020-06-10,Solano,095,438530,847,608,4,612,19
2020-06-10,Sonoma,097,501317,823,673,2,675,4
2020-06-10,Stanislaus,099,539301,1510,1030,6,1036,29
2020-06-10,Sutter,101,95872,91,56,0,56,2
2020-06-10,Tehama,103,63373,25,10,2,12,1
2020-06-10,Trinity,105,12862,11,2,3,5,0
2020-06-10,Tulare,107,460477,3444,2455,10,2465,95
2020-06-10,Tuolumne,109,53932,10,7,0,7,0
2020-06-10,Ventura,111,848112,2172,1446,11,1457,34
2020-06-10,Yolo,113,214977,296,226,0,226,24
2020-06-10,Yuba,115,75493,35,27,0,27,1
2020-06-09,Alameda,001,1643700,4566,3963,6,3969,103
2020-06-09,Alpine,003,1148,1,1,0,1,0
2020-06-09,Amador,005,37829,10,10,0,10,0
2020-06-09,Butte,007,227075,103,70,10,80,1
2020-06-09,Calaveras,009,45235,27,16,0,16,0
2020-06-09,Colusa,011,21464,10,7,0,7,0
2020-06-09,Contra Costa,013,1133247,2058,1744,2,1746,42
2020-06-09,Del Norte,015,27424,47,45,0,45,0
2020-06-09,El Dorado,017,186661,142,108,2,110,0
2020-06-09,Fresno,019,978130,4308,2278,57,2335,43
2020-06-09,Glenn,021,27897,38,19,0,19,0
2020-06-09,Humboldt,023,135768,116,113,0,113,2
2020-06-09,Imperial,025,180216,5329,3067,4,3071,36
2020-06-09,Inyo,027,18085,22,22,0,22,1
2020-06-09,Kern,029,883053,3874,2920,11,2931,51
2020-06-09,Kings,031,150075,1881,934,2,936,6
2020-06-09,Lake,033,64148,39,28,0,28,0
2020-06-09,Lassen,035,31185,15,5,2,7,0
2020-06-09,Los Angeles,037,10098052,74770,65827,25,65852,2692
2020-06-09,Madera,039,155013,416,172,1,173,3
2020-06-09,Marin,041,260295,721,616,2,618,17
2020-06-09,Mariposa,043,17540,17,16,0,16,1
2020-06-09,Mendocino,045,87422,35,35,0,35,0
2020-06-09,Merced,047,269075,575,349,1,350,7
2020-06-09,Modoc,049,8938,1,0,0,0,0
2020-06-09,Mono,051,14174,39,35,0,35,1
2020-06-09,Monterey,053,433212,1065,772,2,774,11
2020-06-09,Napa,055,140530,199,156,0,156,3
2020-06-09,Nevada,057,99092,57,50,1,51,1
2020-06-09,Orange,059,3164182,11220,7991,79,8070,174
2020-06-09,Placer,061,380077,438,301,3,304,9
2020-06-09,Plumas,063,18699,5,4,0,4,0
2020-06-09,Riverside,065,2383286,12515,9511,23,9534,354
2020-06-09,Sacramento,067,1510023,1832,1625,2,1627,59
2020-06-09,San Benito,069,59416,138,95,0,95,2
2020-06-09,San Bernardino,071,2135413,8556,6268,6,6274,217
2020-06-09,San Diego,073,3302833,10042,8731,0,8731,301
2020-06-09,San Francisco,075,870044,2991,2749,1,2750,44
2020-06-09,San Joaquin,077,732212,1840,1240,3,1243,41
2020-06-09,San Luis Obispo,079,281455,429,301,4,305,1
2020-06-09,San Mateo,081,765935,2676,2463,3,2466,74
2020-06-09,Santa Barbara,083,443738,2171,1854,17,1871,13
2020-06-09,Santa Clara,085,1922200,3870,3006,14,3020,147
2020-06-09,Santa Cruz,087,273765,269,237,0,237,2
2020-06-09,Shasta,089,179085,78,44,0,44,4
2020-06-09,Sierra,091,2930,1,1,0,1,0
2020-06-09,Siskiyou,093,43540,20,10,0,10,0
2020-06-09,Solano,095,438530,812,596,4,600,18
2020-06-09,Sonoma,097,501317,800,661,2,663,4
2020-06-09,Stanislaus,099,539301,1409,993,6,999,25
2020-06-09,Sutter,101,95872,88,56,0,56,2
2020-06-09,Tehama,103,63373,25,9,2,11,1
2020-06-09,Trinity,105,12862,10,2,3,5,0
2020-06-09,Tulare,107,460477,3378,2393,10,2403,91
2020-06-09,Tuolumne,109,53932,10,8,0,8,0
2020-06-09,Ventura,111,848112,2106,1407,11,1418,34
2020-06-09,Yolo,113,214977,285,226,0,226,24
2020-06-09,Yuba,115,75493,34,27,0,27,1
2020-06-08,Alameda,001,1643700,4485,3937,6,3943,103
2020-06-08,Alpine,003,1148,1,1,0,1,0
2020-06-08,Amador,005,37829,10,10,0,10,0
2020-06-08,Butte,007,227075,99,68,10,78,1
2020-06-08,Calaveras,009,45235,27,16,0,16,0
2020-06-08,Colusa,011,21464,9,7,0,7,0
2020-06-08,Contra Costa,013,1133247,2015,1714,2,1716,41
2020-06-08,Del Norte,015,27424,47,45,0,45,0
2020-06-08,El Dorado,017,186661,138,107,1,108,0
2020-06-08,Fresno,019,978130,4185,2194,56,2250,42
2020-06-08,Glenn,021,27897,36,17,0,17,0
2020-06-08,Humboldt,023,135768,116,112,0,112,2
2020-06-08,Imperial,025,180216,5177,3051,4,3055,21
2020-06-08,Inyo,027,18085,22,22,0,22,1
2020-06-08,Kern,029,883053,3743,2853,10,2863,49
2020-06-08,Kings,031,150075,1805,892,2,894,6
2020-06-08,Lake,033,64148,39,28,0,28,0
2020-06-08,Lassen,035,31185,15,4,2,6,0
2020-06-08,Los Angeles,037,10098052,73309,64634,25,64659,2640
2020-06-08,Madera,039,155013,386,154,1,155,3
2020-06-08,Marin,041,260295,680,596,2,598,17
2020-06-08,Mariposa,043,17540,16,16,0,16,1
2020-06-08,Mendocino,045,87422,33,32,0,32,0
2020-06-08,Merced,047,269075,541,331,1,332,7
2020-06-08,Modoc,049,8938,1,0,0,0,0
2020-06-08,Mono,051,14174,39,35,0,35,1
2020-06-08,Monterey,053,433212,1014,751,2,753,10
2020-06-08,Napa,055,140530,183,151,0,151,3
2020-06-08,Nevada,057,99092,56,50,1,51,1
2020-06-08,Orange,059,3164182,10968,7786,77,7863,160
2020-06-08,Placer,061,380077,421,290,3,293,9
2020-06-08,Plumas,063,18699,5,4,0,4,0
2020-06-08,Riverside,065,2383286,12146,9246,23,9269,347
2020-06-08,Sacramento,067,1510023,1782,1591,2,1593,59
2020-06-08,San Benito,069,59416,131,93,0,93,2
2020-06-08,San Bernardino,071,2135413,8237,6122,6,6128,214
2020-06-08,San Diego,073,3302833,9885,8621,0,8621,296
2020-06-08,San Francisco,075,870044,2964,2715,1,2716,43
2020-06-08,San Joaquin,077,732212,1733,1198,3,1201,40
2020-06-08,San Luis Obispo,079,281455,423,300,4,304,1
2020-06-08,San Mateo,081,765935,2645,2431,2,2433,74
2020-06-08,Santa Barbara,083,443738,2116,1824,15,1839,13
2020-06-08,Santa Clara,085,1922200,3824,2971,14,2985,146
2020-06-08,Santa Cruz,087,273765,268,234,0,234,2
2020-06-08,Shasta,089,179085,74,43,0,43,4
2020-06-08,Sierra,091,2930,1,1,0,1,0
2020-06-08,Siskiyou,093,43540,20,8,0,8,0
2020-06-08,Solano,095,438530,785,560,4,564,19
2020-06-08,Sonoma,097,501317,784,654,2,656,4
2020-06-08,Stanislaus,099,539301,1326,956,6,962,28
2020-06-08,Sutter,101,95872,81,55,0,55,2
2020-06-08,Tehama,103,63373,19,8,2,10,1
2020-06-08,Trinity,105,12862,10,2,3,5,0
2020-06-08,Tulare,107,460477,3295,2301,10,2311,91
2020-06-08,Tuolumne,109,53932,9,8,0,8,0
2020-06-08,Ventura,111,848112,2048,1382,11,1393,30
2020-06-08,Yolo,113,214977,274,228,0,228,24
2020-06-08,Yuba,115,75493,32,27,0,27,1
2020-06-07,Alameda,001,1643700,4372,3866,6,3872,102
2020-06-07,Alpine,003,1148,1,1,0,1,0
2020-06-07,Amador,005,37829,10,10,0,10,0
2020-06-07,Butte,007,227075,97,64,8,72,1
2020-06-07,Calaveras,009,45235,25,16,0,16,0
2020-06-07,Colusa,011,21464,9,7,0,7,0
2020-06-07,Contra Costa,013,1133247,1964,1653,1,1654,38
2020-06-07,Del Norte,015,27424,45,45,0,45,0
2020-06-07,El Dorado,017,186661,138,104,1,105,0
2020-06-07,Fresno,019,978130,4056,2144,56,2200,41
2020-06-07,Glenn,021,27897,29,16,0,16,0
2020-06-07,Humboldt,023,135768,116,112,0,112,2
2020-06-07,Imperial,025,180216,5027,3048,4,3052,19
2020-06-07,Inyo,027,18085,22,21,0,21,1
2020-06-07,Kern,029,883053,3612,2771,10,2781,46
2020-06-07,Kings,031,150075,1756,882,2,884,6
2020-06-07,Lake,033,64148,36,28,0,28,0
2020-06-07,Lassen,035,31185,14,4,2,6,0
2020-06-07,Los Angeles,037,10098052,71600,63750,25,63775,2629
2020-06-07,Madera,039,155013,369,149,1,150,3
2020-06-07,Marin,041,260295,666,584,2,586,17
2020-06-07,Mariposa,043,17540,16,16,0,16,1
2020-06-07,Mendocino,045,87422,33,32,0,32,0
2020-06-07,Merced,047,269075,512,318,1,319,7
2020-06-07,Modoc,049,8938,1,0,0,0,0
2020-06-07,Mono,051,14174,39,35,0,35,1
2020-06-07,Monterey,053,433212,968,732,2,734,10
2020-06-07,Napa,055,140530,175,142,0,142,3
2020-06-07,Nevada,057,99092,55,50,1,51,1
2020-06-07,Orange,059,3164182,10709,7643,75,7718,158
2020-06-07,Placer,061,380077,400,273,2,275,9
2020-06-07,Plumas,063,18699,5,4,0,4,0
2020-06-07,Riverside,065,2383286,11850,9105,23,9128,344
2020-06-07,Sacramento,067,1510023,1734,1568,2,1570,59
2020-06-07,San Benito,069,59416,128,92,0,92,2
2020-06-07,San Bernardino,071,2135413,7951,6033,6,6039,214
2020-06-07,San Diego,073,3302833,9706,8478,0,8478,296
2020-06-07,San Francisco,075,870044,2920,2674,0,2674,43
2020-06-07,San Joaquin,077,732212,1632,1126,3,1129,37
2020-06-07,San Luis Obispo,079,281455,413,296,4,300,1
2020-06-07,San Mateo,081,765935,2618,2399,2,2401,73
2020-06-07,Santa Barbara,083,443738,2061,1818,15,1833,13
2020-06-07,Santa Clara,085,1922200,3772,2947,14,2961,146
2020-06-07,Santa Cruz,087,273765,260,230,0,230,2
2020-06-07,Shasta,089,179085,73,41,0,41,4
2020-06-07,Sierra,091,2930,1,1,0,1,0
2020-06-07,Siskiyou,093,43540,20,8,0,8,0
2020-06-07,Solano,095,438530,762,560,4,564,19
2020-06-07,Sonoma,097,501317,753,639,2,641,4
2020-06-07,Stanislaus,099,539301,1246,905,5,910,28
2020-06-07,Sutter,101,95872,73,55,0,55,2
2020-06-07,Tehama,103,63373,16,8,2,10,1
2020-06-07,Trinity,105,12862,8,2,3,5,0
2020-06-07,Tulare,107,460477,3173,2219,10,2229,90
2020-06-07,Tuolumne,109,53932,9,4,0,4,0
2020-06-07,Ventura,111,848112,1982,1337,11,1348,30
2020-06-07,Yolo,113,214977,264,224,0,224,24
2020-06-07,Yuba,115,75493,32,27,0,27,1
2020-06-06,Alameda,001,1643700,4326,3801,6,3807,102
2020-06-06,Alpine,003,1148,1,1,0,1,0
2020-06-06,Amador,005,37829,10,10,0,10,0
2020-06-06,Butte,007,227075,96,63,8,71,1
2020-06-06,Calaveras,009,45235,23,16,0,16,0
2020-06-06,Colusa,011,21464,9,7,0,7,0
2020-06-06,Contra Costa,013,1133247,1944,1619,1,1620,37
2020-06-06,Del Norte,015,27424,45,45,0,45,0
2020-06-06,El Dorado,017,186661,133,104,1,105,0
2020-06-06,Fresno,019,978130,4000,2117,56,2173,41
2020-06-06,Glenn,021,27897,27,16,0,16,0
2020-06-06,Humboldt,023,135768,116,112,0,112,2
2020-06-06,Imperial,025,180216,4952,3047,4,3051,19
2020-06-06,Inyo,027,18085,22,21,0,21,1
2020-06-06,Kern,029,883053,3541,2695,10,2705,46
2020-06-06,Kings,031,150075,1737,882,2,884,6
2020-06-06,Lake,033,64148,36,28,0,28,0
2020-06-06,Lassen,035,31185,14,4,2,6,0
2020-06-06,Los Angeles,037,10098052,70845,62269,25,62294,2607
2020-06-06,Madera,039,155013,360,149,1,150,3
2020-06-06,Marin,041,260295,661,556,2,558,17
2020-06-06,Mariposa,043,17540,16,16,0,16,1
2020-06-06,Mendocino,045,87422,33,32,0,32,0
2020-06-06,Merced,047,269075,510,315,1,316,7
2020-06-06,Modoc,049,8938,1,0,0,0,0
2020-06-06,Mono,051,14174,39,35,0,35,1
2020-06-06,Monterey,053,433212,944,679,2,681,10
2020-06-06,Napa,055,140530,169,136,0,136,3
2020-06-06,Nevada,057,99092,54,50,1,51,1
2020-06-06,Orange,059,3164182,10550,7576,74,7650,157
2020-06-06,Placer,061,380077,388,270,2,272,9
2020-06-06,Plumas,063,18699,5,4,0,4,0
2020-06-06,Riverside,065,2383286,11672,8935,23,8958,345
2020-06-06,Sacramento,067,1510023,1711,1533,2,1535,59
2020-06-06,San Benito,069,59416,118,92,0,92,2
2020-06-06,San Bernardino,071,2135413,7802,5946,6,5952,214
2020-06-06,San Diego,073,3302833,9585,8347,0,8347,296
2020-06-06,San Francisco,075,870044,2905,2674,0,2674,43
2020-06-06,San Joaquin,077,732212,1592,1076,3,1079,37
2020-06-06,San Luis Obispo,079,281455,407,295,4,299,1
2020-06-06,San Mateo,081,765935,2603,2342,2,2344,72
2020-06-06,Santa Barbara,083,443738,2022,1815,15,1830,13
2020-06-06,Santa Clara,085,1922200,3731,2934,14,2948,144
2020-06-06,Santa Cruz,087,273765,258,226,0,226,2
2020-06-06,Shasta,089,179085,73,40,0,40,4
2020-06-06,Sierra,091,2930,1,1,0,1,0
2020-06-06,Siskiyou,093,43540,18,8,0,8,0
2020-06-06,Solano,095,438530,747,560,4,564,19
2020-06-06,Sonoma,097,501317,741,622,2,624,4
2020-06-06,Stanislaus,099,539301,1212,858,5,863,27
2020-06-06,Sutter,101,95872,73,51,0,51,2
2020-06-06,Tehama,103,63373,15,8,2,10,1
2020-06-06,Trinity,105,12862,8,2,2,4,0
2020-06-06,Tulare,107,460477,3140,2213,10,2223,90
2020-06-06,Tuolumne,109,53932,9,4,0,4,0
2020-06-06,Ventura,111,848112,1958,1303,11,1314,30
2020-06-06,Yolo,113,214977,262,223,0,223,24
2020-06-06,Yuba,115,75493,32,27,0,27,1
2020-06-05,Alameda,001,1643700,4275,3734,6,3740,102
2020-06-05,Alpine,003,1148,1,1,0,1,0
2020-06-05,Amador,005,37829,10,10,0,10,0
2020-06-05,Butte,007,227075,93,61,8,69,1
2020-06-05,Calaveras,009,45235,22,16,0,16,0
2020-06-05,Colusa,011,21464,9,7,0,7,0
2020-06-05,Contra Costa,013,1133247,1929,1575,1,1576,37
2020-06-05,Del Norte,015,27424,45,45,0,45,0
2020-06-05,El Dorado,017,186661,131,101,1,102,0
2020-06-05,Fresno,019,978130,3936,2051,55,2106,38
2020-06-05,Glenn,021,27897,25,16,0,16,0
2020-06-05,Humboldt,023,135768,115,111,0,111,2
2020-06-05,Imperial,025,180216,4844,2778,4,2782,19
2020-06-05,Inyo,027,18085,22,21,0,21,1
2020-06-05,Kern,029,883053,3452,2624,10,2634,46
2020-06-05,Kings,031,150075,1722,865,2,867,6
2020-06-05,Lake,033,64148,35,28,0,28,0
2020-06-05,Lassen,035,31185,13,4,2,6,0
2020-06-05,Los Angeles,037,10098052,69694,60955,23,60978,2553
2020-06-05,Madera,039,155013,338,144,1,145,3
2020-06-05,Marin,041,260295,652,546,2,548,17
2020-06-05,Mariposa,043,17540,16,16,0,16,1
2020-06-05,Mendocino,045,87422,33,32,0,32,0
2020-06-05,Merced,047,269075,507,309,1,310,7
2020-06-05,Modoc,049,8938,1,0,0,0,0
2020-06-05,Mono,051,14174,39,35,0,35,1
2020-06-05,Monterey,053,433212,912,649,2,651,10
2020-06-05,Napa,055,140530,166,123,0,123,3
2020-06-05,Nevada,057,99092,54,50,1,51,1
2020-06-05,Orange,059,3164182,10354,7391,73,7464,153
2020-06-05,Placer,061,380077,378,265,2,267,9
2020-06-05,Plumas,063,18699,5,4,0,4,0
2020-06-05,Riverside,065,2383286,11413,8700,23,8723,345
2020-06-05,Sacramento,067,1510023,1689,1514,2,1516,59
2020-06-05,San Benito,069,59416,116,92,0,92,2
2020-06-05,San Bernardino,071,2135413,7620,5869,5,5874,212
2020-06-05,San Diego,073,3302833,9470,8182,0,8182,294
2020-06-05,San Francisco,075,870044,2887,2675,0,2675,43
2020-06-05,San Joaquin,077,732212,1513,1046,3,1049,36
2020-06-05,San Luis Obispo,079,281455,400,293,4,297,1
2020-06-05,San Mateo,081,765935,2578,2331,2,2333,72
2020-06-05,Santa Barbara,083,443738,1991,1795,15,1810,13
2020-06-05,Santa Clara,085,1922200,3696,2902,14,2916,144
2020-06-05,Santa Cruz,087,273765,255,222,0,222,2
2020-06-05,Shasta,089,179085,72,40,0,40,4
2020-06-05,Sierra,091,2930,1,1,0,1,0
2020-06-05,Siskiyou,093,43540,16,8,0,8,0
2020-06-05,Solano,095,438530,740,558,4,562,19
2020-06-05,Sonoma,097,501317,720,618,2,620,4
2020-06-05,Stanislaus,099,539301,1179,842,5,847,27
2020-06-05,Sutter,101,95872,73,49,0,49,2
2020-06-05,Tehama,103,63373,15,7,2,9,1
2020-06-05,Trinity,105,12862,8,1,2,3,0
2020-06-05,Tulare,107,460477,3091,2180,10,2190,90
2020-06-05,Tuolumne,109,53932,9,4,0,4,0
2020-06-05,Ventura,111,848112,1925,1274,11,1285,30
2020-06-05,Yolo,113,214977,261,216,0,216,24
2020-06-05,Yuba,115,75493,32,27,0,27,1
2020-06-04,Alameda,001,1643700,4176,3643,6,3649,99
2020-06-04,Alpine,003,1148,1,1,0,1,0
2020-06-04,Amador,005,37829,10,10,0,10,0
2020-06-04,Butte,007,227075,89,57,7,64,1
2020-06-04,Calaveras,009,45235,22,15,0,15,0
2020-06-04,Colusa,011,21464,9,7,0,7,0
2020-06-04,Contra Costa,013,1133247,1872,1551,1,1552,37
2020-06-04,Del Norte,015,27424,45,45,0,45,0
2020-06-04,El Dorado,017,186661,129,101,1,102,0
2020-06-04,Fresno,019,978130,3832,2007,54,2061,35
2020-06-04,Glenn,021,27897,22,16,0,16,0
2020-06-04,Humboldt,023,135768,115,109,0,109,2
2020-06-04,Imperial,025,180216,4662,2631,4,2635,19
2020-06-04,Inyo,027,18085,22,20,0,20,1
2020-06-04,Kern,029,883053,3336,2530,10,2540,46
2020-06-04,Kings,031,150075,1653,842,2,844,6
2020-06-04,Lake,033,64148,34,27,0,27,0
2020-06-04,Lassen,035,31185,11,4,2,6,0
2020-06-04,Los Angeles,037,10098052,68229,59596,23,59619,2515
2020-06-04,Madera,039,155013,330,127,1,128,3
2020-06-04,Marin,041,260295,630,533,2,535,14
2020-06-04,Mariposa,043,17540,16,16,0,16,1
2020-06-04,Mendocino,045,87422,33,29,0,29,0
2020-06-04,Merced,047,269075,497,304,1,305,7
2020-06-04,Modoc,049,8938,1,0,0,0,0
2020-06-04,Mono,051,14174,39,35,0,35,1
2020-06-04,Monterey,053,433212,877,621,1,622,10
2020-06-04,Napa,055,140530,162,117,0,117,3
2020-06-04,Nevada,057,99092,53,49,1,50,1
2020-06-04,Orange,059,3164182,10099,7192,72,7264,148
2020-06-04,Placer,061,380077,362,256,2,258,9
2020-06-04,Plumas,063,18699,4,4,0,4,0
2020-06-04,Riverside,065,2383286,11135,8473,23,8496,341
2020-06-04,Sacramento,067,1510023,1660,1492,2,1494,58
2020-06-04,San Benito,069,59416,114,88,0,88,2
2020-06-04,San Bernardino,071,2135413,7351,5726,5,5731,207
2020-06-04,San Diego,073,3302833,9307,7942,0,7942,288
2020-06-04,San Francisco,075,870044,2854,2636,0,2636,43
2020-06-04,San Joaquin,077,732212,1451,1016,3,1019,36
2020-06-04,San Luis Obispo,079,281455,389,288,4,292,1
2020-06-04,San Mateo,081,765935,2551,2284,2,2286,72
2020-06-04,Santa Barbara,083,443738,1960,1750,14,1764,13
2020-06-04,Santa Clara,085,1922200,3661,2871,14,2885,144
2020-06-04,Santa Cruz,087,273765,249,218,0,218,2
2020-06-04,Shasta,089,179085,66,40,0,40,4
2020-06-04,Sierra,091,2930,1,1,0,1,0
2020-06-04,Siskiyou,093,43540,15,8,0,8,0
2020-06-04,Solano,095,438530,723,551,4,555,19
2020-06-04,Sonoma,097,501317,701,591,1,592,4
2020-06-04,Stanislaus,099,539301,1103,806,5,811,28
2020-06-04,Sutter,101,95872,68,46,0,46,2
2020-06-04,Tehama,103,63373,14,6,1,7,1
2020-06-04,Trinity,105,12862,8,1,2,3,0
2020-06-04,Tulare,107,460477,2974,2086,10,2096,90
2020-06-04,Tuolumne,109,53932,8,4,0,4,0
2020-06-04,Ventura,111,848112,1881,1236,10,1246,30
2020-06-04,Yolo,113,214977,256,216,0,216,24
2020-06-04,Yuba,115,75493,31,27,0,27,1
2020-06-03,Alameda,001,1643700,4117,3589,5,3594,99
2020-06-03,Alpine,003,1148,1,1,0,1,0
2020-06-03,Amador,005,37829,10,10,0,10,0
2020-06-03,Butte,007,227075,87,53,7,60,1
2020-06-03,Calaveras,009,45235,21,15,0,15,0
2020-06-03,Colusa,011,21464,9,7,0,7,0
2020-06-03,Contra Costa,013,1133247,1824,1511,1,1512,37
2020-06-03,Del Norte,015,27424,45,39,0,39,0
2020-06-03,El Dorado,017,186661,126,90,1,91,0
2020-06-03,Fresno,019,978130,3733,1943,54,1997,35
2020-06-03,Glenn,021,27897,22,16,0,16,0
2020-06-03,Humboldt,023,135768,115,103,0,103,2
2020-06-03,Imperial,025,180216,4489,2540,4,2544,19
2020-06-03,Inyo,027,18085,22,20,0,20,1
2020-06-03,Kern,029,883053,3240,2452,9,2461,44
2020-06-03,Kings,031,150075,1592,744,2,746,6
2020-06-03,Lake,033,64148,32,26,0,26,0
2020-06-03,Lassen,035,31185,11,4,2,6,0
2020-06-03,Los Angeles,037,10098052,66631,58166,23,58189,2472
2020-06-03,Madera,039,155013,322,117,1,118,3
2020-06-03,Marin,041,260295,612,527,2,529,14
2020-06-03,Mariposa,043,17540,16,16,0,16,1
2020-06-03,Mendocino,045,87422,32,29,0,29,0
2020-06-03,Merced,047,269075,485,299,1,300,7
2020-06-03,Modoc,049,8938,1,0,0,0,0
2020-06-03,Mono,051,14174,39,35,0,35,1
2020-06-03,Monterey,053,433212,849,592,1,593,10
2020-06-03,Napa,055,140530,161,116,0,116,3
2020-06-03,Nevada,057,99092,52,43,1,44,1
2020-06-03,Orange,059,3164182,9873,6939,71,7010,145
2020-06-03,Placer,061,380077,342,243,2,245,9
2020-06-03,Plumas,063,18699,4,4,0,4,0
2020-06-03,Riverside,065,2383286,10861,8208,23,8231,335
2020-06-03,Sacramento,067,1510023,1631,1457,2,1459,58
2020-06-03,San Benito,069,59416,108,88,0,88,2
2020-06-03,San Bernardino,071,2135413,7128,5565,5,5570,203
2020-06-03,San Diego,073,3302833,9159,7800,0,7800,283
2020-06-03,San Francisco,075,870044,2823,2608,0,2608,43
2020-06-03,San Joaquin,077,732212,1386,1004,3,1007,35
2020-06-03,San Luis Obispo,079,281455,384,279,4,283,1
2020-06-03,San Mateo,081,765935,2523,2243,2,2245,71
2020-06-03,Santa Barbara,083,443738,1926,1722,13,1735,12
2020-06-03,Santa Clara,085,1922200,3619,2836,14,2850,144
2020-06-03,Santa Cruz,087,273765,243,217,0,217,2
2020-06-03,Shasta,089,179085,63,40,0,40,4
2020-06-03,Sierra,091,2930,1,1,0,1,0
2020-06-03,Siskiyou,093,43540,14,8,0,8,0
2020-06-03,Solano,095,438530,698,543,2,545,18
2020-06-03,Sonoma,097,501317,689,578,1,579,4
2020-06-03,Stanislaus,099,539301,1063,780,5,785,27
2020-06-03,Sutter,101,95872,60,45,0,45,2
2020-06-03,Tehama,103,63373,14,6,1,7,1
2020-06-03,Trinity,105,12862,8,1,2,3,0
2020-06-03,Tulare,107,460477,2905,2041,10,2051,88
2020-06-03,Tuolumne,109,53932,6,4,0,4,0
2020-06-03,Ventura,111,848112,1814,1202,10,1212,30
2020-06-03,Yolo,113,214977,252,213,0,213,24
2020-06-03,Yuba,115,75493,31,27,0,27,1
2020-06-02,Alameda,001,1643700,4041,3517,5,3522,99
2020-06-02,Alpine,003,1148,1,1,0,1,0
2020-06-02,Amador,005,37829,10,10,0,10,0
2020-06-02,Butte,007,227075,83,51,6,57,1
2020-06-02,Calaveras,009,45235,21,15,0,15,0
2020-06-02,Colusa,011,21464,9,7,0,7,0
2020-06-02,Contra Costa,013,1133247,1792,1505,1,1506,37
2020-06-02,Del Norte,015,27424,45,39,0,39,0
2020-06-02,El Dorado,017,186661,125,88,1,89,0
2020-06-02,Fresno,019,978130,3620,1917,54,1971,34
2020-06-02,Glenn,021,27897,21,16,0,16,0
2020-06-02,Humboldt,023,135768,115,101,0,101,2
2020-06-02,Imperial,025,180216,4296,2459,4,2463,19
2020-06-02,Inyo,027,18085,20,20,0,20,1
2020-06-02,Kern,029,883053,3141,2406,7,2413,41
2020-06-02,Kings,031,150075,1564,720,2,722,5
2020-06-02,Lake,033,64148,32,25,0,25,0
2020-06-02,Lassen,035,31185,10,4,2,6,0
2020-06-02,Los Angeles,037,10098052,65228,57144,23,57167,2430
2020-06-02,Madera,039,155013,301,110,1,111,2
2020-06-02,Marin,041,260295,585,509,2,511,14
2020-06-02,Mariposa,043,17540,16,16,0,16,1
2020-06-02,Mendocino,045,87422,32,29,0,29,0
2020-06-02,Merced,047,269075,469,297,1,298,6
2020-06-02,Modoc,049,8938,1,0,0,0,0
2020-06-02,Mono,051,14174,39,35,0,35,1
2020-06-02,Monterey,053,433212,819,582,1,583,10
2020-06-02,Napa,055,140530,152,116,0,116,3
2020-06-02,Nevada,057,99092,51,41,1,42,1
2020-06-02,Orange,059,3164182,9671,6790,70,6860,142
2020-06-02,Placer,061,380077,328,226,2,228,9
2020-06-02,Plumas,063,18699,4,4,0,4,0
2020-06-02,Riverside,065,2383286,10565,8091,22,8113,330
2020-06-02,Sacramento,067,1510023,1602,1428,2,1430,58
2020-06-02,San Benito,069,59416,107,86,0,86,2
2020-06-02,San Bernardino,071,2135413,6921,5438,5,5443,202
2020-06-02,San Diego,073,3302833,9013,7676,0,7676,276
2020-06-02,San Francisco,075,870044,2788,2554,0,2554,43
2020-06-02,San Joaquin,077,732212,1320,985,3,988,35
2020-06-02,San Luis Obispo,079,281455,379,275,4,279,1
2020-06-02,San Mateo,081,765935,2488,2203,2,2205,71
2020-06-02,Santa Barbara,083,443738,1886,1703,13,1716,12
2020-06-02,Santa Clara,085,1922200,3569,2819,14,2833,144
2020-06-02,Santa Cruz,087,273765,238,215,0,215,2
2020-06-02,Shasta,089,179085,62,38,0,38,4
2020-06-02,Sierra,091,2930,1,1,0,1,0
2020-06-02,Siskiyou,093,43540,13,8,0,8,0
2020-06-02,Solano,095,438530,683,537,1,538,18
2020-06-02,Sonoma,097,501317,678,571,1,572,4
2020-06-02,Stanislaus,099,539301,1004,772,5,777,27
2020-06-02,Sutter,101,95872,57,43,0,43,2
2020-06-02,Tehama,103,63373,14,6,1,7,1
2020-06-02,Trinity,105,12862,8,1,2,3,0
2020-06-02,Tulare,107,460477,2825,2012,10,2022,86
2020-06-02,Tuolumne,109,53932,6,4,0,4,0
2020-06-02,Ventura,111,848112,1761,1178,10,1188,30
2020-06-02,Yolo,113,214977,250,213,0,213,24
2020-06-02,Yuba,115,75493,31,27,0,27,1
2020-06-01,Alameda,001,1643700,3975,3460,5,3465,98
2020-06-01,Alpine,003,1148,1,1,0,1,0
2020-06-01,Amador,005,37829,10,10,0,10,0
2020-06-01,Butte,007,227075,82,50,5,55,1
2020-06-01,Calaveras,009,45235,21,15,0,15,0
2020-06-01,Colusa,011,21464,9,7,0,7,0
2020-06-01,Contra Costa,013,1133247,1756,1486,1,1487,37
2020-06-01,Del Norte,015,27424,45,38,0,38,0
2020-06-01,El Dorado,017,186661,123,88,1,89,0
2020-06-01,Fresno,019,978130,3525,1854,52,1906,33
2020-06-01,Glenn,021,27897,21,16,0,16,0
2020-06-01,Humboldt,023,135768,115,98,0,98,2
2020-06-01,Imperial,025,180216,4074,2366,4,2370,14
2020-06-01,Inyo,027,18085,20,20,0,20,1
2020-06-01,Kern,029,883053,3058,2366,7,2373,38
2020-06-01,Kings,031,150075,1296,703,2,705,4
2020-06-01,Lake,033,64148,32,22,0,22,0
2020-06-01,Lassen,035,31185,10,4,2,6,0
2020-06-01,Los Angeles,037,10098052,63755,55899,22,55921,2367
2020-06-01,Madera,039,155013,289,103,1,104,2
2020-06-01,Marin,041,260295,544,495,2,497,14
2020-06-01,Mariposa,043,17540,16,16,0,16,1
2020-06-01,Mendocino,045,87422,32,28,0,28,0
2020-06-01,Merced,047,269075,452,289,1,290,6
2020-06-01,Modoc,049,8938,1,0,0,0,0
2020-06-01,Mono,051,14174,39,35,0,35,1
2020-06-01,Monterey,053,433212,795,554,1,555,10
2020-06-01,Napa,055,140530,149,114,0,114,3
2020-06-01,Nevada,057,99092,51,41,1,42,1
2020-06-01,Orange,059,3164182,9474,6640,69,6709,135
2020-06-01,Placer,061,380077,316,218,2,220,9
2020-06-01,Plumas,063,18699,4,4,0,4,0
2020-06-01,Riverside,065,2383286,10113,7921,21,7942,322
2020-06-01,Sacramento,067,1510023,1563,1415,2,1417,58
2020-06-01,San Benito,069,59416,104,86,0,86,2
2020-06-01,San Bernardino,071,2135413,6715,5310,5,5315,202
2020-06-01,San Diego,073,3302833,8833,7556,0,7556,269
2020-06-01,San Francisco,075,870044,2751,2546,0,2546,43
2020-06-01,San Joaquin,077,732212,1255,957,3,960,35
2020-06-01,San Luis Obispo,079,281455,375,275,4,279,1
2020-06-01,San Mateo,081,765935,2458,2190,2,2192,71
2020-06-01,Santa Barbara,083,443738,1852,1671,12,1683,10
2020-06-01,Santa Clara,085,1922200,3531,2797,13,2810,142
2020-06-01,Santa Cruz,087,273765,234,215,0,215,2
2020-06-01,Shasta,089,179085,62,38,0,38,4
2020-06-01,Sierra,091,2930,1,1,0,1,0
2020-06-01,Siskiyou,093,43540,13,7,0,7,0
2020-06-01,Solano,095,438530,659,529,1,530,17
2020-06-01,Sonoma,097,501317,662,565,1,566,4
2020-06-01,Stanislaus,099,539301,967,758,5,763,27
2020-06-01,Sutter,101,95872,52,43,0,43,2
2020-06-01,Tehama,103,63373,11,5,1,6,1
2020-06-01,Trinity,105,12862,7,1,2,3,0
2020-06-01,Tulare,107,460477,2710,1976,10,1986,84
2020-06-01,Tuolumne,109,53932,5,4,0,4,0
2020-06-01,Ventura,111,848112,1708,1163,10,1173,29
2020-06-01,Yolo,113,214977,247,212,0,212,24
2020-06-01,Yuba,115,75493,30,26,0,26,1
2020-05-31,Alameda,001,1643700,3870,3362,5,3367,98
2020-05-31,Alpine,003,1148,1,1,0,1,0
2020-05-31,Amador,005,37829,10,10,0,10,0
2020-05-31,Butte,007,227075,80,51,5,56,0
2020-05-31,Calaveras,009,45235,18,15,0,15,0
2020-05-31,Colusa,011,21464,9,5,0,5,0
2020-05-31,Contra Costa,013,1133247,1722,1458,1,1459,37
2020-05-31,Del Norte,015,27424,45,37,0,37,0
2020-05-31,El Dorado,017,186661,119,88,1,89,0
2020-05-31,Fresno,019,978130,3361,1780,47,1827,31
2020-05-31,Glenn,021,27897,20,16,0,16,0
2020-05-31,Humboldt,023,135768,113,98,0,98,2
2020-05-31,Imperial,025,180216,3807,2197,4,2201,14
2020-05-31,Inyo,027,18085,20,20,0,20,1
2020-05-31,Kern,029,883053,2923,2300,7,2307,38
2020-05-31,Kings,031,150075,1260,703,2,705,3
2020-05-31,Lake,033,64148,32,19,0,19,0
2020-05-31,Lassen,035,31185,10,4,2,6,0
2020-05-31,Los Angeles,037,10098052,62460,54925,22,54947,2344
2020-05-31,Madera,039,155013,271,101,1,102,2
2020-05-31,Marin,041,260295,534,486,2,488,14
2020-05-31,Mariposa,043,17540,16,16,0,16,1
2020-05-31,Mendocino,045,87422,32,24,0,24,0
2020-05-31,Merced,047,269075,418,288,0,288,6
2020-05-31,Modoc,049,8938,0,0,0,0,0
2020-05-31,Mono,051,14174,39,34,0,34,1
2020-05-31,Monterey,053,433212,721,545,1,546,10
2020-05-31,Napa,055,140530,147,114,0,114,3
2020-05-31,Nevada,057,99092,50,41,1,42,1
2020-05-31,Orange,059,3164182,9262,6532,68,6600,135
2020-05-31,Placer,061,380077,294,215,2,217,9
2020-05-31,Plumas,063,18699,4,4,0,4,0
2020-05-31,Riverside,065,2383286,9857,7704,21,7725,321
2020-05-31,Sacramento,067,1510023,1532,1398,2,1400,57
2020-05-31,San Benito,069,59416,98,85,0,85,2
2020-05-31,San Bernardino,071,2135413,6447,5185,5,5190,198
2020-05-31,San Diego,073,3302833,8639,7483,0,7483,269
2020-05-31,San Francisco,075,870044,2715,2501,0,2501,43
2020-05-31,San Joaquin,077,732212,1190,888,3,891,34
2020-05-31,San Luis Obispo,079,281455,365,271,4,275,1
2020-05-31,San Mateo,081,765935,2412,2169,2,2171,71
2020-05-31,Santa Barbara,083,443738,1801,1662,11,1673,9
2020-05-31,Santa Clara,085,1922200,3487,2785,13,2798,142
2020-05-31,Santa Cruz,087,273765,231,210,0,210,2
2020-05-31,Shasta,089,179085,60,38,0,38,4
2020-05-31,Sierra,091,2930,1,1,0,1,0
2020-05-31,Siskiyou,093,43540,12,7,0,7,0
2020-05-31,Solano,095,438530,633,512,1,513,6
2020-05-31,Sonoma,097,501317,642,555,1,556,4
2020-05-31,Stanislaus,099,539301,913,738,5,743,27
2020-05-31,Sutter,101,95872,50,42,0,42,2
2020-05-31,Tehama,103,63373,10,4,1,5,1
2020-05-31,Trinity,105,12862,7,1,2,3,0
2020-05-31,Tulare,107,460477,2637,1884,10,1894,82
2020-05-31,Tuolumne,109,53932,5,4,0,4,0
2020-05-31,Ventura,111,848112,1647,1151,10,1161,30
2020-05-31,Yolo,113,214977,241,211,0,211,24
2020-05-31,Yuba,115,75493,30,26,0,26,1
2020-05-30,Alameda,001,1643700,3844,3304,5,3309,96
2020-05-30,Alpine,003,1148,1,1,0,1,0
2020-05-30,Amador,005,37829,10,10,0,10,0
2020-05-30,Butte,007,227075,79,44,5,49,0
2020-05-30,Calaveras,009,45235,17,15,0,15,0
2020-05-30,Colusa,011,21464,8,5,0,5,0
2020-05-30,Contra Costa,013,1133247,1706,1429,1,1430,37
2020-05-30,Del Norte,015,27424,45,37,0,37,0
2020-05-30,El Dorado,017,186661,118,86,1,87,0
2020-05-30,Fresno,019,978130,3300,1744,46,1790,31
2020-05-30,Glenn,021,27897,19,16,0,16,0
2020-05-30,Humboldt,023,135768,112,98,0,98,2
2020-05-30,Imperial,025,180216,3717,2091,4,2095,14
2020-05-30,Inyo,027,18085,20,20,0,20,1
2020-05-30,Kern,029,883053,2854,2217,7,2224,38
2020-05-30,Kings,031,150075,1246,703,2,705,3
2020-05-30,Lake,033,64148,31,18,0,18,0
2020-05-30,Lassen,035,31185,10,4,2,6,0
2020-05-30,Los Angeles,037,10098052,61925,53627,22,53649,2319
2020-05-30,Madera,039,155013,266,101,1,102,2
2020-05-30,Marin,041,260295,534,462,2,464,14
2020-05-30,Mariposa,043,17540,16,16,0,16,1
2020-05-30,Mendocino,045,87422,32,24,0,24,0
2020-05-30,Merced,047,269075,414,285,0,285,6
2020-05-30,Modoc,049,8938,0,0,0,0,0
2020-05-30,Mono,051,14174,39,34,0,34,1
2020-05-30,Monterey,053,433212,705,520,1,521,10
2020-05-30,Napa,055,140530,145,113,0,113,3
2020-05-30,Nevada,057,99092,50,41,1,42,1
2020-05-30,Orange,059,3164182,9105,6354,67,6421,134
2020-05-30,Placer,061,380077,286,199,1,200,9
2020-05-30,Plumas,063,18699,4,4,0,4,0
2020-05-30,Riverside,065,2383286,9713,7492,21,7513,316
2020-05-30,Sacramento,067,1510023,1521,1384,2,1386,57
2020-05-30,San Benito,069,59416,97,85,0,85,2
2020-05-30,San Bernardino,071,2135413,6338,5122,5,5127,198
2020-05-30,San Diego,073,3302833,8546,7387,0,7387,269
2020-05-30,San Francisco,075,870044,2690,2496,0,2496,41
2020-05-30,San Joaquin,077,732212,1152,888,3,891,34
2020-05-30,San Luis Obispo,079,281455,360,270,4,274,1
2020-05-30,San Mateo,081,765935,2388,2129,2,2131,71
2020-05-30,Santa Barbara,083,443738,1782,1660,11,1671,9
2020-05-30,Santa Clara,085,1922200,3471,2741,13,2754,141
2020-05-30,Santa Cruz,087,273765,231,206,0,206,2
2020-05-30,Shasta,089,179085,60,36,0,36,4
2020-05-30,Sierra,091,2930,1,1,0,1,0
2020-05-30,Siskiyou,093,43540,11,7,0,7,0
2020-05-30,Solano,095,438530,626,512,1,513,6
2020-05-30,Sonoma,097,501317,632,551,1,552,4
2020-05-30,Stanislaus,099,539301,896,712,5,717,27
2020-05-30,Sutter,101,95872,49,40,0,40,2
2020-05-30,Tehama,103,63373,10,4,1,5,1
2020-05-30,Trinity,105,12862,7,1,2,3,0
2020-05-30,Tulare,107,460477,2600,1879,10,1889,81
2020-05-30,Tuolumne,109,53932,5,4,0,4,0
2020-05-30,Ventura,111,848112,1630,1116,10,1126,30
2020-05-30,Yolo,113,214977,237,210,0,210,24
2020-05-30,Yuba,115,75493,30,25,0,25,1
2020-05-29,Alameda,001,1643700,3809,3209,5,3214,96
2020-05-29,Alpine,003,1148,1,1,0,1,0
2020-05-29,Amador,005,37829,10,10,0,10,0
2020-05-29,Butte,007,227075,74,41,5,46,0
2020-05-29,Calaveras,009,45235,17,15,0,15,0
2020-05-29,Colusa,011,21464,8,5,0,5,0
2020-05-29,Contra Costa,013,1133247,1690,1411,1,1412,37
2020-05-29,Del Norte,015,27424,45,37,0,37,0
2020-05-29,El Dorado,017,186661,117,85,1,86,0
2020-05-29,Fresno,019,978130,3250,1687,46,1733,31
2020-05-29,Glenn,021,27897,19,14,0,14,0
2020-05-29,Humboldt,023,135768,111,98,0,98,2
2020-05-29,Imperial,025,180216,3599,1607,4,1611,14
2020-05-29,Inyo,027,18085,20,20,0,20,1
2020-05-29,Kern,029,883053,2796,2128,7,2135,36
2020-05-29,Kings,031,150075,1235,693,2,695,3
2020-05-29,Lake,033,64148,30,17,0,17,0
2020-05-29,Lassen,035,31185,10,0,2,2,0
2020-05-29,Los Angeles,037,10098052,60969,51578,22,51600,2273
2020-05-29,Madera,039,155013,251,98,1,99,2
2020-05-29,Marin,041,260295,526,448,2,450,14
2020-05-29,Mariposa,043,17540,16,16,0,16,1
2020-05-29,Mendocino,045,87422,30,25,0,25,0
2020-05-29,Merced,047,269075,404,285,0,285,7
2020-05-29,Modoc,049,8938,0,0,0,0,0
2020-05-29,Mono,051,14174,38,34,0,34,1
2020-05-29,Monterey,053,433212,675,479,1,480,10
2020-05-29,Napa,055,140530,142,113,0,113,3
2020-05-29,Nevada,057,99092,50,41,1,42,1
2020-05-29,Orange,059,3164182,8919,6176,64,6240,133
2020-05-29,Placer,061,380077,264,199,1,200,9
2020-05-29,Plumas,063,18699,4,4,0,4,0
2020-05-29,Riverside,065,2383286,9527,7376,21,7397,313
2020-05-29,Sacramento,067,1510023,1498,1360,2,1362,57
2020-05-29,San Benito,069,59416,97,84,0,84,2
2020-05-29,San Bernardino,071,2135413,6230,4983,5,4988,196
2020-05-29,San Diego,073,3302833,8423,7242,0,7242,266
2020-05-29,San Francisco,075,870044,2666,2453,0,2453,41
2020-05-29,San Joaquin,077,732212,1115,855,3,858,34
2020-05-29,San Luis Obispo,079,281455,356,270,4,274,1
2020-05-29,San Mateo,081,765935,2372,2103,2,2105,71
2020-05-29,Santa Barbara,083,443738,1754,1656,11,1667,9
2020-05-29,Santa Clara,085,1922200,3443,2707,13,2720,141
2020-05-29,Santa Cruz,087,273765,228,203,0,203,2
2020-05-29,Shasta,089,179085,60,36,0,36,4
2020-05-29,Sierra,091,2930,1,1,0,1,0
2020-05-29,Siskiyou,093,43540,11,7,0,7,0
2020-05-29,Solano,095,438530,618,498,1,499,6
2020-05-29,Sonoma,097,501317,621,537,1,538,4
2020-05-29,Stanislaus,099,539301,866,698,5,703,27
2020-05-29,Sutter,101,95872,47,40,0,40,2
2020-05-29,Tehama,103,63373,9,4,1,5,1
2020-05-29,Trinity,105,12862,7,1,2,3,0
2020-05-29,Tulare,107,460477,2562,1852,10,1862,80
2020-05-29,Tuolumne,109,53932,5,4,0,4,0
2020-05-29,Ventura,111,848112,1606,1093,10,1103,29
2020-05-29,Yolo,113,214977,233,211,0,211,24
2020-05-29,Yuba,115,75493,29,25,0,25,1
2020-05-28,Alameda,001,1643700,3710,3083,5,3088,94
2020-05-28,Alpine,003,1148,1,1,0,1,0
2020-05-28,Amador,005,37829,10,10,0,10,0
2020-05-28,Butte,007,227075,73,40,5,45,0
2020-05-28,Calaveras,009,45235,16,15,0,15,0
2020-05-28,Colusa,011,21464,8,5,0,5,0
2020-05-28,Contra Costa,013,1133247,1651,1392,1,1393,37
2020-05-28,Del Norte,015,27424,45,37,0,37,0
2020-05-28,El Dorado,017,186661,114,82,1,83,0
2020-05-28,Fresno,019,978130,3169,1653,45,1698,31
2020-05-28,Glenn,021,27897,18,14,0,14,0
2020-05-28,Humboldt,023,135768,110,97,0,97,2
2020-05-28,Imperial,025,180216,3404,1430,4,1434,14
2020-05-28,Inyo,027,18085,20,20,0,20,1
2020-05-28,Kern,029,883053,2718,2069,7,2076,36
2020-05-28,Kings,031,150075,898,626,2,628,3
2020-05-28,Lake,033,64148,29,17,0,17,0
2020-05-28,Lassen,035,31185,10,0,2,2,0
2020-05-28,Los Angeles,037,10098052,59393,49861,22,49883,2222
2020-05-28,Madera,039,155013,233,93,1,94,2
2020-05-28,Marin,041,260295,501,443,2,445,14
2020-05-28,Mariposa,043,17540,16,16,0,16,1
2020-05-28,Mendocino,045,87422,28,24,0,24,0
2020-05-28,Merced,047,269075,394,283,0,283,7
2020-05-28,Modoc,049,8938,0,0,0,0,0
2020-05-28,Mono,051,14174,38,34,0,34,1
2020-05-28,Monterey,053,433212,643,471,1,472,10
2020-05-28,Napa,055,140530,139,113,0,113,3
2020-05-28,Nevada,057,99092,45,41,1,42,1
2020-05-28,Orange,059,3164182,8724,6045,64,6109,130
2020-05-28,Placer,061,380077,257,196,1,197,9
2020-05-28,Plumas,063,18699,4,4,0,4,0
2020-05-28,Riverside,065,2383286,9123,7240,20,7260,304
2020-05-28,Sacramento,067,1510023,1478,1339,2,1341,57
2020-05-28,San Benito,069,59416,96,82,0,82,2
2020-05-28,San Bernardino,071,2135413,6065,4831,5,4836,191
2020-05-28,San Diego,073,3302833,8266,7102,0,7102,260
2020-05-28,San Francisco,075,870044,2632,2417,0,2417,40
2020-05-28,San Joaquin,077,732212,1080,840,3,843,34
2020-05-28,San Luis Obispo,079,281455,353,267,4,271,1
2020-05-28,San Mateo,081,765935,2345,2070,2,2072,71
2020-05-28,Santa Barbara,083,443738,1726,1642,10,1652,9
2020-05-28,Santa Clara,085,1922200,3403,2698,13,2711,140
2020-05-28,Santa Cruz,087,273765,227,201,0,201,2
2020-05-28,Shasta,089,179085,58,36,0,36,4
2020-05-28,Sierra,091,2930,1,1,0,1,0
2020-05-28,Siskiyou,093,43540,9,6,0,6,0
2020-05-28,Solano,095,438530,601,489,1,490,6
2020-05-28,Sonoma,097,501317,599,529,1,530,4
2020-05-28,Stanislaus,099,539301,825,684,5,689,27
2020-05-28,Sutter,101,95872,47,40,0,40,2
2020-05-28,Tehama,103,63373,9,4,1,5,1
2020-05-28,Trinity,105,12862,6,1,2,3,0
2020-05-28,Tulare,107,460477,2526,1832,10,1842,79
2020-05-28,Tuolumne,109,53932,5,4,0,4,0
2020-05-28,Ventura,111,848112,1573,1083,10,1093,29
2020-05-28,Yolo,113,214977,230,206,0,206,22
2020-05-28,Yuba,115,75493,28,24,0,24,1
2020-05-27,Alameda,001,1643700,3627,3037,5,3042,94
2020-05-27,Alpine,003,1148,1,1,0,1,0
2020-05-27,Amador,005,37829,10,10,0,10,0
2020-05-27,Butte,007,227075,70,40,4,44,0
2020-05-27,Calaveras,009,45235,15,15,0,15,0
2020-05-27,Colusa,011,21464,8,5,0,5,0
2020-05-27,Contra Costa,013,1133247,1611,1373,1,1374,37
2020-05-27,Del Norte,015,27424,45,34,0,34,0
2020-05-27,El Dorado,017,186661,113,82,1,83,0
2020-05-27,Fresno,019,978130,3079,1620,45,1665,27
2020-05-27,Glenn,021,27897,18,14,0,14,0
2020-05-27,Humboldt,023,135768,110,86,0,86,2
2020-05-27,Imperial,025,180216,3224,1369,4,1373,14
2020-05-27,Inyo,027,18085,20,20,0,20,1
2020-05-27,Kern,029,883053,2653,1999,7,2006,37
2020-05-27,Kings,031,150075,871,586,2,588,3
2020-05-27,Lake,033,64148,29,13,0,13,0
2020-05-27,Lassen,035,31185,10,0,2,2,0
2020-05-27,Los Angeles,037,10098052,58023,48711,22,48733,2177
2020-05-27,Madera,039,155013,224,91,1,92,2
2020-05-27,Marin,041,260295,472,439,2,441,14
2020-05-27,Mariposa,043,17540,16,16,0,16,1
2020-05-27,Mendocino,045,87422,27,21,0,21,0
2020-05-27,Merced,047,269075,388,278,0,278,7
2020-05-27,Modoc,049,8938,0,0,0,0,0
2020-05-27,Mono,051,14174,38,34,0,34,1
2020-05-27,Monterey,053,433212,603,443,1,444,8
2020-05-27,Napa,055,140530,134,112,0,112,3
2020-05-27,Nevada,057,99092,44,41,1,42,1
2020-05-27,Orange,059,3164182,8569,5849,64,5913,121
2020-05-27,Placer,061,380077,238,196,0,196,9
2020-05-27,Plumas,063,18699,4,4,0,4,0
2020-05-27,Riverside,065,2383286,8744,7156,20,7176,299
2020-05-27,Sacramento,067,1510023,1450,1318,2,1320,50
2020-05-27,San Benito,069,59416,93,74,0,74,2
2020-05-27,San Bernardino,071,2135413,5881,4708,5,4713,183
2020-05-27,San Diego,073,3302833,8115,6985,0,6985,255
2020-05-27,San Francisco,075,870044,2603,2394,0,2394,40
2020-05-27,San Joaquin,077,732212,1039,825,3,828,34
2020-05-27,San Luis Obispo,079,281455,348,266,4,270,1
2020-05-27,San Mateo,081,765935,2305,2045,2,2047,71
2020-05-27,Santa Barbara,083,443738,1711,1629,10,1639,9
2020-05-27,Santa Clara,085,1922200,3370,2680,13,2693,140
2020-05-27,Santa Cruz,087,273765,223,202,0,202,2
2020-05-27,Shasta,089,179085,55,36,0,36,4
2020-05-27,Sierra,091,2930,1,1,0,1,0
2020-05-27,Siskiyou,093,43540,9,6,0,6,0
2020-05-27,Solano,095,438530,581,477,1,478,5
2020-05-27,Sonoma,097,501317,585,521,1,522,4
2020-05-27,Stanislaus,099,539301,800,675,5,680,27
2020-05-27,Sutter,101,95872,46,40,0,40,2
2020-05-27,Tehama,103,63373,9,3,1,4,1
2020-05-27,Trinity,105,12862,6,1,2,3,0
2020-05-27,Tulare,107,460477,2474,1817,10,1827,77
2020-05-27,Tuolumne,109,53932,5,4,0,4,0
2020-05-27,Ventura,111,848112,1548,1065,10,1075,28
2020-05-27,Yolo,113,214977,229,204,0,204,22
2020-05-27,Yuba,115,75493,28,24,0,24,1
2020-05-26,Alameda,001,1643700,3532,2956,5,2961,92
2020-05-26,Alpine,003,1148,1,1,0,1,0
2020-05-26,Amador,005,37829,10,10,0,10,0
2020-05-26,Butte,007,227075,68,37,3,40,0
2020-05-26,Calaveras,009,45235,15,13,0,13,0
2020-05-26,Colusa,011,21464,8,4,0,4,0
2020-05-26,Contra Costa,013,1133247,1575,1352,1,1353,37
2020-05-26,Del Norte,015,27424,44,30,0,30,0
2020-05-26,El Dorado,017,186661,109,79,1,80,0
2020-05-26,Fresno,019,978130,2992,1496,45,1541,22
2020-05-26,Glenn,021,27897,16,12,0,12,0
2020-05-26,Humboldt,023,135768,108,81,0,81,2
2020-05-26,Imperial,025,180216,3011,1369,4,1373,14
2020-05-26,Inyo,027,18085,20,20,0,20,1
2020-05-26,Kern,029,883053,2575,1890,7,1897,31
2020-05-26,Kings,031,150075,803,449,1,450,2
2020-05-26,Lake,033,64148,27,12,0,12,0
2020-05-26,Lassen,035,31185,9,0,2,2,0
2020-05-26,Los Angeles,037,10098052,56557,47760,22,47782,2121
2020-05-26,Madera,039,155013,209,83,1,84,2
2020-05-26,Marin,041,260295,460,424,2,426,14
2020-05-26,Mariposa,043,17540,16,16,0,16,1
2020-05-26,Mendocino,045,87422,25,20,0,20,0
2020-05-26,Merced,047,269075,377,266,0,266,7
2020-05-26,Modoc,049,8938,0,1,0,1,0
2020-05-26,Mono,051,14174,37,34,0,34,1
2020-05-26,Monterey,053,433212,575,424,1,425,8
2020-05-26,Napa,055,140530,129,109,0,109,3
2020-05-26,Nevada,057,99092,43,41,1,42,1
2020-05-26,Orange,059,3164182,8299,5651,63,5714,115
2020-05-26,Placer,061,380077,233,188,0,188,9
2020-05-26,Plumas,063,18699,4,4,0,4,0
2020-05-26,Riverside,065,2383286,8297,6917,20,6937,284
2020-05-26,Sacramento,067,1510023,1424,1298,2,1300,50
2020-05-26,San Benito,069,59416,88,69,0,69,2
2020-05-26,San Bernardino,071,2135413,5713,4430,5,4435,175
2020-05-26,San Diego,073,3302833,7972,6884,0,6884,249
2020-05-26,San Francisco,075,870044,2570,2363,0,2363,40
2020-05-26,San Joaquin,077,732212,992,760,3,763,33
2020-05-26,San Luis Obispo,079,281455,346,260,4,264,1
2020-05-26,San Mateo,081,765935,2267,1967,2,1969,71
2020-05-26,Santa Barbara,083,443738,1694,1590,9,1599,9
2020-05-26,Santa Clara,085,1922200,3338,2659,13,2672,139
2020-05-26,Santa Cruz,087,273765,221,197,0,197,2
2020-05-26,Shasta,089,179085,55,36,0,36,4
2020-05-26,Sierra,091,2930,1,1,0,1,0
2020-05-26,Siskiyou,093,43540,8,6,0,6,0
2020-05-26,Solano,095,438530,563,470,1,471,5
2020-05-26,Sonoma,097,501317,577,509,0,509,4
2020-05-26,Stanislaus,099,539301,780,663,5,668,27
2020-05-26,Sutter,101,95872,45,39,0,39,2
2020-05-26,Tehama,103,63373,8,2,1,3,1
2020-05-26,Trinity,105,12862,6,1,2,3,0
2020-05-26,Tulare,107,460477,2418,1768,10,1778,76
2020-05-26,Tuolumne,109,53932,5,2,0,2,0
2020-05-26,Ventura,111,848112,1511,1033,8,1041,27
2020-05-26,Yolo,113,214977,223,198,0,198,22
2020-05-26,Yuba,115,75493,27,24,0,24,1
2020-05-25,Alameda,001,1643700,3438,2900,5,2905,92
2020-05-25,Alpine,003,1148,1,1,0,1,0
2020-05-25,Amador,005,37829,10,10,0,10,0
2020-05-25,Butte,007,227075,65,37,3,40,0
2020-05-25,Calaveras,009,45235,15,13,0,13,0
2020-05-25,Colusa,011,21464,7,4,0,4,0
2020-05-25,Contra Costa,013,1133247,1543,1348,1,1349,37
2020-05-25,Del Norte,015,27424,44,20,0,20,0
2020-05-25,El Dorado,017,186661,101,78,1,79,0
2020-05-25,Fresno,019,978130,2889,1496,43,1539,22
2020-05-25,Glenn,021,27897,16,12,0,12,0
2020-05-25,Humboldt,023,135768,107,81,0,81,2
2020-05-25,Imperial,025,180216,2804,1369,4,1373,14
2020-05-25,Inyo,027,18085,19,20,0,20,1
2020-05-25,Kern,029,883053,2504,1890,7,1897,31
2020-05-25,Kings,031,150075,773,447,1,448,2
2020-05-25,Lake,033,64148,25,13,0,13,0
2020-05-25,Lassen,035,31185,9,0,2,2,0
2020-05-25,Los Angeles,037,10098052,54744,45952,21,45973,2094
2020-05-25,Madera,039,155013,196,83,1,84,2
2020-05-25,Marin,041,260295,442,415,2,417,14
2020-05-25,Mariposa,043,17540,16,15,0,15,1
2020-05-25,Mendocino,045,87422,22,19,0,19,0
2020-05-25,Merced,047,269075,371,262,0,262,6
2020-05-25,Modoc,049,8938,0,1,0,1,0
2020-05-25,Mono,051,14174,37,34,0,34,1
2020-05-25,Monterey,053,433212,545,418,1,419,8
2020-05-25,Napa,055,140530,129,107,0,107,3
2020-05-25,Nevada,057,99092,43,41,1,42,1
2020-05-25,Orange,059,3164182,8076,5601,62,5663,115
2020-05-25,Placer,061,380077,229,186,0,186,9
2020-05-25,Plumas,063,18699,4,4,0,4,0
2020-05-25,Riverside,065,2383286,8066,6900,20,6920,284
2020-05-25,Sacramento,067,1510023,1404,1290,1,1291,50
2020-05-25,San Benito,069,59416,87,70,0,70,2
2020-05-25,San Bernardino,071,2135413,5523,4393,4,4397,175
2020-05-25,San Diego,073,3302833,7796,6799,0,6799,249
2020-05-25,San Francisco,075,870044,2533,2358,0,2358,40
2020-05-25,San Joaquin,077,732212,966,760,3,763,33
2020-05-25,San Luis Obispo,079,281455,343,260,4,264,1
2020-05-25,San Mateo,081,765935,2230,1938,2,1940,71
2020-05-25,Santa Barbara,083,443738,1684,1590,9,1599,9
2020-05-25,Santa Clara,085,1922200,3305,2647,13,2660,139
2020-05-25,Santa Cruz,087,273765,219,191,0,191,2
2020-05-25,Shasta,089,179085,54,36,0,36,4
2020-05-25,Sierra,091,2930,1,1,0,1,0
2020-05-25,Siskiyou,093,43540,8,6,0,6,0
2020-05-25,Solano,095,438530,549,437,1,438,5
2020-05-25,Sonoma,097,501317,565,496,0,496,4
2020-05-25,Stanislaus,099,539301,750,651,5,656,27
2020-05-25,Sutter,101,95872,45,38,0,38,2
2020-05-25,Tehama,103,63373,7,2,1,3,1
2020-05-25,Trinity,105,12862,6,1,2,3,0
2020-05-25,Tulare,107,460477,2354,1747,10,1757,76
2020-05-25,Tuolumne,109,53932,5,2,0,2,0
2020-05-25,Ventura,111,848112,1470,1020,8,1028,27
2020-05-25,Yolo,113,214977,221,197,0,197,22
2020-05-25,Yuba,115,75493,26,24,0,24,1
2020-05-24,Alameda,001,1643700,3365,2830,5,2835,92
2020-05-24,Alpine,003,1148,1,1,0,1,0
2020-05-24,Amador,005,37829,10,9,0,9,0
2020-05-24,Butte,007,227075,63,35,3,38,0
2020-05-24,Calaveras,009,45235,15,13,0,13,0
2020-05-24,Colusa,011,21464,7,4,0,4,0
2020-05-24,Contra Costa,013,1133247,1515,1325,1,1326,37
2020-05-24,Del Norte,015,27424,43,16,0,16,0
2020-05-24,El Dorado,017,186661,100,76,1,77,0
2020-05-24,Fresno,019,978130,2822,1455,42,1497,22
2020-05-24,Glenn,021,27897,15,12,0,12,0
2020-05-24,Humboldt,023,135768,107,81,0,81,2
2020-05-24,Imperial,025,180216,2678,1369,4,1373,14
2020-05-24,Inyo,027,18085,19,20,0,20,1
2020-05-24,Kern,029,883053,2431,1861,6,1867,31
2020-05-24,Kings,031,150075,762,446,1,447,2
2020-05-24,Lake,033,64148,24,12,0,12,0
2020-05-24,Lassen,035,31185,8,0,2,2,0
2020-05-24,Los Angeles,037,10098052,53728,44954,21,44975,2085
2020-05-24,Madera,039,155013,190,83,1,84,2
2020-05-24,Marin,041,260295,440,401,2,403,14
2020-05-24,Mariposa,043,17540,16,15,0,15,1
2020-05-24,Mendocino,045,87422,21,19,0,19,0
2020-05-24,Merced,047,269075,370,258,0,258,6
2020-05-24,Modoc,049,8938,0,0,0,0,0
2020-05-24,Mono,051,14174,37,34,0,34,1
2020-05-24,Monterey,053,433212,517,405,1,406,8
2020-05-24,Napa,055,140530,127,104,0,104,3
2020-05-24,Nevada,057,99092,43,41,1,42,1
2020-05-24,Orange,059,3164182,7922,5439,61,5500,113
2020-05-24,Placer,061,380077,221,184,0,184,9
2020-05-24,Plumas,063,18699,4,4,0,4,0
2020-05-24,Riverside,065,2383286,7925,6571,20,6591,284
2020-05-24,Sacramento,067,1510023,1388,1283,1,1284,50
2020-05-24,San Benito,069,59416,86,67,0,67,2
2020-05-24,San Bernardino,071,2135413,5415,4262,4,4266,175
2020-05-24,San Diego,073,3302833,7653,6703,0,6703,249
2020-05-24,San Francisco,075,870044,2510,2318,0,2318,40
2020-05-24,San Joaquin,077,732212,947,760,3,763,33
2020-05-24,San Luis Obispo,079,281455,341,257,4,261,1
2020-05-24,San Mateo,081,765935,2195,1925,2,1927,71
2020-05-24,Santa Barbara,083,443738,1672,1573,9,1582,9
2020-05-24,Santa Clara,085,1922200,3285,2623,13,2636,139
2020-05-24,Santa Cruz,087,273765,216,185,0,185,2
2020-05-24,Shasta,089,179085,53,36,0,36,4
2020-05-24,Sierra,091,2930,1,1,0,1,0
2020-05-24,Siskiyou,093,43540,7,6,0,6,0
2020-05-24,Solano,095,438530,541,436,0,436,5
2020-05-24,Sonoma,097,501317,554,485,0,485,4
2020-05-24,Stanislaus,099,539301,730,634,5,639,27
2020-05-24,Sutter,101,95872,45,38,0,38,2
2020-05-24,Tehama,103,63373,5,2,1,3,1
2020-05-24,Trinity,105,12862,6,1,2,3,0
2020-05-24,Tulare,107,460477,2308,1684,10,1694,74
2020-05-24,Tuolumne,109,53932,5,2,0,2,0
2020-05-24,Ventura,111,848112,1458,982,8,990,27
2020-05-24,Yolo,113,214977,219,192,0,192,22
2020-05-24,Yuba,115,75493,26,24,0,24,1
2020-05-23,Alameda,001,1643700,3324,2783,5,2788,91
2020-05-23,Alpine,003,1148,1,1,0,1,0
2020-05-23,Amador,005,37829,10,9,0,9,0
2020-05-23,Butte,007,227075,62,34,3,37,0
2020-05-23,Calaveras,009,45235,15,13,0,13,0
2020-05-23,Colusa,011,21464,7,4,0,4,0
2020-05-23,Contra Costa,013,1133247,1504,1302,1,1303,36
2020-05-23,Del Norte,015,27424,43,10,0,10,0
2020-05-23,El Dorado,017,186661,100,74,1,75,0
2020-05-23,Fresno,019,978130,2802,1447,42,1489,21
2020-05-23,Glenn,021,27897,15,12,0,12,0
2020-05-23,Humboldt,023,135768,105,80,0,80,2
2020-05-23,Imperial,025,180216,2590,1283,4,1287,14
2020-05-23,Inyo,027,18085,19,20,0,20,1
2020-05-23,Kern,029,883053,2388,1806,6,1812,31
2020-05-23,Kings,031,150075,758,444,1,445,2
2020-05-23,Lake,033,64148,23,10,0,10,0
2020-05-23,Lassen,035,31185,8,0,2,2,0
2020-05-23,Los Angeles,037,10098052,53183,44029,21,44050,2069
2020-05-23,Madera,039,155013,186,83,1,84,2
2020-05-23,Marin,041,260295,440,393,1,394,14
2020-05-23,Mariposa,043,17540,16,15,0,15,1
2020-05-23,Mendocino,045,87422,21,13,0,13,0
2020-05-23,Merced,047,269075,365,247,0,247,6
2020-05-23,Modoc,049,8938,0,0,0,0,0
2020-05-23,Mono,051,14174,36,34,0,34,1
2020-05-23,Monterey,053,433212,503,397,1,398,8
2020-05-23,Napa,055,140530,123,101,0,101,3
2020-05-23,Nevada,057,99092,43,41,1,42,1
2020-05-23,Orange,059,3164182,7763,5313,60,5373,113
2020-05-23,Placer,061,380077,215,184,0,184,9
2020-05-23,Plumas,063,18699,4,4,0,4,0
2020-05-23,Riverside,065,2383286,7834,6460,20,6480,284
2020-05-23,Sacramento,067,1510023,1372,1275,1,1276,50
2020-05-23,San Benito,069,59416,81,67,0,67,2
2020-05-23,San Bernardino,071,2135413,5321,4172,4,4176,175
2020-05-23,San Diego,073,3302833,7562,6561,0,6561,249
2020-05-23,San Francisco,075,870044,2491,2312,0,2312,40
2020-05-23,San Joaquin,077,732212,932,759,3,762,33
2020-05-23,San Luis Obispo,079,281455,337,256,4,260,1
2020-05-23,San Mateo,081,765935,2167,1862,2,1864,71
2020-05-23,Santa Barbara,083,443738,1664,1566,9,1575,9
2020-05-23,Santa Clara,085,1922200,3271,2593,12,2605,139
2020-05-23,Santa Cruz,087,273765,214,177,0,177,2
2020-05-23,Shasta,089,179085,53,35,0,35,4
2020-05-23,Sierra,091,2930,1,1,0,1,0
2020-05-23,Siskiyou,093,43540,7,6,0,6,0
2020-05-23,Solano,095,438530,536,435,0,435,5
2020-05-23,Sonoma,097,501317,540,462,0,462,4
2020-05-23,Stanislaus,099,539301,722,625,5,630,27
2020-05-23,Sutter,101,95872,44,38,0,38,2
2020-05-23,Tehama,103,63373,5,2,1,3,1
2020-05-23,Trinity,105,12862,6,1,2,3,0
2020-05-23,Tulare,107,460477,2287,1682,10,1692,73
2020-05-23,Tuolumne,109,53932,5,2,0,2,0
2020-05-23,Ventura,111,848112,1438,961,8,969,27
2020-05-23,Yolo,113,214977,218,188,0,188,22
2020-05-23,Yuba,115,75493,26,24,0,24,1
2020-05-22,Alameda,001,1643700,3270,2722,5,2727,91
2020-05-22,Alpine,003,1148,1,1,0,1,0
2020-05-22,Amador,005,37829,10,9,0,9,0
2020-05-22,Butte,007,227075,60,34,3,37,0
2020-05-22,Calaveras,009,45235,15,13,0,13,0
2020-05-22,Colusa,011,21464,7,4,0,4,0
2020-05-22,Contra Costa,013,1133247,1492,1272,1,1273,36
2020-05-22,Del Norte,015,27424,41,9,0,9,0
2020-05-22,El Dorado,017,186661,97,74,1,75,0
2020-05-22,Fresno,019,978130,2743,1399,41,1440,20
2020-05-22,Glenn,021,27897,15,12,0,12,0
2020-05-22,Humboldt,023,135768,105,80,0,80,2
2020-05-22,Imperial,025,180216,2488,1214,4,1218,14
2020-05-22,Inyo,027,18085,19,20,0,20,1
2020-05-22,Kern,029,883053,2339,1749,6,1755,28
2020-05-22,Kings,031,150075,755,428,1,429,2
2020-05-22,Lake,033,64148,22,10,0,10,0
2020-05-22,Lassen,035,31185,6,0,2,2,0
2020-05-22,Los Angeles,037,10098052,52386,43025,21,43046,2027
2020-05-22,Madera,039,155013,182,82,1,83,2
2020-05-22,Marin,041,260295,436,372,1,373,14
2020-05-22,Mariposa,043,17540,16,15,0,15,1
2020-05-22,Mendocino,045,87422,20,13,0,13,0
2020-05-22,Merced,047,269075,359,233,0,233,6
2020-05-22,Modoc,049,8938,0,0,0,0,0
2020-05-22,Mono,051,14174,36,34,0,34,1
2020-05-22,Monterey,053,433212,492,372,1,373,8
2020-05-22,Napa,055,140530,121,97,0,97,3
2020-05-22,Nevada,057,99092,42,41,1,42,1
2020-05-22,Orange,059,3164182,7566,5144,58,5202,113
2020-05-22,Placer,061,380077,215,181,0,181,9
2020-05-22,Plumas,063,18699,4,4,0,4,0
2020-05-22,Riverside,065,2383286,7719,6351,20,6371,283
2020-05-22,Sacramento,067,1510023,1356,1262,1,1263,50
2020-05-22,San Benito,069,59416,80,64,0,64,2
2020-05-22,San Bernardino,071,2135413,5246,4107,4,4111,173
2020-05-22,San Diego,073,3302833,7476,6436,0,6436,242
2020-05-22,San Francisco,075,870044,2473,2251,0,2251,40
2020-05-22,San Joaquin,077,732212,919,747,3,750,33
2020-05-22,San Luis Obispo,079,281455,336,254,4,258,1
2020-05-22,San Mateo,081,765935,2148,1847,2,1849,71
2020-05-22,Santa Barbara,083,443738,1654,1554,9,1563,9
2020-05-22,Santa Clara,085,1922200,3251,2537,12,2549,139
2020-05-22,Santa Cruz,087,273765,211,171,0,171,2
2020-05-22,Shasta,089,179085,53,34,0,34,4
2020-05-22,Sierra,091,2930,1,0,0,0,0
2020-05-22,Siskiyou,093,43540,7,6,0,6,0
2020-05-22,Solano,095,438530,533,431,0,431,4
2020-05-22,Sonoma,097,501317,536,444,0,444,4
2020-05-22,Stanislaus,099,539301,712,616,5,621,27
2020-05-22,Sutter,101,95872,44,38,0,38,2
2020-05-22,Tehama,103,63373,5,2,0,2,1
2020-05-22,Trinity,105,12862,6,1,2,3,0
2020-05-22,Tulare,107,460477,2257,1662,10,1672,73
2020-05-22,Tuolumne,109,53932,5,2,0,2,0
2020-05-22,Ventura,111,848112,1420,937,8,945,27
2020-05-22,Yolo,113,214977,216,187,0,187,22
2020-05-22,Yuba,115,75493,26,24,0,24,1
2020-05-21,Alameda,001,1643700,3204,2606,5,2611,89
2020-05-21,Alpine,003,1148,1,1,0,1,0
2020-05-21,Amador,005,37829,10,9,0,9,0
2020-05-21,Butte,007,227075,59,31,3,34,0
2020-05-21,Calaveras,009,45235,15,13,0,13,0
2020-05-21,Colusa,011,21464,7,4,0,4,0
2020-05-21,Contra Costa,013,1133247,1456,1243,1,1244,36
2020-05-21,Del Norte,015,27424,38,9,0,9,0
2020-05-21,El Dorado,017,186661,95,67,1,68,0
2020-05-21,Fresno,019,978130,2653,1362,40,1402,20
2020-05-21,Glenn,021,27897,14,12,0,12,0
2020-05-21,Humboldt,023,135768,104,79,0,79,0
2020-05-21,Imperial,025,180216,2327,1096,4,1100,14
2020-05-21,Inyo,027,18085,19,20,0,20,1
2020-05-21,Kern,029,883053,2263,1684,5,1689,27
2020-05-21,Kings,031,150075,734,417,1,418,2
2020-05-21,Lake,033,64148,17,10,0,10,0
2020-05-21,Lassen,035,31185,6,0,2,2,0
2020-05-21,Los Angeles,037,10098052,51346,42063,21,42084,1996
2020-05-21,Madera,039,155013,179,82,1,83,2
2020-05-21,Marin,041,260295,425,359,1,360,14
2020-05-21,Mariposa,043,17540,16,15,0,15,1
2020-05-21,Mendocino,045,87422,20,12,0,12,0
2020-05-21,Merced,047,269075,351,226,0,226,6
2020-05-21,Modoc,049,8938,0,0,0,0,0
2020-05-21,Mono,051,14174,36,33,0,33,1
2020-05-21,Monterey,053,433212,481,363,1,364,8
2020-05-21,Napa,055,140530,119,96,0,96,3
2020-05-21,Nevada,057,99092,42,41,1,42,1
2020-05-21,Orange,059,3164182,7363,4975,58,5033,106
2020-05-21,Placer,061,380077,208,176,0,176,8
2020-05-21,Plumas,063,18699,4,4,0,4,0
2020-05-21,Riverside,065,2383286,7532,6245,20,6265,279
2020-05-21,Sacramento,067,1510023,1343,1258,1,1259,56
2020-05-21,San Benito,069,59416,77,61,0,61,2
2020-05-21,San Bernardino,071,2135413,5099,3950,4,3954,167
2020-05-21,San Diego,073,3302833,7340,6317,0,6317,241
2020-05-21,San Francisco,075,870044,2449,2248,0,2248,37
2020-05-21,San Joaquin,077,732212,883,730,3,733,33
2020-05-21,San Luis Obispo,079,281455,336,251,3,254,1
2020-05-21,San Mateo,081,765935,2112,1791,2,1793,74
2020-05-21,Santa Barbara,083,443738,1639,1541,9,1550,10
2020-05-21,Santa Clara,085,1922200,3229,2520,12,2532,138
2020-05-21,Santa Cruz,087,273765,203,164,0,164,3
2020-05-21,Shasta,089,179085,51,34,0,34,4
2020-05-21,Sierra,091,2930,1,0,0,0,0
2020-05-21,Siskiyou,093,43540,7,6,0,6,0
2020-05-21,Solano,095,438530,524,424,0,424,4
2020-05-21,Sonoma,097,501317,518,427,0,427,4
2020-05-21,Stanislaus,099,539301,700,602,5,607,27
2020-05-21,Sutter,101,95872,43,38,0,38,2
2020-05-21,Tehama,103,63373,4,2,0,2,1
2020-05-21,Trinity,105,12862,5,1,2,3,0
2020-05-21,Tulare,107,460477,2207,1606,8,1614,73
2020-05-21,Tuolumne,109,53932,3,2,0,2,0
2020-05-21,Ventura,111,848112,1371,907,8,915,30
2020-05-21,Yolo,113,214977,213,185,0,185,22
2020-05-21,Yuba,115,75493,26,24,0,24,1
2020-05-20,Alameda,001,1643700,3131,2554,5,2559,89
2020-05-20,Alpine,003,1148,1,1,0,1,0
2020-05-20,Amador,005,37829,10,9,0,9,0
2020-05-20,Butte,007,227075,56,30,3,33,0
2020-05-20,Calaveras,009,45235,15,13,0,13,0
2020-05-20,Colusa,011,21464,7,3,0,3,0
2020-05-20,Contra Costa,013,1133247,1426,1223,1,1224,33
2020-05-20,Del Norte,015,27424,31,9,0,9,0
2020-05-20,El Dorado,017,186661,94,67,1,68,0
2020-05-20,Fresno,019,978130,2580,1329,39,1368,17
2020-05-20,Glenn,021,27897,13,12,0,12,0
2020-05-20,Humboldt,023,135768,101,73,0,73,0
2020-05-20,Imperial,025,180216,2213,1047,4,1051,14
2020-05-20,Inyo,027,18085,19,20,0,20,1
2020-05-20,Kern,029,883053,2200,1639,4,1643,27
2020-05-20,Kings,031,150075,590,403,1,404,2
2020-05-20,Lake,033,64148,17,9,0,9,0
2020-05-20,Lassen,035,31185,5,0,2,2,0
2020-05-20,Los Angeles,037,10098052,50356,40932,21,40953,1955
2020-05-20,Madera,039,155013,177,82,1,83,2
2020-05-20,Marin,041,260295,398,348,1,349,14
2020-05-20,Mariposa,043,17540,16,15,0,15,1
2020-05-20,Mendocino,045,87422,20,12,0,12,0
2020-05-20,Merced,047,269075,346,225,0,225,6
2020-05-20,Modoc,049,8938,0,0,0,0,0
2020-05-20,Mono,051,14174,36,33,0,33,1
2020-05-20,Monterey,053,433212,467,356,1,357,8
2020-05-20,Napa,055,140530,112,93,0,93,3
2020-05-20,Nevada,057,99092,42,41,1,42,1
2020-05-20,Orange,059,3164182,7155,4866,56,4922,96
2020-05-20,Placer,061,380077,206,176,0,176,8
2020-05-20,Plumas,063,18699,4,4,0,4,0
2020-05-20,Riverside,065,2383286,7389,6090,20,6110,265
2020-05-20,Sacramento,067,1510023,1333,1244,1,1245,56
2020-05-20,San Benito,069,59416,76,61,0,61,2
2020-05-20,San Bernardino,071,2135413,4971,3771,4,3775,161
2020-05-20,San Diego,073,3302833,7223,6142,0,6142,230
2020-05-20,San Francisco,075,870044,2426,2199,0,2199,37
2020-05-20,San Joaquin,077,732212,847,713,3,716,33
2020-05-20,San Luis Obispo,079,281455,329,249,3,252,1
2020-05-20,San Mateo,081,765935,2059,1739,2,1741,74
2020-05-20,Santa Barbara,083,443738,1620,1524,9,1533,10
2020-05-20,Santa Clara,085,1922200,3208,2508,11,2519,138
2020-05-20,Santa Cruz,087,273765,200,163,0,163,3
2020-05-20,Shasta,089,179085,51,34,0,34,4
2020-05-20,Sierra,091,2930,1,0,0,0,0
2020-05-20,Siskiyou,093,43540,7,6,0,6,0
2020-05-20,Solano,095,438530,519,418,0,418,4
2020-05-20,Sonoma,097,501317,509,411,0,411,4
2020-05-20,Stanislaus,099,539301,684,584,4,588,25
2020-05-20,Sutter,101,95872,43,38,0,38,2
2020-05-20,Tehama,103,63373,4,2,0,2,1
2020-05-20,Trinity,105,12862,4,1,1,2,0
2020-05-20,Tulare,107,460477,2166,1585,8,1593,71
2020-05-20,Tuolumne,109,53932,3,2,0,2,0
2020-05-20,Ventura,111,848112,1335,879,8,887,29
2020-05-20,Yolo,113,214977,210,184,0,184,22
2020-05-20,Yuba,115,75493,26,23,0,23,1
2020-05-19,Alameda,001,1643700,3054,2493,3,2496,88
2020-05-19,Alpine,003,1148,1,1,0,1,0
2020-05-19,Amador,005,37829,10,9,0,9,0
2020-05-19,Butte,007,227075,54,25,3,28,0
2020-05-19,Calaveras,009,45235,15,13,0,13,0
2020-05-19,Colusa,011,21464,5,3,0,3,0
2020-05-19,Contra Costa,013,1133247,1402,1205,1,1206,33
2020-05-19,Del Norte,015,27424,28,8,0,8,0
2020-05-19,El Dorado,017,186661,91,67,0,67,0
2020-05-19,Fresno,019,978130,2467,1288,38,1326,15
2020-05-19,Glenn,021,27897,13,12,0,12,0
2020-05-19,Humboldt,023,135768,101,72,0,72,0
2020-05-19,Imperial,025,180216,2052,1012,4,1016,14
2020-05-19,Inyo,027,18085,19,20,0,20,1
2020-05-19,Kern,029,883053,2102,1601,4,1605,26
2020-05-19,Kings,031,150075,579,393,1,394,2
2020-05-19,Lake,033,64148,14,11,0,11,0
2020-05-19,Lassen,035,31185,5,0,2,2,0
2020-05-19,Los Angeles,037,10098052,49151,39670,21,39691,1906
2020-05-19,Madera,039,155013,173,80,1,81,2
2020-05-19,Marin,041,260295,374,340,1,341,14
2020-05-19,Mariposa,043,17540,16,15,0,15,1
2020-05-19,Mendocino,045,87422,20,12,0,12,0
2020-05-19,Merced,047,269075,338,222,0,222,5
2020-05-19,Modoc,049,8938,0,0,0,0,0
2020-05-19,Mono,051,14174,36,33,0,33,1
2020-05-19,Monterey,053,433212,455,350,1,351,8
2020-05-19,Napa,055,140530,111,93,0,93,3
2020-05-19,Nevada,057,99092,42,41,1,42,1
2020-05-19,Orange,059,3164182,6961,4746,54,4800,90
2020-05-19,Placer,061,380077,204,177,0,177,8
2020-05-19,Plumas,063,18699,4,5,0,5,0
2020-05-19,Riverside,065,2383286,7229,5963,19,5982,265
2020-05-19,Sacramento,067,1510023,1319,1239,1,1240,57
2020-05-19,San Benito,069,59416,74,59,0,59,2
2020-05-19,San Bernardino,071,2135413,4821,3656,4,3660,158
2020-05-19,San Diego,073,3302833,7079,6028,0,6028,222
2020-05-19,San Francisco,075,870044,2392,2186,0,2186,37
2020-05-19,San Joaquin,077,732212,825,705,3,708,33
2020-05-19,San Luis Obispo,079,281455,329,245,3,248,1
2020-05-19,San Mateo,081,765935,2018,1704,2,1706,71
2020-05-19,Santa Barbara,083,443738,1606,1521,9,1530,10
2020-05-19,Santa Clara,085,1922200,3158,2480,11,2491,138
2020-05-19,Santa Cruz,087,273765,189,161,0,161,3
2020-05-19,Shasta,089,179085,51,34,0,34,4
2020-05-19,Sierra,091,2930,0,0,0,0,0
2020-05-19,Siskiyou,093,43540,7,6,0,6,0
2020-05-19,Solano,095,438530,505,415,0,415,4
2020-05-19,Sonoma,097,501317,498,389,0,389,4
2020-05-19,Stanislaus,099,539301,670,582,4,586,25
2020-05-19,Sutter,101,95872,43,38,0,38,2
2020-05-19,Tehama,103,63373,4,2,0,2,1
2020-05-19,Trinity,105,12862,3,1,0,1,0
2020-05-19,Tulare,107,460477,2118,1551,8,1559,68
2020-05-19,Tuolumne,109,53932,3,2,0,2,0
2020-05-19,Ventura,111,848112,1294,861,7,868,28
2020-05-19,Yolo,113,214977,208,183,0,183,22
2020-05-19,Yuba,115,75493,26,23,0,23,1
2020-05-18,Alameda,001,1643700,2981,2442,3,2445,84
2020-05-18,Alpine,003,1148,1,1,0,1,0
2020-05-18,Amador,005,37829,10,8,0,8,0
2020-05-18,Butte,007,227075,52,24,3,27,0
2020-05-18,Calaveras,009,45235,15,13,0,13,0
2020-05-18,Colusa,011,21464,5,3,0,3,0
2020-05-18,Contra Costa,013,1133247,1371,1173,1,1174,33
2020-05-18,Del Norte,015,27424,23,8,0,8,0
2020-05-18,El Dorado,017,186661,89,67,0,67,0
2020-05-18,Fresno,019,978130,2391,1244,37,1281,14
2020-05-18,Glenn,021,27897,13,11,0,11,0
2020-05-18,Humboldt,023,135768,101,70,0,70,0
2020-05-18,Imperial,025,180216,1899,767,4,771,14
2020-05-18,Inyo,027,18085,19,20,0,20,1
2020-05-18,Kern,029,883053,2053,1566,4,1570,26
2020-05-18,Kings,031,150075,548,381,1,382,2
2020-05-18,Lake,033,64148,13,9,0,9,0
2020-05-18,Lassen,035,31185,5,0,2,2,0
2020-05-18,Los Angeles,037,10098052,48125,38477,21,38498,1825
2020-05-18,Madera,039,155013,167,74,1,75,2
2020-05-18,Marin,041,260295,361,329,1,330,14
2020-05-18,Mariposa,043,17540,16,15,0,15,1
2020-05-18,Mendocino,045,87422,15,12,0,12,0
2020-05-18,Merced,047,269075,329,217,0,217,5
2020-05-18,Modoc,049,8938,0,0,0,0,0
2020-05-18,Mono,051,14174,36,33,0,33,1
2020-05-18,Monterey,053,433212,444,345,1,346,8
2020-05-18,Napa,055,140530,107,92,0,92,3
2020-05-18,Nevada,057,99092,42,41,1,42,1
2020-05-18,Orange,059,3164182,6771,4558,52,4610,88
2020-05-18,Placer,061,380077,202,176,0,176,8
2020-05-18,Plumas,063,18699,4,5,0,5,0
2020-05-18,Riverside,065,2383286,7029,5873,18,5891,253
2020-05-18,Sacramento,067,1510023,1313,1233,0,1233,57
2020-05-18,San Benito,069,59416,72,59,0,59,2
2020-05-18,San Bernardino,071,2135413,4674,3558,4,3562,156
2020-05-18,San Diego,073,3302833,6946,5948,0,5948,211
2020-05-18,San Francisco,075,870044,2369,2183,0,2183,36
2020-05-18,San Joaquin,077,732212,813,697,3,700,33
2020-05-18,San Luis Obispo,079,281455,325,243,3,246,1
2020-05-18,San Mateo,081,765935,1980,1701,2,1703,68
2020-05-18,Santa Barbara,083,443738,1595,1501,9,1510,10
2020-05-18,Santa Clara,085,1922200,3125,2468,11,2479,137
2020-05-18,Santa Cruz,087,273765,187,160,0,160,3
2020-05-18,Shasta,089,179085,50,34,0,34,4
2020-05-18,Sierra,091,2930,0,0,0,0,0
2020-05-18,Siskiyou,093,43540,7,6,0,6,0
2020-05-18,Solano,095,438530,495,398,0,398,4
2020-05-18,Sonoma,097,501317,480,387,0,387,4
2020-05-18,Stanislaus,099,539301,658,572,4,576,25
2020-05-18,Sutter,101,95872,43,38,0,38,2
2020-05-18,Tehama,103,63373,4,2,0,2,1
2020-05-18,Trinity,105,12862,3,1,0,1,0
2020-05-18,Tulare,107,460477,2074,1491,8,1499,63
2020-05-18,Tuolumne,109,53932,3,2,0,2,0
2020-05-18,Ventura,111,848112,1271,850,6,856,27
2020-05-18,Yolo,113,214977,203,183,0,183,22
2020-05-18,Yuba,115,75493,26,23,0,23,1
2020-05-17,Alameda,001,1643700,2886,2389,3,2392,83
2020-05-17,Alpine,003,1148,1,1,0,1,0
2020-05-17,Amador,005,37829,10,8,0,8,0
2020-05-17,Butte,007,227075,51,23,3,26,0
2020-05-17,Calaveras,009,45235,15,13,0,13,0
2020-05-17,Colusa,011,21464,3,3,0,3,0
2020-05-17,Contra Costa,013,1133247,1332,1155,1,1156,33
2020-05-17,Del Norte,015,27424,23,7,0,7,0
2020-05-17,El Dorado,017,186661,89,65,0,65,0
2020-05-17,Fresno,019,978130,2286,1213,34,1247,14
2020-05-17,Glenn,021,27897,13,9,0,9,0
2020-05-17,Humboldt,023,135768,94,70,0,70,0
2020-05-17,Imperial,025,180216,1751,715,4,719,14
2020-05-17,Inyo,027,18085,19,20,0,20,1
2020-05-17,Kern,029,883053,1975,1546,3,1549,26
2020-05-17,Kings,031,150075,501,356,1,357,2
2020-05-17,Lake,033,64148,13,7,0,7,0
2020-05-17,Lassen,035,31185,5,0,2,2,0
2020-05-17,Los Angeles,037,10098052,46884,37996,21,38017,1807
2020-05-17,Madera,039,155013,165,69,1,70,2
2020-05-17,Marin,041,260295,350,315,1,316,14
2020-05-17,Mariposa,043,17540,15,15,0,15,1
2020-05-17,Mendocino,045,87422,14,10,0,10,0
2020-05-17,Merced,047,269075,319,214,0,214,5
2020-05-17,Modoc,049,8938,0,0,0,0,0
2020-05-17,Mono,051,14174,36,32,0,32,1
2020-05-17,Monterey,053,433212,424,342,1,343,8
2020-05-17,Napa,055,140530,104,89,0,89,3
2020-05-17,Nevada,057,99092,42,41,1,42,1
2020-05-17,Orange,059,3164182,6591,4466,51,4517,88
2020-05-17,Placer,061,380077,197,175,0,175,8
2020-05-17,Plumas,063,18699,4,4,0,4,0
2020-05-17,Riverside,065,2383286,6856,5776,18,5794,245
2020-05-17,Sacramento,067,1510023,1302,1224,0,1224,56
2020-05-17,San Benito,069,59416,71,59,0,59,2
2020-05-17,San Bernardino,071,2135413,4524,3467,4,3471,155
2020-05-17,San Diego,073,3302833,6814,5838,0,5838,209
2020-05-17,San Francisco,075,870044,2342,2132,0,2132,36
2020-05-17,San Joaquin,077,732212,783,688,3,691,32
2020-05-17,San Luis Obispo,079,281455,323,242,3,245,1
2020-05-17,San Mateo,081,765935,1943,1680,2,1682,68
2020-05-17,Santa Barbara,083,443738,1576,1457,9,1466,10
2020-05-17,Santa Clara,085,1922200,3087,2453,11,2464,135
2020-05-17,Santa Cruz,087,273765,176,155,0,155,3
2020-05-17,Shasta,089,179085,49,34,0,34,4
2020-05-17,Sierra,091,2930,0,0,0,0,0
2020-05-17,Siskiyou,093,43540,7,6,0,6,0
2020-05-17,Solano,095,438530,483,392,0,392,4
2020-05-17,Sonoma,097,501317,459,376,0,376,4
2020-05-17,Stanislaus,099,539301,647,566,4,570,25
2020-05-17,Sutter,101,95872,42,38,0,38,2
2020-05-17,Tehama,103,63373,3,2,0,2,1
2020-05-17,Trinity,105,12862,2,1,0,1,0
2020-05-17,Tulare,107,460477,1998,1430,7,1437,63
2020-05-17,Tuolumne,109,53932,3,2,0,2,0
2020-05-17,Ventura,111,848112,1226,838,6,844,27
2020-05-17,Yolo,113,214977,201,182,0,182,22
2020-05-17,Yuba,115,75493,26,21,0,21,1
2020-05-16,Alameda,001,1643700,2836,2327,3,2330,83
2020-05-16,Alpine,003,1148,1,1,0,1,0
2020-05-16,Amador,005,37829,10,8,0,8,0
2020-05-16,Butte,007,227075,46,22,3,25,0
2020-05-16,Calaveras,009,45235,15,13,0,13,0
2020-05-16,Colusa,011,21464,3,3,0,3,0
2020-05-16,Contra Costa,013,1133247,1314,1136,1,1137,33
2020-05-16,Del Norte,015,27424,19,4,0,4,0
2020-05-16,El Dorado,017,186661,89,65,0,65,0
2020-05-16,Fresno,019,978130,2230,1177,34,1211,14
2020-05-16,Glenn,021,27897,13,9,0,9,0
2020-05-16,Humboldt,023,135768,92,69,0,69,0
2020-05-16,Imperial,025,180216,1686,712,4,716,14
2020-05-16,Inyo,027,18085,19,20,0,20,1
2020-05-16,Kern,029,883053,1939,1509,3,1512,26
2020-05-16,Kings,031,150075,491,356,1,357,2
2020-05-16,Lake,033,64148,13,7,0,7,0
2020-05-16,Lassen,035,31185,4,0,2,2,0
2020-05-16,Los Angeles,037,10098052,46309,37352,21,37373,1778
2020-05-16,Madera,039,155013,163,70,1,71,2
2020-05-16,Marin,041,260295,346,297,1,298,14
2020-05-16,Mariposa,043,17540,15,15,0,15,1
2020-05-16,Mendocino,045,87422,14,10,0,10,0
2020-05-16,Merced,047,269075,317,201,0,201,5
2020-05-16,Modoc,049,8938,0,0,0,0,0
2020-05-16,Mono,051,14174,36,32,0,32,1
2020-05-16,Monterey,053,433212,409,329,1,330,8
2020-05-16,Napa,055,140530,104,86,0,86,3
2020-05-16,Nevada,057,99092,42,41,1,42,1
2020-05-16,Orange,059,3164182,6515,4396,50,4446,87
2020-05-16,Placer,061,380077,195,174,0,174,8
2020-05-16,Plumas,063,18699,4,4,0,4,0
2020-05-16,Riverside,065,2383286,6771,5633,18,5651,243
2020-05-16,Sacramento,067,1510023,1295,1209,0,1209,55
2020-05-16,San Benito,069,59416,66,58,0,58,2
2020-05-16,San Bernardino,071,2135413,4452,3362,4,3366,155
2020-05-16,San Diego,073,3302833,6728,5664,0,5664,209
2020-05-16,San Francisco,075,870044,2319,2094,0,2094,36
2020-05-16,San Joaquin,077,732212,775,668,3,671,32
2020-05-16,San Luis Obispo,079,281455,322,240,3,243,1
2020-05-16,San Mateo,081,765935,1928,1652,2,1654,68
2020-05-16,Santa Barbara,083,443738,1565,1422,9,1431,10
2020-05-16,Santa Clara,085,1922200,3069,2420,11,2431,135
2020-05-16,Santa Cruz,087,273765,173,154,0,154,3
2020-05-16,Shasta,089,179085,49,33,0,33,4
2020-05-16,Sierra,091,2930,0,0,0,0,0
2020-05-16,Siskiyou,093,43540,7,6,0,6,0
2020-05-16,Solano,095,438530,478,392,0,392,4
2020-05-16,Sonoma,097,501317,446,356,0,356,4
2020-05-16,Stanislaus,099,539301,638,546,4,550,24
2020-05-16,Sutter,101,95872,42,35,0,35,2
2020-05-16,Tehama,103,63373,3,2,0,2,1
2020-05-16,Trinity,105,12862,2,1,0,1,0
2020-05-16,Tulare,107,460477,1980,1426,7,1433,63
2020-05-16,Tuolumne,109,53932,3,2,0,2,0
2020-05-16,Ventura,111,848112,1200,813,6,819,25
2020-05-16,Yolo,113,214977,200,181,0,181,22
2020-05-16,Yuba,115,75493,26,21,0,21,1
2020-05-15,Alameda,001,1643700,2802,2289,3,2292,83
2020-05-15,Alpine,003,1148,1,1,0,1,0
2020-05-15,Amador,005,37829,10,8,0,8,0
2020-05-15,Butte,007,227075,44,22,3,25,0
2020-05-15,Calaveras,009,45235,14,13,0,13,0
2020-05-15,Colusa,011,21464,3,3,0,3,0
2020-05-15,Contra Costa,013,1133247,1296,1106,1,1107,33
2020-05-15,Del Norte,015,27424,14,4,0,4,0
2020-05-15,El Dorado,017,186661,89,64,0,64,0
2020-05-15,Fresno,019,978130,2164,1126,34,1160,14
2020-05-15,Glenn,021,27897,13,9,0,9,0
2020-05-15,Humboldt,023,135768,91,60,0,60,0
2020-05-15,Imperial,025,180216,1602,680,0,680,14
2020-05-15,Inyo,027,18085,19,20,0,20,1
2020-05-15,Kern,029,883053,1883,1472,3,1475,25
2020-05-15,Kings,031,150075,488,347,1,348,2
2020-05-15,Lake,033,64148,13,7,0,7,0
2020-05-15,Lassen,035,31185,4,0,2,2,0
2020-05-15,Los Angeles,037,10098052,45521,36317,21,36338,1734
2020-05-15,Madera,039,155013,162,71,1,72,2
2020-05-15,Marin,041,260295,338,295,1,296,14
2020-05-15,Mariposa,043,17540,15,15,0,15,1
2020-05-15,Mendocino,045,87422,14,10,0,10,0
2020-05-15,Merced,047,269075,313,191,0,191,5
2020-05-15,Modoc,049,8938,0,0,0,0,0
2020-05-15,Mono,051,14174,36,31,0,31,1
2020-05-15,Monterey,053,433212,403,321,1,322,8
2020-05-15,Napa,055,140530,104,83,0,83,3
2020-05-15,Nevada,057,99092,42,41,1,42,1
2020-05-15,Orange,059,3164182,6342,4281,50,4331,87
2020-05-15,Placer,061,380077,193,174,0,174,8
2020-05-15,Plumas,063,18699,4,4,0,4,0
2020-05-15,Riverside,065,2383286,6657,5496,18,5514,233
2020-05-15,Sacramento,067,1510023,1285,1203,0,1203,55
2020-05-15,San Benito,069,59416,63,57,0,57,2
2020-05-15,San Bernardino,071,2135413,4374,3225,4,3229,153
2020-05-15,San Diego,073,3302833,6621,5525,0,5525,208
2020-05-15,San Francisco,075,870044,2303,2062,0,2062,36
2020-05-15,San Joaquin,077,732212,769,656,3,659,32
2020-05-15,San Luis Obispo,079,281455,320,237,3,240,1
2020-05-15,San Mateo,081,765935,1906,1612,2,1614,68
2020-05-15,Santa Barbara,083,443738,1556,1409,8,1417,10
2020-05-15,Santa Clara,085,1922200,3026,2395,10,2405,135
2020-05-15,Santa Cruz,087,273765,172,146,0,146,3
2020-05-15,Shasta,089,179085,48,33,0,33,4
2020-05-15,Sierra,091,2930,0,0,0,0,0
2020-05-15,Siskiyou,093,43540,6,5,0,5,0
2020-05-15,Solano,095,438530,474,388,0,388,4
2020-05-15,Sonoma,097,501317,438,349,0,349,4
2020-05-15,Stanislaus,099,539301,631,540,4,544,23
2020-05-15,Sutter,101,95872,41,35,0,35,2
2020-05-15,Tehama,103,63373,3,1,0,1,1
2020-05-15,Trinity,105,12862,2,1,0,1,0
2020-05-15,Tulare,107,460477,1952,1356,7,1363,61
2020-05-15,Tuolumne,109,53932,3,2,0,2,0
2020-05-15,Ventura,111,848112,1182,789,5,794,25
2020-05-15,Yolo,113,214977,199,182,0,182,22
2020-05-15,Yuba,115,75493,26,21,0,21,1
2020-05-14,Alameda,001,1643700,2710,2255,3,2258,80
2020-05-14,Alpine,003,1148,1,1,0,1,0
2020-05-14,Amador,005,37829,10,8,0,8,0
2020-05-14,Butte,007,227075,42,22,3,25,0
2020-05-14,Calaveras,009,45235,14,13,0,13,0
2020-05-14,Colusa,011,21464,3,3,0,3,0
2020-05-14,Contra Costa,013,1133247,1269,1090,1,1091,32
2020-05-14,Del Norte,015,27424,14,4,0,4,0
2020-05-14,El Dorado,017,186661,80,59,0,59,0
2020-05-14,Fresno,019,978130,2104,1038,30,1068,12
2020-05-14,Glenn,021,27897,12,8,0,8,0
2020-05-14,Humboldt,023,135768,89,59,0,59,0
2020-05-14,Imperial,025,180216,1486,652,0,652,13
2020-05-14,Inyo,027,18085,19,20,0,20,1
2020-05-14,Kern,029,883053,1841,1430,3,1433,21
2020-05-14,Kings,031,150075,472,342,1,343,1
2020-05-14,Lake,033,64148,13,7,0,7,0
2020-05-14,Lassen,035,31185,4,0,2,2,0
2020-05-14,Los Angeles,037,10098052,44349,35427,21,35448,1693
2020-05-14,Madera,039,155013,153,69,1,70,2
2020-05-14,Marin,041,260295,320,283,1,284,14
2020-05-14,Mariposa,043,17540,15,15,0,15,0
2020-05-14,Mendocino,045,87422,13,10,0,10,0
2020-05-14,Merced,047,269075,303,182,0,182,3
2020-05-14,Modoc,049,8938,0,0,0,0,0
2020-05-14,Mono,051,14174,36,31,0,31,1
2020-05-14,Monterey,053,433212,393,317,1,318,7
2020-05-14,Napa,055,140530,102,83,0,83,3
2020-05-14,Nevada,057,99092,41,41,1,42,1
2020-05-14,Orange,059,3164182,6167,4163,48,4211,83
2020-05-14,Placer,061,380077,193,172,0,172,8
2020-05-14,Plumas,063,18699,4,4,0,4,0
2020-05-14,Riverside,065,2383286,6473,5339,18,5357,224
2020-05-14,Sacramento,067,1510023,1273,1181,0,1181,55
2020-05-14,San Benito,069,59416,61,56,0,56,2
2020-05-14,San Bernardino,071,2135413,4195,3149,4,3153,149
2020-05-14,San Diego,073,3302833,6486,5393,0,5393,200
2020-05-14,San Francisco,075,870044,2270,2029,0,2029,36
2020-05-14,San Joaquin,077,732212,754,643,3,646,31
2020-05-14,San Luis Obispo,079,281455,317,236,3,239,1
2020-05-14,San Mateo,081,765935,1874,1588,2,1590,67
2020-05-14,Santa Barbara,083,443738,1544,1395,8,1403,11
2020-05-14,Santa Clara,085,1922200,3003,2380,10,2390,134
2020-05-14,Santa Cruz,087,273765,170,145,0,145,3
2020-05-14,Shasta,089,179085,48,33,0,33,4
2020-05-14,Sierra,091,2930,0,0,0,0,0
2020-05-14,Siskiyou,093,43540,6,5,0,5,0
2020-05-14,Solano,095,438530,465,372,0,372,4
2020-05-14,Sonoma,097,501317,421,333,0,333,4
2020-05-14,Stanislaus,099,539301,612,533,4,537,23
2020-05-14,Sutter,101,95872,41,34,0,34,2
2020-05-14,Tehama,103,63373,3,1,0,1,1
2020-05-14,Trinity,105,12862,2,1,0,1,0
2020-05-14,Tulare,107,460477,1913,1317,7,1324,55
2020-05-14,Tuolumne,109,53932,3,2,0,2,0
2020-05-14,Ventura,111,848112,1151,760,5,765,25
2020-05-14,Yolo,113,214977,199,180,0,180,22
2020-05-14,Yuba,115,75493,26,21,0,21,1
2020-05-13,Alameda,001,1643700,2652,2181,3,2184,78
2020-05-13,Alpine,003,1148,1,1,0,1,0
2020-05-13,Amador,005,37829,10,8,0,8,0
2020-05-13,Butte,007,227075,42,21,3,24,0
2020-05-13,Calaveras,009,45235,14,13,0,13,0
2020-05-13,Colusa,011,21464,3,3,0,3,0
2020-05-13,Contra Costa,013,1133247,1247,1082,1,1083,32
2020-05-13,Del Norte,015,27424,13,4,0,4,0
2020-05-13,El Dorado,017,186661,79,58,0,58,0
2020-05-13,Fresno,019,978130,2007,993,30,1023,10
2020-05-13,Glenn,021,27897,11,6,0,6,0
2020-05-13,Humboldt,023,135768,83,58,0,58,0
2020-05-13,Imperial,025,180216,1415,610,0,610,11
2020-05-13,Inyo,027,18085,19,20,0,20,1
2020-05-13,Kern,029,883053,1795,1390,3,1393,19
2020-05-13,Kings,031,150075,458,314,1,315,1
2020-05-13,Lake,033,64148,13,7,0,7,0
2020-05-13,Lassen,035,31185,4,0,2,2,0
2020-05-13,Los Angeles,037,10098052,43037,34574,21,34595,1643
2020-05-13,Madera,039,155013,144,69,1,70,2
2020-05-13,Marin,041,260295,307,278,1,279,14
2020-05-13,Mariposa,043,17540,15,15,0,15,0
2020-05-13,Mendocino,045,87422,13,10,0,10,0
2020-05-13,Merced,047,269075,299,176,0,176,3
2020-05-13,Modoc,049,8938,0,0,0,0,0
2020-05-13,Mono,051,14174,35,31,0,31,1
2020-05-13,Monterey,053,433212,383,309,1,310,6
2020-05-13,Napa,055,140530,102,81,0,81,3
2020-05-13,Nevada,057,99092,41,41,1,42,1
2020-05-13,Orange,059,3164182,5921,4025,46,4071,79
2020-05-13,Placer,061,380077,192,170,0,170,8
2020-05-13,Plumas,063,18699,4,4,0,4,0
2020-05-13,Riverside,065,2383286,6350,5204,18,5222,216
2020-05-13,Sacramento,067,1510023,1258,1173,0,1173,53
2020-05-13,San Benito,069,59416,61,55,0,55,2
2020-05-13,San Bernardino,071,2135413,3939,3064,3,3067,140
2020-05-13,San Diego,073,3302833,6350,5280,0,5280,194
2020-05-13,San Francisco,075,870044,2242,2004,0,2004,35
2020-05-13,San Joaquin,077,732212,733,639,3,642,31
2020-05-13,San Luis Obispo,079,281455,315,231,3,234,1
2020-05-13,San Mateo,081,765935,1842,1550,2,1552,66
2020-05-13,Santa Barbara,083,443738,1533,1382,8,1390,10
2020-05-13,Santa Clara,085,1922200,2983,2370,10,2380,132
2020-05-13,Santa Cruz,087,273765,166,142,0,142,2
2020-05-13,Shasta,089,179085,48,32,0,32,4
2020-05-13,Sierra,091,2930,0,0,0,0,0
2020-05-13,Siskiyou,093,43540,6,5,0,5,0
2020-05-13,Solano,095,438530,452,368,0,368,4
2020-05-13,Sonoma,097,501317,411,330,0,330,4
2020-05-13,Stanislaus,099,539301,603,521,4,525,15
2020-05-13,Sutter,101,95872,41,33,0,33,2
2020-05-13,Tehama,103,63373,3,1,0,1,1
2020-05-13,Trinity,105,12862,2,2,0,2,0
2020-05-13,Tulare,107,460477,1880,1283,7,1290,54
2020-05-13,Tuolumne,109,53932,3,2,0,2,0
2020-05-13,Ventura,111,848112,1120,742,5,747,25
2020-05-13,Yolo,113,214977,197,178,0,178,22
2020-05-13,Yuba,115,75493,24,19,0,19,1
2020-05-12,Alameda,001,1643700,2588,2146,3,2149,74
2020-05-12,Alpine,003,1148,1,1,0,1,0
2020-05-12,Amador,005,37829,10,8,0,8,0
2020-05-12,Butte,007,227075,40,20,3,23,0
2020-05-12,Calaveras,009,45235,13,13,0,13,0
2020-05-12,Colusa,011,21464,3,3,0,3,0
2020-05-12,Contra Costa,013,1133247,1216,1067,1,1068,32
2020-05-12,Del Norte,015,27424,10,3,0,3,0
2020-05-12,El Dorado,017,186661,76,56,0,56,0
2020-05-12,Fresno,019,978130,1923,978,28,1006,9
2020-05-12,Glenn,021,27897,10,6,0,6,0
2020-05-12,Humboldt,023,135768,80,58,0,58,0
2020-05-12,Imperial,025,180216,1286,602,0,602,9
2020-05-12,Inyo,027,18085,19,20,0,20,1
2020-05-12,Kern,029,883053,1754,1363,3,1366,18
2020-05-12,Kings,031,150075,437,302,1,303,1
2020-05-12,Lake,033,64148,13,7,0,7,0
2020-05-12,Lassen,035,31185,4,0,2,2,0
2020-05-12,Los Angeles,037,10098052,42044,33281,20,33301,1601
2020-05-12,Madera,039,155013,138,69,1,70,2
2020-05-12,Marin,041,260295,302,274,1,275,14
2020-05-12,Mariposa,043,17540,15,15,0,15,0
2020-05-12,Mendocino,045,87422,13,10,0,10,0
2020-05-12,Merced,047,269075,286,175,0,175,3
2020-05-12,Modoc,049,8938,0,0,0,0,0
2020-05-12,Mono,051,14174,35,31,0,31,1
2020-05-12,Monterey,053,433212,376,298,1,299,6
2020-05-12,Napa,055,140530,100,80,0,80,3
2020-05-12,Nevada,057,99092,41,41,1,42,1
2020-05-12,Orange,059,3164182,5738,3843,44,3887,78
2020-05-12,Placer,061,380077,191,170,0,170,8
2020-05-12,Plumas,063,18699,4,4,0,4,0
2020-05-12,Riverside,065,2383286,6227,5134,18,5152,210
2020-05-12,Sacramento,067,1510023,1238,1166,0,1166,52
2020-05-12,San Benito,069,59416,61,55,0,55,2
2020-05-12,San Bernardino,071,2135413,3787,2997,3,3000,131
2020-05-12,San Diego,073,3302833,6206,3,0,3,0
2020-05-12,San Francisco,075,870044,2207,1981,0,1981,35
2020-05-12,San Joaquin,077,732212,718,625,3,628,30
2020-05-12,San Luis Obispo,079,281455,312,226,3,229,1
2020-05-12,San Mateo,081,765935,1816,1533,2,1535,66
2020-05-12,Santa Barbara,083,443738,1502,1377,8,1385,10
2020-05-12,Santa Clara,085,1922200,2952,2362,10,2372,131
2020-05-12,Santa Cruz,087,273765,164,141,0,141,2
2020-05-12,Shasta,089,179085,47,33,0,33,4
2020-05-12,Sierra,091,2930,0,0,0,0,0
2020-05-12,Siskiyou,093,43540,6,5,0,5,0
2020-05-12,Solano,095,438530,444,361,0,361,4
2020-05-12,Sonoma,097,501317,388,308,0,308,4
2020-05-12,Stanislaus,099,539301,596,515,4,519,15
2020-05-12,Sutter,101,95872,41,33,0,33,2
2020-05-12,Tehama,103,63373,3,1,0,1,1
2020-05-12,Trinity,105,12862,2,1,0,1,0
2020-05-12,Tulare,107,460477,1848,1261,7,1268,52
2020-05-12,Tuolumne,109,53932,3,2,0,2,0
2020-05-12,Ventura,111,848112,1064,718,5,723,20
2020-05-12,Yolo,113,214977,196,176,0,176,22
2020-05-12,Yuba,115,75493,24,19,0,19,1
2020-05-11,Alameda,001,1643700,2538,2103,3,2106,71
2020-05-11,Alpine,003,1148,1,1,0,1,0
2020-05-11,Amador,005,37829,10,8,0,8,0
2020-05-11,Butte,007,227075,39,19,3,22,0
2020-05-11,Calaveras,009,45235,13,13,0,13,0
2020-05-11,Colusa,011,21464,3,3,0,3,0
2020-05-11,Contra Costa,013,1133247,1202,1052,1,1053,32
2020-05-11,Del Norte,015,27424,8,3,0,3,0
2020-05-11,El Dorado,017,186661,76,55,0,55,0
2020-05-11,Fresno,019,978130,1832,937,27,964,8
2020-05-11,Glenn,021,27897,10,6,0,6,0
2020-05-11,Humboldt,023,135768,77,56,0,56,0
2020-05-11,Imperial,025,180216,1180,562,0,562,9
2020-05-11,Inyo,027,18085,19,20,0,20,1
2020-05-11,Kern,029,883053,1702,1331,3,1334,17
2020-05-11,Kings,031,150075,414,289,0,289,1
2020-05-11,Lake,033,64148,12,7,0,7,0
2020-05-11,Lassen,035,31185,4,0,2,2,0
2020-05-11,Los Angeles,037,10098052,40861,32279,20,32299,1553
2020-05-11,Madera,039,155013,129,68,1,69,2
2020-05-11,Marin,041,260295,293,271,1,272,14
2020-05-11,Mariposa,043,17540,15,15,0,15,0
2020-05-11,Mendocino,045,87422,13,10,0,10,0
2020-05-11,Merced,047,269075,269,158,0,158,3
2020-05-11,Modoc,049,8938,0,0,0,0,0
2020-05-11,Mono,051,14174,35,30,0,30,1
2020-05-11,Monterey,053,433212,373,286,1,287,6
2020-05-11,Napa,055,140530,94,79,0,79,2
2020-05-11,Nevada,057,99092,41,41,1,42,1
2020-05-11,Orange,059,3164182,5523,3699,38,3737,77
2020-05-11,Placer,061,380077,191,170,0,170,8
2020-05-11,Plumas,063,18699,4,4,0,4,0
2020-05-11,Riverside,065,2383286,6069,5082,17,5099,203
2020-05-11,Sacramento,067,1510023,1223,1160,0,1160,52
2020-05-11,San Benito,069,59416,59,52,0,52,2
2020-05-11,San Bernardino,071,2135413,3676,2945,3,2948,124
2020-05-11,San Diego,073,3302833,6053,5067,0,5067,175
2020-05-11,San Francisco,075,870044,2161,1974,0,1974,35
2020-05-11,San Joaquin,077,732212,708,620,3,623,30
2020-05-11,San Luis Obispo,079,281455,310,224,3,227,1
2020-05-11,San Mateo,081,765935,1790,1499,2,1501,66
2020-05-11,Santa Barbara,083,443738,1491,1372,7,1379,10
2020-05-11,Santa Clara,085,1922200,2935,2340,10,2350,129
2020-05-11,Santa Cruz,087,273765,161,140,0,140,2
2020-05-11,Shasta,089,179085,47,31,0,31,4
2020-05-11,Sierra,091,2930,0,0,0,0,0
2020-05-11,Siskiyou,093,43540,6,5,0,5,0
2020-05-11,Solano,095,438530,439,354,0,354,4
2020-05-11,Sonoma,097,501317,378,303,0,303,3
2020-05-11,Stanislaus,099,539301,586,507,4,511,14
2020-05-11,Sutter,101,95872,40,32,0,32,2
2020-05-11,Tehama,103,63373,3,1,0,1,1
2020-05-11,Trinity,105,12862,2,1,0,1,0
2020-05-11,Tulare,107,460477,1799,1203,7,1210,49
2020-05-11,Tuolumne,109,53932,3,2,0,2,0
2020-05-11,Ventura,111,848112,1003,698,4,702,19
2020-05-11,Yolo,113,214977,196,174,0,174,20
2020-05-11,Yuba,115,75493,24,18,0,18,1
2020-05-10,Alameda,001,1643700,2461,2047,3,2050,71
2020-05-10,Alpine,003,1148,1,1,0,1,0
2020-05-10,Amador,005,37829,10,8,0,8,0
2020-05-10,Butte,007,227075,34,18,3,21,0
2020-05-10,Calaveras,009,45235,13,13,0,13,0
2020-05-10,Colusa,011,21464,3,3,0,3,0
2020-05-10,Contra Costa,013,1133247,1188,1046,0,1046,31
2020-05-10,Del Norte,015,27424,7,3,0,3,0
2020-05-10,El Dorado,017,186661,76,55,0,55,0
2020-05-10,Fresno,019,978130,1747,894,27,921,8
2020-05-10,Glenn,021,27897,10,6,0,6,0
2020-05-10,Humboldt,023,135768,73,56,0,56,0
2020-05-10,Imperial,025,180216,1086,509,0,509,7
2020-05-10,Inyo,027,18085,19,20,0,20,1
2020-05-10,Kern,029,883053,1651,1300,2,1302,16
2020-05-10,Kings,031,150075,401,266,0,266,1
2020-05-10,Lake,033,64148,12,7,0,7,0
2020-05-10,Lassen,035,31185,4,0,2,2,0
2020-05-10,Los Angeles,037,10098052,39601,31711,20,31731,1514
2020-05-10,Madera,039,155013,127,65,1,66,2
2020-05-10,Marin,041,260295,285,267,1,268,14
2020-05-10,Mariposa,043,17540,15,15,0,15,0
2020-05-10,Mendocino,045,87422,12,10,0,10,0
2020-05-10,Merced,047,269075,253,154,0,154,3
2020-05-10,Modoc,049,8938,0,0,0,0,0
2020-05-10,Mono,051,14174,35,27,0,27,1
2020-05-10,Monterey,053,433212,359,282,1,283,6
2020-05-10,Napa,055,140530,88,79,0,79,2
2020-05-10,Nevada,057,99092,41,41,1,42,1
2020-05-10,Orange,059,3164182,5380,3627,38,3665,76
2020-05-10,Placer,061,380077,190,168,0,168,8
2020-05-10,Plumas,063,18699,4,4,0,4,0
2020-05-10,Riverside,065,2383286,5947,4951,17,4968,193
2020-05-10,Sacramento,067,1510023,1207,1152,0,1152,52
2020-05-10,San Benito,069,59416,59,52,0,52,2
2020-05-10,San Bernardino,071,2135413,3578,2910,3,2913,121
2020-05-10,San Diego,073,3302833,5901,4928,0,4928,175
2020-05-10,San Francisco,075,870044,2143,1953,0,1953,35
2020-05-10,San Joaquin,077,732212,693,611,3,614,29
2020-05-10,San Luis Obispo,079,281455,307,218,3,221,1
2020-05-10,San Mateo,081,765935,1768,1463,2,1465,65
2020-05-10,Santa Barbara,083,443738,1480,1323,7,1330,10
2020-05-10,Santa Clara,085,1922200,2908,2331,10,2341,129
2020-05-10,Santa Cruz,087,273765,160,139,0,139,2
2020-05-10,Shasta,089,179085,47,31,0,31,4
2020-05-10,Sierra,091,2930,0,0,0,0,0
2020-05-10,Siskiyou,093,43540,5,5,0,5,0
2020-05-10,Solano,095,438530,429,322,0,322,4
2020-05-10,Sonoma,097,501317,368,290,0,290,3
2020-05-10,Stanislaus,099,539301,579,498,4,502,14
2020-05-10,Sutter,101,95872,37,31,0,31,2
2020-05-10,Tehama,103,63373,3,1,0,1,1
2020-05-10,Trinity,105,12862,2,1,0,1,0
2020-05-10,Tulare,107,460477,1728,1143,7,1150,47
2020-05-10,Tuolumne,109,53932,3,2,0,2,0
2020-05-10,Ventura,111,848112,945,690,2,692,19
2020-05-10,Yolo,113,214977,196,173,0,173,20
2020-05-10,Yuba,115,75493,23,17,0,17,1
2020-05-09,Alameda,001,1643700,2418,2011,3,2014,71
2020-05-09,Alpine,003,1148,1,1,0,1,0
2020-05-09,Amador,005,37829,9,8,0,8,0
2020-05-09,Butte,007,227075,33,18,3,21,0
2020-05-09,Calaveras,009,45235,13,13,0,13,0
2020-05-09,Colusa,011,21464,3,3,0,3,0
2020-05-09,Contra Costa,013,1133247,1174,1039,0,1039,31
2020-05-09,Del Norte,015,27424,7,3,0,3,0
2020-05-09,El Dorado,017,186661,73,54,0,54,0
2020-05-09,Fresno,019,978130,1709,861,26,887,8
2020-05-09,Glenn,021,27897,9,6,0,6,0
2020-05-09,Humboldt,023,135768,71,55,0,55,0
2020-05-09,Imperial,025,180216,1029,474,0,474,7
2020-05-09,Inyo,027,18085,19,20,0,20,1
2020-05-09,Kern,029,883053,1615,1262,1,1263,15
2020-05-09,Kings,031,150075,396,264,0,264,1
2020-05-09,Lake,033,64148,12,7,0,7,0
2020-05-09,Lassen,035,31185,4,0,2,2,0
2020-05-09,Los Angeles,037,10098052,38979,31268,20,31288,1499
2020-05-09,Madera,039,155013,126,61,1,62,2
2020-05-09,Marin,041,260295,284,261,1,262,14
2020-05-09,Mariposa,043,17540,15,15,0,15,0
2020-05-09,Mendocino,045,87422,12,10,0,10,0
2020-05-09,Merced,047,269075,249,153,0,153,3
2020-05-09,Modoc,049,8938,0,0,0,0,0
2020-05-09,Mono,051,14174,35,27,0,27,1
2020-05-09,Monterey,053,433212,352,273,0,273,6
2020-05-09,Napa,055,140530,87,78,0,78,2
2020-05-09,Nevada,057,99092,41,41,1,42,1
2020-05-09,Orange,059,3164182,5297,3506,38,3544,75
2020-05-09,Placer,061,380077,189,168,0,168,8
2020-05-09,Plumas,063,18699,4,4,0,4,0
2020-05-09,Riverside,065,2383286,5852,4871,17,4888,183
2020-05-09,Sacramento,067,1510023,1203,1150,0,1150,52
2020-05-09,San Benito,069,59416,58,52,0,52,2
2020-05-09,San Bernardino,071,2135413,3522,2825,3,2828,121
2020-05-09,San Diego,073,3302833,5789,4778,0,4778,175
2020-05-09,San Francisco,075,870044,2128,1944,0,1944,34
2020-05-09,San Joaquin,077,732212,684,605,3,608,28
2020-05-09,San Luis Obispo,079,281455,303,213,3,216,1
2020-05-09,San Mateo,081,765935,1749,1453,2,1455,65
2020-05-09,Santa Barbara,083,443738,1472,1245,7,1252,10
2020-05-09,Santa Clara,085,1922200,2894,2317,10,2327,128
2020-05-09,Santa Cruz,087,273765,159,138,0,138,2
2020-05-09,Shasta,089,179085,47,31,0,31,4
2020-05-09,Sierra,091,2930,0,0,0,0,0
2020-05-09,Siskiyou,093,43540,5,5,0,5,0
2020-05-09,Solano,095,438530,423,321,0,321,4
2020-05-09,Sonoma,097,501317,364,288,0,288,3
2020-05-09,Stanislaus,099,539301,571,491,4,495,12
2020-05-09,Sutter,101,95872,37,31,0,31,2
2020-05-09,Tehama,103,63373,2,1,0,1,1
2020-05-09,Trinity,105,12862,2,1,0,1,0
2020-05-09,Tulare,107,460477,1700,1083,7,1090,47
2020-05-09,Tuolumne,109,53932,3,2,0,2,0
2020-05-09,Ventura,111,848112,924,679,2,681,19
2020-05-09,Yolo,113,214977,196,172,0,172,18
2020-05-09,Yuba,115,75493,23,17,0,17,1
2020-05-08,Alameda,001,1643700,2375,1955,3,1958,70
2020-05-08,Alpine,003,1148,1,1,0,1,0
2020-05-08,Amador,005,37829,9,8,0,8,0
2020-05-08,Butte,007,227075,33,18,3,21,0
2020-05-08,Calaveras,009,45235,13,13,0,13,0
2020-05-08,Colusa,011,21464,3,3,0,3,0
2020-05-08,Contra Costa,013,1133247,1162,1024,0,1024,29
2020-05-08,Del Norte,015,27424,7,3,0,3,0
2020-05-08,El Dorado,017,186661,72,54,0,54,0
2020-05-08,Fresno,019,978130,1667,838,24,862,8
2020-05-08,Glenn,021,27897,8,6,0,6,0
2020-05-08,Humboldt,023,135768,68,54,0,54,0
2020-05-08,Imperial,025,180216,983,467,0,467,7
2020-05-08,Inyo,027,18085,19,20,0,20,1
2020-05-08,Kern,029,883053,1584,1214,1,1215,13
2020-05-08,Kings,031,150075,387,236,0,236,1
2020-05-08,Lake,033,64148,12,7,0,7,0
2020-05-08,Lassen,035,31185,4,0,2,2,0
2020-05-08,Los Angeles,037,10098052,38245,30357,20,30377,1447
2020-05-08,Madera,039,155013,123,57,1,58,2
2020-05-08,Marin,041,260295,284,257,1,258,14
2020-05-08,Mariposa,043,17540,15,15,0,15,0
2020-05-08,Mendocino,045,87422,12,10,0,10,0
2020-05-08,Merced,047,269075,248,151,0,151,3
2020-05-08,Modoc,049,8938,0,0,0,0,0
2020-05-08,Mono,051,14174,32,27,0,27,1
2020-05-08,Monterey,053,433212,344,265,0,265,6
2020-05-08,Napa,055,140530,86,78,0,78,2
2020-05-08,Nevada,057,99092,41,41,1,42,1
2020-05-08,Orange,059,3164182,5150,3395,38,3433,72
2020-05-08,Placer,061,380077,187,166,0,166,8
2020-05-08,Plumas,063,18699,4,4,0,4,0
2020-05-08,Riverside,065,2383286,5752,4672,16,4688,181
2020-05-08,Sacramento,067,1510023,1198,1145,0,1145,51
2020-05-08,San Benito,069,59416,58,51,0,51,2
2020-05-08,San Bernardino,071,2135413,3474,2631,3,2634,119
2020-05-08,San Diego,073,3302833,5682,4664,0,4664,169
2020-05-08,San Francisco,075,870044,2110,1890,0,1890,33
2020-05-08,San Joaquin,077,732212,677,595,3,598,28
2020-05-08,San Luis Obispo,079,281455,300,210,3,213,1
2020-05-08,San Mateo,081,765935,1664,1423,2,1425,62
2020-05-08,Santa Barbara,083,443738,1463,1054,5,1059,8
2020-05-08,Santa Clara,085,1922200,2871,2285,10,2295,128
2020-05-08,Santa Cruz,087,273765,155,137,0,137,2
2020-05-08,Shasta,089,179085,47,31,0,31,4
2020-05-08,Sierra,091,2930,0,0,0,0,0
2020-05-08,Siskiyou,093,43540,5,5,0,5,0
2020-05-08,Solano,095,438530,418,314,0,314,4
2020-05-08,Sonoma,097,501317,359,285,0,285,3
2020-05-08,Stanislaus,099,539301,557,487,4,491,12
2020-05-08,Sutter,101,95872,37,30,0,30,2
2020-05-08,Tehama,103,63373,2,1,0,1,1
2020-05-08,Trinity,105,12862,2,0,0,0,0
2020-05-08,Tulare,107,460477,1655,1050,6,1056,43
2020-05-08,Tuolumne,109,53932,3,2,0,2,0
2020-05-08,Ventura,111,848112,906,665,2,667,19
2020-05-08,Yolo,113,214977,195,172,0,172,18
2020-05-08,Yuba,115,75493,22,16,0,16,1
2020-05-07,Alameda,001,1643700,2315,1914,3,1917,68
2020-05-07,Alpine,003,1148,1,1,0,1,0
2020-05-07,Amador,005,37829,9,8,0,8,0
2020-05-07,Butte,007,227075,33,19,3,22,0
2020-05-07,Calaveras,009,45235,13,13,0,13,0
2020-05-07,Colusa,011,21464,3,3,0,3,0
2020-05-07,Contra Costa,013,1133247,1148,1005,0,1005,29
2020-05-07,Del Norte,015,27424,6,3,0,3,0
2020-05-07,El Dorado,017,186661,71,54,0,54,0
2020-05-07,Fresno,019,978130,1581,812,23,835,8
2020-05-07,Glenn,021,27897,8,5,0,5,0
2020-05-07,Humboldt,023,135768,67,54,0,54,0
2020-05-07,Imperial,025,180216,919,442,0,442,6
2020-05-07,Inyo,027,18085,19,20,0,20,1
2020-05-07,Kern,029,883053,1540,1176,1,1177,13
2020-05-07,Kings,031,150075,364,219,0,219,1
2020-05-07,Lake,033,64148,11,7,0,7,0
2020-05-07,Lassen,035,31185,4,0,2,2,0
2020-05-07,Los Angeles,037,10098052,37123,29544,20,29564,1399
2020-05-07,Madera,039,155013,119,54,1,55,2
2020-05-07,Marin,041,260295,277,252,1,253,14
2020-05-07,Mariposa,043,17540,15,15,0,15,0
2020-05-07,Mendocino,045,87422,12,10,0,10,0
2020-05-07,Merced,047,269075,236,146,0,146,3
2020-05-07,Modoc,049,8938,0,0,0,0,0
2020-05-07,Mono,051,14174,32,26,0,26,1
2020-05-07,Monterey,053,433212,336,249,0,249,6
2020-05-07,Napa,055,140530,86,78,0,78,2
2020-05-07,Nevada,057,99092,41,41,1,42,1
2020-05-07,Orange,059,3164182,4965,3283,37,3320,69
2020-05-07,Placer,061,380077,187,165,0,165,8
2020-05-07,Plumas,063,18699,4,4,0,4,0
2020-05-07,Riverside,065,2383286,5636,4608,16,4624,170
2020-05-07,Sacramento,067,1510023,1192,1139,0,1139,50
2020-05-07,San Benito,069,59416,58,50,0,50,2
2020-05-07,San Bernardino,071,2135413,3382,2522,3,2525,115
2020-05-07,San Diego,073,3302833,5525,4431,0,4431,165
2020-05-07,San Francisco,075,870044,2079,1852,0,1852,33
2020-05-07,San Joaquin,077,732212,664,583,3,586,28
2020-05-07,San Luis Obispo,079,281455,289,209,3,212,1
2020-05-07,San Mateo,081,765935,1642,1398,2,1400,58
2020-05-07,Santa Barbara,083,443738,1436,720,4,724,8
2020-05-07,Santa Clara,085,1922200,2833,2281,10,2291,127
2020-05-07,Santa Cruz,087,273765,152,136,0,136,2
2020-05-07,Shasta,089,179085,46,31,0,31,4
2020-05-07,Sierra,091,2930,0,0,0,0,0
2020-05-07,Siskiyou,093,43540,5,5,0,5,0
2020-05-07,Solano,095,438530,412,307,0,307,4
2020-05-07,Sonoma,097,501317,347,282,0,282,3
2020-05-07,Stanislaus,099,539301,548,466,4,470,10
2020-05-07,Sutter,101,95872,37,29,0,29,2
2020-05-07,Tehama,103,63373,2,1,0,1,1
2020-05-07,Trinity,105,12862,2,0,0,0,0
2020-05-07,Tulare,107,460477,1587,1001,6,1007,41
2020-05-07,Tuolumne,109,53932,3,2,0,2,0
2020-05-07,Ventura,111,848112,882,647,1,648,19
2020-05-07,Yolo,113,214977,194,172,0,172,18
2020-05-07,Yuba,115,75493,22,16,0,16,1
2020-05-06,Alameda,001,1643700,2277,1864,3,1867,67
2020-05-06,Alpine,003,1148,1,1,0,1,0
2020-05-06,Amador,005,37829,9,8,0,8,0
2020-05-06,Butte,007,227075,32,19,3,22,0
2020-05-06,Calaveras,009,45235,13,13,0,13,0
2020-05-06,Colusa,011,21464,3,3,0,3,0
2020-05-06,Contra Costa,013,1133247,1127,990,0,990,29
2020-05-06,Del Norte,015,27424,6,3,0,3,0
2020-05-06,El Dorado,017,186661,69,53,0,53,0
2020-05-06,Fresno,019,978130,1518,773,21,794,8
2020-05-06,Glenn,021,27897,8,3,0,3,0
2020-05-06,Humboldt,023,135768,66,54,0,54,0
2020-05-06,Imperial,025,180216,851,399,0,399,6
2020-05-06,Inyo,027,18085,19,20,0,20,1
2020-05-06,Kern,029,883053,1484,1112,1,1113,12
2020-05-06,Kings,031,150075,346,208,0,208,1
2020-05-06,Lake,033,64148,11,7,0,7,0
2020-05-06,Lassen,035,31185,4,0,2,2,0
2020-05-06,Los Angeles,037,10098052,36118,28687,20,28707,1347
2020-05-06,Madera,039,155013,117,55,1,56,2
2020-05-06,Marin,041,260295,270,244,1,245,14
2020-05-06,Mariposa,043,17540,15,14,0,14,0
2020-05-06,Mendocino,045,87422,12,10,0,10,0
2020-05-06,Merced,047,269075,229,140,0,140,3
2020-05-06,Modoc,049,8938,0,0,0,0,0
2020-05-06,Mono,051,14174,32,26,0,26,1
2020-05-06,Monterey,053,433212,328,246,0,246,6
2020-05-06,Napa,055,140530,85,78,0,78,2
2020-05-06,Nevada,057,99092,41,41,1,42,1
2020-05-06,Orange,059,3164182,4781,3156,36,3192,66
2020-05-06,Placer,061,380077,184,164,0,164,8
2020-05-06,Plumas,063,18699,4,4,0,4,0
2020-05-06,Riverside,065,2383286,5492,4535,16,4551,163
2020-05-06,Sacramento,067,1510023,1186,1135,0,1135,49
2020-05-06,San Benito,069,59416,57,50,0,50,2
2020-05-06,San Bernardino,071,2135413,3260,2426,2,2428,110
2020-05-06,San Diego,073,3302833,5392,4321,0,4321,158
2020-05-06,San Francisco,075,870044,2054,1804,0,1804,32
2020-05-06,San Joaquin,077,732212,651,581,3,584,28
2020-05-06,San Luis Obispo,079,281455,285,207,3,210,1
2020-05-06,San Mateo,081,765935,1611,1348,2,1350,57
2020-05-06,Santa Barbara,083,443738,1395,565,3,568,8
2020-05-06,Santa Clara,085,1922200,2816,2270,9,2279,127
2020-05-06,Santa Cruz,087,273765,149,135,0,135,2
2020-05-06,Shasta,089,179085,45,31,0,31,4
2020-05-06,Sierra,091,2930,0,0,0,0,0
2020-05-06,Siskiyou,093,43540,5,5,0,5,0
2020-05-06,Solano,095,438530,402,300,0,300,4
2020-05-06,Sonoma,097,501317,331,269,0,269,3
2020-05-06,Stanislaus,099,539301,532,434,4,438,9
2020-05-06,Sutter,101,95872,37,29,0,29,2
2020-05-06,Tehama,103,63373,2,1,0,1,1
2020-05-06,Trinity,105,12862,2,0,0,0,0
2020-05-06,Tulare,107,460477,1539,963,6,969,40
2020-05-06,Tuolumne,109,53932,3,2,0,2,0
2020-05-06,Ventura,111,848112,855,619,1,620,19
2020-05-06,Yolo,113,214977,193,172,0,172,18
2020-05-06,Yuba,115,75493,22,15,0,15,1
2020-05-05,Alameda,001,1643700,2234,1819,3,1822,67
2020-05-05,Alpine,003,1148,1,1,0,1,0
2020-05-05,Amador,005,37829,9,8,0,8,0
2020-05-05,Butte,007,227075,31,19,3,22,0
2020-05-05,Calaveras,009,45235,13,13,0,13,0
2020-05-05,Colusa,011,21464,3,3,0,3,0
2020-05-05,Contra Costa,013,1133247,1109,976,0,976,29
2020-05-05,Del Norte,015,27424,6,3,0,3,0
2020-05-05,El Dorado,017,186661,67,54,0,54,0
2020-05-05,Fresno,019,978130,1445,726,19,745,8
2020-05-05,Glenn,021,27897,8,3,0,3,0
2020-05-05,Humboldt,023,135768,63,54,0,54,0
2020-05-05,Imperial,025,180216,795,389,0,389,6
2020-05-05,Inyo,027,18085,19,20,0,20,1
2020-05-05,Kern,029,883053,1432,1084,1,1085,11
2020-05-05,Kings,031,150075,328,187,0,187,1
2020-05-05,Lake,033,64148,10,7,0,7,0
2020-05-05,Lassen,035,31185,4,0,2,2,0
2020-05-05,Los Angeles,037,10098052,35051,27867,20,27887,1289
2020-05-05,Madera,039,155013,113,53,1,54,2
2020-05-05,Marin,041,260295,264,244,1,245,14
2020-05-05,Mariposa,043,17540,15,14,0,14,0
2020-05-05,Mendocino,045,87422,12,10,0,10,0
2020-05-05,Merced,047,269075,224,141,0,141,3
2020-05-05,Modoc,049,8938,0,0,0,0,0
2020-05-05,Mono,051,14174,32,25,0,25,1
2020-05-05,Monterey,053,433212,314,240,0,240,6
2020-05-05,Napa,055,140530,85,74,0,74,2
2020-05-05,Nevada,057,99092,41,41,1,42,1
2020-05-05,Orange,059,3164182,4657,3041,36,3077,63
2020-05-05,Placer,061,380077,184,162,0,162,8
2020-05-05,Plumas,063,18699,4,4,0,4,0
2020-05-05,Riverside,065,2383286,5382,4309,16,4325,161
2020-05-05,Sacramento,067,1510023,1179,1125,0,1125,48
2020-05-05,San Benito,069,59416,56,50,0,50,2
2020-05-05,San Bernardino,071,2135413,3167,2345,2,2347,104
2020-05-05,San Diego,073,3302833,5249,4162,0,4162,150
2020-05-05,San Francisco,075,870044,2019,1779,0,1779,31
2020-05-05,San Joaquin,077,732212,642,577,3,580,26
2020-05-05,San Luis Obispo,079,281455,283,203,3,206,1
2020-05-05,San Mateo,081,765935,1579,1335,2,1337,56
2020-05-05,Santa Barbara,083,443738,1174,541,3,544,7
2020-05-05,Santa Clara,085,1922200,2770,2249,8,2257,124
2020-05-05,Santa Cruz,087,273765,146,134,0,134,2
2020-05-05,Shasta,089,179085,44,31,0,31,4
2020-05-05,Sierra,091,2930,0,0,0,0,0
2020-05-05,Siskiyou,093,43540,5,5,0,5,0
2020-05-05,Solano,095,438530,386,299,0,299,4
2020-05-05,Sonoma,097,501317,328,263,0,263,3
2020-05-05,Stanislaus,099,539301,520,430,4,434,9
2020-05-05,Sutter,101,95872,36,29,0,29,2
2020-05-05,Tehama,103,63373,2,1,0,1,1
2020-05-05,Trinity,105,12862,2,0,0,0,0
2020-05-05,Tulare,107,460477,1441,869,6,875,40
2020-05-05,Tuolumne,109,53932,3,2,0,2,0
2020-05-05,Ventura,111,848112,831,607,1,608,19
2020-05-05,Yolo,113,214977,191,171,0,171,18
2020-05-05,Yuba,115,75493,22,15,0,15,1
2020-05-04,Alameda,001,1643700,2176,1762,2,1764,65
2020-05-04,Alpine,003,1148,1,1,0,1,0
2020-05-04,Amador,005,37829,8,8,0,8,0
2020-05-04,Butte,007,227075,30,16,2,18,0
2020-05-04,Calaveras,009,45235,13,13,0,13,0
2020-05-04,Colusa,011,21464,3,3,0,3,0
2020-05-04,Contra Costa,013,1133247,1091,949,0,949,28
2020-05-04,Del Norte,015,27424,5,3,0,3,0
2020-05-04,El Dorado,017,186661,66,51,0,51,0
2020-05-04,Fresno,019,978130,1375,680,18,698,8
2020-05-04,Glenn,021,27897,8,4,0,4,0
2020-05-04,Humboldt,023,135768,61,54,0,54,0
2020-05-04,Imperial,025,180216,744,351,0,351,6
2020-05-04,Inyo,027,18085,19,20,0,20,1
2020-05-04,Kern,029,883053,1390,1047,1,1048,8
2020-05-04,Kings,031,150075,311,153,0,153,1
2020-05-04,Lake,033,64148,9,7,0,7,0
2020-05-04,Lassen,035,31185,3,0,2,2,0
2020-05-04,Los Angeles,037,10098052,33767,26243,18,26261,1235
2020-05-04,Madera,039,155013,110,52,1,53,2
2020-05-04,Marin,041,260295,259,244,1,245,13
2020-05-04,Mariposa,043,17540,15,13,0,13,0
2020-05-04,Mendocino,045,87422,12,10,0,10,0
2020-05-04,Merced,047,269075,224,138,0,138,3
2020-05-04,Modoc,049,8938,0,0,0,0,0
2020-05-04,Mono,051,14174,32,25,0,25,1
2020-05-04,Monterey,053,433212,303,237,0,237,6
2020-05-04,Napa,055,140530,85,72,0,72,2
2020-05-04,Nevada,057,99092,41,41,1,42,1
2020-05-04,Orange,059,3164182,4519,2931,33,2964,57
2020-05-04,Placer,061,380077,182,162,0,162,8
2020-05-04,Plumas,063,18699,4,4,0,4,0
2020-05-04,Riverside,065,2383286,5288,4221,16,4237,147
2020-05-04,Sacramento,067,1510023,1169,1119,0,1119,44
2020-05-04,San Benito,069,59416,54,49,0,49,2
2020-05-04,San Bernardino,071,2135413,3027,2184,2,2186,99
2020-05-04,San Diego,073,3302833,5108,4022,0,4022,144
2020-05-04,San Francisco,075,870044,1981,1760,0,1760,31
2020-05-04,San Joaquin,077,732212,628,574,3,577,26
2020-05-04,San Luis Obispo,079,281455,280,202,3,205,1
2020-05-04,San Mateo,081,765935,1554,1313,2,1315,53
2020-05-04,Santa Barbara,083,443738,927,524,3,527,7
2020-05-04,Santa Clara,085,1922200,2755,2238,8,2246,119
2020-05-04,Santa Cruz,087,273765,145,133,0,133,2
2020-05-04,Shasta,089,179085,42,31,0,31,4
2020-05-04,Sierra,091,2930,0,0,0,0,0
2020-05-04,Siskiyou,093,43540,5,5,0,5,0
2020-05-04,Solano,095,438530,372,293,0,293,4
2020-05-04,Sonoma,097,501317,314,256,0,256,4
2020-05-04,Stanislaus,099,539301,514,422,4,426,8
2020-05-04,Sutter,101,95872,33,28,0,28,2
2020-05-04,Tehama,103,63373,2,1,0,1,1
2020-05-04,Trinity,105,12862,1,0,0,0,0
2020-05-04,Tulare,107,460477,1362,760,6,766,40
2020-05-04,Tuolumne,109,53932,3,3,0,3,0
2020-05-04,Ventura,111,848112,810,590,1,591,19
2020-05-04,Yolo,113,214977,190,171,0,171,18
2020-05-04,Yuba,115,75493,19,16,0,16,1
2020-05-03,Alameda,001,1643700,2118,1731,2,1733,64
2020-05-03,Alpine,003,1148,1,1,0,1,0
2020-05-03,Amador,005,37829,8,8,0,8,0
2020-05-03,Butte,007,227075,30,17,2,19,0
2020-05-03,Calaveras,009,45235,13,13,0,13,0
2020-05-03,Colusa,011,21464,3,3,0,3,0
2020-05-03,Contra Costa,013,1133247,1075,945,0,945,28
2020-05-03,Del Norte,015,27424,5,3,0,3,0
2020-05-03,El Dorado,017,186661,64,49,0,49,0
2020-05-03,Fresno,019,978130,1282,646,15,661,8
2020-05-03,Glenn,021,27897,7,5,0,5,0
2020-05-03,Humboldt,023,135768,60,54,0,54,0
2020-05-03,Imperial,025,180216,688,351,0,351,6
2020-05-03,Inyo,027,18085,19,20,0,20,1
2020-05-03,Kern,029,883053,1335,1025,1,1026,8
2020-05-03,Kings,031,150075,291,137,0,137,1
2020-05-03,Lake,033,64148,9,7,0,7,0
2020-05-03,Lassen,035,31185,3,0,2,2,0
2020-05-03,Los Angeles,037,10098052,32810,25708,17,25725,1210
2020-05-03,Madera,039,155013,103,46,1,47,2
2020-05-03,Marin,041,260295,254,243,1,244,13
2020-05-03,Mariposa,043,17540,15,13,0,13,0
2020-05-03,Mendocino,045,87422,12,10,0,10,0
2020-05-03,Merced,047,269075,217,134,0,134,3
2020-05-03,Modoc,049,8938,0,0,0,0,0
2020-05-03,Mono,051,14174,32,25,0,25,1
2020-05-03,Monterey,053,433212,294,235,0,235,6
2020-05-03,Napa,055,140530,85,72,0,72,2
2020-05-03,Nevada,057,99092,41,41,1,42,1
2020-05-03,Orange,059,3164182,4345,2859,32,2891,55
2020-05-03,Placer,061,380077,182,161,0,161,8
2020-05-03,Plumas,063,18699,4,4,0,4,0
2020-05-03,Riverside,065,2383286,5183,4034,16,4050,139
2020-05-03,Sacramento,067,1510023,1160,1109,0,1109,43
2020-05-03,San Benito,069,59416,54,49,0,49,2
2020-05-03,San Bernardino,071,2135413,2967,2123,2,2125,99
2020-05-03,San Diego,073,3302833,4971,3929,0,3929,142
2020-05-03,San Francisco,075,870044,1952,1692,0,1692,30
2020-05-03,San Joaquin,077,732212,621,570,3,573,26
2020-05-03,San Luis Obispo,079,281455,277,200,3,203,1
2020-05-03,San Mateo,081,765935,1526,1277,2,1279,53
2020-05-03,Santa Barbara,083,443738,568,512,3,515,7
2020-05-03,Santa Clara,085,1922200,2718,2235,8,2243,116
2020-05-03,Santa Cruz,087,273765,145,133,0,133,2
2020-05-03,Shasta,089,179085,40,31,0,31,4
2020-05-03,Sierra,091,2930,0,0,0,0,0
2020-05-03,Siskiyou,093,43540,5,5,0,5,0
2020-05-03,Solano,095,438530,362,266,0,266,4
2020-05-03,Sonoma,097,501317,305,254,0,254,4
2020-05-03,Stanislaus,099,539301,486,411,4,415,8
2020-05-03,Sutter,101,95872,31,28,0,28,2
2020-05-03,Tehama,103,63373,2,1,0,1,1
2020-05-03,Trinity,105,12862,1,0,0,0,0
2020-05-03,Tulare,107,460477,1283,736,6,742,40
2020-05-03,Tuolumne,109,53932,3,3,0,3,0
2020-05-03,Ventura,111,848112,776,583,1,584,19
2020-05-03,Yolo,113,214977,189,171,0,171,18
2020-05-03,Yuba,115,75493,19,16,0,16,1
2020-05-02,Alameda,001,1643700,2081,1678,2,1680,63
2020-05-02,Alpine,003,1148,1,1,0,1,0
2020-05-02,Amador,005,37829,8,8,0,8,0
2020-05-02,Butte,007,227075,30,17,2,19,0
2020-05-02,Calaveras,009,45235,13,13,0,13,0
2020-05-02,Colusa,011,21464,3,3,0,3,0
2020-05-02,Contra Costa,013,1133247,1057,929,0,929,28
2020-05-02,Del Norte,015,27424,5,3,0,3,0
2020-05-02,El Dorado,017,186661,64,47,0,47,0
2020-05-02,Fresno,019,978130,1257,629,14,643,8
2020-05-02,Glenn,021,27897,7,5,0,5,0
2020-05-02,Humboldt,023,135768,60,54,0,54,0
2020-05-02,Imperial,025,180216,661,345,0,345,6
2020-05-02,Inyo,027,18085,19,20,0,20,1
2020-05-02,Kern,029,883053,1309,1007,1,1008,8
2020-05-02,Kings,031,150075,288,120,0,120,1
2020-05-02,Lake,033,64148,9,7,0,7,0
2020-05-02,Lassen,035,31185,3,0,2,2,0
2020-05-02,Los Angeles,037,10098052,32280,24955,17,24972,1192
2020-05-02,Madera,039,155013,103,46,1,47,2
2020-05-02,Marin,041,260295,253,243,1,244,13
2020-05-02,Mariposa,043,17540,15,13,0,13,0
2020-05-02,Mendocino,045,87422,12,10,0,10,0
2020-05-02,Merced,047,269075,212,131,0,131,3
2020-05-02,Modoc,049,8938,0,0,0,0,0
2020-05-02,Mono,051,14174,32,25,0,25,1
2020-05-02,Monterey,053,433212,288,225,0,225,5
2020-05-02,Napa,055,140530,85,71,0,71,2
2020-05-02,Nevada,057,99092,41,41,1,42,1
2020-05-02,Orange,059,3164182,4231,2774,32,2806,52
2020-05-02,Placer,061,380077,180,150,0,150,8
2020-05-02,Plumas,063,18699,4,4,0,4,0
2020-05-02,Riverside,065,2383286,5117,3997,16,4013,137
2020-05-02,Sacramento,067,1510023,1157,1097,0,1097,43
2020-05-02,San Benito,069,59416,54,49,0,49,2
2020-05-02,San Bernardino,071,2135413,2928,2124,2,2126,99
2020-05-02,San Diego,073,3302833,4869,3844,0,3844,138
2020-05-02,San Francisco,075,870044,1929,1632,0,1632,29
2020-05-02,San Joaquin,077,732212,613,559,3,562,25
2020-05-02,San Luis Obispo,079,281455,271,193,3,196,1
2020-05-02,San Mateo,081,765935,1510,1272,2,1274,52
2020-05-02,Santa Barbara,083,443738,560,506,3,509,7
2020-05-02,Santa Clara,085,1922200,2708,2203,8,2211,115
2020-05-02,Santa Cruz,087,273765,144,131,0,131,2
2020-05-02,Shasta,089,179085,40,31,0,31,4
2020-05-02,Sierra,091,2930,0,0,0,0,0
2020-05-02,Siskiyou,093,43540,5,5,0,5,0
2020-05-02,Solano,095,438530,355,267,0,267,4
2020-05-02,Sonoma,097,501317,302,250,0,250,3
2020-05-02,Stanislaus,099,539301,478,388,4,392,8
2020-05-02,Sutter,101,95872,31,28,0,28,2
2020-05-02,Tehama,103,63373,2,1,0,1,1
2020-05-02,Trinity,105,12862,1,0,0,0,0
2020-05-02,Tulare,107,460477,1240,711,6,717,35
2020-05-02,Tuolumne,109,53932,3,3,0,3,0
2020-05-02,Ventura,111,848112,762,564,1,565,19
2020-05-02,Yolo,113,214977,189,169,0,169,17
2020-05-02,Yuba,115,75493,19,16,0,16,1
2020-05-01,Alameda,001,1643700,2043,1630,2,1632,63
2020-05-01,Alpine,003,1148,1,1,0,1,0
2020-05-01,Amador,005,37829,8,8,0,8,0
2020-05-01,Butte,007,227075,30,17,2,19,0
2020-05-01,Calaveras,009,45235,13,13,0,13,0
2020-05-01,Colusa,011,21464,3,3,0,3,0
2020-05-01,Contra Costa,013,1133247,1043,915,0,915,28
2020-05-01,Del Norte,015,27424,5,3,0,3,0
2020-05-01,El Dorado,017,186661,64,47,0,47,0
2020-05-01,Fresno,019,978130,1226,617,14,631,7
2020-05-01,Glenn,021,27897,7,4,0,4,0
2020-05-01,Humboldt,023,135768,60,54,0,54,0
2020-05-01,Imperial,025,180216,624,337,0,337,6
2020-05-01,Inyo,027,18085,19,20,0,20,1
2020-05-01,Kern,029,883053,1282,972,1,973,8
2020-05-01,Kings,031,150075,271,112,0,112,1
2020-05-01,Lake,033,64148,9,6,0,6,0
2020-05-01,Lassen,035,31185,3,0,2,2,0
2020-05-01,Los Angeles,037,10098052,31524,24306,17,24323,1155
2020-05-01,Madera,039,155013,99,46,1,47,2
2020-05-01,Marin,041,260295,253,242,1,243,13
2020-05-01,Mariposa,043,17540,15,10,0,10,0
2020-05-01,Mendocino,045,87422,12,11,0,11,0
2020-05-01,Merced,047,269075,209,131,0,131,3
2020-05-01,Modoc,049,8938,0,0,0,0,0
2020-05-01,Mono,051,14174,32,25,0,25,1
2020-05-01,Monterey,053,433212,284,222,0,222,5
2020-05-01,Napa,055,140530,85,69,0,69,2
2020-05-01,Nevada,057,99092,41,41,1,42,1
2020-05-01,Orange,059,3164182,4154,2660,30,2690,51
2020-05-01,Placer,061,380077,179,149,0,149,8
2020-05-01,Plumas,063,18699,4,4,0,4,0
2020-05-01,Riverside,065,2383286,5053,3893,16,3909,132
2020-05-01,Sacramento,067,1510023,1152,1081,0,1081,43
2020-05-01,San Benito,069,59416,54,49,0,49,2
2020-05-01,San Bernardino,071,2135413,2873,2084,2,2086,98
2020-05-01,San Diego,073,3302833,4778,3713,0,3713,134
2020-05-01,San Francisco,075,870044,1885,1552,0,1552,29
2020-05-01,San Joaquin,077,732212,609,554,3,557,25
2020-05-01,San Luis Obispo,079,281455,268,186,3,189,1
2020-05-01,San Mateo,081,765935,1488,1222,2,1224,52
2020-05-01,Santa Barbara,083,443738,554,499,2,501,7
2020-05-01,Santa Clara,085,1922200,2696,2176,8,2184,112
2020-05-01,Santa Cruz,087,273765,144,127,0,127,2
2020-05-01,Shasta,089,179085,40,31,0,31,4
2020-05-01,Sierra,091,2930,0,0,0,0,0
2020-05-01,Siskiyou,093,43540,5,5,0,5,0
2020-05-01,Solano,095,438530,347,266,0,266,4
2020-05-01,Sonoma,097,501317,299,242,0,242,3
2020-05-01,Stanislaus,099,539301,473,384,4,388,8
2020-05-01,Sutter,101,95872,31,28,0,28,2
2020-05-01,Tehama,103,63373,2,1,0,1,1
2020-05-01,Trinity,105,12862,1,0,0,0,0
2020-05-01,Tulare,107,460477,1196,685,6,691,32
2020-05-01,Tuolumne,109,53932,3,3,0,3,0
2020-05-01,Ventura,111,848112,749,556,1,557,18
2020-05-01,Yolo,113,214977,189,165,0,165,18
2020-05-01,Yuba,115,75493,19,16,0,16,1
2020-04-30,Alameda,001,1643700,1983,1599,2,1601,60
2020-04-30,Alpine,003,1148,1,1,0,1,0
2020-04-30,Amador,005,37829,8,8,0,8,0
2020-04-30,Butte,007,227075,30,16,2,18,0
2020-04-30,Calaveras,009,45235,13,13,0,13,0
2020-04-30,Colusa,011,21464,3,3,0,3,0
2020-04-30,Contra Costa,013,1133247,1021,900,0,900,25
2020-04-30,Del Norte,015,27424,4,3,0,3,0
2020-04-30,El Dorado,017,186661,64,44,0,44,0
2020-04-30,Fresno,019,978130,1161,562,11,573,7
2020-04-30,Glenn,021,27897,7,4,0,4,0
2020-04-30,Humboldt,023,135768,60,54,0,54,0
2020-04-30,Imperial,025,180216,578,322,0,322,6
2020-04-30,Inyo,027,18085,19,20,0,20,1
2020-04-30,Kern,029,883053,1250,941,1,942,8
2020-04-30,Kings,031,150075,259,87,0,87,1
2020-04-30,Lake,033,64148,9,6,0,6,0
2020-04-30,Lassen,035,31185,3,0,2,2,0
2020-04-30,Los Angeles,037,10098052,30515,23284,17,23301,1099
2020-04-30,Madera,039,155013,88,46,1,47,2
2020-04-30,Marin,041,260295,253,240,1,241,13
2020-04-30,Mariposa,043,17540,15,3,0,3,0
2020-04-30,Mendocino,045,87422,12,11,0,11,0
2020-04-30,Merced,047,269075,202,122,0,122,3
2020-04-30,Modoc,049,8938,0,0,0,0,0
2020-04-30,Mono,051,14174,31,25,0,25,1
2020-04-30,Monterey,053,433212,274,213,0,213,5
2020-04-30,Napa,055,140530,83,69,0,69,2
2020-04-30,Nevada,057,99092,41,41,1,42,1
2020-04-30,Orange,059,3164182,3932,2591,27,2618,46
2020-04-30,Placer,061,380077,178,148,0,148,8
2020-04-30,Plumas,063,18699,4,4,0,4,0
2020-04-30,Riverside,065,2383286,4953,3820,15,3835,124
2020-04-30,Sacramento,067,1510023,1146,1071,0,1071,43
2020-04-30,San Benito,069,59416,54,48,0,48,2
2020-04-30,San Bernardino,071,2135413,2671,2020,2,2022,96
2020-04-30,San Diego,073,3302833,4607,3566,0,3566,124
2020-04-30,San Francisco,075,870044,1851,1518,0,1518,26
2020-04-30,San Joaquin,077,732212,601,548,3,551,25
2020-04-30,San Luis Obispo,079,281455,265,182,3,185,1
2020-04-30,San Mateo,081,765935,1458,1194,2,1196,52
2020-04-30,Santa Barbara,083,443738,542,490,2,492,7
2020-04-30,Santa Clara,085,1922200,2656,2172,8,2180,111
2020-04-30,Santa Cruz,087,273765,143,126,0,126,2
2020-04-30,Shasta,089,179085,39,31,0,31,4
2020-04-30,Sierra,091,2930,0,0,0,0,0
2020-04-30,Siskiyou,093,43540,5,5,0,5,0
2020-04-30,Solano,095,438530,337,262,0,262,4
2020-04-30,Sonoma,097,501317,290,233,0,233,3
2020-04-30,Stanislaus,099,539301,466,378,4,382,7
2020-04-30,Sutter,101,95872,31,28,0,28,2
2020-04-30,Tehama,103,63373,1,1,0,1,1
2020-04-30,Trinity,105,12862,1,0,0,0,0
2020-04-30,Tulare,107,460477,1130,637,6,643,31
2020-04-30,Tuolumne,109,53932,3,3,0,3,0
2020-04-30,Ventura,111,848112,721,547,1,548,18
2020-04-30,Yolo,113,214977,188,164,0,164,16
2020-04-30,Yuba,115,75493,19,15,0,15,1
2020-04-29,Alameda,001,1643700,1925,1564,2,1566,60
2020-04-29,Alpine,003,1148,1,1,0,1,0
2020-04-29,Amador,005,37829,8,8,0,8,0
2020-04-29,Butte,007,227075,30,16,2,18,0
2020-04-29,Calaveras,009,45235,13,13,0,13,0
2020-04-29,Colusa,011,21464,3,3,0,3,0
2020-04-29,Contra Costa,013,1133247,1002,885,0,885,25
2020-04-29,Del Norte,015,27424,4,3,0,3,0
2020-04-29,El Dorado,017,186661,62,44,0,44,0
2020-04-29,Fresno,019,978130,1109,544,11,555,7
2020-04-29,Glenn,021,27897,7,4,0,4,0
2020-04-29,Humboldt,023,135768,60,53,0,53,0
2020-04-29,Imperial,025,180216,548,300,0,300,6
2020-04-29,Inyo,027,18085,19,20,0,20,1
2020-04-29,Kern,029,883053,1207,910,1,911,6
2020-04-29,Kings,031,150075,240,80,0,80,1
2020-04-29,Lake,033,64148,9,6,0,6,0
2020-04-29,Lassen,035,31185,3,0,2,2,0
2020-04-29,Los Angeles,037,10098052,29538,22560,16,22576,1043
2020-04-29,Madera,039,155013,86,45,1,46,2
2020-04-29,Marin,041,260295,250,234,1,235,13
2020-04-29,Mariposa,043,17540,15,1,0,1,0
2020-04-29,Mendocino,045,87422,12,11,0,11,0
2020-04-29,Merced,047,269075,195,116,0,116,3
2020-04-29,Modoc,049,8938,0,0,0,0,0
2020-04-29,Mono,051,14174,31,25,0,25,1
2020-04-29,Monterey,053,433212,266,204,0,204,5
2020-04-29,Napa,055,140530,81,68,0,68,2
2020-04-29,Nevada,057,99092,41,41,1,42,1
2020-04-29,Orange,059,3164182,3798,2421,26,2447,43
2020-04-29,Placer,061,380077,176,145,0,145,8
2020-04-29,Plumas,063,18699,4,4,0,4,0
2020-04-29,Riverside,065,2383286,4876,3700,15,3715,116
2020-04-29,Sacramento,067,1510023,1124,1055,0,1055,41
2020-04-29,San Benito,069,59416,54,48,0,48,2
2020-04-29,San Bernardino,071,2135413,2584,1975,1,1976,91
2020-04-29,San Diego,073,3302833,4465,3434,0,3434,120
2020-04-29,San Francisco,075,870044,1823,1489,0,1489,23
2020-04-29,San Joaquin,077,732212,593,540,3,543,25
2020-04-29,San Luis Obispo,079,281455,263,181,3,184,1
2020-04-29,San Mateo,081,765935,1432,1170,2,1172,50
2020-04-29,Santa Barbara,083,443738,529,477,2,479,7
2020-04-29,Santa Clara,085,1922200,2629,2147,8,2155,108
2020-04-29,Santa Cruz,087,273765,142,124,0,124,2
2020-04-29,Shasta,089,179085,38,31,0,31,4
2020-04-29,Sierra,091,2930,0,0,0,0,0
2020-04-29,Siskiyou,093,43540,5,5,0,5,0
2020-04-29,Solano,095,438530,313,252,0,252,3
2020-04-29,Sonoma,097,501317,282,230,0,230,2
2020-04-29,Stanislaus,099,539301,453,374,4,378,5
2020-04-29,Sutter,101,95872,31,28,0,28,2
2020-04-29,Tehama,103,63373,1,1,0,1,1
2020-04-29,Trinity,105,12862,1,0,0,0,0
2020-04-29,Tulare,107,460477,1057,615,5,620,30
2020-04-29,Tuolumne,109,53932,3,4,0,4,0
2020-04-29,Ventura,111,848112,697,530,1,531,18
2020-04-29,Yolo,113,214977,185,161,0,161,11
2020-04-29,Yuba,115,75493,19,15,0,15,1
2020-04-28,Alameda,001,1643700,1868,1525,2,1527,55
2020-04-28,Alpine,003,1148,1,1,0,1,0
2020-04-28,Amador,005,37829,8,8,0,8,0
2020-04-28,Butte,007,227075,30,16,2,18,0
2020-04-28,Calaveras,009,45235,13,13,0,13,0
2020-04-28,Colusa,011,21464,3,3,0,3,0
2020-04-28,Contra Costa,013,1133247,995,866,0,866,25
2020-04-28,Del Norte,015,27424,4,3,0,3,0
2020-04-28,El Dorado,017,186661,61,43,0,43,0
2020-04-28,Fresno,019,978130,1058,525,9,534,7
2020-04-28,Glenn,021,27897,5,4,0,4,0
2020-04-28,Humboldt,023,135768,59,53,0,53,0
2020-04-28,Imperial,025,180216,515,295,0,295,6
2020-04-28,Inyo,027,18085,19,20,0,20,1
2020-04-28,Kern,029,883053,1164,882,1,883,5
2020-04-28,Kings,031,150075,227,57,0,57,1
2020-04-28,Lake,033,64148,9,6,0,6,0
2020-04-28,Lassen,035,31185,3,0,2,2,0
2020-04-28,Los Angeles,037,10098052,28474,21029,16,21045,984
2020-04-28,Madera,039,155013,86,44,1,45,2
2020-04-28,Marin,041,260295,249,228,1,229,12
2020-04-28,Mariposa,043,17540,15,0,0,0,0
2020-04-28,Mendocino,045,87422,12,10,0,10,0
2020-04-28,Merced,047,269075,188,108,0,108,3
2020-04-28,Modoc,049,8938,0,0,0,0,0
2020-04-28,Mono,051,14174,31,25,0,25,1
2020-04-28,Monterey,053,433212,260,191,0,191,5
2020-04-28,Napa,055,140530,80,67,0,67,2
2020-04-28,Nevada,057,99092,41,41,1,42,1
2020-04-28,Orange,059,3164182,3635,2324,25,2349,42
2020-04-28,Placer,061,380077,166,143,0,143,8
2020-04-28,Plumas,063,18699,4,4,0,4,0
2020-04-28,Riverside,065,2383286,4781,3504,15,3519,113
2020-04-28,Sacramento,067,1510023,1109,1044,0,1044,41
2020-04-28,San Benito,069,59416,52,46,0,46,2
2020-04-28,San Bernardino,071,2135413,2507,1891,1,1892,89
2020-04-28,San Diego,073,3302833,4335,3316,0,3316,118
2020-04-28,San Francisco,075,870044,1788,1471,0,1471,23
2020-04-28,San Joaquin,077,732212,587,532,3,535,25
2020-04-28,San Luis Obispo,079,281455,255,172,3,175,1
2020-04-28,San Mateo,081,765935,1419,1129,2,1131,48
2020-04-28,Santa Barbara,083,443738,524,469,2,471,7
2020-04-28,Santa Clara,085,1922200,2595,2130,8,2138,106
2020-04-28,Santa Cruz,087,273765,142,123,0,123,2
2020-04-28,Shasta,089,179085,38,29,0,29,4
2020-04-28,Sierra,091,2930,0,0,0,0,0
2020-04-28,Siskiyou,093,43540,5,5,0,5,0
2020-04-28,Solano,095,438530,294,246,0,246,3
2020-04-28,Sonoma,097,501317,279,226,0,226,1
2020-04-28,Stanislaus,099,539301,437,330,4,334,5
2020-04-28,Sutter,101,95872,31,25,0,25,2
2020-04-28,Tehama,103,63373,1,1,0,1,1
2020-04-28,Trinity,105,12862,1,0,0,0,0
2020-04-28,Tulare,107,460477,960,579,5,584,30
2020-04-28,Tuolumne,109,53932,3,4,0,4,0
2020-04-28,Ventura,111,848112,677,517,1,518,17
2020-04-28,Yolo,113,214977,185,160,0,160,10
2020-04-28,Yuba,115,75493,19,15,0,15,1
2020-04-27,Alameda,001,1643700,1808,1494,2,1496,53
2020-04-27,Alpine,003,1148,1,1,0,1,0
2020-04-27,Amador,005,37829,8,8,0,8,0
2020-04-27,Butte,007,227075,29,16,2,18,0
2020-04-27,Calaveras,009,45235,13,13,0,13,0
2020-04-27,Colusa,011,21464,3,3,0,3,0
2020-04-27,Contra Costa,013,1133247,983,843,0,843,25
2020-04-27,Del Norte,015,27424,4,3,0,3,0
2020-04-27,El Dorado,017,186661,60,43,0,43,0
2020-04-27,Fresno,019,978130,956,504,8,512,7
2020-04-27,Glenn,021,27897,5,4,0,4,0
2020-04-27,Humboldt,023,135768,59,52,0,52,0
2020-04-27,Imperial,025,180216,485,290,0,290,6
2020-04-27,Inyo,027,18085,19,20,0,20,1
2020-04-27,Kern,029,883053,1125,865,1,866,4
2020-04-27,Kings,031,150075,204,48,0,48,1
2020-04-27,Lake,033,64148,8,6,0,6,0
2020-04-27,Lassen,035,31185,3,0,2,2,0
2020-04-27,Los Angeles,037,10098052,27454,20456,16,20472,931
2020-04-27,Madera,039,155013,84,42,1,43,2
2020-04-27,Marin,041,260295,244,227,1,228,12
2020-04-27,Mariposa,043,17540,14,0,0,0,0
2020-04-27,Mendocino,045,87422,12,10,0,10,0
2020-04-27,Merced,047,269075,185,108,0,108,3
2020-04-27,Modoc,049,8938,0,0,0,0,0
2020-04-27,Mono,051,14174,31,23,0,23,1
2020-04-27,Monterey,053,433212,253,185,0,185,4
2020-04-27,Napa,055,140530,77,64,0,64,2
2020-04-27,Nevada,057,99092,41,39,1,40,1
2020-04-27,Orange,059,3164182,3466,2198,25,2223,42
2020-04-27,Placer,061,380077,166,142,0,142,8
2020-04-27,Plumas,063,18699,4,4,0,4,0
2020-04-27,Riverside,065,2383286,4658,3381,15,3396,100
2020-04-27,Sacramento,067,1510023,1094,1035,0,1035,41
2020-04-27,San Benito,069,59416,50,45,0,45,2
2020-04-27,San Bernardino,071,2135413,2393,1742,1,1743,82
2020-04-27,San Diego,073,3302833,4209,3143,0,3143,113
2020-04-27,San Francisco,075,870044,1734,1453,0,1453,23
2020-04-27,San Joaquin,077,732212,581,522,3,525,25
2020-04-27,San Luis Obispo,079,281455,247,166,3,169,1
2020-04-27,San Mateo,081,765935,1397,1092,2,1094,46
2020-04-27,Santa Barbara,083,443738,516,466,2,468,7
2020-04-27,Santa Clara,085,1922200,2570,2104,7,2111,105
2020-04-27,Santa Cruz,087,273765,142,123,0,123,2
2020-04-27,Shasta,089,179085,38,29,0,29,4
2020-04-27,Sierra,091,2930,0,0,0,0,0
2020-04-27,Siskiyou,093,43540,5,5,0,5,0
2020-04-27,Solano,095,438530,294,222,0,222,3
2020-04-27,Sonoma,097,501317,270,220,0,220,1
2020-04-27,Stanislaus,099,539301,421,316,4,320,5
2020-04-27,Sutter,101,95872,29,26,0,26,2
2020-04-27,Tehama,103,63373,1,1,0,1,1
2020-04-27,Trinity,105,12862,1,0,0,0,0
2020-04-27,Tulare,107,460477,889,535,5,540,28
2020-04-27,Tuolumne,109,53932,3,3,0,3,0
2020-04-27,Ventura,111,848112,658,513,1,514,17
2020-04-27,Yolo,113,214977,182,160,0,160,9
2020-04-27,Yuba,115,75493,19,15,0,15,1
2020-04-26,Alameda,001,1643700,1747,1449,2,1451,52
2020-04-26,Alpine,003,1148,1,1,0,1,0
2020-04-26,Amador,005,37829,8,8,0,8,0
2020-04-26,Butte,007,227075,29,16,2,18,0
2020-04-26,Calaveras,009,45235,13,13,0,13,0
2020-04-26,Colusa,011,21464,3,3,0,3,0
2020-04-26,Contra Costa,013,1133247,967,830,0,830,25
2020-04-26,Del Norte,015,27424,3,3,0,3,0
2020-04-26,El Dorado,017,186661,58,41,0,41,0
2020-04-26,Fresno,019,978130,862,476,7,483,7
2020-04-26,Glenn,021,27897,5,4,0,4,0
2020-04-26,Humboldt,023,135768,59,53,0,53,0
2020-04-26,Imperial,025,180216,450,272,0,272,6
2020-04-26,Inyo,027,18085,19,20,0,20,1
2020-04-26,Kern,029,883053,1075,831,1,832,4
2020-04-26,Kings,031,150075,179,33,0,33,1
2020-04-26,Lake,033,64148,8,6,0,6,0
2020-04-26,Lassen,035,31185,3,0,2,2,0
2020-04-26,Los Angeles,037,10098052,26300,19570,16,19586,901
2020-04-26,Madera,039,155013,82,39,1,40,2
2020-04-26,Marin,041,260295,238,225,1,226,12
2020-04-26,Mariposa,043,17540,14,0,0,0,0
2020-04-26,Mendocino,045,87422,12,5,0,5,0
2020-04-26,Merced,047,269075,169,104,0,104,3
2020-04-26,Modoc,049,8938,0,0,0,0,0
2020-04-26,Mono,051,14174,31,23,0,23,1
2020-04-26,Monterey,053,433212,246,182,0,182,4
2020-04-26,Napa,055,140530,76,62,0,62,2
2020-04-26,Nevada,057,99092,41,37,1,38,1
2020-04-26,Orange,059,3164182,3301,2124,25,2149,40
2020-04-26,Placer,061,380077,165,141,0,141,8
2020-04-26,Plumas,063,18699,4,4,0,4,0
2020-04-26,Riverside,065,2383286,4515,3301,15,3316,95
2020-04-26,Sacramento,067,1510023,1085,1027,0,1027,41
2020-04-26,San Benito,069,59416,50,45,0,45,2
2020-04-26,San Bernardino,071,2135413,2297,1681,1,1682,82
2020-04-26,San Diego,073,3302833,4067,3045,0,3045,111
2020-04-26,San Francisco,075,870044,1695,1403,0,1403,23
2020-04-26,San Joaquin,077,732212,573,514,3,517,25
2020-04-26,San Luis Obispo,079,281455,244,165,3,168,1
2020-04-26,San Mateo,081,765935,1371,1070,2,1072,46
2020-04-26,Santa Barbara,083,443738,509,464,2,466,7
2020-04-26,Santa Clara,085,1922200,2547,2097,6,2103,102
2020-04-26,Santa Cruz,087,273765,142,116,0,116,2
2020-04-26,Shasta,089,179085,35,29,0,29,4
2020-04-26,Sierra,091,2930,0,0,0,0,0
2020-04-26,Siskiyou,093,43540,5,5,0,5,0
2020-04-26,Solano,095,438530,285,205,0,205,3
2020-04-26,Sonoma,097,501317,259,216,0,216,1
2020-04-26,Stanislaus,099,539301,406,294,4,298,4
2020-04-26,Sutter,101,95872,29,26,0,26,2
2020-04-26,Tehama,103,63373,1,1,0,1,1
2020-04-26,Trinity,105,12862,1,0,0,0,0
2020-04-26,Tulare,107,460477,830,497,5,502,28
2020-04-26,Tuolumne,109,53932,3,3,0,3,0
2020-04-26,Ventura,111,848112,640,509,1,510,17
2020-04-26,Yolo,113,214977,181,158,0,158,8
2020-04-26,Yuba,115,75493,18,15,0,15,1
2020-04-25,Alameda,001,1643700,1722,1396,2,1398,52
2020-04-25,Alpine,003,1148,1,1,0,1,0
2020-04-25,Amador,005,37829,8,8,0,8,0
2020-04-25,Butte,007,227075,28,16,2,18,0
2020-04-25,Calaveras,009,45235,13,12,0,12,0
2020-04-25,Colusa,011,21464,3,3,0,3,0
2020-04-25,Contra Costa,013,1133247,953,821,0,821,24
2020-04-25,Del Norte,015,27424,2,2,0,2,0
2020-04-25,El Dorado,017,186661,57,41,0,41,0
2020-04-25,Fresno,019,978130,830,459,6,465,7
2020-04-25,Glenn,021,27897,5,4,0,4,0
2020-04-25,Humboldt,023,135768,59,53,0,53,0
2020-04-25,Imperial,025,180216,433,232,0,232,6
2020-04-25,Inyo,027,18085,19,20,0,20,1
2020-04-25,Kern,029,883053,1044,802,1,803,4
2020-04-25,Kings,031,150075,167,33,0,33,1
2020-04-25,Lake,033,64148,6,6,0,6,0
2020-04-25,Lassen,035,31185,3,0,2,2,0
2020-04-25,Los Angeles,037,10098052,25667,19144,16,19160,881
2020-04-25,Madera,039,155013,79,39,1,40,2
2020-04-25,Marin,041,260295,238,215,1,216,12
2020-04-25,Mariposa,043,17540,14,0,0,0,0
2020-04-25,Mendocino,045,87422,11,5,0,5,0
2020-04-25,Merced,047,269075,167,103,0,103,3
2020-04-25,Modoc,049,8938,0,0,0,0,0
2020-04-25,Mono,051,14174,31,23,0,23,1
2020-04-25,Monterey,053,433212,244,173,0,173,4
2020-04-25,Napa,055,140530,76,60,0,60,2
2020-04-25,Nevada,057,99092,41,37,1,38,1
2020-04-25,Orange,059,3164182,3193,2047,25,2072,40
2020-04-25,Placer,061,380077,165,137,0,137,8
2020-04-25,Plumas,063,18699,4,4,0,4,0
2020-04-25,Riverside,065,2383286,4425,3037,15,3052,93
2020-04-25,Sacramento,067,1510023,1083,1015,0,1015,41
2020-04-25,San Benito,069,59416,50,45,0,45,2
2020-04-25,San Bernardino,071,2135413,2251,1675,1,1676,82
2020-04-25,San Diego,073,3302833,3966,2945,0,2945,111
2020-04-25,San Francisco,075,870044,1670,1341,0,1341,22
2020-04-25,San Joaquin,077,732212,566,497,3,500,24
2020-04-25,San Luis Obispo,079,281455,243,159,3,162,1
2020-04-25,San Mateo,081,765935,1353,1054,2,1056,46
2020-04-25,Santa Barbara,083,443738,502,457,2,459,7
2020-04-25,Santa Clara,085,1922200,2525,2045,5,2050,99
2020-04-25,Santa Cruz,087,273765,142,112,0,112,2
2020-04-25,Shasta,089,179085,35,29,0,29,4
2020-04-25,Sierra,091,2930,0,0,0,0,0
2020-04-25,Siskiyou,093,43540,5,5,0,5,0
2020-04-25,Solano,095,438530,281,203,0,203,3
2020-04-25,Sonoma,097,501317,254,199,0,199,1
2020-04-25,Stanislaus,099,539301,398,276,4,280,4
2020-04-25,Sutter,101,95872,29,24,0,24,2
2020-04-25,Tehama,103,63373,1,1,0,1,1
2020-04-25,Trinity,105,12862,0,0,0,0,0
2020-04-25,Tulare,107,460477,797,478,5,483,28
2020-04-25,Tuolumne,109,53932,3,2,0,2,0
2020-04-25,Ventura,111,848112,626,494,1,495,16
2020-04-25,Yolo,113,214977,181,157,0,157,8
2020-04-25,Yuba,115,75493,17,15,0,15,1
2020-04-24,Alameda,001,1643700,1691,1385,2,1387,50
2020-04-24,Alpine,003,1148,1,1,0,1,0
2020-04-24,Amador,005,37829,8,8,0,8,0
2020-04-24,Butte,007,227075,27,15,2,17,0
2020-04-24,Calaveras,009,45235,13,12,0,12,0
2020-04-24,Colusa,011,21464,3,3,0,3,0
2020-04-24,Contra Costa,013,1133247,944,806,0,806,23
2020-04-24,Del Norte,015,27424,2,2,0,2,0
2020-04-24,El Dorado,017,186661,56,41,0,41,0
2020-04-24,Fresno,019,978130,807,449,6,455,7
2020-04-24,Glenn,021,27897,5,4,0,4,0
2020-04-24,Humboldt,023,135768,59,53,0,53,0
2020-04-24,Imperial,025,180216,416,232,0,232,6
2020-04-24,Inyo,027,18085,19,20,0,20,0
2020-04-24,Kern,029,883053,1020,770,1,771,4
2020-04-24,Kings,031,150075,138,30,0,30,1
2020-04-24,Lake,033,64148,6,6,0,6,0
2020-04-24,Lassen,035,31185,3,0,2,2,0
2020-04-24,Los Angeles,037,10098052,24737,18553,16,18569,836
2020-04-24,Madera,039,155013,79,39,1,40,2
2020-04-24,Marin,041,260295,238,211,1,212,11
2020-04-24,Mariposa,043,17540,8,0,0,0,0
2020-04-24,Mendocino,045,87422,11,5,0,5,0
2020-04-24,Merced,047,269075,164,102,0,102,3
2020-04-24,Modoc,049,8938,0,0,0,0,0
2020-04-24,Mono,051,14174,30,23,0,23,1
2020-04-24,Monterey,053,433212,237,167,0,167,4
2020-04-24,Napa,055,140530,75,59,0,59,2
2020-04-24,Nevada,057,99092,41,36,1,37,1
2020-04-24,Orange,059,3164182,3086,1945,25,1970,39
2020-04-24,Placer,061,380077,163,137,0,137,8
2020-04-24,Plumas,063,18699,4,4,0,4,0
2020-04-24,Riverside,065,2383286,4344,3044,15,3059,87
2020-04-24,Sacramento,067,1510023,1077,1009,0,1009,41
2020-04-24,San Benito,069,59416,50,45,0,45,2
2020-04-24,San Bernardino,071,2135413,2216,1667,1,1668,80
2020-04-24,San Diego,073,3302833,3855,2828,0,2828,102
2020-04-24,San Francisco,075,870044,1612,1345,0,1345,22
2020-04-24,San Joaquin,077,732212,559,484,3,487,24
2020-04-24,San Luis Obispo,079,281455,240,151,3,154,1
2020-04-24,San Mateo,081,765935,1330,1004,2,1006,43
2020-04-24,Santa Barbara,083,443738,496,450,2,452,6
2020-04-24,Santa Clara,085,1922200,2483,2026,5,2031,98
2020-04-24,Santa Cruz,087,273765,138,111,0,111,2
2020-04-24,Shasta,089,179085,35,28,0,28,4
2020-04-24,Sierra,091,2930,0,0,0,0,0
2020-04-24,Siskiyou,093,43540,5,5,0,5,0
2020-04-24,Solano,095,438530,279,203,0,203,3
2020-04-24,Sonoma,097,501317,250,199,0,199,1
2020-04-24,Stanislaus,099,539301,395,273,4,277,4
2020-04-24,Sutter,101,95872,28,24,0,24,2
2020-04-24,Tehama,103,63373,1,1,0,1,1
2020-04-24,Trinity,105,12862,0,0,0,0,0
2020-04-24,Tulare,107,460477,769,459,5,464,27
2020-04-24,Tuolumne,109,53932,3,2,0,2,0
2020-04-24,Ventura,111,848112,616,489,1,490,16
2020-04-24,Yolo,113,214977,180,155,0,155,8
2020-04-24,Yuba,115,75493,16,15,0,15,1
2020-04-23,Alameda,001,1643700,1653,1336,2,1338,46
2020-04-23,Alpine,003,1148,1,1,0,1,0
2020-04-23,Amador,005,37829,8,8,0,8,0
2020-04-23,Butte,007,227075,27,15,2,17,0
2020-04-23,Calaveras,009,45235,13,12,0,12,0
2020-04-23,Colusa,011,21464,3,3,0,3,0
2020-04-23,Contra Costa,013,1133247,923,786,0,786,23
2020-04-23,Del Norte,015,27424,2,2,0,2,0
2020-04-23,El Dorado,017,186661,55,39,0,39,0
2020-04-23,Fresno,019,978130,769,426,6,432,7
2020-04-23,Glenn,021,27897,5,3,0,3,0
2020-04-23,Humboldt,023,135768,59,53,0,53,0
2020-04-23,Imperial,025,180216,397,181,0,181,4
2020-04-23,Inyo,027,18085,19,19,0,19,0
2020-04-23,Kern,029,883053,972,732,1,733,4
2020-04-23,Kings,031,150075,123,28,0,28,1
2020-04-23,Lake,033,64148,6,6,0,6,0
2020-04-23,Lassen,035,31185,3,0,2,2,0
2020-04-23,Los Angeles,037,10098052,23675,17548,15,17563,784
2020-04-23,Madera,039,155013,77,37,1,38,2
2020-04-23,Marin,041,260295,225,209,1,210,11
2020-04-23,Mariposa,043,17540,7,0,0,0,0
2020-04-23,Mendocino,045,87422,9,5,0,5,0
2020-04-23,Merced,047,269075,160,98,0,98,3
2020-04-23,Modoc,049,8938,0,0,0,0,0
2020-04-23,Mono,051,14174,30,23,0,23,1
2020-04-23,Monterey,053,433212,233,161,0,161,4
2020-04-23,Napa,055,140530,68,59,0,59,2
2020-04-23,Nevada,057,99092,41,36,1,37,1
2020-04-23,Orange,059,3164182,2907,1841,24,1865,37
2020-04-23,Placer,061,380077,160,136,0,136,8
2020-04-23,Plumas,063,18699,4,4,0,4,0
2020-04-23,Riverside,065,2383286,4230,2935,14,2949,78
2020-04-23,Sacramento,067,1510023,1065,978,0,978,41
2020-04-23,San Benito,069,59416,47,43,0,43,2
2020-04-23,San Bernardino,071,2135413,2151,1604,1,1605,79
2020-04-23,San Diego,073,3302833,3694,2645,0,2645,100
2020-04-23,San Francisco,075,870044,1587,1312,0,1312,21
2020-04-23,San Joaquin,077,732212,549,479,3,482,20
2020-04-23,San Luis Obispo,079,281455,236,146,3,149,1
2020-04-23,San Mateo,081,765935,1291,970,2,972,42
2020-04-23,Santa Barbara,083,443738,490,445,2,447,6
2020-04-23,Santa Clara,085,1922200,2448,1996,5,2001,95
2020-04-23,Santa Cruz,087,273765,137,110,0,110,2
2020-04-23,Shasta,089,179085,35,27,0,27,3
2020-04-23,Sierra,091,2930,0,0,0,0,0
2020-04-23,Siskiyou,093,43540,5,5,0,5,0
2020-04-23,Solano,095,438530,265,196,0,196,3
2020-04-23,Sonoma,097,501317,238,187,0,187,1
2020-04-23,Stanislaus,099,539301,391,254,4,258,4
2020-04-23,Sutter,101,95872,28,24,0,24,2
2020-04-23,Tehama,103,63373,1,1,0,1,1
2020-04-23,Trinity,105,12862,0,0,0,0,0
2020-04-23,Tulare,107,460477,740,440,5,445,25
2020-04-23,Tuolumne,109,53932,3,2,0,2,0
2020-04-23,Ventura,111,848112,602,479,1,480,16
2020-04-23,Yolo,113,214977,177,151,0,151,8
2020-04-23,Yuba,115,75493,16,15,0,15,1
2020-04-22,Alameda,001,1643700,1604,1275,2,1277,46
2020-04-22,Alpine,003,1148,1,1,0,1,0
2020-04-22,Amador,005,37829,8,7,0,7,0
2020-04-22,Butte,007,227075,26,15,2,17,0
2020-04-22,Calaveras,009,45235,13,12,0,12,0
2020-04-22,Colusa,011,21464,3,3,0,3,0
2020-04-22,Contra Costa,013,1133247,908,772,0,772,22
2020-04-22,Del Norte,015,27424,2,2,0,2,0
2020-04-22,El Dorado,017,186661,55,39,0,39,0
2020-04-22,Fresno,019,978130,729,388,6,394,7
2020-04-22,Glenn,021,27897,5,3,0,3,0
2020-04-22,Humboldt,023,135768,59,53,0,53,0
2020-04-22,Imperial,025,180216,386,170,0,170,3
2020-04-22,Inyo,027,18085,19,18,0,18,0
2020-04-22,Kern,029,883053,950,713,1,714,4
2020-04-22,Kings,031,150075,102,28,0,28,1
2020-04-22,Lake,033,64148,6,6,0,6,0
2020-04-22,Lassen,035,31185,3,0,2,2,0
2020-04-22,Los Angeles,037,10098052,22649,16400,15,16415,715
2020-04-22,Madera,039,155013,75,37,1,38,2
2020-04-22,Marin,041,260295,223,202,1,203,11
2020-04-22,Mariposa,043,17540,6,0,0,0,0
2020-04-22,Mendocino,045,87422,6,5,0,5,0
2020-04-22,Merced,047,269075,146,92,0,92,3
2020-04-22,Modoc,049,8938,0,0,0,0,0
2020-04-22,Mono,051,14174,29,23,0,23,1
2020-04-22,Monterey,053,433212,226,154,0,154,4
2020-04-22,Napa,055,140530,67,58,0,58,2
2020-04-22,Nevada,057,99092,41,36,1,37,1
2020-04-22,Orange,059,3164182,2813,1785,23,1808,36
2020-04-22,Placer,061,380077,158,133,0,133,8
2020-04-22,Plumas,063,18699,4,4,0,4,0
2020-04-22,Riverside,065,2383286,4126,2822,14,2836,76
2020-04-22,Sacramento,067,1510023,1060,959,0,959,36
2020-04-22,San Benito,069,59416,46,43,0,43,2
2020-04-22,San Bernardino,071,2135413,2088,1564,1,1565,74
2020-04-22,San Diego,073,3302833,3566,2493,0,2493,96
2020-04-22,San Francisco,075,870044,1550,1255,0,1255,21
2020-04-22,San Joaquin,077,732212,538,462,3,465,20
2020-04-22,San Luis Obispo,079,281455,227,142,3,145,1
2020-04-22,San Mateo,081,765935,1268,945,2,947,40
2020-04-22,Santa Barbara,083,443738,485,437,2,439,6
2020-04-22,Santa Clara,085,1922200,2432,1969,5,1974,95
2020-04-22,Santa Cruz,087,273765,133,106,0,106,2
2020-04-22,Shasta,089,179085,34,26,0,26,3
2020-04-22,Sierra,091,2930,0,0,0,0,0
2020-04-22,Siskiyou,093,43540,5,5,0,5,0
2020-04-22,Solano,095,438530,247,195,0,195,3
2020-04-22,Sonoma,097,501317,235,185,0,185,1
2020-04-22,Stanislaus,099,539301,334,247,4,251,4
2020-04-22,Sutter,101,95872,28,22,0,22,2
2020-04-22,Tehama,103,63373,1,1,0,1,1
2020-04-22,Trinity,105,12862,0,0,0,0,0
2020-04-22,Tulare,107,460477,706,425,5,430,23
2020-04-22,Tuolumne,109,53932,3,2,0,2,0
2020-04-22,Ventura,111,848112,591,465,1,466,15
2020-04-22,Yolo,113,214977,176,147,0,147,8
2020-04-22,Yuba,115,75493,16,15,0,15,1
2020-04-21,Alameda,001,1643700,1574,1234,2,1236,46
2020-04-21,Alpine,003,1148,1,1,0,1,0
2020-04-21,Amador,005,37829,8,7,0,7,0
2020-04-21,Butte,007,227075,25,15,2,17,0
2020-04-21,Calaveras,009,45235,12,12,0,12,0
2020-04-21,Colusa,011,21464,3,3,0,3,0
2020-04-21,Contra Costa,013,1133247,894,766,0,766,22
2020-04-21,Del Norte,015,27424,2,2,0,2,0
2020-04-21,El Dorado,017,186661,54,36,0,36,0
2020-04-21,Fresno,019,978130,695,372,6,378,7
2020-04-21,Glenn,021,27897,5,3,0,3,0
2020-04-21,Humboldt,023,135768,58,53,0,53,0
2020-04-21,Imperial,025,180216,366,165,0,165,2
2020-04-21,Inyo,027,18085,19,18,0,18,0
2020-04-21,Kern,029,883053,908,676,1,677,4
2020-04-21,Kings,031,150075,88,28,0,28,1
2020-04-21,Lake,033,64148,6,6,0,6,0
2020-04-21,Lassen,035,31185,3,0,2,2,0
2020-04-21,Los Angeles,037,10098052,21786,15096,15,15111,650
2020-04-21,Madera,039,155013,75,37,1,38,2
2020-04-21,Marin,041,260295,217,202,1,203,10
2020-04-21,Mariposa,043,17540,5,0,0,0,0
2020-04-21,Mendocino,045,87422,6,5,0,5,0
2020-04-21,Merced,047,269075,142,89,0,89,3
2020-04-21,Modoc,049,8938,0,0,0,0,0
2020-04-21,Mono,051,14174,29,23,0,23,1
2020-04-21,Monterey,053,433212,223,151,0,151,4
2020-04-21,Napa,055,140530,66,58,0,58,2
2020-04-21,Nevada,057,99092,41,36,1,37,1
2020-04-21,Orange,059,3164182,2690,1717,22,1739,36
2020-04-21,Placer,061,380077,156,133,0,133,8
2020-04-21,Plumas,063,18699,4,4,0,4,0
2020-04-21,Riverside,065,2383286,3994,2631,14,2645,68
2020-04-21,Sacramento,067,1510023,1050,941,0,941,33
2020-04-21,San Benito,069,59416,44,43,0,43,2
2020-04-21,San Bernardino,071,2135413,2028,1499,1,1500,71
2020-04-21,San Diego,073,3302833,3410,2436,0,2436,87
2020-04-21,San Francisco,075,870044,1520,1232,0,1232,20
2020-04-21,San Joaquin,077,732212,528,447,3,450,20
2020-04-21,San Luis Obispo,079,281455,219,134,3,137,1
2020-04-21,San Mateo,081,765935,1222,933,2,935,34
2020-04-21,Santa Barbara,083,443738,476,414,2,416,5
2020-04-21,Santa Clara,085,1922200,2382,1943,5,1948,91
2020-04-21,Santa Cruz,087,273765,131,104,0,104,2
2020-04-21,Shasta,089,179085,33,26,0,26,3
2020-04-21,Sierra,091,2930,0,0,0,0,0
2020-04-21,Siskiyou,093,43540,5,5,0,5,0
2020-04-21,Solano,095,438530,239,193,0,193,3
2020-04-21,Sonoma,097,501317,225,182,0,182,1
2020-04-21,Stanislaus,099,539301,315,235,4,239,4
2020-04-21,Sutter,101,95872,28,22,0,22,2
2020-04-21,Tehama,103,63373,1,1,0,1,1
2020-04-21,Trinity,105,12862,0,0,0,0,0
2020-04-21,Tulare,107,460477,669,410,5,415,23
2020-04-21,Tuolumne,109,53932,3,2,0,2,0
2020-04-21,Ventura,111,848112,579,455,1,456,14
2020-04-21,Yolo,113,214977,174,143,0,143,8
2020-04-21,Yuba,115,75493,16,15,0,15,1
2020-04-20,Alameda,001,1643700,1541,1181,2,1183,42
2020-04-20,Alpine,003,1148,1,1,0,1,0
2020-04-20,Amador,005,37829,8,7,0,7,0
2020-04-20,Butte,007,227075,24,15,2,17,0
2020-04-20,Calaveras,009,45235,12,12,0,12,0
2020-04-20,Colusa,011,21464,3,3,0,3,0
2020-04-20,Contra Costa,013,1133247,884,753,0,753,22
2020-04-20,Del Norte,015,27424,2,2,0,2,0
2020-04-20,El Dorado,017,186661,54,36,0,36,0
2020-04-20,Fresno,019,978130,678,356,6,362,7
2020-04-20,Glenn,021,27897,4,3,0,3,0
2020-04-20,Humboldt,023,135768,58,53,0,53,0
2020-04-20,Imperial,025,180216,347,149,0,149,2
2020-04-20,Inyo,027,18085,19,17,0,17,0
2020-04-20,Kern,029,883053,876,651,1,652,3
2020-04-20,Kings,031,150075,77,19,0,19,1
2020-04-20,Lake,033,64148,6,6,0,6,0
2020-04-20,Lassen,035,31185,3,0,2,2,0
2020-04-20,Los Angeles,037,10098052,20874,13787,15,13802,608
2020-04-20,Madera,039,155013,74,35,1,36,2
2020-04-20,Marin,041,260295,213,200,1,201,10
2020-04-20,Mariposa,043,17540,5,0,0,0,0
2020-04-20,Mendocino,045,87422,6,5,0,5,0
2020-04-20,Merced,047,269075,135,88,0,88,3
2020-04-20,Modoc,049,8938,0,0,0,0,0
2020-04-20,Mono,051,14174,29,23,0,23,1
2020-04-20,Monterey,053,433212,214,147,0,147,4
2020-04-20,Napa,055,140530,66,55,0,55,2
2020-04-20,Nevada,057,99092,41,34,1,35,1
2020-04-20,Orange,059,3164182,2606,1679,22,1701,33
2020-04-20,Placer,061,380077,155,132,0,132,8
2020-04-20,Plumas,063,18699,4,4,0,4,0
2020-04-20,Riverside,065,2383286,3869,2477,14,2491,61
2020-04-20,Sacramento,067,1510023,1040,924,0,924,32
2020-04-20,San Benito,069,59416,44,43,0,43,2
2020-04-20,San Bernardino,071,2135413,1941,1344,1,1345,63
2020-04-20,San Diego,073,3302833,3268,2327,0,2327,72
2020-04-20,San Francisco,075,870044,1488,1223,0,1223,19
2020-04-20,San Joaquin,077,732212,524,422,3,425,17
2020-04-20,San Luis Obispo,079,281455,205,132,3,135,1
2020-04-20,San Mateo,081,765935,1199,890,2,892,31
2020-04-20,Santa Barbara,083,443738,469,388,2,390,4
2020-04-20,Santa Clara,085,1922200,2351,1920,5,1925,84
2020-04-20,Santa Cruz,087,273765,129,102,0,102,2
2020-04-20,Shasta,089,179085,33,26,0,26,3
2020-04-20,Sierra,091,2930,0,0,0,0,0
2020-04-20,Siskiyou,093,43540,5,5,0,5,0
2020-04-20,Solano,095,438530,236,185,0,185,2
2020-04-20,Sonoma,097,501317,217,178,0,178,1
2020-04-20,Stanislaus,099,539301,301,228,4,232,3
2020-04-20,Sutter,101,95872,27,22,0,22,2
2020-04-20,Tehama,103,63373,1,1,0,1,1
2020-04-20,Trinity,105,12862,0,0,0,0,0
2020-04-20,Tulare,107,460477,659,401,5,406,20
2020-04-20,Tuolumne,109,53932,3,2,0,2,0
2020-04-20,Ventura,111,848112,565,426,1,427,13
2020-04-20,Yolo,113,214977,173,125,0,125,5
2020-04-20,Yuba,115,75493,16,15,0,15,1
2020-04-19,Alameda,001,1643700,1491,1134,2,1136,41
2020-04-19,Alpine,003,1148,1,1,0,1,0
2020-04-19,Amador,005,37829,7,7,0,7,0
2020-04-19,Butte,007,227075,23,15,2,17,0
2020-04-19,Calaveras,009,45235,12,12,0,12,0
2020-04-19,Colusa,011,21464,3,3,0,3,0
2020-04-19,Contra Costa,013,1133247,868,731,0,731,20
2020-04-19,Del Norte,015,27424,2,2,0,2,0
2020-04-19,El Dorado,017,186661,54,36,0,36,0
2020-04-19,Fresno,019,978130,642,326,6,332,7
2020-04-19,Glenn,021,27897,4,3,0,3,0
2020-04-19,Humboldt,023,135768,58,53,0,53,0
2020-04-19,Imperial,025,180216,319,144,0,144,2
2020-04-19,Inyo,027,18085,19,17,0,17,0
2020-04-19,Kern,029,883053,851,629,1,630,3
2020-04-19,Kings,031,150075,67,17,0,17,1
2020-04-19,Lake,033,64148,6,6,0,6,0
2020-04-19,Lassen,035,31185,3,0,2,2,0
2020-04-19,Los Angeles,037,10098052,19867,12299,15,12314,589
2020-04-19,Madera,039,155013,72,34,1,35,2
2020-04-19,Marin,041,260295,212,194,1,195,10
2020-04-19,Mariposa,043,17540,2,0,0,0,0
2020-04-19,Mendocino,045,87422,6,4,0,4,0
2020-04-19,Merced,047,269075,130,85,0,85,3
2020-04-19,Modoc,049,8938,0,0,0,0,0
2020-04-19,Mono,051,14174,29,23,0,23,1
2020-04-19,Monterey,053,433212,205,140,0,140,4
2020-04-19,Napa,055,140530,64,49,0,49,2
2020-04-19,Nevada,057,99092,40,34,1,35,1
2020-04-19,Orange,059,3164182,2509,1591,21,1612,32
2020-04-19,Placer,061,380077,154,131,0,131,8
2020-04-19,Plumas,063,18699,4,4,0,4,0
2020-04-19,Riverside,065,2383286,3726,2316,14,2330,56
2020-04-19,Sacramento,067,1510023,1013,912,0,912,32
2020-04-19,San Benito,069,59416,42,40,0,40,2
2020-04-19,San Bernardino,071,2135413,1878,1262,1,1263,58
2020-04-19,San Diego,073,3302833,3101,2270,0,2270,71
2020-04-19,San Francisco,075,870044,1455,1153,0,1153,19
2020-04-19,San Joaquin,077,732212,506,404,3,407,17
2020-04-19,San Luis Obispo,079,281455,200,132,3,135,1
2020-04-19,San Mateo,081,765935,1163,845,2,847,31
2020-04-19,Santa Barbara,083,443738,462,377,2,379,3
2020-04-19,Santa Clara,085,1922200,2306,1878,5,1883,81
2020-04-19,Santa Cruz,087,273765,126,98,0,98,2
2020-04-19,Shasta,089,179085,31,26,0,26,3
2020-04-19,Sierra,091,2930,0,0,0,0,0
2020-04-19,Siskiyou,093,43540,5,5,0,5,0
2020-04-19,Solano,095,438530,228,174,0,174,2
2020-04-19,Sonoma,097,501317,211,172,0,172,1
2020-04-19,Stanislaus,099,539301,293,221,4,225,3
2020-04-19,Sutter,101,95872,26,21,0,21,2
2020-04-19,Tehama,103,63373,1,1,0,1,1
2020-04-19,Trinity,105,12862,0,0,0,0,0
2020-04-19,Tulare,107,460477,613,391,5,396,17
2020-04-19,Tuolumne,109,53932,3,2,0,2,0
2020-04-19,Ventura,111,848112,557,418,1,419,13
2020-04-19,Yolo,113,214977,173,120,0,120,5
2020-04-19,Yuba,115,75493,16,15,0,15,1
2020-04-18,Alameda,001,1643700,1466,1085,2,1087,40
2020-04-18,Alpine,003,1148,1,1,0,1,0
2020-04-18,Amador,005,37829,7,7,0,7,0
2020-04-18,Butte,007,227075,22,15,2,17,0
2020-04-18,Calaveras,009,45235,12,12,0,12,0
2020-04-18,Colusa,011,21464,3,3,0,3,0
2020-04-18,Contra Costa,013,1133247,856,721,0,721,17
2020-04-18,Del Norte,015,27424,2,2,0,2,0
2020-04-18,El Dorado,017,186661,54,36,0,36,0
2020-04-18,Fresno,019,978130,621,319,6,325,7
2020-04-18,Glenn,021,27897,4,3,0,3,0
2020-04-18,Humboldt,023,135768,58,52,0,52,0
2020-04-18,Imperial,025,180216,309,137,0,137,2
2020-04-18,Inyo,027,18085,19,17,0,17,0
2020-04-18,Kern,029,883053,829,626,1,627,3
2020-04-18,Kings,031,150075,66,17,0,17,1
2020-04-18,Lake,033,64148,6,6,0,6,0
2020-04-18,Lassen,035,31185,3,0,2,2,0
2020-04-18,Los Angeles,037,10098052,19338,11984,15,11999,566
2020-04-18,Madera,039,155013,71,34,1,35,2
2020-04-18,Marin,041,260295,210,193,1,194,10
2020-04-18,Mariposa,043,17540,2,0,0,0,0
2020-04-18,Mendocino,045,87422,6,4,0,4,0
2020-04-18,Merced,047,269075,128,82,0,82,3
2020-04-18,Modoc,049,8938,0,0,0,0,0
2020-04-18,Mono,051,14174,29,22,0,22,1
2020-04-18,Monterey,053,433212,201,135,0,135,3
2020-04-18,Napa,055,140530,64,49,0,49,2
2020-04-18,Nevada,057,99092,39,34,1,35,1
2020-04-18,Orange,059,3164182,2444,1569,20,1589,32
2020-04-18,Placer,061,380077,152,130,0,130,8
2020-04-18,Plumas,063,18699,4,4,0,4,0
2020-04-18,Riverside,065,2383286,3651,2257,14,2271,56
2020-04-18,Sacramento,067,1510023,1001,901,0,901,32
2020-04-18,San Benito,069,59416,42,40,0,40,2
2020-04-18,San Bernardino,071,2135413,1833,1255,1,1256,58
2020-04-18,San Diego,073,3302833,2999,2215,0,2215,71
2020-04-18,San Francisco,075,870044,1416,1144,0,1144,19
2020-04-18,San Joaquin,077,732212,497,392,3,395,17
2020-04-18,San Luis Obispo,079,281455,196,129,3,132,1
2020-04-18,San Mateo,081,765935,1141,821,2,823,31
2020-04-18,Santa Barbara,083,443738,456,372,2,374,3
2020-04-18,Santa Clara,085,1922200,2273,1862,5,1867,79
2020-04-18,Santa Cruz,087,273765,124,96,0,96,2
2020-04-18,Shasta,089,179085,31,26,0,26,3
2020-04-18,Sierra,091,2930,0,0,0,0,0
2020-04-18,Siskiyou,093,43540,5,5,0,5,0
2020-04-18,Solano,095,438530,225,175,0,175,2
2020-04-18,Sonoma,097,501317,207,168,0,168,1
2020-04-18,Stanislaus,099,539301,285,216,4,220,3
2020-04-18,Sutter,101,95872,26,21,0,21,2
2020-04-18,Tehama,103,63373,1,1,0,1,1
2020-04-18,Trinity,105,12862,0,0,0,0,0
2020-04-18,Tulare,107,460477,602,385,5,390,17
2020-04-18,Tuolumne,109,53932,3,2,0,2,0
2020-04-18,Ventura,111,848112,549,416,1,417,13
2020-04-18,Yolo,113,214977,171,118,0,118,5
2020-04-18,Yuba,115,75493,16,14,0,14,1
2020-04-17,Alameda,001,1643700,1411,1043,1,1044,40
2020-04-17,Alpine,003,1148,1,1,0,1,0
2020-04-17,Amador,005,37829,7,7,0,7,0
2020-04-17,Butte,007,227075,22,15,2,17,0
2020-04-17,Calaveras,009,45235,12,11,0,11,0
2020-04-17,Colusa,011,21464,3,3,0,3,0
2020-04-17,Contra Costa,013,1133247,845,687,0,687,15
2020-04-17,Del Norte,015,27424,2,2,0,2,0
2020-04-17,El Dorado,017,186661,54,35,0,35,0
2020-04-17,Fresno,019,978130,599,315,6,321,7
2020-04-17,Glenn,021,27897,4,3,0,3,0
2020-04-17,Humboldt,023,135768,57,52,0,52,0
2020-04-17,Imperial,025,180216,300,135,0,135,2
2020-04-17,Inyo,027,18085,19,17,0,17,0
2020-04-17,Kern,029,883053,809,612,1,613,3
2020-04-17,Kings,031,150075,64,15,0,15,1
2020-04-17,Lake,033,64148,6,6,0,6,0
2020-04-17,Lassen,035,31185,3,0,2,2,0
2020-04-17,Los Angeles,037,10098052,18698,11354,15,11369,489
2020-04-17,Madera,039,155013,71,34,1,35,2
2020-04-17,Marin,041,260295,207,189,1,190,10
2020-04-17,Mariposa,043,17540,1,0,0,0,0
2020-04-17,Mendocino,045,87422,6,4,0,4,0
2020-04-17,Merced,047,269075,127,80,0,80,3
2020-04-17,Modoc,049,8938,0,0,0,0,0
2020-04-17,Mono,051,14174,29,22,0,22,1
2020-04-17,Monterey,053,433212,196,119,0,119,3
2020-04-17,Napa,055,140530,62,46,0,46,2
2020-04-17,Nevada,057,99092,38,34,1,35,1
2020-04-17,Orange,059,3164182,2393,1496,20,1516,31
2020-04-17,Placer,061,380077,152,130,0,130,8
2020-04-17,Plumas,063,18699,4,4,0,4,0
2020-04-17,Riverside,065,2383286,3524,2080,14,2094,50
2020-04-17,Sacramento,067,1510023,994,882,0,882,32
2020-04-17,San Benito,069,59416,42,38,0,38,2
2020-04-17,San Bernardino,071,2135413,1794,1229,1,1230,57
2020-04-17,San Diego,073,3302833,2909,2160,0,2160,70
2020-04-17,San Francisco,075,870044,1391,1090,0,1090,19
2020-04-17,San Joaquin,077,732212,486,356,3,359,17
2020-04-17,San Luis Obispo,079,281455,189,116,3,119,1
2020-04-17,San Mateo,081,765935,1125,768,2,770,31
2020-04-17,Santa Barbara,083,443738,451,349,2,351,3
2020-04-17,Santa Clara,085,1922200,2237,1834,5,1839,74
2020-04-17,Santa Cruz,087,273765,123,94,0,94,2
2020-04-17,Shasta,089,179085,31,26,0,26,3
2020-04-17,Sierra,091,2930,0,0,0,0,0
2020-04-17,Siskiyou,093,43540,5,5,0,5,0
2020-04-17,Solano,095,438530,224,173,0,173,2
2020-04-17,Sonoma,097,501317,204,167,0,167,1
2020-04-17,Stanislaus,099,539301,283,201,4,205,3
2020-04-17,Sutter,101,95872,26,20,0,20,2
2020-04-17,Tehama,103,63373,1,1,0,1,1
2020-04-17,Trinity,105,12862,0,0,0,0,0
2020-04-17,Tulare,107,460477,595,370,5,375,17
2020-04-17,Tuolumne,109,53932,3,2,0,2,0
2020-04-17,Ventura,111,848112,544,398,1,399,13
2020-04-17,Yolo,113,214977,170,117,0,117,5
2020-04-17,Yuba,115,75493,16,14,0,14,1
2020-04-16,Alameda,001,1643700,1378,981,1,982,39
2020-04-16,Alpine,003,1148,1,1,0,1,0
2020-04-16,Amador,005,37829,7,7,0,7,0
2020-04-16,Butte,007,227075,21,15,2,17,0
2020-04-16,Calaveras,009,45235,12,10,0,10,0
2020-04-16,Colusa,011,21464,3,3,0,3,0
2020-04-16,Contra Costa,013,1133247,831,675,0,675,14
2020-04-16,Del Norte,015,27424,2,2,0,2,0
2020-04-16,El Dorado,017,186661,53,34,0,34,0
2020-04-16,Fresno,019,978130,569,289,6,295,7
2020-04-16,Glenn,021,27897,4,3,0,3,0
2020-04-16,Humboldt,023,135768,57,47,0,47,0
2020-04-16,Imperial,025,180216,285,132,0,132,2
2020-04-16,Inyo,027,18085,17,17,0,17,0
2020-04-16,Kern,029,883053,782,587,1,588,3
2020-04-16,Kings,031,150075,60,12,0,12,1
2020-04-16,Lake,033,64148,6,6,0,6,0
2020-04-16,Lassen,035,31185,3,0,2,2,0
2020-04-16,Los Angeles,037,10098052,17807,10786,15,10801,447
2020-04-16,Madera,039,155013,69,34,1,35,2
2020-04-16,Marin,041,260295,203,170,1,171,10
2020-04-16,Mariposa,043,17540,1,1,0,1,0
2020-04-16,Mendocino,045,87422,6,4,0,4,0
2020-04-16,Merced,047,269075,121,76,0,76,3
2020-04-16,Modoc,049,8938,0,0,0,0,0
2020-04-16,Mono,051,14174,29,22,0,22,1
2020-04-16,Monterey,053,433212,193,116,0,116,3
2020-04-16,Napa,055,140530,59,44,0,44,2
2020-04-16,Nevada,057,99092,38,34,1,35,1
2020-04-16,Orange,059,3164182,2328,1439,19,1458,28
2020-04-16,Placer,061,380077,150,129,0,129,7
2020-04-16,Plumas,063,18699,4,4,0,4,0
2020-04-16,Riverside,065,2383286,3404,1913,14,1927,45
2020-04-16,Sacramento,067,1510023,986,865,0,865,32
2020-04-16,San Benito,069,59416,42,36,0,36,2
2020-04-16,San Bernardino,071,2135413,1713,1143,0,1143,54
2020-04-16,San Diego,073,3302833,2801,2089,0,2089,63
2020-04-16,San Francisco,075,870044,1347,1039,0,1039,16
2020-04-16,San Joaquin,077,732212,471,345,3,348,17
2020-04-16,San Luis Obispo,079,281455,185,113,3,116,1
2020-04-16,San Mateo,081,765935,1096,745,2,747,29
2020-04-16,Santa Barbara,083,443738,440,331,2,333,3
2020-04-16,Santa Clara,085,1922200,2200,1789,5,1794,70
2020-04-16,Santa Cruz,087,273765,121,90,0,90,2
2020-04-16,Shasta,089,179085,31,25,0,25,3
2020-04-16,Sierra,091,2930,0,0,0,0,0
2020-04-16,Siskiyou,093,43540,5,5,0,5,0
2020-04-16,Solano,095,438530,221,162,0,162,2
2020-04-16,Sonoma,097,501317,199,145,0,145,1
2020-04-16,Stanislaus,099,539301,280,185,4,189,3
2020-04-16,Sutter,101,95872,25,21,0,21,2
2020-04-16,Tehama,103,63373,1,1,0,1,1
2020-04-16,Trinity,105,12862,0,0,0,0,0
2020-04-16,Tulare,107,460477,578,305,5,310,16
2020-04-16,Tuolumne,109,53932,3,1,0,1,0
2020-04-16,Ventura,111,848112,532,384,1,385,13
2020-04-16,Yolo,113,214977,168,98,0,98,4
2020-04-16,Yuba,115,75493,15,14,0,14,1
2020-04-15,Alameda,001,1643700,1328,915,1,916,38
2020-04-15,Alpine,003,1148,1,1,0,1,0
2020-04-15,Amador,005,37829,7,7,0,7,0
2020-04-15,Butte,007,227075,21,14,2,16,0
2020-04-15,Calaveras,009,45235,11,9,0,9,0
2020-04-15,Colusa,011,21464,3,3,0,3,0
2020-04-15,Contra Costa,013,1133247,809,645,0,645,14
2020-04-15,Del Norte,015,27424,2,2,0,2,0
2020-04-15,El Dorado,017,186661,51,33,0,33,0
2020-04-15,Fresno,019,978130,543,264,6,270,7
2020-04-15,Glenn,021,27897,4,3,0,3,0
2020-04-15,Humboldt,023,135768,57,47,0,47,0
2020-04-15,Imperial,025,180216,259,115,0,115,2
2020-04-15,Inyo,027,18085,17,12,0,12,0
2020-04-15,Kern,029,883053,760,500,1,501,3
2020-04-15,Kings,031,150075,56,12,0,12,1
2020-04-15,Lake,033,64148,6,4,0,4,0
2020-04-15,Lassen,035,31185,3,0,2,2,0
2020-04-15,Los Angeles,037,10098052,16984,10416,15,10431,394
2020-04-15,Madera,039,155013,69,30,1,31,2
2020-04-15,Marin,041,260295,200,162,1,163,10
2020-04-15,Mariposa,043,17540,0,0,0,0,0
2020-04-15,Mendocino,045,87422,5,4,0,4,0
2020-04-15,Merced,047,269075,119,74,0,74,3
2020-04-15,Modoc,049,8938,0,0,0,0,0
2020-04-15,Mono,051,14174,29,22,0,22,1
2020-04-15,Monterey,053,433212,185,106,0,106,3
2020-04-15,Napa,055,140530,56,34,0,34,2
2020-04-15,Nevada,057,99092,37,34,1,35,1
2020-04-15,Orange,059,3164182,2225,1377,19,1396,24
2020-04-15,Placer,061,380077,149,123,0,123,6
2020-04-15,Plumas,063,18699,4,4,0,4,0
2020-04-15,Riverside,065,2383286,3209,1723,14,1737,42
2020-04-15,Sacramento,067,1510023,977,839,0,839,32
2020-04-15,San Benito,069,59416,42,34,0,34,2
2020-04-15,San Bernardino,071,2135413,1643,1063,0,1063,45
2020-04-15,San Diego,073,3302833,2713,2014,0,2014,60
2020-04-15,San Francisco,075,870044,1311,1006,0,1006,16
2020-04-15,San Joaquin,077,732212,463,329,3,332,17
2020-04-15,San Luis Obispo,079,281455,177,112,3,115,1
2020-04-15,San Mateo,081,765935,1047,707,2,709,28
2020-04-15,Santa Barbara,083,443738,424,317,2,319,2
2020-04-15,Santa Clara,085,1922200,2161,1692,5,1697,69
2020-04-15,Santa Cruz,087,273765,117,92,0,92,2
2020-04-15,Shasta,089,179085,31,25,0,25,3
2020-04-15,Sierra,091,2930,0,0,0,0,0
2020-04-15,Siskiyou,093,43540,5,5,0,5,0
2020-04-15,Solano,095,438530,216,153,0,153,2
2020-04-15,Sonoma,097,501317,197,140,0,140,1
2020-04-15,Stanislaus,099,539301,273,174,4,178,3
2020-04-15,Sutter,101,95872,25,19,0,19,2
2020-04-15,Tehama,103,63373,1,1,0,1,1
2020-04-15,Trinity,105,12862,0,0,0,0,0
2020-04-15,Tulare,107,460477,560,289,5,294,14
2020-04-15,Tuolumne,109,53932,3,1,0,1,0
2020-04-15,Ventura,111,848112,517,365,1,366,13
2020-04-15,Yolo,113,214977,161,93,0,93,3
2020-04-15,Yuba,115,75493,15,15,0,15,1
2020-04-14,Alameda,001,1643700,1283,843,1,844,30
2020-04-14,Alpine,003,1148,1,1,0,1,0
2020-04-14,Amador,005,37829,7,6,0,6,0
2020-04-14,Butte,007,227075,21,13,2,15,0
2020-04-14,Calaveras,009,45235,11,5,0,5,0
2020-04-14,Colusa,011,21464,3,3,0,3,0
2020-04-14,Contra Costa,013,1133247,797,617,0,617,12
2020-04-14,Del Norte,015,27424,2,2,0,2,0
2020-04-14,El Dorado,017,186661,51,30,0,30,0
2020-04-14,Fresno,019,978130,520,244,6,250,6
2020-04-14,Glenn,021,27897,4,3,0,3,0
2020-04-14,Humboldt,023,135768,57,44,0,44,0
2020-04-14,Imperial,025,180216,239,86,0,86,2
2020-04-14,Inyo,027,18085,17,12,0,12,0
2020-04-14,Kern,029,883053,736,453,1,454,3
2020-04-14,Kings,031,150075,55,12,0,12,1
2020-04-14,Lake,033,64148,6,3,0,3,0
2020-04-14,Lassen,035,31185,3,0,2,2,0
2020-04-14,Los Angeles,037,10098052,16091,9948,14,9962,357
2020-04-14,Madera,039,155013,68,29,1,30,2
2020-04-14,Marin,041,260295,196,147,1,148,9
2020-04-14,Mariposa,043,17540,0,0,0,0,0
2020-04-14,Mendocino,045,87422,5,4,0,4,0
2020-04-14,Merced,047,269075,112,61,0,61,3
2020-04-14,Modoc,049,8938,0,0,0,0,0
2020-04-14,Mono,051,14174,29,22,0,22,1
2020-04-14,Monterey,053,433212,180,98,0,98,3
2020-04-14,Napa,055,140530,56,33,0,33,2
2020-04-14,Nevada,057,99092,37,34,1,35,1
2020-04-14,Orange,059,3164182,2125,1362,19,1381,24
2020-04-14,Placer,061,380077,148,117,0,117,5
2020-04-14,Plumas,063,18699,4,3,0,3,0
2020-04-14,Riverside,065,2383286,3074,1467,14,1481,40
2020-04-14,Sacramento,067,1510023,968,737,0,737,29
2020-04-14,San Benito,069,59416,39,34,0,34,2
2020-04-14,San Bernardino,071,2135413,1588,933,0,933,37
2020-04-14,San Diego,073,3302833,2618,1932,0,1932,53
2020-04-14,San Francisco,075,870044,1257,968,0,968,14
2020-04-14,San Joaquin,077,732212,453,280,3,283,17
2020-04-14,San Luis Obispo,079,281455,174,109,3,112,1
2020-04-14,San Mateo,081,765935,1013,681,2,683,28
2020-04-14,Santa Barbara,083,443738,400,292,2,294,2
2020-04-14,Santa Clara,085,1922200,2128,1561,5,1566,63
2020-04-14,Santa Cruz,087,273765,109,84,0,84,2
2020-04-14,Shasta,089,179085,31,24,0,24,3
2020-04-14,Sierra,091,2930,0,0,0,0,0
2020-04-14,Siskiyou,093,43540,5,5,0,5,0
2020-04-14,Solano,095,438530,213,140,0,140,2
2020-04-14,Sonoma,097,501317,193,133,0,133,1
2020-04-14,Stanislaus,099,539301,260,136,4,140,3
2020-04-14,Sutter,101,95872,24,19,0,19,2
2020-04-14,Tehama,103,63373,1,1,0,1,1
2020-04-14,Trinity,105,12862,0,0,0,0,0
2020-04-14,Tulare,107,460477,536,228,5,233,12
2020-04-14,Tuolumne,109,53932,3,0,0,0,0
2020-04-14,Ventura,111,848112,504,328,1,329,11
2020-04-14,Yolo,113,214977,158,81,0,81,3
2020-04-14,Yuba,115,75493,14,14,0,14,1
2020-04-13,Alameda,001,1643700,1245,821,1,822,23
2020-04-13,Alpine,003,1148,1,1,0,1,0
2020-04-13,Amador,005,37829,7,6,0,6,0
2020-04-13,Butte,007,227075,20,13,2,15,0
2020-04-13,Calaveras,009,45235,10,5,0,5,0
2020-04-13,Colusa,011,21464,3,3,0,3,0
2020-04-13,Contra Costa,013,1133247,781,569,0,569,12
2020-04-13,Del Norte,015,27424,2,2,0,2,0
2020-04-13,El Dorado,017,186661,49,29,0,29,0
2020-04-13,Fresno,019,978130,498,205,5,210,4
2020-04-13,Glenn,021,27897,4,3,0,3,0
2020-04-13,Humboldt,023,135768,57,44,0,44,0
2020-04-13,Imperial,025,180216,221,82,0,82,2
2020-04-13,Inyo,027,18085,17,12,0,12,0
2020-04-13,Kern,029,883053,711,346,1,347,3
2020-04-13,Kings,031,150075,51,9,0,9,0
2020-04-13,Lake,033,64148,6,3,0,3,0
2020-04-13,Lassen,035,31185,3,0,2,2,0
2020-04-13,Los Angeles,037,10098052,15370,9367,14,9381,317
2020-04-13,Madera,039,155013,66,29,1,30,2
2020-04-13,Marin,041,260295,192,144,1,145,6
2020-04-13,Mariposa,043,17540,0,0,0,0,0
2020-04-13,Mendocino,045,87422,5,4,0,4,0
2020-04-13,Merced,047,269075,111,60,0,60,3
2020-04-13,Modoc,049,8938,0,0,0,0,0
2020-04-13,Mono,051,14174,29,21,0,21,1
2020-04-13,Monterey,053,433212,173,86,0,86,3
2020-04-13,Napa,055,140530,55,30,0,30,2
2020-04-13,Nevada,057,99092,37,24,1,25,1
2020-04-13,Orange,059,3164182,2053,1313,19,1332,21
2020-04-13,Placer,061,380077,147,116,0,116,5
2020-04-13,Plumas,063,18699,4,3,0,3,0
2020-04-13,Riverside,065,2383286,2933,1460,13,1473,35
2020-04-13,Sacramento,067,1510023,956,723,0,723,25
2020-04-13,San Benito,069,59416,38,33,0,33,2
2020-04-13,San Bernardino,071,2135413,1513,920,0,920,30
2020-04-13,San Diego,073,3302833,2535,1849,0,1849,47
2020-04-13,San Francisco,075,870044,1219,948,0,948,12
2020-04-13,San Joaquin,077,732212,438,255,3,258,16
2020-04-13,San Luis Obispo,079,281455,169,106,3,109,1
2020-04-13,San Mateo,081,765935,973,679,2,681,25
2020-04-13,Santa Barbara,083,443738,381,271,1,272,2
2020-04-13,Santa Clara,085,1922200,2082,1540,5,1545,58
2020-04-13,Santa Cruz,087,273765,103,82,0,82,1
2020-04-13,Shasta,089,179085,30,24,0,24,3
2020-04-13,Sierra,091,2930,0,0,0,0,0
2020-04-13,Siskiyou,093,43540,5,5,0,5,0
2020-04-13,Solano,095,438530,210,136,0,136,2
2020-04-13,Sonoma,097,501317,186,133,0,133,1
2020-04-13,Stanislaus,099,539301,254,130,4,134,1
2020-04-13,Sutter,101,95872,24,18,0,18,2
2020-04-13,Tehama,103,63373,1,1,0,1,0
2020-04-13,Trinity,105,12862,0,0,0,0,0
2020-04-13,Tulare,107,460477,500,185,5,190,11
2020-04-13,Tuolumne,109,53932,3,0,0,0,0
2020-04-13,Ventura,111,848112,483,309,0,309,9
2020-04-13,Yolo,113,214977,152,81,0,81,3
2020-04-13,Yuba,115,75493,14,13,0,13,1
2020-04-12,Alameda,001,1643700,1202,774,1,775,23
2020-04-12,Alpine,003,1148,1,1,0,1,0
2020-04-12,Amador,005,37829,7,6,0,6,0
2020-04-12,Butte,007,227075,20,13,2,15,0
2020-04-12,Calaveras,009,45235,10,5,0,5,0
2020-04-12,Colusa,011,21464,3,3,0,3,0
2020-04-12,Contra Costa,013,1133247,768,553,0,553,12
2020-04-12,Del Norte,015,27424,2,2,0,2,0
2020-04-12,El Dorado,017,186661,49,28,0,28,0
2020-04-12,Fresno,019,978130,469,205,5,210,4
2020-04-12,Glenn,021,27897,4,3,0,3,0
2020-04-12,Humboldt,023,135768,57,43,0,43,0
2020-04-12,Imperial,025,180216,198,78,0,78,2
2020-04-12,Inyo,027,18085,15,12,0,12,0
2020-04-12,Kern,029,883053,679,319,0,319,3
2020-04-12,Kings,031,150075,49,9,0,9,0
2020-04-12,Lake,033,64148,6,3,0,3,0
2020-04-12,Lassen,035,31185,3,0,2,2,0
2020-04-12,Los Angeles,037,10098052,14650,9133,14,9147,294
2020-04-12,Madera,039,155013,65,29,1,30,2
2020-04-12,Marin,041,260295,181,138,1,139,6
2020-04-12,Mariposa,043,17540,0,0,0,0,0
2020-04-12,Mendocino,045,87422,5,4,0,4,0
2020-04-12,Merced,047,269075,107,58,0,58,3
2020-04-12,Modoc,049,8938,0,0,0,0,0
2020-04-12,Mono,051,14174,29,20,0,20,1
2020-04-12,Monterey,053,433212,159,85,0,85,3
2020-04-12,Napa,055,140530,53,29,0,29,2
2020-04-12,Nevada,057,99092,37,24,1,25,1
2020-04-12,Orange,059,3164182,1993,1283,18,1301,21
2020-04-12,Placer,061,380077,146,114,0,114,4
2020-04-12,Plumas,063,18699,4,3,0,3,0
2020-04-12,Riverside,065,2383286,2751,1330,13,1343,34
2020-04-12,Sacramento,067,1510023,919,689,0,689,25
2020-04-12,San Benito,069,59416,36,33,0,33,2
2020-04-12,San Bernardino,071,2135413,1437,827,0,827,30
2020-04-12,San Diego,073,3302833,2445,1806,0,1806,45
2020-04-12,San Francisco,075,870044,1192,886,0,886,11
2020-04-12,San Joaquin,077,732212,420,246,3,249,15
2020-04-12,San Luis Obispo,079,281455,166,102,2,104,1
2020-04-12,San Mateo,081,765935,947,664,2,666,25
2020-04-12,Santa Barbara,083,443738,362,261,1,262,2
2020-04-12,Santa Clara,085,1922200,2054,1461,5,1466,53
2020-04-12,Santa Cruz,087,273765,102,80,0,80,1
2020-04-12,Shasta,089,179085,30,24,0,24,3
2020-04-12,Sierra,091,2930,0,0,0,0,0
2020-04-12,Siskiyou,093,43540,5,5,0,5,0
2020-04-12,Solano,095,438530,204,136,0,136,2
2020-04-12,Sonoma,097,501317,183,131,0,131,1
2020-04-12,Stanislaus,099,539301,246,117,4,121,1
2020-04-12,Sutter,101,95872,23,18,0,18,2
2020-04-12,Tehama,103,63373,1,1,0,1,0
2020-04-12,Trinity,105,12862,0,0,0,0,0
2020-04-12,Tulare,107,460477,488,166,5,171,11
2020-04-12,Tuolumne,109,53932,3,0,0,0,0
2020-04-12,Ventura,111,848112,473,306,0,306,9
2020-04-12,Yolo,113,214977,138,67,0,67,3
2020-04-12,Yuba,115,75493,14,13,0,13,1
2020-04-11,Alameda,001,1643700,1160,751,1,752,23
2020-04-11,Alpine,003,1148,1,1,0,1,0
2020-04-11,Amador,005,37829,7,6,0,6,0
2020-04-11,Butte,007,227075,20,13,2,15,0
2020-04-11,Calaveras,009,45235,10,5,0,5,0
2020-04-11,Colusa,011,21464,3,3,0,3,0
2020-04-11,Contra Costa,013,1133247,759,550,0,550,12
2020-04-11,Del Norte,015,27424,2,2,0,2,0
2020-04-11,El Dorado,017,186661,48,29,0,29,0
2020-04-11,Fresno,019,978130,459,201,5,206,4
2020-04-11,Glenn,021,27897,4,3,0,3,0
2020-04-11,Humboldt,023,135768,57,38,0,38,0
2020-04-11,Imperial,025,180216,188,78,0,78,2
2020-04-11,Inyo,027,18085,15,12,0,12,0
2020-04-11,Kern,029,883053,651,304,0,304,3
2020-04-11,Kings,031,150075,46,9,0,9,0
2020-04-11,Lake,033,64148,6,3,0,3,0
2020-04-11,Lassen,035,31185,3,0,2,2,0
2020-04-11,Los Angeles,037,10098052,14174,8823,14,8837,262
2020-04-11,Madera,039,155013,64,29,1,30,2
2020-04-11,Marin,041,260295,178,136,1,137,6
2020-04-11,Mariposa,043,17540,0,0,0,0,0
2020-04-11,Mendocino,045,87422,5,4,0,4,0
2020-04-11,Merced,047,269075,104,59,0,59,3
2020-04-11,Modoc,049,8938,0,0,0,0,0
2020-04-11,Mono,051,14174,29,20,0,20,1
2020-04-11,Monterey,053,433212,153,78,0,78,3
2020-04-11,Napa,055,140530,53,29,0,29,2
2020-04-11,Nevada,057,99092,37,24,1,25,1
2020-04-11,Orange,059,3164182,1931,1267,18,1285,21
2020-04-11,Placer,061,380077,146,113,0,113,4
2020-04-11,Plumas,063,18699,4,3,0,3,0
2020-04-11,Riverside,065,2383286,2672,1260,13,1273,33
2020-04-11,Sacramento,067,1510023,908,685,0,685,25
2020-04-11,San Benito,069,59416,36,33,0,33,2
2020-04-11,San Bernardino,071,2135413,1401,826,0,826,28
2020-04-11,San Diego,073,3302833,2379,1763,0,1763,45
2020-04-11,San Francisco,075,870044,1170,860,0,860,11
2020-04-11,San Joaquin,077,732212,415,244,3,247,15
2020-04-11,San Luis Obispo,079,281455,166,100,1,101,1
2020-04-11,San Mateo,081,765935,935,662,2,664,25
2020-04-11,Santa Barbara,083,443738,354,258,1,259,2
2020-04-11,Santa Clara,085,1922200,1995,1441,5,1446,51
2020-04-11,Santa Cruz,087,273765,102,79,0,79,1
2020-04-11,Shasta,089,179085,30,24,0,24,3
2020-04-11,Sierra,091,2930,0,0,0,0,0
2020-04-11,Siskiyou,093,43540,5,5,0,5,0
2020-04-11,Solano,095,438530,200,138,0,138,2
2020-04-11,Sonoma,097,501317,181,131,0,131,1
2020-04-11,Stanislaus,099,539301,238,119,3,122,1
2020-04-11,Sutter,101,95872,23,18,0,18,2
2020-04-11,Tehama,103,63373,1,1,0,1,0
2020-04-11,Trinity,105,12862,0,0,0,0,0
2020-04-11,Tulare,107,460477,466,168,5,173,10
2020-04-11,Tuolumne,109,53932,3,0,0,0,0
2020-04-11,Ventura,111,848112,463,304,0,304,9
2020-04-11,Yolo,113,214977,135,67,0,67,3
2020-04-11,Yuba,115,75493,14,13,0,13,1
2020-04-10,Alameda,001,1643700,1119,706,1,707,21
2020-04-10,Alpine,003,1148,1,1,0,1,0
2020-04-10,Amador,005,37829,7,5,0,5,0
2020-04-10,Butte,007,227075,20,13,2,15,0
2020-04-10,Calaveras,009,45235,10,5,0,5,0
2020-04-10,Colusa,011,21464,3,3,0,3,0
2020-04-10,Contra Costa,013,1133247,746,537,0,537,10
2020-04-10,Del Norte,015,27424,2,2,0,2,0
2020-04-10,El Dorado,017,186661,48,26,0,26,0
2020-04-10,Fresno,019,978130,452,186,4,190,3
2020-04-10,Glenn,021,27897,4,3,0,3,0
2020-04-10,Humboldt,023,135768,57,36,0,36,0
2020-04-10,Imperial,025,180216,181,70,0,70,2
2020-04-10,Inyo,027,18085,13,11,0,11,0
2020-04-10,Kern,029,883053,627,272,0,272,3
2020-04-10,Kings,031,150075,43,7,0,7,0
2020-04-10,Lake,033,64148,6,3,0,3,0
2020-04-10,Lassen,035,31185,3,0,2,2,0
2020-04-10,Los Angeles,037,10098052,13657,8384,13,8397,239
2020-04-10,Madera,039,155013,63,29,1,30,2
2020-04-10,Marin,041,260295,173,128,1,129,6
2020-04-10,Mariposa,043,17540,0,0,0,0,0
2020-04-10,Mendocino,045,87422,5,4,0,4,0
2020-04-10,Merced,047,269075,102,56,0,56,3
2020-04-10,Modoc,049,8938,0,0,0,0,0
2020-04-10,Mono,051,14174,29,20,0,20,1
2020-04-10,Monterey,053,433212,142,78,0,78,3
2020-04-10,Napa,055,140530,50,28,0,28,2
2020-04-10,Nevada,057,99092,37,23,1,24,1
2020-04-10,Orange,059,3164182,1884,1167,18,1185,21
2020-04-10,Placer,061,380077,145,112,0,112,4
2020-04-10,Plumas,063,18699,4,3,0,3,0
2020-04-10,Riverside,065,2383286,2606,1162,13,1175,30
2020-04-10,Sacramento,067,1510023,899,642,0,642,24
2020-04-10,San Benito,069,59416,36,32,0,32,2
2020-04-10,San Bernardino,071,2135413,1353,779,0,779,27
2020-04-10,San Diego,073,3302833,2319,1695,0,1695,44
2020-04-10,San Francisco,075,870044,1139,797,0,797,10
2020-04-10,San Joaquin,077,732212,403,234,3,237,14
2020-04-10,San Luis Obispo,079,281455,166,97,1,98,1
2020-04-10,San Mateo,081,765935,919,642,2,644,24
2020-04-10,Santa Barbara,083,443738,346,254,1,255,2
2020-04-10,Santa Clara,085,1922200,1943,1351,5,1356,50
2020-04-10,Santa Cruz,087,273765,101,75,0,75,1
2020-04-10,Shasta,089,179085,30,24,0,24,3
2020-04-10,Sierra,091,2930,0,0,0,0,0
2020-04-10,Siskiyou,093,43540,5,5,0,5,0
2020-04-10,Solano,095,438530,197,129,0,129,2
2020-04-10,Sonoma,097,501317,180,129,0,129,1
2020-04-10,Stanislaus,099,539301,231,101,3,104,0
2020-04-10,Sutter,101,95872,23,18,0,18,2
2020-04-10,Tehama,103,63373,1,1,0,1,0
2020-04-10,Trinity,105,12862,0,0,0,0,0
2020-04-10,Tulare,107,460477,424,163,5,168,10
2020-04-10,Tuolumne,109,53932,3,0,0,0,0
2020-04-10,Ventura,111,848112,454,290,0,290,9
2020-04-10,Yolo,113,214977,133,62,0,62,3
2020-04-10,Yuba,115,75493,14,13,0,13,1
2020-04-09,Alameda,001,1643700,1069,641,1,642,17
2020-04-09,Alpine,003,1148,1,1,0,1,0
2020-04-09,Amador,005,37829,7,2,0,2,0
2020-04-09,Butte,007,227075,20,12,2,14,0
2020-04-09,Calaveras,009,45235,10,5,0,5,0
2020-04-09,Colusa,011,21464,3,3,0,3,0
2020-04-09,Contra Costa,013,1133247,703,505,0,505,7
2020-04-09,Del Norte,015,27424,2,2,0,2,0
2020-04-09,El Dorado,017,186661,47,25,0,25,0
2020-04-09,Fresno,019,978130,427,165,4,169,3
2020-04-09,Glenn,021,27897,4,2,0,2,0
2020-04-09,Humboldt,023,135768,57,36,0,36,0
2020-04-09,Imperial,025,180216,160,67,0,67,2
2020-04-09,Inyo,027,18085,12,11,0,11,0
2020-04-09,Kern,029,883053,591,241,0,241,2
2020-04-09,Kings,031,150075,40,5,0,5,0
2020-04-09,Lake,033,64148,5,1,0,1,0
2020-04-09,Lassen,035,31185,3,0,2,2,0
2020-04-09,Los Angeles,037,10098052,13026,7919,13,7932,220
2020-04-09,Madera,039,155013,63,28,1,29,2
2020-04-09,Marin,041,260295,171,126,1,127,7
2020-04-09,Mariposa,043,17540,0,0,0,0,0
2020-04-09,Mendocino,045,87422,5,4,0,4,0
2020-04-09,Merced,047,269075,98,41,0,41,3
2020-04-09,Modoc,049,8938,0,0,0,0,0
2020-04-09,Mono,051,14174,29,19,0,19,1
2020-04-09,Monterey,053,433212,124,70,0,70,3
2020-04-09,Napa,055,140530,46,27,0,27,2
2020-04-09,Nevada,057,99092,36,23,1,24,1
2020-04-09,Orange,059,3164182,1810,1105,18,1123,19
2020-04-09,Placer,061,380077,144,107,0,107,4
2020-04-09,Plumas,063,18699,4,3,0,3,0
2020-04-09,Riverside,065,2383286,2463,1083,13,1096,29
2020-04-09,Sacramento,067,1510023,876,601,0,601,21
2020-04-09,San Benito,069,59416,36,32,0,32,2
2020-04-09,San Bernardino,071,2135413,1284,717,0,717,27
2020-04-09,San Diego,073,3302833,2223,1630,0,1630,40
2020-04-09,San Francisco,075,870044,1119,748,0,748,8
2020-04-09,San Joaquin,077,732212,382,223,3,226,14
2020-04-09,San Luis Obispo,079,281455,158,93,1,94,1
2020-04-09,San Mateo,081,765935,903,630,2,632,23
2020-04-09,Santa Barbara,083,443738,336,232,1,233,2
2020-04-09,Santa Clara,085,1922200,1873,1301,5,1306,49
2020-04-09,Santa Cruz,087,273765,101,73,0,73,1
2020-04-09,Shasta,089,179085,30,22,0,22,3
2020-04-09,Sierra,091,2930,0,0,0,0,0
2020-04-09,Siskiyou,093,43540,5,4,0,4,0
2020-04-09,Solano,095,438530,188,118,0,118,2
2020-04-09,Sonoma,097,501317,176,113,0,113,1
2020-04-09,Stanislaus,099,539301,219,93,3,96,0
2020-04-09,Sutter,101,95872,23,17,0,17,2
2020-04-09,Tehama,103,63373,1,1,0,1,0
2020-04-09,Trinity,105,12862,0,0,0,0,0
2020-04-09,Tulare,107,460477,395,147,5,152,9
2020-04-09,Tuolumne,109,53932,3,0,0,0,0
2020-04-09,Ventura,111,848112,435,273,0,273,9
2020-04-09,Yolo,113,214977,124,59,0,59,3
2020-04-09,Yuba,115,75493,14,13,0,13,0
2020-04-08,Alameda,001,1643700,1027,594,1,595,15
2020-04-08,Alpine,003,1148,1,1,0,1,0
2020-04-08,Amador,005,37829,7,2,0,2,0
2020-04-08,Butte,007,227075,19,11,2,13,0
2020-04-08,Calaveras,009,45235,10,5,0,5,0
2020-04-08,Colusa,011,21464,3,3,0,3,0
2020-04-08,Contra Costa,013,1133247,690,481,0,481,7
2020-04-08,Del Norte,015,27424,2,2,0,2,0
2020-04-08,El Dorado,017,186661,47,25,0,25,0
2020-04-08,Fresno,019,978130,407,151,4,155,3
2020-04-08,Glenn,021,27897,4,2,0,2,0
2020-04-08,Humboldt,023,135768,57,40,0,40,0
2020-04-08,Imperial,025,180216,149,59,0,59,2
2020-04-08,Inyo,027,18085,12,11,0,11,0
2020-04-08,Kern,029,883053,550,198,0,198,2
2020-04-08,Kings,031,150075,40,5,0,5,0
2020-04-08,Lake,033,64148,5,1,0,1,0
2020-04-08,Lassen,035,31185,3,0,2,2,0
2020-04-08,Los Angeles,037,10098052,12428,7505,13,7518,196
2020-04-08,Madera,039,155013,62,28,1,29,2
2020-04-08,Marin,041,260295,165,125,1,126,7
2020-04-08,Mariposa,043,17540,0,0,0,0,0
2020-04-08,Mendocino,045,87422,5,4,0,4,0
2020-04-08,Merced,047,269075,87,35,0,35,1
2020-04-08,Modoc,049,8938,0,0,0,0,0
2020-04-08,Mono,051,14174,29,19,0,19,1
2020-04-08,Monterey,053,433212,115,68,0,68,3
2020-04-08,Napa,055,140530,44,21,0,21,2
2020-04-08,Nevada,057,99092,36,21,1,22,1
2020-04-08,Orange,059,3164182,1747,1034,18,1052,19
2020-04-08,Placer,061,380077,144,102,0,102,4
2020-04-08,Plumas,063,18699,4,3,0,3,0
2020-04-08,Riverside,065,2383286,2306,974,13,987,28
2020-04-08,Sacramento,067,1510023,842,565,0,565,21
2020-04-08,San Benito,069,59416,36,31,0,31,2
2020-04-08,San Bernardino,071,2135413,1227,635,0,635,22
2020-04-08,San Diego,073,3302833,2149,1532,0,1532,36
2020-04-08,San Francisco,075,870044,1052,687,0,687,7
2020-04-08,San Joaquin,077,732212,365,211,3,214,12
2020-04-08,San Luis Obispo,079,281455,156,90,1,91,1
2020-04-08,San Mateo,081,765935,888,608,2,610,22
2020-04-08,Santa Barbara,083,443738,319,221,1,222,2
2020-04-08,Santa Clara,085,1922200,1828,1257,5,1262,47
2020-04-08,Santa Cruz,087,273765,100,69,0,69,1
2020-04-08,Shasta,089,179085,30,18,0,18,3
2020-04-08,Sierra,091,2930,0,0,0,0,0
2020-04-08,Siskiyou,093,43540,5,4,0,4,0
2020-04-08,Solano,095,438530,175,111,0,111,2
2020-04-08,Sonoma,097,501317,170,107,0,107,1
2020-04-08,Stanislaus,099,539301,203,86,3,89,0
2020-04-08,Sutter,101,95872,22,17,0,17,2
2020-04-08,Tehama,103,63373,1,1,0,1,0
2020-04-08,Trinity,105,12862,0,0,0,0,0
2020-04-08,Tulare,107,460477,364,145,5,150,6
2020-04-08,Tuolumne,109,53932,3,0,0,0,0
2020-04-08,Ventura,111,848112,426,263,0,263,7
2020-04-08,Yolo,113,214977,107,56,0,56,3
2020-04-08,Yuba,115,75493,14,10,0,10,0
2020-04-07,Alameda,001,1643700,992,560,1,561,14
2020-04-07,Alpine,003,1148,1,1,0,1,0
2020-04-07,Amador,005,37829,7,2,0,2,0
2020-04-07,Butte,007,227075,18,11,2,13,0
2020-04-07,Calaveras,009,45235,9,5,0,5,0
2020-04-07,Colusa,011,21464,3,2,0,2,0
2020-04-07,Contra Costa,013,1133247,670,471,0,471,7
2020-04-07,Del Norte,015,27424,2,2,0,2,0
2020-04-07,El Dorado,017,186661,46,22,0,22,0
2020-04-07,Fresno,019,978130,393,138,4,142,3
2020-04-07,Glenn,021,27897,4,2,0,2,0
2020-04-07,Humboldt,023,135768,56,40,0,40,0
2020-04-07,Imperial,025,180216,130,53,0,53,2
2020-04-07,Inyo,027,18085,12,11,0,11,0
2020-04-07,Kern,029,883053,507,134,0,134,2
2020-04-07,Kings,031,150075,37,5,0,5,0
2020-04-07,Lake,033,64148,4,1,0,1,0
2020-04-07,Lassen,035,31185,3,0,2,2,0
2020-04-07,Los Angeles,037,10098052,11777,6885,13,6898,170
2020-04-07,Madera,039,155013,60,28,0,28,2
2020-04-07,Marin,041,260295,163,122,1,123,7
2020-04-07,Mariposa,043,17540,0,0,0,0,0
2020-04-07,Mendocino,045,87422,5,4,0,4,0
2020-04-07,Merced,047,269075,79,27,0,27,1
2020-04-07,Modoc,049,8938,0,0,0,0,0
2020-04-07,Mono,051,14174,28,18,0,18,1
2020-04-07,Monterey,053,433212,106,63,0,63,2
2020-04-07,Napa,055,140530,42,18,0,18,2
2020-04-07,Nevada,057,99092,36,20,1,21,1
2020-04-07,Orange,059,3164182,1700,971,16,987,19
2020-04-07,Placer,061,380077,139,94,0,94,3
2020-04-07,Plumas,063,18699,4,3,0,3,0
2020-04-07,Riverside,065,2383286,2149,905,13,918,25
2020-04-07,Sacramento,067,1510023,812,513,0,513,18
2020-04-07,San Benito,069,59416,36,26,0,26,2
2020-04-07,San Bernardino,071,2135413,1160,554,0,554,19
2020-04-07,San Diego,073,3302833,2072,1456,0,1456,31
2020-04-07,San Francisco,075,870044,992,636,0,636,6
2020-04-07,San Joaquin,077,732212,347,198,3,201,12
2020-04-07,San Luis Obispo,079,281455,149,87,1,88,1
2020-04-07,San Mateo,081,765935,867,573,2,575,22
2020-04-07,Santa Barbara,083,443738,305,209,1,210,2
2020-04-07,Santa Clara,085,1922200,1759,1193,4,1197,46
2020-04-07,Santa Cruz,087,273765,100,67,0,67,1
2020-04-07,Shasta,089,179085,29,16,0,16,3
2020-04-07,Sierra,091,2930,0,0,0,0,0
2020-04-07,Siskiyou,093,43540,5,4,0,4,0
2020-04-07,Solano,095,438530,170,99,0,99,1
2020-04-07,Sonoma,097,501317,167,102,0,102,1
2020-04-07,Stanislaus,099,539301,186,83,3,86,0
2020-04-07,Sutter,101,95872,22,16,0,16,2
2020-04-07,Tehama,103,63373,1,1,0,1,0
2020-04-07,Trinity,105,12862,0,0,0,0,0
2020-04-07,Tulare,107,460477,335,144,5,149,5
2020-04-07,Tuolumne,109,53932,3,1,0,1,0
2020-04-07,Ventura,111,848112,409,247,0,247,6
2020-04-07,Yolo,113,214977,100,51,0,51,2
2020-04-07,Yuba,115,75493,14,10,0,10,0
2020-04-06,Alameda,001,1643700,961,527,1,528,13
2020-04-06,Alpine,003,1148,1,1,0,1,0
2020-04-06,Amador,005,37829,6,2,0,2,0
2020-04-06,Butte,007,227075,17,11,2,13,0
2020-04-06,Calaveras,009,45235,9,4,0,4,0
2020-04-06,Colusa,011,21464,3,1,0,1,0
2020-04-06,Contra Costa,013,1133247,645,447,0,447,7
2020-04-06,Del Norte,015,27424,2,2,0,2,0
2020-04-06,El Dorado,017,186661,44,23,0,23,0
2020-04-06,Fresno,019,978130,371,122,4,126,1
2020-04-06,Glenn,021,27897,4,2,0,2,0
2020-04-06,Humboldt,023,135768,55,37,0,37,0
2020-04-06,Imperial,025,180216,123,47,0,47,1
2020-04-06,Inyo,027,18085,11,11,0,11,0
2020-04-06,Kern,029,883053,470,117,0,117,2
2020-04-06,Kings,031,150075,37,3,0,3,0
2020-04-06,Lake,033,64148,4,1,0,1,0
2020-04-06,Lassen,035,31185,3,0,2,2,0
2020-04-06,Los Angeles,037,10098052,11048,6346,13,6359,145
2020-04-06,Madera,039,155013,58,29,0,29,2
2020-04-06,Marin,041,260295,160,119,1,120,7
2020-04-06,Mariposa,043,17540,0,0,0,0,0
2020-04-06,Mendocino,045,87422,5,4,0,4,0
2020-04-06,Merced,047,269075,74,25,0,25,1
2020-04-06,Modoc,049,8938,0,0,0,0,0
2020-04-06,Mono,051,14174,28,18,0,18,1
2020-04-06,Monterey,053,433212,101,62,0,62,2
2020-04-06,Napa,055,140530,42,18,0,18,2
2020-04-06,Nevada,057,99092,36,19,1,20,1
2020-04-06,Orange,059,3164182,1656,910,15,925,17
2020-04-06,Placer,061,380077,139,90,0,90,3
2020-04-06,Plumas,063,18699,4,2,0,2,0
2020-04-06,Riverside,065,2383286,2023,854,13,867,17
2020-04-06,Sacramento,067,1510023,782,448,0,448,15
2020-04-06,San Benito,069,59416,34,25,0,25,1
2020-04-06,San Bernardino,071,2135413,1101,550,0,550,13
2020-04-06,San Diego,073,3302833,1990,1406,0,1406,19
2020-04-06,San Francisco,075,870044,952,586,0,586,6
2020-04-06,San Joaquin,077,732212,332,191,3,194,10
2020-04-06,San Luis Obispo,079,281455,147,85,1,86,1
2020-04-06,San Mateo,081,765935,849,569,2,571,20
2020-04-06,Santa Barbara,083,443738,296,189,1,190,2
2020-04-06,Santa Clara,085,1922200,1706,1128,4,1132,43
2020-04-06,Santa Cruz,087,273765,98,65,0,65,1
2020-04-06,Shasta,089,179085,29,16,0,16,3
2020-04-06,Sierra,091,2930,0,0,0,0,0
2020-04-06,Siskiyou,093,43540,4,4,0,4,0
2020-04-06,Solano,095,438530,163,95,0,95,1
2020-04-06,Sonoma,097,501317,166,102,0,102,1
2020-04-06,Stanislaus,099,539301,170,72,3,75,0
2020-04-06,Sutter,101,95872,22,14,0,14,2
2020-04-06,Tehama,103,63373,1,1,0,1,0
2020-04-06,Trinity,105,12862,0,0,0,0,0
2020-04-06,Tulare,107,460477,319,126,5,131,5
2020-04-06,Tuolumne,109,53932,3,1,0,1,0
2020-04-06,Ventura,111,848112,391,234,0,234,6
2020-04-06,Yolo,113,214977,96,43,0,43,1
2020-04-06,Yuba,115,75493,14,8,0,8,0
2020-04-05,Alameda,001,1643700,919,475,1,476,12
2020-04-05,Alpine,003,1148,1,1,0,1,0
2020-04-05,Amador,005,37829,6,2,0,2,0
2020-04-05,Butte,007,227075,17,10,2,12,0
2020-04-05,Calaveras,009,45235,9,3,0,3,0
2020-04-05,Colusa,011,21464,3,1,0,1,0
2020-04-05,Contra Costa,013,1133247,628,415,0,415,6
2020-04-05,Del Norte,015,27424,2,1,0,1,0
2020-04-05,El Dorado,017,186661,42,19,0,19,0
2020-04-05,Fresno,019,978130,337,102,4,106,1
2020-04-05,Glenn,021,27897,4,2,0,2,0
2020-04-05,Humboldt,023,135768,55,29,0,29,0
2020-04-05,Imperial,025,180216,115,42,0,42,1
2020-04-05,Inyo,027,18085,11,10,0,10,0
2020-04-05,Kern,029,883053,415,109,0,109,2
2020-04-05,Kings,031,150075,36,4,0,4,0
2020-04-05,Lake,033,64148,4,0,0,0,0
2020-04-05,Lassen,035,31185,3,0,2,2,0
2020-04-05,Los Angeles,037,10098052,10481,5892,13,5905,130
2020-04-05,Madera,039,155013,57,27,0,27,2
2020-04-05,Marin,041,260295,160,113,1,114,6
2020-04-05,Mariposa,043,17540,0,0,0,0,0
2020-04-05,Mendocino,045,87422,5,4,0,4,0
2020-04-05,Merced,047,269075,67,16,0,16,0
2020-04-05,Modoc,049,8938,0,0,0,0,0
2020-04-05,Mono,051,14174,28,18,0,18,1
2020-04-05,Monterey,053,433212,94,61,0,61,2
2020-04-05,Napa,055,140530,40,15,0,15,2
2020-04-05,Nevada,057,99092,36,19,1,20,1
2020-04-05,Orange,059,3164182,1600,820,15,835,15
2020-04-05,Placer,061,380077,136,86,0,86,3
2020-04-05,Plumas,063,18699,3,2,0,2,0
2020-04-05,Riverside,065,2383286,1894,669,13,682,17
2020-04-05,Sacramento,067,1510023,751,393,0,393,11
2020-04-05,San Benito,069,59416,34,22,0,22,1
2020-04-05,San Bernardino,071,2135413,1028,375,0,375,13
2020-04-05,San Diego,073,3302833,1908,1328,0,1328,19
2020-04-05,San Francisco,075,870044,905,559,0,559,6
2020-04-05,San Joaquin,077,732212,317,179,3,182,10
2020-04-05,San Luis Obispo,079,281455,145,83,1,84,1
2020-04-05,San Mateo,081,765935,829,528,2,530,19
2020-04-05,Santa Barbara,083,443738,280,171,1,172,1
2020-04-05,Santa Clara,085,1922200,1659,1052,4,1056,42
2020-04-05,Santa Cruz,087,273765,98,59,0,59,1
2020-04-05,Shasta,089,179085,28,11,0,11,2
2020-04-05,Sierra,091,2930,0,0,0,0,0
2020-04-05,Siskiyou,093,43540,4,3,0,3,0
2020-04-05,Solano,095,438530,159,78,0,78,1
2020-04-05,Sonoma,097,501317,164,88,0,88,1
2020-04-05,Stanislaus,099,539301,156,51,3,54,0
2020-04-05,Sutter,101,95872,22,14,0,14,1
2020-04-05,Tehama,103,63373,1,1,0,1,0
2020-04-05,Trinity,105,12862,0,0,0,0,0
2020-04-05,Tulare,107,460477,282,81,5,86,4
2020-04-05,Tuolumne,109,53932,3,1,0,1,0
2020-04-05,Ventura,111,848112,377,196,0,196,6
2020-04-05,Yolo,113,214977,77,37,0,37,2
2020-04-05,Yuba,115,75493,14,7,0,7,0
2020-04-04,Alameda,001,1643700,896,468,1,469,12
2020-04-04,Alpine,003,1148,1,1,0,1,0
2020-04-04,Amador,005,37829,5,2,0,2,0
2020-04-04,Butte,007,227075,17,10,2,12,0
2020-04-04,Calaveras,009,45235,9,3,0,3,0
2020-04-04,Colusa,011,21464,3,1,0,1,0
2020-04-04,Contra Costa,013,1133247,620,382,0,382,5
2020-04-04,Del Norte,015,27424,2,1,0,1,0
2020-04-04,El Dorado,017,186661,42,19,0,19,0
2020-04-04,Fresno,019,978130,327,102,4,106,1
2020-04-04,Glenn,021,27897,4,2,0,2,0
2020-04-04,Humboldt,023,135768,55,29,0,29,0
2020-04-04,Imperial,025,180216,114,42,0,42,1
2020-04-04,Inyo,027,18085,11,10,0,10,0
2020-04-04,Kern,029,883053,385,103,0,103,2
2020-04-04,Kings,031,150075,36,3,0,3,0
2020-04-04,Lake,033,64148,4,0,0,0,0
2020-04-04,Lassen,035,31185,3,0,2,2,0
2020-04-04,Los Angeles,037,10098052,9865,5275,13,5288,117
2020-04-04,Madera,039,155013,55,27,0,27,2
2020-04-04,Marin,041,260295,158,111,0,111,6
2020-04-04,Mariposa,043,17540,0,0,0,0,0
2020-04-04,Mendocino,045,87422,5,4,0,4,0
2020-04-04,Merced,047,269075,64,11,0,11,0
2020-04-04,Modoc,049,8938,0,0,0,0,0
2020-04-04,Mono,051,14174,28,18,0,18,1
2020-04-04,Monterey,053,433212,91,61,0,61,2
2020-04-04,Napa,055,140530,40,15,0,15,2
2020-04-04,Nevada,057,99092,36,19,1,20,1
2020-04-04,Orange,059,3164182,1558,781,14,795,15
2020-04-04,Placer,061,380077,135,87,0,87,2
2020-04-04,Plumas,063,18699,3,2,0,2,0
2020-04-04,Riverside,065,2383286,1793,652,13,665,15
2020-04-04,Sacramento,067,1510023,733,393,0,393,11
2020-04-04,San Benito,069,59416,34,22,0,22,1
2020-04-04,San Bernardino,071,2135413,980,373,0,373,13
2020-04-04,San Diego,073,3302833,1860,1211,0,1211,18
2020-04-04,San Francisco,075,870044,867,537,0,537,6
2020-04-04,San Joaquin,077,732212,294,171,3,174,10
2020-04-04,San Luis Obispo,079,281455,145,82,1,83,0
2020-04-04,San Mateo,081,765935,817,520,2,522,17
2020-04-04,Santa Barbara,083,443738,271,167,1,168,1
2020-04-04,Santa Clara,085,1922200,1607,1045,4,1049,39
2020-04-04,Santa Cruz,087,273765,98,56,0,56,1
2020-04-04,Shasta,089,179085,27,11,0,11,2
2020-04-04,Sierra,091,2930,0,0,0,0,0
2020-04-04,Siskiyou,093,43540,4,3,0,3,0
2020-04-04,Solano,095,438530,154,79,0,79,1
2020-04-04,Sonoma,097,501317,161,88,0,88,1
2020-04-04,Stanislaus,099,539301,145,51,3,54,0
2020-04-04,Sutter,101,95872,22,14,0,14,1
2020-04-04,Tehama,103,63373,1,1,0,1,0
2020-04-04,Trinity,105,12862,0,0,0,0,0
2020-04-04,Tulare,107,460477,268,79,5,84,4
2020-04-04,Tuolumne,109,53932,3,1,0,1,0
2020-04-04,Ventura,111,848112,364,194,0,194,6
2020-04-04,Yolo,113,214977,75,40,0,40,2
2020-04-04,Yuba,115,75493,13,7,0,7,0
2020-04-03,Alameda,001,1643700,860,395,1,396,11
2020-04-03,Alpine,003,1148,1,1,0,1,0
2020-04-03,Amador,005,37829,5,2,0,2,0
2020-04-03,Butte,007,227075,17,8,2,10,0
2020-04-03,Calaveras,009,45235,9,3,0,3,0
2020-04-03,Colusa,011,21464,3,1,0,1,0
2020-04-03,Contra Costa,013,1133247,597,327,0,327,5
2020-04-03,Del Norte,015,27424,2,1,0,1,0
2020-04-03,El Dorado,017,186661,40,16,0,16,0
2020-04-03,Fresno,019,978130,315,98,4,102,1
2020-04-03,Glenn,021,27897,4,2,0,2,0
2020-04-03,Humboldt,023,135768,55,34,0,34,0
2020-04-03,Imperial,025,180216,105,35,0,35,0
2020-04-03,Inyo,027,18085,11,10,0,10,0
2020-04-03,Kern,029,883053,359,87,0,87,1
2020-04-03,Kings,031,150075,34,3,0,3,0
2020-04-03,Lake,033,64148,3,0,0,0,0
2020-04-03,Lassen,035,31185,3,0,2,2,0
2020-04-03,Los Angeles,037,10098052,9251,4566,13,4579,91
2020-04-03,Madera,039,155013,54,28,0,28,2
2020-04-03,Marin,041,260295,156,106,0,106,6
2020-04-03,Mariposa,043,17540,0,0,0,0,0
2020-04-03,Mendocino,045,87422,5,4,0,4,0
2020-04-03,Merced,047,269075,60,9,0,9,0
2020-04-03,Modoc,049,8938,0,0,0,0,0
2020-04-03,Mono,051,14174,28,18,0,18,1
2020-04-03,Monterey,053,433212,88,58,0,58,2
2020-04-03,Napa,055,140530,39,13,0,13,1
2020-04-03,Nevada,057,99092,36,19,1,20,1
2020-04-03,Orange,059,3164182,1519,713,14,727,13
2020-04-03,Placer,061,380077,131,76,0,76,2
2020-04-03,Plumas,063,18699,3,2,0,2,0
2020-04-03,Riverside,065,2383286,1713,540,13,553,14
2020-04-03,Sacramento,067,1510023,712,363,0,363,11
2020-04-03,San Benito,069,59416,34,22,0,22,1
2020-04-03,San Bernardino,071,2135413,935,356,0,356,11
2020-04-03,San Diego,073,3302833,1799,1114,0,1114,17
2020-04-03,San Francisco,075,870044,843,506,0,506,6
2020-04-03,San Joaquin,077,732212,282,162,3,165,10
2020-04-03,San Luis Obispo,079,281455,144,82,1,83,0
2020-04-03,San Mateo,081,765935,800,474,2,476,13
2020-04-03,Santa Barbara,083,443738,260,154,1,155,1
2020-04-03,Santa Clara,085,1922200,1571,983,4,987,39
2020-04-03,Santa Cruz,087,273765,98,52,0,52,1
2020-04-03,Shasta,089,179085,27,10,0,10,1
2020-04-03,Sierra,091,2930,0,0,0,0,0
2020-04-03,Siskiyou,093,43540,4,3,0,3,0
2020-04-03,Solano,095,438530,146,72,0,72,1
2020-04-03,Sonoma,097,501317,161,84,0,84,1
2020-04-03,Stanislaus,099,539301,139,48,3,51,0
2020-04-03,Sutter,101,95872,22,12,0,12,1
2020-04-03,Tehama,103,63373,1,1,0,1,0
2020-04-03,Trinity,105,12862,0,0,0,0,0
2020-04-03,Tulare,107,460477,254,73,5,78,3
2020-04-03,Tuolumne,109,53932,3,1,0,1,0
2020-04-03,Ventura,111,848112,354,186,0,186,6
2020-04-03,Yolo,113,214977,74,33,0,33,1
2020-04-03,Yuba,115,75493,13,6,0,6,0
2020-04-02,Alameda,001,1643700,809,345,1,346,10
2020-04-02,Alpine,003,1148,1,1,0,1,0
2020-04-02,Amador,005,37829,5,2,0,2,0
2020-04-02,Butte,007,227075,17,7,1,8,0
2020-04-02,Calaveras,009,45235,7,3,0,3,0
2020-04-02,Colusa,011,21464,3,1,0,1,0
2020-04-02,Contra Costa,013,1133247,567,297,0,297,3
2020-04-02,Del Norte,015,27424,2,0,0,0,0
2020-04-02,El Dorado,017,186661,38,16,0,16,0
2020-04-02,Fresno,019,978130,299,92,4,96,0
2020-04-02,Glenn,021,27897,3,2,0,2,0
2020-04-02,Humboldt,023,135768,51,23,0,23,0
2020-04-02,Imperial,025,180216,101,24,0,24,0
2020-04-02,Inyo,027,18085,10,8,0,8,0
2020-04-02,Kern,029,883053,332,74,0,74,0
2020-04-02,Kings,031,150075,34,3,0,3,0
2020-04-02,Lake,033,64148,3,0,0,0,0
2020-04-02,Lassen,035,31185,3,0,2,2,0
2020-04-02,Los Angeles,037,10098052,8421,4040,13,4053,79
2020-04-02,Madera,039,155013,52,25,0,25,1
2020-04-02,Marin,041,260295,150,102,0,102,1
2020-04-02,Mariposa,043,17540,0,0,0,0,0
2020-04-02,Mendocino,045,87422,5,4,0,4,0
2020-04-02,Merced,047,269075,55,9,0,9,0
2020-04-02,Modoc,049,8938,0,0,0,0,0
2020-04-02,Mono,051,14174,28,16,0,16,1
2020-04-02,Monterey,053,433212,86,50,0,50,2
2020-04-02,Napa,055,140530,39,13,0,13,0
2020-04-02,Nevada,057,99092,35,17,1,18,0
2020-04-02,Orange,059,3164182,1467,640,13,653,12
2020-04-02,Placer,061,380077,130,72,0,72,2
2020-04-02,Plumas,063,18699,3,1,0,1,0
2020-04-02,Riverside,065,2383286,1596,438,13,451,13
2020-04-02,Sacramento,067,1510023,694,322,0,322,9
2020-04-02,San Benito,069,59416,32,18,0,18,1
2020-04-02,San Bernardino,071,2135413,880,335,0,335,8
2020-04-02,San Diego,073,3302833,1732,968,0,968,16
2020-04-02,San Francisco,075,870044,817,473,0,473,6
2020-04-02,San Joaquin,077,732212,263,148,3,151,9
2020-04-02,San Luis Obispo,079,281455,139,79,1,80,0
2020-04-02,San Mateo,081,765935,779,423,2,425,13
2020-04-02,Santa Barbara,083,443738,249,125,1,126,1
2020-04-02,Santa Clara,085,1922200,1520,908,4,912,38
2020-04-02,Santa Cruz,087,273765,96,49,0,49,1
2020-04-02,Shasta,089,179085,26,7,0,7,1
2020-04-02,Sierra,091,2930,0,0,0,0,0
2020-04-02,Siskiyou,093,43540,4,3,0,3,0
2020-04-02,Solano,095,438530,136,65,0,65,0
2020-04-02,Sonoma,097,501317,157,76,0,76,1
2020-04-02,Stanislaus,099,539301,128,40,3,43,0
2020-04-02,Sutter,101,95872,21,10,0,10,1
2020-04-02,Tehama,103,63373,1,1,0,1,0
2020-04-02,Trinity,105,12862,0,0,0,0,0
2020-04-02,Tulare,107,460477,220,64,5,69,1
2020-04-02,Tuolumne,109,53932,3,1,0,1,0
2020-04-02,Ventura,111,848112,336,178,0,178,5
2020-04-02,Yolo,113,214977,72,29,0,29,1
2020-04-02,Yuba,115,75493,10,5,0,5,0
2020-04-01,Alameda,001,1643700,782,287,1,288,8
2020-04-01,Alpine,003,1148,1,1,0,1,0
2020-04-01,Amador,005,37829,5,1,0,1,0
2020-04-01,Butte,007,227075,17,6,1,7,0
2020-04-01,Calaveras,009,45235,6,3,0,3,0
2020-04-01,Colusa,011,21464,3,1,0,1,0
2020-04-01,Contra Costa,013,1133247,524,267,0,267,3
2020-04-01,Del Norte,015,27424,2,0,0,0,0
2020-04-01,El Dorado,017,186661,37,14,0,14,0
2020-04-01,Fresno,019,978130,277,75,3,78,0
2020-04-01,Glenn,021,27897,3,2,0,2,0
2020-04-01,Humboldt,023,135768,51,19,0,19,0
2020-04-01,Imperial,025,180216,95,25,0,25,0
2020-04-01,Inyo,027,18085,10,8,0,8,0
2020-04-01,Kern,029,883053,305,53,0,53,0
2020-04-01,Kings,031,150075,32,3,0,3,0
2020-04-01,Lake,033,64148,3,0,0,0,0
2020-04-01,Lassen,035,31185,3,0,2,2,0
2020-04-01,Los Angeles,037,10098052,7773,3502,13,3515,66
2020-04-01,Madera,039,155013,50,17,0,17,1
2020-04-01,Marin,041,260295,146,87,0,87,1
2020-04-01,Mariposa,043,17540,0,0,0,0,0
2020-04-01,Mendocino,045,87422,5,4,0,4,0
2020-04-01,Merced,047,269075,54,7,0,7,0
2020-04-01,Modoc,049,8938,0,0,0,0,0
2020-04-01,Mono,051,14174,28,12,0,12,1
2020-04-01,Monterey,053,433212,85,47,0,47,2
2020-04-01,Napa,055,140530,36,11,0,11,0
2020-04-01,Nevada,057,99092,35,15,1,16,0
2020-04-01,Orange,059,3164182,1415,579,13,592,11
2020-04-01,Placer,061,380077,128,52,0,52,2
2020-04-01,Plumas,063,18699,3,1,0,1,0
2020-04-01,Riverside,065,2383286,1428,306,12,318,11
2020-04-01,Sacramento,067,1510023,661,299,0,299,8
2020-04-01,San Benito,069,59416,29,14,0,14,1
2020-04-01,San Bernardino,071,2135413,831,245,0,245,5
2020-04-01,San Diego,073,3302833,1662,851,0,851,11
2020-04-01,San Francisco,075,870044,789,432,0,432,6
2020-04-01,San Joaquin,077,732212,251,132,3,135,8
2020-04-01,San Luis Obispo,079,281455,133,69,1,70,0
2020-04-01,San Mateo,081,765935,761,354,2,356,13
2020-04-01,Santa Barbara,083,443738,236,103,1,104,0
2020-04-01,Santa Clara,085,1922200,1478,805,4,809,33
2020-04-01,Santa Cruz,087,273765,91,44,0,44,1
2020-04-01,Shasta,089,179085,25,5,0,5,1
2020-04-01,Sierra,091,2930,0,0,0,0,0
2020-04-01,Siskiyou,093,43540,4,3,0,3,0
2020-04-01,Solano,095,438530,131,57,0,57,0
2020-04-01,Sonoma,097,501317,153,60,0,60,1
2020-04-01,Stanislaus,099,539301,117,29,3,32,0
2020-04-01,Sutter,101,95872,21,9,0,9,1
2020-04-01,Tehama,103,63373,1,0,0,0,0
2020-04-01,Trinity,105,12862,0,0,0,0,0
2020-04-01,Tulare,107,460477,182,43,5,48,1
2020-04-01,Tuolumne,109,53932,3,1,0,1,0
2020-04-01,Ventura,111,848112,323,154,0,154,5
2020-04-01,Yolo,113,214977,67,22,0,22,1
2020-04-01,Yuba,115,75493,9,5,0,5,0
2020-03-31,Alameda,001,1643700,716,269,1,270,7
2020-03-31,Alpine,003,1148,1,1,0,1,0
2020-03-31,Amador,005,37829,5,1,0,1,0
2020-03-31,Butte,007,227075,17,6,1,7,0
2020-03-31,Calaveras,009,45235,6,3,0,3,0
2020-03-31,Colusa,011,21464,3,1,0,1,0
2020-03-31,Contra Costa,013,1133247,499,246,0,246,3
2020-03-31,Del Norte,015,27424,1,0,0,0,0
2020-03-31,El Dorado,017,186661,33,14,0,14,0
2020-03-31,Fresno,019,978130,252,59,3,62,0
2020-03-31,Glenn,021,27897,3,2,0,2,0
2020-03-31,Humboldt,023,135768,51,18,0,18,0
2020-03-31,Imperial,025,180216,89,17,0,17,0
2020-03-31,Inyo,027,18085,10,8,0,8,0
2020-03-31,Kern,029,883053,281,47,0,47,0
2020-03-31,Kings,031,150075,30,2,0,2,0
2020-03-31,Lake,033,64148,1,0,0,0,0
2020-03-31,Lassen,035,31185,3,0,2,2,0
2020-03-31,Los Angeles,037,10098052,7111,3001,13,3014,53
2020-03-31,Madera,039,155013,49,17,0,17,1
2020-03-31,Marin,041,260295,137,85,0,85,1
2020-03-31,Mariposa,043,17540,0,0,0,0,0
2020-03-31,Mendocino,045,87422,5,4,0,4,0
2020-03-31,Merced,047,269075,45,6,0,6,0
2020-03-31,Modoc,049,8938,0,0,0,0,0
2020-03-31,Mono,051,14174,26,12,0,12,0
2020-03-31,Monterey,053,433212,83,43,0,43,2
2020-03-31,Napa,055,140530,35,9,0,9,0
2020-03-31,Nevada,057,99092,35,15,1,16,0
2020-03-31,Orange,059,3164182,1345,506,13,519,7
2020-03-31,Placer,061,380077,121,49,0,49,2
2020-03-31,Plumas,063,18699,1,0,0,0,0
2020-03-31,Riverside,065,2383286,1284,284,12,296,8
2020-03-31,Sacramento,067,1510023,609,271,0,271,8
2020-03-31,San Benito,069,59416,29,14,0,14,1
2020-03-31,San Bernardino,071,2135413,746,193,0,193,5
2020-03-31,San Diego,073,3302833,1580,736,0,736,9
2020-03-31,San Francisco,075,870044,754,404,0,404,5
2020-03-31,San Joaquin,077,732212,235,122,3,125,7
2020-03-31,San Luis Obispo,079,281455,129,67,1,68,0
2020-03-31,San Mateo,081,765935,742,297,2,299,12
2020-03-31,Santa Barbara,083,443738,221,89,1,90,0
2020-03-31,Santa Clara,085,1922200,1428,777,4,781,30
2020-03-31,Santa Cruz,087,273765,84,40,0,40,1
2020-03-31,Shasta,089,179085,22,5,0,5,1
2020-03-31,Sierra,091,2930,0,0,0,0,0
2020-03-31,Siskiyou,093,43540,4,3,0,3,0
2020-03-31,Solano,095,438530,117,56,0,56,0
2020-03-31,Sonoma,097,501317,148,58,0,58,1
2020-03-31,Stanislaus,099,539301,102,28,3,31,0
2020-03-31,Sutter,101,95872,21,8,0,8,0
2020-03-31,Tehama,103,63373,1,0,0,0,0
2020-03-31,Trinity,105,12862,0,0,0,0,0
2020-03-31,Tulare,107,460477,159,42,4,46,1
2020-03-31,Tuolumne,109,53932,3,1,0,1,0
2020-03-31,Ventura,111,848112,312,143,0,143,4
2020-03-31,Yolo,113,214977,60,21,0,21,1
2020-03-31,Yuba,115,75493,9,5,0,5,0
2020-03-30,Alameda,001,1643700,677,250,1,251,7
2020-03-30,Alpine,003,1148,1,1,0,1,0
2020-03-30,Amador,005,37829,5,1,0,1,0
2020-03-30,Butte,007,227075,15,5,1,6,0
2020-03-30,Calaveras,009,45235,6,3,0,3,0
2020-03-30,Colusa,011,21464,3,1,0,1,0
2020-03-30,Contra Costa,013,1133247,473,212,0,212,3
2020-03-30,Del Norte,015,27424,0,0,0,0,0
2020-03-30,El Dorado,017,186661,33,11,0,11,0
2020-03-30,Fresno,019,978130,227,46,3,49,0
2020-03-30,Glenn,021,27897,3,2,0,2,0
2020-03-30,Humboldt,023,135768,49,11,0,11,0
2020-03-30,Imperial,025,180216,86,9,0,9,0
2020-03-30,Inyo,027,18085,10,5,0,5,0
2020-03-30,Kern,029,883053,248,30,0,30,0
2020-03-30,Kings,031,150075,30,1,0,1,0
2020-03-30,Lake,033,64148,1,0,0,0,0
2020-03-30,Lassen,035,31185,3,0,1,1,0
2020-03-30,Los Angeles,037,10098052,6449,2467,13,2480,44
2020-03-30,Madera,039,155013,48,14,0,14,1
2020-03-30,Marin,041,260295,130,78,0,78,0
2020-03-30,Mariposa,043,17540,0,0,0,0,0
2020-03-30,Mendocino,045,87422,5,2,0,2,0
2020-03-30,Merced,047,269075,41,6,0,6,0
2020-03-30,Modoc,049,8938,0,0,0,0,0
2020-03-30,Mono,051,14174,26,11,0,11,0
2020-03-30,Monterey,053,433212,78,41,0,41,1
2020-03-30,Napa,055,140530,34,9,0,9,0
2020-03-30,Nevada,057,99092,34,14,1,15,0
2020-03-30,Orange,059,3164182,1280,418,13,431,5
2020-03-30,Placer,061,380077,118,44,0,44,2
2020-03-30,Plumas,063,18699,1,0,0,0,0
2020-03-30,Riverside,065,2383286,1203,204,12,216,7
2020-03-30,Sacramento,067,1510023,585,238,0,238,8
2020-03-30,San Benito,069,59416,29,11,0,11,1
2020-03-30,San Bernardino,071,2135413,702,145,0,145,4
2020-03-30,San Diego,073,3302833,1510,605,0,605,7
2020-03-30,San Francisco,075,870044,714,368,0,368,5
2020-03-30,San Joaquin,077,732212,228,112,3,115,5
2020-03-30,San Luis Obispo,079,281455,126,62,1,63,0
2020-03-30,San Mateo,081,765935,717,257,2,259,11
2020-03-30,Santa Barbara,083,443738,212,79,1,80,0
2020-03-30,Santa Clara,085,1922200,1397,745,3,748,31
2020-03-30,Santa Cruz,087,273765,81,36,0,36,1
2020-03-30,Shasta,089,179085,21,4,0,4,1
2020-03-30,Sierra,091,2930,0,0,0,0,0
2020-03-30,Siskiyou,093,43540,4,2,0,2,0
2020-03-30,Solano,095,438530,111,50,0,50,0
2020-03-30,Sonoma,097,501317,145,57,0,57,1
2020-03-30,Stanislaus,099,539301,95,28,3,31,0
2020-03-30,Sutter,101,95872,20,6,0,6,0
2020-03-30,Tehama,103,63373,1,0,0,0,0
2020-03-30,Trinity,105,12862,0,0,0,0,0
2020-03-30,Tulare,107,460477,147,40,3,43,1
2020-03-30,Tuolumne,109,53932,3,1,0,1,0
2020-03-30,Ventura,111,848112,301,118,0,118,2
2020-03-30,Yolo,113,214977,57,17,0,17,1
2020-03-30,Yuba,115,75493,8,5,0,5,0
2020-03-29,Alameda,001,1643700,643,207,1,208,6
2020-03-29,Alpine,003,1148,1,0,0,0,0
2020-03-29,Amador,005,37829,5,1,0,1,0
2020-03-29,Butte,007,227075,15,4,1,5,0
2020-03-29,Calaveras,009,45235,6,2,0,2,0
2020-03-29,Colusa,011,21464,3,1,0,1,0
2020-03-29,Contra Costa,013,1133247,443,187,0,187,3
2020-03-29,Del Norte,015,27424,0,0,0,0,0
2020-03-29,El Dorado,017,186661,32,9,0,9,0
2020-03-29,Fresno,019,978130,203,31,3,34,0
2020-03-29,Glenn,021,27897,2,1,0,1,0
2020-03-29,Humboldt,023,135768,46,9,0,9,0
2020-03-29,Imperial,025,180216,79,9,0,9,0
2020-03-29,Inyo,027,18085,9,0,0,0,0
2020-03-29,Kern,029,883053,230,20,0,20,0
2020-03-29,Kings,031,150075,27,1,0,1,0
2020-03-29,Lake,033,64148,0,0,0,0,0
2020-03-29,Lassen,035,31185,3,0,1,1,0
2020-03-29,Los Angeles,037,10098052,5798,2119,12,2131,37
2020-03-29,Madera,039,155013,43,11,0,11,1
2020-03-29,Marin,041,260295,125,60,0,60,0
2020-03-29,Mariposa,043,17540,0,0,0,0,0
2020-03-29,Mendocino,045,87422,5,2,0,2,0
2020-03-29,Merced,047,269075,38,4,0,4,0
2020-03-29,Modoc,049,8938,0,0,0,0,0
2020-03-29,Mono,051,14174,26,8,0,8,0
2020-03-29,Monterey,053,433212,73,36,0,36,1
2020-03-29,Napa,055,140530,32,5,0,5,0
2020-03-29,Nevada,057,99092,32,13,1,14,0
2020-03-29,Orange,059,3164182,1207,343,13,356,2
2020-03-29,Placer,061,380077,117,35,0,35,2
2020-03-29,Plumas,063,18699,1,0,0,0,0
2020-03-29,Riverside,065,2383286,1079,122,12,134,7
2020-03-29,Sacramento,067,1510023,545,217,0,217,7
2020-03-29,San Benito,069,59416,28,10,0,10,1
2020-03-29,San Bernardino,071,2135413,650,94,0,94,2
2020-03-29,San Diego,073,3302833,1438,521,0,521,7
2020-03-29,San Francisco,075,870044,670,333,0,333,5
2020-03-29,San Joaquin,077,732212,219,86,3,89,4
2020-03-29,San Luis Obispo,079,281455,119,55,0,55,0
2020-03-29,San Mateo,081,765935,692,234,2,236,12
2020-03-29,Santa Barbara,083,443738,204,52,1,53,0
2020-03-29,Santa Clara,085,1922200,1340,591,3,594,30
2020-03-29,Santa Cruz,087,273765,81,33,0,33,1
2020-03-29,Shasta,089,179085,20,4,0,4,1
2020-03-29,Sierra,091,2930,0,0,0,0,0
2020-03-29,Siskiyou,093,43540,4,2,0,2,0
2020-03-29,Solano,095,438530,103,48,0,48,0
2020-03-29,Sonoma,097,501317,143,35,0,35,1
2020-03-29,Stanislaus,099,539301,90,19,3,22,0
2020-03-29,Sutter,101,95872,17,6,0,6,0
2020-03-29,Tehama,103,63373,1,0,0,0,0
2020-03-29,Trinity,105,12862,0,0,0,0,0
2020-03-29,Tulare,107,460477,122,24,3,27,1
2020-03-29,Tuolumne,109,53932,2,1,0,1,0
2020-03-29,Ventura,111,848112,274,92,0,92,2
2020-03-29,Yolo,113,214977,52,13,0,13,1
2020-03-29,Yuba,115,75493,8,3,0,3,0
2020-03-28,Alameda,001,1643700,616,410,1,411,12
2020-03-28,Alpine,003,1148,1,0,0,0,0
2020-03-28,Amador,005,37829,5,2,0,2,0
2020-03-28,Butte,007,227075,15,8,1,9,0
2020-03-28,Calaveras,009,45235,6,4,0,4,0
2020-03-28,Colusa,011,21464,3,2,0,2,0
2020-03-28,Contra Costa,013,1133247,420,350,0,350,4
2020-03-28,Del Norte,015,27424,0,0,0,0,0
2020-03-28,El Dorado,017,186661,31,18,0,18,0
2020-03-28,Fresno,019,978130,193,62,3,65,0
2020-03-28,Glenn,021,27897,2,2,0,2,0
2020-03-28,Humboldt,023,135768,46,18,0,18,0
2020-03-28,Imperial,025,180216,74,18,0,18,0
2020-03-28,Inyo,027,18085,9,0,0,0,0
2020-03-28,Kern,029,883053,213,40,0,40,0
2020-03-28,Kings,031,150075,26,2,0,2,0
2020-03-28,Lake,033,64148,0,0,0,0,0
2020-03-28,Lassen,035,31185,3,0,1,1,0
2020-03-28,Los Angeles,037,10098052,5413,3600,11,3611,64
2020-03-28,Madera,039,155013,43,22,0,22,2
2020-03-28,Marin,041,260295,120,116,0,116,0
2020-03-28,Mariposa,043,17540,0,0,0,0,0
2020-03-28,Mendocino,045,87422,5,4,0,4,0
2020-03-28,Merced,047,269075,37,8,0,8,0
2020-03-28,Modoc,049,8938,0,0,0,0,0
2020-03-28,Mono,051,14174,24,12,0,12,0
2020-03-28,Monterey,053,433212,72,64,0,64,2
2020-03-28,Napa,055,140530,27,10,0,10,0
2020-03-28,Nevada,057,99092,32,22,1,23,0
2020-03-28,Orange,059,3164182,1171,656,13,669,4
2020-03-28,Placer,061,380077,112,70,0,70,2
2020-03-28,Plumas,063,18699,1,0,0,0,0
2020-03-28,Riverside,065,2383286,1011,242,12,254,14
2020-03-28,Sacramento,067,1510023,527,406,0,406,14
2020-03-28,San Benito,069,59416,28,20,0,20,2
2020-03-28,San Bernardino,071,2135413,603,162,0,162,4
2020-03-28,San Diego,073,3302833,1379,980,0,980,14
2020-03-28,San Francisco,075,870044,646,600,0,600,6
2020-03-28,San Joaquin,077,732212,212,166,3,169,8
2020-03-28,San Luis Obispo,079,281455,117,104,0,104,0
2020-03-28,San Mateo,081,765935,672,462,2,464,17
2020-03-28,Santa Barbara,083,443738,194,98,1,99,0
2020-03-28,Santa Clara,085,1922200,1321,1174,3,1177,54
2020-03-28,Santa Cruz,087,273765,80,62,0,62,0
2020-03-28,Shasta,089,179085,20,8,0,8,2
2020-03-28,Sierra,091,2930,0,0,0,0,0
2020-03-28,Siskiyou,093,43540,4,4,0,4,0
2020-03-28,Solano,095,438530,99,96,0,96,0
2020-03-28,Sonoma,097,501317,141,70,0,70,2
2020-03-28,Stanislaus,099,539301,85,34,3,37,0
2020-03-28,Sutter,101,95872,17,6,0,6,0
2020-03-28,Tehama,103,63373,1,0,0,0,0
2020-03-28,Trinity,105,12862,0,0,0,0,0
2020-03-28,Tulare,107,460477,114,46,3,49,0
2020-03-28,Tuolumne,109,53932,2,2,0,2,0
2020-03-28,Ventura,111,848112,270,178,0,178,4
2020-03-28,Yolo,113,214977,51,26,0,26,2
2020-03-28,Yuba,115,75493,8,6,0,6,0
2020-03-27,Alameda,001,1643700,597,185,1,186,4
2020-03-27,Alpine,003,1148,1,0,0,0,0
2020-03-27,Amador,005,37829,4,1,0,1,0
2020-03-27,Butte,007,227075,13,4,1,5,0
2020-03-27,Calaveras,009,45235,6,2,0,2,0
2020-03-27,Colusa,011,21464,3,0,0,0,0
2020-03-27,Contra Costa,013,1133247,399,161,0,161,2
2020-03-27,Del Norte,015,27424,0,0,0,0,0
2020-03-27,El Dorado,017,186661,29,9,0,9,0
2020-03-27,Fresno,019,978130,181,29,2,31,0
2020-03-27,Glenn,021,27897,2,0,0,0,0
2020-03-27,Humboldt,023,135768,42,9,0,9,0
2020-03-27,Imperial,025,180216,69,9,0,9,0
2020-03-27,Inyo,027,18085,9,0,0,0,0
2020-03-27,Kern,029,883053,200,20,0,20,0
2020-03-27,Kings,031,150075,25,0,0,0,0
2020-03-27,Lake,033,64148,0,0,0,0,0
2020-03-27,Lassen,035,31185,3,0,1,1,0
2020-03-27,Los Angeles,037,10098052,5005,1474,11,1485,26
2020-03-27,Madera,039,155013,41,10,0,10,1
2020-03-27,Marin,041,260295,115,58,0,58,0
2020-03-27,Mariposa,043,17540,0,0,0,0,0
2020-03-27,Mendocino,045,87422,5,2,0,2,0
2020-03-27,Merced,047,269075,35,3,0,3,0
2020-03-27,Modoc,049,8938,0,0,0,0,0
2020-03-27,Mono,051,14174,24,6,0,6,0
2020-03-27,Monterey,053,433212,69,26,0,26,1
2020-03-27,Napa,055,140530,27,5,0,5,0
2020-03-27,Nevada,057,99092,32,6,1,7,0
2020-03-27,Orange,059,3164182,1121,299,13,312,2
2020-03-27,Placer,061,380077,109,33,0,33,1
2020-03-27,Plumas,063,18699,0,0,0,0,0
2020-03-27,Riverside,065,2383286,955,121,12,133,7
2020-03-27,Sacramento,067,1510023,504,163,0,163,6
2020-03-27,San Benito,069,59416,27,9,0,9,1
2020-03-27,San Bernardino,071,2135413,513,77,0,77,2
2020-03-27,San Diego,073,3302833,1322,419,0,419,5
2020-03-27,San Francisco,075,870044,621,285,0,285,2
2020-03-27,San Joaquin,077,732212,201,73,3,76,3
2020-03-27,San Luis Obispo,079,281455,115,46,0,46,0
2020-03-27,San Mateo,081,765935,646,213,2,215,7
2020-03-27,Santa Barbara,083,443738,180,37,1,38,0
2020-03-27,Santa Clara,085,1922200,1283,557,3,560,25
2020-03-27,Santa Cruz,087,273765,79,31,0,31,0
2020-03-27,Shasta,089,179085,17,3,0,3,1
2020-03-27,Sierra,091,2930,0,0,0,0,0
2020-03-27,Siskiyou,093,43540,4,2,0,2,0
2020-03-27,Solano,095,438530,93,48,0,48,0
2020-03-27,Sonoma,097,501317,133,35,0,35,1
2020-03-27,Stanislaus,099,539301,83,16,3,19,0
2020-03-27,Sutter,101,95872,16,2,0,2,0
2020-03-27,Tehama,103,63373,1,0,0,0,0
2020-03-27,Trinity,105,12862,0,0,0,0,0
2020-03-27,Tulare,107,460477,106,15,3,18,0
2020-03-27,Tuolumne,109,53932,2,1,0,1,0
2020-03-27,Ventura,111,848112,261,80,0,80,2
2020-03-27,Yolo,113,214977,50,13,0,13,1
2020-03-27,Yuba,115,75493,7,3,0,3,0
2020-03-26,Alameda,001,1643700,557,172,1,173,4
2020-03-26,Alpine,003,1148,1,0,0,0,0
2020-03-26,Amador,005,37829,4,1,0,1,0
2020-03-26,Butte,007,227075,13,4,1,5,0
2020-03-26,Calaveras,009,45235,6,2,0,2,0
2020-03-26,Colusa,011,21464,3,0,0,0,0
2020-03-26,Contra Costa,013,1133247,388,147,0,147,2
2020-03-26,Del Norte,015,27424,0,0,0,0,0
2020-03-26,El Dorado,017,186661,27,7,0,7,0
2020-03-26,Fresno,019,978130,172,25,2,27,0
2020-03-26,Glenn,021,27897,2,0,0,0,0
2020-03-26,Humboldt,023,135768,38,8,0,8,0
2020-03-26,Imperial,025,180216,65,8,0,8,0
2020-03-26,Inyo,027,18085,8,0,0,0,0
2020-03-26,Kern,029,883053,184,20,0,20,0
2020-03-26,Kings,031,150075,25,0,0,0,0
2020-03-26,Lake,033,64148,0,0,0,0,0
2020-03-26,Lassen,035,31185,3,0,1,1,0
2020-03-26,Los Angeles,037,10098052,4598,1075,11,1086,19
2020-03-26,Madera,039,155013,39,8,0,8,0
2020-03-26,Marin,041,260295,106,56,0,56,0
2020-03-26,Mariposa,043,17540,0,0,0,0,0
2020-03-26,Mendocino,045,87422,4,1,0,1,0
2020-03-26,Merced,047,269075,32,1,0,1,0
2020-03-26,Modoc,049,8938,0,0,0,0,0
2020-03-26,Mono,051,14174,23,5,0,5,0
2020-03-26,Monterey,053,433212,66,25,0,25,1
2020-03-26,Napa,055,140530,26,5,0,5,0
2020-03-26,Nevada,057,99092,32,7,1,8,0
2020-03-26,Orange,059,3164182,1059,279,11,290,1
2020-03-26,Placer,061,380077,106,34,0,34,1
2020-03-26,Plumas,063,18699,0,0,0,0,0
2020-03-26,Riverside,065,2383286,884,118,12,130,7
2020-03-26,Sacramento,067,1510023,471,147,0,147,5
2020-03-26,San Benito,069,59416,27,8,0,8,1
2020-03-26,San Bernardino,071,2135413,447,57,0,57,1
2020-03-26,San Diego,073,3302833,1255,299,0,299,2
2020-03-26,San Francisco,075,870044,594,261,0,261,1
2020-03-26,San Joaquin,077,732212,190,69,3,72,3
2020-03-26,San Luis Obispo,079,281455,110,38,0,38,0
2020-03-26,San Mateo,081,765935,612,122,2,124,5
2020-03-26,Santa Barbara,083,443738,167,33,1,34,0
2020-03-26,Santa Clara,085,1922200,1238,487,2,489,20
2020-03-26,Santa Cruz,087,273765,75,30,0,30,0
2020-03-26,Shasta,089,179085,17,3,0,3,1
2020-03-26,Sierra,091,2930,0,0,0,0,0
2020-03-26,Siskiyou,093,43540,4,2,0,2,0
2020-03-26,Solano,095,438530,85,41,0,41,0
2020-03-26,Sonoma,097,501317,128,33,0,33,1
2020-03-26,Stanislaus,099,539301,81,15,3,18,0
2020-03-26,Sutter,101,95872,12,2,0,2,0
2020-03-26,Tehama,103,63373,1,0,0,0,0
2020-03-26,Trinity,105,12862,0,0,0,0,0
2020-03-26,Tulare,107,460477,97,15,3,18,0
2020-03-26,Tuolumne,109,53932,2,0,0,0,0
2020-03-26,Ventura,111,848112,245,70,0,70,1
2020-03-26,Yolo,113,214977,46,13,0,13,1
2020-03-26,Yuba,115,75493,7,3,0,3,0
2020-03-25,Alameda,001,1643700,536,134,1,135,3
2020-03-25,Alpine,003,1148,1,0,0,0,0
2020-03-25,Amador,005,37829,4,1,0,1,0
2020-03-25,Butte,007,227075,13,4,1,5,0
2020-03-25,Calaveras,009,45235,6,2,0,2,0
2020-03-25,Colusa,011,21464,2,0,0,0,0
2020-03-25,Contra Costa,013,1133247,374,131,0,131,1
2020-03-25,Del Norte,015,27424,0,0,0,0,0
2020-03-25,El Dorado,017,186661,27,5,0,5,0
2020-03-25,Fresno,019,978130,152,21,2,23,0
2020-03-25,Glenn,021,27897,2,0,0,0,0
2020-03-25,Humboldt,023,135768,35,3,0,3,0
2020-03-25,Imperial,025,180216,57,8,0,8,0
2020-03-25,Inyo,027,18085,5,0,0,0,0
2020-03-25,Kern,029,883053,164,13,0,13,0
2020-03-25,Kings,031,150075,23,0,0,0,0
2020-03-25,Lake,033,64148,0,0,0,0,0
2020-03-25,Lassen,035,31185,3,0,1,1,0
2020-03-25,Los Angeles,037,10098052,4198,725,11,736,10
2020-03-25,Madera,039,155013,37,6,0,6,0
2020-03-25,Marin,041,260295,100,47,0,47,0
2020-03-25,Mariposa,043,17540,0,0,0,0,0
2020-03-25,Mendocino,045,87422,3,1,0,1,0
2020-03-25,Merced,047,269075,29,0,0,0,0
2020-03-25,Modoc,049,8938,0,0,0,0,0
2020-03-25,Mono,051,14174,22,4,0,4,0
2020-03-25,Monterey,053,433212,63,23,0,23,1
2020-03-25,Napa,055,140530,26,5,0,5,0
2020-03-25,Nevada,057,99092,31,5,1,6,0
2020-03-25,Orange,059,3164182,1001,214,9,223,1
2020-03-25,Placer,061,380077,100,30,0,30,1
2020-03-25,Plumas,063,18699,0,1,0,1,0
2020-03-25,Riverside,065,2383286,813,87,12,99,5
2020-03-25,Sacramento,067,1510023,445,114,0,114,5
2020-03-25,San Benito,069,59416,26,4,0,4,1
2020-03-25,San Bernardino,071,2135413,408,46,0,46,1
2020-03-25,San Diego,073,3302833,1193,238,0,238,2
2020-03-25,San Francisco,075,870044,553,212,0,212,1
2020-03-25,San Joaquin,077,732212,177,64,3,67,2
2020-03-25,San Luis Obispo,079,281455,105,35,0,35,0
2020-03-25,San Mateo,081,765935,577,111,2,113,5
2020-03-25,Santa Barbara,083,443738,157,25,1,26,0
2020-03-25,Santa Clara,085,1922200,1194,452,2,454,20
2020-03-25,Santa Cruz,087,273765,72,26,0,26,0
2020-03-25,Shasta,089,179085,16,3,0,3,1
2020-03-25,Sierra,091,2930,0,0,0,0,0
2020-03-25,Siskiyou,093,43540,4,2,0,2,0
2020-03-25,Solano,095,438530,80,39,0,39,0
2020-03-25,Sonoma,097,501317,123,31,0,31,1
2020-03-25,Stanislaus,099,539301,74,14,3,17,0
2020-03-25,Sutter,101,95872,9,1,0,1,0
2020-03-25,Tehama,103,63373,1,0,0,0,0
2020-03-25,Trinity,105,12862,0,0,0,0,0
2020-03-25,Tulare,107,460477,87,11,3,14,0
2020-03-25,Tuolumne,109,53932,2,0,0,0,0
2020-03-25,Ventura,111,848112,229,53,0,53,1
2020-03-25,Yolo,113,214977,44,9,0,9,1
2020-03-25,Yuba,115,75493,7,2,0,2,0
2020-03-24,Alameda,001,1643700,504,96,1,97,2
2020-03-24,Alpine,003,1148,1,0,0,0,0
2020-03-24,Amador,005,37829,2,1,0,1,0
2020-03-24,Butte,007,227075,12,3,1,4,0
2020-03-24,Calaveras,009,45235,5,2,0,2,0
2020-03-24,Colusa,011,21464,2,0,0,0,0
2020-03-24,Contra Costa,013,1133247,361,108,0,108,1
2020-03-24,Del Norte,015,27424,0,0,0,0,0
2020-03-24,El Dorado,017,186661,27,3,0,3,0
2020-03-24,Fresno,019,978130,133,18,2,20,0
2020-03-24,Glenn,021,27897,2,0,0,0,0
2020-03-24,Humboldt,023,135768,33,2,0,2,0
2020-03-24,Imperial,025,180216,54,3,0,3,0
2020-03-24,Inyo,027,18085,5,0,0,0,0
2020-03-24,Kern,029,883053,144,5,0,5,0
2020-03-24,Kings,031,150075,22,0,0,0,0
2020-03-24,Lake,033,64148,0,0,0,0,0
2020-03-24,Lassen,035,31185,3,0,1,1,0
2020-03-24,Los Angeles,037,10098052,3754,633,11,644,7
2020-03-24,Madera,039,155013,36,6,0,6,0
2020-03-24,Marin,041,260295,89,44,0,44,0
2020-03-24,Mariposa,043,17540,0,0,0,0,0
2020-03-24,Mendocino,045,87422,3,1,0,1,0
2020-03-24,Merced,047,269075,26,0,0,0,0
2020-03-24,Modoc,049,8938,0,0,0,0,0
2020-03-24,Mono,051,14174,21,1,0,1,0
2020-03-24,Monterey,053,433212,59,23,0,23,1
2020-03-24,Napa,055,140530,23,2,0,2,0
2020-03-24,Nevada,057,99092,30,4,1,5,0
2020-03-24,Orange,059,3164182,939,166,9,175,0
2020-03-24,Placer,061,380077,93,22,0,22,1
2020-03-24,Plumas,063,18699,0,1,0,1,0
2020-03-24,Riverside,065,2383286,746,56,12,68,5
2020-03-24,Sacramento,067,1510023,426,93,0,93,4
2020-03-24,San Benito,069,59416,25,4,0,4,1
2020-03-24,San Bernardino,071,2135413,364,27,0,27,0
2020-03-24,San Diego,073,3302833,1126,231,0,231,2
2020-03-24,San Francisco,075,870044,521,181,0,181,1
2020-03-24,San Joaquin,077,732212,166,52,3,55,2
2020-03-24,San Luis Obispo,079,281455,102,32,0,32,0
2020-03-24,San Mateo,081,765935,536,100,2,102,2
2020-03-24,Santa Barbara,083,443738,151,20,1,21,0
2020-03-24,Santa Clara,085,1922200,1125,389,2,391,17
2020-03-24,Santa Cruz,087,273765,67,22,0,22,0
2020-03-24,Shasta,089,179085,15,3,0,3,0
2020-03-24,Sierra,091,2930,0,0,0,0,0
2020-03-24,Siskiyou,093,43540,4,2,0,2,0
2020-03-24,Solano,095,438530,78,34,0,34,0
2020-03-24,Sonoma,097,501317,116,27,0,27,1
2020-03-24,Stanislaus,099,539301,65,13,3,16,0
2020-03-24,Sutter,101,95872,9,0,0,0,0
2020-03-24,Tehama,103,63373,1,0,0,0,0
2020-03-24,Trinity,105,12862,0,0,0,0,0
2020-03-24,Tulare,107,460477,77,10,3,13,0
2020-03-24,Tuolumne,109,53932,2,0,0,0,0
2020-03-24,Ventura,111,848112,213,44,0,44,1
2020-03-24,Yolo,113,214977,40,8,0,8,0
2020-03-24,Yuba,115,75493,7,2,0,2,0
2020-03-23,Alameda,001,1643700,472,88,1,89,1
2020-03-23,Alpine,003,1148,1,0,0,0,0
2020-03-23,Amador,005,37829,2,1,0,1,0
2020-03-23,Butte,007,227075,12,2,0,2,0
2020-03-23,Calaveras,009,45235,5,2,0,2,0
2020-03-23,Colusa,011,21464,1,0,0,0,0
2020-03-23,Contra Costa,013,1133247,341,91,0,91,2
2020-03-23,Del Norte,015,27424,0,0,0,0,0
2020-03-23,El Dorado,017,186661,26,3,0,3,0
2020-03-23,Fresno,019,978130,123,10,2,12,0
2020-03-23,Glenn,021,27897,2,0,0,0,0
2020-03-23,Humboldt,023,135768,31,2,0,2,0
2020-03-23,Imperial,025,180216,50,2,0,2,0
2020-03-23,Inyo,027,18085,3,0,0,0,0
2020-03-23,Kern,029,883053,130,5,0,5,0
2020-03-23,Kings,031,150075,22,0,0,0,0
2020-03-23,Lake,033,64148,0,0,0,0,0
2020-03-23,Lassen,035,31185,3,0,1,1,0
2020-03-23,Los Angeles,037,10098052,3446,389,10,399,4
2020-03-23,Madera,039,155013,36,4,0,4,0
2020-03-23,Marin,041,260295,84,30,0,30,0
2020-03-23,Mariposa,043,17540,0,0,0,0,0
2020-03-23,Mendocino,045,87422,3,1,0,1,0
2020-03-23,Merced,047,269075,19,0,0,0,0
2020-03-23,Modoc,049,8938,0,0,0,0,0
2020-03-23,Mono,051,14174,19,1,0,1,0
2020-03-23,Monterey,053,433212,54,14,0,14,1
2020-03-23,Napa,055,140530,21,1,0,1,0
2020-03-23,Nevada,057,99092,27,2,1,3,0
2020-03-23,Orange,059,3164182,884,138,7,145,0
2020-03-23,Placer,061,380077,90,19,0,19,1
2020-03-23,Plumas,063,18699,0,0,0,0,0
2020-03-23,Riverside,065,2383286,703,39,12,51,5
2020-03-23,Sacramento,067,1510023,393,87,0,87,4
2020-03-23,San Benito,069,59416,24,4,0,4,1
2020-03-23,San Bernardino,071,2135413,334,17,0,17,0
2020-03-23,San Diego,073,3302833,1067,178,0,178,1
2020-03-23,San Francisco,075,870044,492,152,0,152,0
2020-03-23,San Joaquin,077,732212,154,37,3,40,2
2020-03-23,San Luis Obispo,079,281455,96,23,0,23,0
2020-03-23,San Mateo,081,765935,497,88,2,90,1
2020-03-23,Santa Barbara,083,443738,133,18,1,19,0
2020-03-23,Santa Clara,085,1922200,1076,336,2,338,13
2020-03-23,Santa Cruz,087,273765,65,21,0,21,0
2020-03-23,Shasta,089,179085,13,2,0,2,0
2020-03-23,Sierra,091,2930,0,0,0,0,0
2020-03-23,Siskiyou,093,43540,4,2,0,2,0
2020-03-23,Solano,095,438530,74,33,0,33,0
2020-03-23,Sonoma,097,501317,104,19,0,19,1
2020-03-23,Stanislaus,099,539301,57,10,3,13,0
2020-03-23,Sutter,101,95872,9,0,0,0,0
2020-03-23,Tehama,103,63373,1,0,0,0,0
2020-03-23,Trinity,105,12862,0,0,0,0,0
2020-03-23,Tulare,107,460477,68,9,3,12,0
2020-03-23,Tuolumne,109,53932,2,0,0,0,0
2020-03-23,Ventura,111,848112,196,30,0,30,0
2020-03-23,Yolo,113,214977,39,8,0,8,0
2020-03-23,Yuba,115,75493,7,2,0,2,0
2020-03-22,Alameda,001,1643700,433,72,1,73,1
2020-03-22,Alpine,003,1148,1,0,0,0,0
2020-03-22,Amador,005,37829,2,1,0,1,0
2020-03-22,Butte,007,227075,8,1,0,1,0
2020-03-22,Calaveras,009,45235,4,2,0,2,0
2020-03-22,Colusa,011,21464,1,0,0,0,0
2020-03-22,Contra Costa,013,1133247,314,79,0,79,1
2020-03-22,Del Norte,015,27424,0,0,0,0,0
2020-03-22,El Dorado,017,186661,24,1,0,1,0
2020-03-22,Fresno,019,978130,103,8,2,10,0
2020-03-22,Glenn,021,27897,2,0,0,0,0
2020-03-22,Humboldt,023,135768,28,1,0,1,0
2020-03-22,Imperial,025,180216,48,2,0,2,0
2020-03-22,Inyo,027,18085,1,0,0,0,0
2020-03-22,Kern,029,883053,114,3,0,3,0
2020-03-22,Kings,031,150075,19,0,0,0,0
2020-03-22,Lake,033,64148,0,0,0,0,0
2020-03-22,Lassen,035,31185,3,0,1,1,0
2020-03-22,Los Angeles,037,10098052,3116,384,10,394,3
2020-03-22,Madera,039,155013,33,4,0,4,0
2020-03-22,Marin,041,260295,74,30,0,30,0
2020-03-22,Mariposa,043,17540,0,0,0,0,0
2020-03-22,Mendocino,045,87422,3,1,0,1,0
2020-03-22,Merced,047,269075,16,0,0,0,0
2020-03-22,Modoc,049,8938,0,0,0,0,0
2020-03-22,Mono,051,14174,14,1,0,1,0
2020-03-22,Monterey,053,433212,51,14,0,14,1
2020-03-22,Napa,055,140530,17,1,0,1,0
2020-03-22,Nevada,057,99092,23,2,1,3,0
2020-03-22,Orange,059,3164182,811,102,4,106,0
2020-03-22,Placer,061,380077,88,18,0,18,1
2020-03-22,Plumas,063,18699,0,0,0,0,0
2020-03-22,Riverside,065,2383286,613,26,8,34,5
2020-03-22,Sacramento,067,1510023,361,82,0,82,4
2020-03-22,San Benito,069,59416,19,4,0,4,1
2020-03-22,San Bernardino,071,2135413,290,16,0,16,0
2020-03-22,San Diego,073,3302833,979,161,0,161,0
2020-03-22,San Francisco,075,870044,455,134,0,134,0
2020-03-22,San Joaquin,077,732212,140,30,3,33,2
2020-03-22,San Luis Obispo,079,281455,89,19,0,19,0
2020-03-22,San Mateo,081,765935,464,82,2,84,1
2020-03-22,Santa Barbara,083,443738,119,16,1,17,0
2020-03-22,Santa Clara,085,1922200,1012,284,2,286,13
2020-03-22,Santa Cruz,087,273765,64,19,0,19,0
2020-03-22,Shasta,089,179085,13,1,0,1,0
2020-03-22,Sierra,091,2930,0,0,0,0,0
2020-03-22,Siskiyou,093,43540,4,2,0,2,0
2020-03-22,Solano,095,438530,65,30,0,30,0
2020-03-22,Sonoma,097,501317,99,18,0,18,1
2020-03-22,Stanislaus,099,539301,51,8,3,11,0
2020-03-22,Sutter,101,95872,8,0,0,0,0
2020-03-22,Tehama,103,63373,0,0,0,0,0
2020-03-22,Trinity,105,12862,0,0,0,0,0
2020-03-22,Tulare,107,460477,62,5,3,8,0
2020-03-22,Tuolumne,109,53932,2,0,0,0,0
2020-03-22,Ventura,111,848112,174,26,0,26,0
2020-03-22,Yolo,113,214977,33,6,0,6,0
2020-03-22,Yuba,115,75493,7,2,0,2,0
2020-03-21,Alameda,001,1643700,409,62,1,63,0
2020-03-21,Alpine,003,1148,1,0,0,0,0
2020-03-21,Amador,005,37829,2,1,0,1,0
2020-03-21,Butte,007,227075,7,1,0,1,0
2020-03-21,Calaveras,009,45235,4,2,0,2,0
2020-03-21,Colusa,011,21464,1,0,0,0,0
2020-03-21,Contra Costa,013,1133247,303,62,0,62,1
2020-03-21,Del Norte,015,27424,0,0,0,0,0
2020-03-21,El Dorado,017,186661,21,1,0,1,0
2020-03-21,Fresno,019,978130,99,8,2,10,0
2020-03-21,Glenn,021,27897,2,0,0,0,0
2020-03-21,Humboldt,023,135768,25,1,0,1,0
2020-03-21,Imperial,025,180216,44,2,0,2,0
2020-03-21,Inyo,027,18085,1,0,0,0,0
2020-03-21,Kern,029,883053,108,3,0,3,0
2020-03-21,Kings,031,150075,19,0,0,0,0
2020-03-21,Lake,033,64148,0,0,0,0,0
2020-03-21,Lassen,035,31185,3,0,1,1,0
2020-03-21,Los Angeles,037,10098052,2839,322,10,332,2
2020-03-21,Madera,039,155013,33,4,0,4,0
2020-03-21,Marin,041,260295,69,30,0,30,0
2020-03-21,Mariposa,043,17540,0,0,0,0,0
2020-03-21,Mendocino,045,87422,3,1,0,1,0
2020-03-21,Merced,047,269075,12,0,0,0,0
2020-03-21,Modoc,049,8938,0,0,0,0,0
2020-03-21,Mono,051,14174,14,1,0,1,0
2020-03-21,Monterey,053,433212,48,8,0,8,1
2020-03-21,Napa,055,140530,17,0,0,0,0
2020-03-21,Nevada,057,99092,23,2,1,3,0
2020-03-21,Orange,059,3164182,762,85,4,89,0
2020-03-21,Placer,061,380077,78,11,0,11,1
2020-03-21,Plumas,063,18699,0,0,0,0,0
2020-03-21,Riverside,065,2383286,566,20,8,28,3
2020-03-21,Sacramento,067,1510023,334,66,0,66,3
2020-03-21,San Benito,069,59416,17,4,0,4,1
2020-03-21,San Bernardino,071,2135413,270,13,0,13,0
2020-03-21,San Diego,073,3302833,901,121,0,121,0
2020-03-21,San Francisco,075,870044,419,106,0,106,0
2020-03-21,San Joaquin,077,732212,131,26,3,29,2
2020-03-21,San Luis Obispo,079,281455,84,16,0,16,0
2020-03-21,San Mateo,081,765935,426,78,2,80,1
2020-03-21,Santa Barbara,083,443738,109,8,1,9,0
2020-03-21,Santa Clara,085,1922200,950,269,2,271,10
2020-03-21,Santa Cruz,087,273765,62,17,0,17,0
2020-03-21,Shasta,089,179085,12,1,0,1,0
2020-03-21,Sierra,091,2930,0,0,0,0,0
2020-03-21,Siskiyou,093,43540,4,0,0,0,0
2020-03-21,Solano,095,438530,63,30,0,30,0
2020-03-21,Sonoma,097,501317,98,15,0,15,1
2020-03-21,Stanislaus,099,539301,45,7,3,10,0
2020-03-21,Sutter,101,95872,7,0,0,0,0
2020-03-21,Tehama,103,63373,0,0,0,0,0
2020-03-21,Trinity,105,12862,0,0,0,0,0
2020-03-21,Tulare,107,460477,54,5,3,8,0
2020-03-21,Tuolumne,109,53932,2,0,0,0,0
2020-03-21,Ventura,111,848112,166,22,0,22,0
2020-03-21,Yolo,113,214977,33,6,0,6,0
2020-03-21,Yuba,115,75493,7,1,0,1,0
2020-03-20,Alameda,001,1643700,388,42,1,43,0
2020-03-20,Alpine,003,1148,1,0,0,0,0
2020-03-20,Amador,005,37829,1,0,0,0,0
2020-03-20,Butte,007,227075,7,0,0,0,0
2020-03-20,Calaveras,009,45235,4,2,0,2,0
2020-03-20,Colusa,011,21464,1,0,0,0,0
2020-03-20,Contra Costa,013,1133247,273,52,0,52,1
2020-03-20,Del Norte,015,27424,0,0,0,0,0
2020-03-20,El Dorado,017,186661,20,1,0,1,0
2020-03-20,Fresno,019,978130,96,7,2,9,0
2020-03-20,Glenn,021,27897,1,0,0,0,0
2020-03-20,Humboldt,023,135768,25,1,0,1,0
2020-03-20,Imperial,025,180216,43,2,0,2,0
2020-03-20,Inyo,027,18085,0,0,0,0,0
2020-03-20,Kern,029,883053,93,3,0,3,0
2020-03-20,Kings,031,150075,18,0,0,0,0
2020-03-20,Lake,033,64148,0,0,0,0,0
2020-03-20,Lassen,035,31185,3,0,1,1,0
2020-03-20,Los Angeles,037,10098052,2610,267,9,276,1
2020-03-20,Madera,039,155013,32,4,0,4,0
2020-03-20,Marin,041,260295,66,30,0,30,0
2020-03-20,Mariposa,043,17540,0,0,0,0,0
2020-03-20,Mendocino,045,87422,3,1,0,1,0
2020-03-20,Merced,047,269075,10,0,0,0,0
2020-03-20,Modoc,049,8938,0,0,0,0,0
2020-03-20,Mono,051,14174,14,0,0,0,0
2020-03-20,Monterey,053,433212,47,4,0,4,0
2020-03-20,Napa,055,140530,16,0,0,0,0
2020-03-20,Nevada,057,99092,20,2,1,3,0
2020-03-20,Orange,059,3164182,715,71,4,75,2
2020-03-20,Placer,061,380077,72,9,0,9,1
2020-03-20,Plumas,063,18699,0,0,0,0,0
2020-03-20,Riverside,065,2383286,507,19,8,27,3
2020-03-20,Sacramento,067,1510023,313,56,0,56,4
2020-03-20,San Benito,069,59416,17,4,0,4,1
2020-03-20,San Bernardino,071,2135413,243,9,0,9,0
2020-03-20,San Diego,073,3302833,849,98,0,98,0
2020-03-20,San Francisco,075,870044,387,87,0,87,0
2020-03-20,San Joaquin,077,732212,116,18,3,21,2
2020-03-20,San Luis Obispo,079,281455,80,11,0,11,0
2020-03-20,San Mateo,081,765935,396,71,2,73,1
2020-03-20,Santa Barbara,083,443738,97,7,1,8,0
2020-03-20,Santa Clara,085,1922200,914,246,2,248,8
2020-03-20,Santa Cruz,087,273765,60,13,0,13,0
2020-03-20,Shasta,089,179085,11,1,0,1,0
2020-03-20,Sierra,091,2930,0,0,0,0,0
2020-03-20,Siskiyou,093,43540,4,0,0,0,0
2020-03-20,Solano,095,438530,59,29,0,29,0
2020-03-20,Sonoma,097,501317,90,7,0,7,0
2020-03-20,Stanislaus,099,539301,39,7,3,10,0
2020-03-20,Sutter,101,95872,7,0,0,0,0
2020-03-20,Tehama,103,63373,0,0,0,0,0
2020-03-20,Trinity,105,12862,0,0,0,0,0
2020-03-20,Tulare,107,460477,50,4,3,7,0
2020-03-20,Tuolumne,109,53932,2,0,0,0,0
2020-03-20,Ventura,111,848112,156,18,0,18,0
2020-03-20,Yolo,113,214977,31,5,0,5,0
2020-03-20,Yuba,115,75493,6,0,0,0,0
2020-03-19,Alameda,001,1643700,352,36,1,37,0
2020-03-19,Alpine,003,1148,1,0,0,0,0
2020-03-19,Amador,005,37829,1,0,0,0,0
2020-03-19,Butte,007,227075,5,0,0,0,0
2020-03-19,Calaveras,009,45235,4,2,0,2,0
2020-03-19,Colusa,011,21464,0,0,0,0,0
2020-03-19,Contra Costa,013,1133247,257,46,0,46,0
2020-03-19,Del Norte,015,27424,0,0,0,0,0
2020-03-19,El Dorado,017,186661,18,0,0,0,0
2020-03-19,Fresno,019,978130,87,6,2,8,0
2020-03-19,Glenn,021,27897,1,0,0,0,0
2020-03-19,Humboldt,023,135768,23,1,0,1,0
2020-03-19,Imperial,025,180216,36,2,0,2,0
2020-03-19,Inyo,027,18085,0,0,0,0,0
2020-03-19,Kern,029,883053,81,3,0,3,0
2020-03-19,Kings,031,150075,14,0,0,0,0
2020-03-19,Lake,033,64148,0,0,0,0,0
2020-03-19,Lassen,035,31185,2,0,1,1,0
2020-03-19,Los Angeles,037,10098052,2319,233,9,242,0
2020-03-19,Madera,039,155013,31,3,0,3,0
2020-03-19,Marin,041,260295,63,19,0,19,0
2020-03-19,Mariposa,043,17540,0,0,0,0,0
2020-03-19,Mendocino,045,87422,2,1,0,1,0
2020-03-19,Merced,047,269075,9,0,0,0,0
2020-03-19,Modoc,049,8938,0,0,0,0,0
2020-03-19,Mono,051,14174,12,0,0,0,0
2020-03-19,Monterey,053,433212,39,3,0,3,0
2020-03-19,Napa,055,140530,14,0,0,0,0
2020-03-19,Nevada,057,99092,18,2,1,3,0
2020-03-19,Orange,059,3164182,634,59,4,63,0
2020-03-19,Placer,061,380077,64,8,0,8,1
2020-03-19,Plumas,063,18699,0,0,0,0,0
2020-03-19,Riverside,065,2383286,396,14,6,20,3
2020-03-19,Sacramento,067,1510023,280,52,0,52,3
2020-03-19,San Benito,069,59416,14,3,0,3,0
2020-03-19,San Bernardino,071,2135413,213,7,0,7,0
2020-03-19,San Diego,073,3302833,766,68,0,68,0
2020-03-19,San Francisco,075,870044,351,80,0,80,0
2020-03-19,San Joaquin,077,732212,102,15,3,18,2
2020-03-19,San Luis Obispo,079,281455,77,6,0,6,0
2020-03-19,San Mateo,081,765935,361,58,2,60,1
2020-03-19,Santa Barbara,083,443738,85,5,0,5,0
2020-03-19,Santa Clara,085,1922200,847,183,2,185,8
2020-03-19,Santa Cruz,087,273765,57,13,0,13,0
2020-03-19,Shasta,089,179085,10,1,0,1,0
2020-03-19,Sierra,091,2930,0,0,0,0,0
2020-03-19,Siskiyou,093,43540,3,0,0,0,0
2020-03-19,Solano,095,438530,55,26,0,26,0
2020-03-19,Sonoma,097,501317,87,8,0,8,0
2020-03-19,Stanislaus,099,539301,38,7,3,10,0
2020-03-19,Sutter,101,95872,7,0,0,0,0
2020-03-19,Tehama,103,63373,0,0,0,0,0
2020-03-19,Trinity,105,12862,0,0,0,0,0
2020-03-19,Tulare,107,460477,44,3,3,6,0
2020-03-19,Tuolumne,109,53932,2,0,0,0,0
2020-03-19,Ventura,111,848112,134,15,0,15,0
2020-03-19,Yolo,113,214977,27,5,0,5,0
2020-03-19,Yuba,115,75493,5,0,0,0,0
2020-03-18,Alameda,001,1643700,323,29,1,30,0
2020-03-18,Alpine,003,1148,1,0,0,0,0
2020-03-18,Amador,005,37829,1,0,0,0,0
2020-03-18,Butte,007,227075,4,0,0,0,0
2020-03-18,Calaveras,009,45235,4,2,0,2,0
2020-03-18,Colusa,011,21464,0,0,0,0,0
2020-03-18,Contra Costa,013,1133247,235,44,0,44,0
2020-03-18,Del Norte,015,27424,0,0,0,0,0
2020-03-18,El Dorado,017,186661,17,0,0,0,0
2020-03-18,Fresno,019,978130,78,3,1,4,0
2020-03-18,Glenn,021,27897,1,0,0,0,0
2020-03-18,Humboldt,023,135768,19,1,0,1,0
2020-03-18,Imperial,025,180216,30,2,0,2,0
2020-03-18,Inyo,027,18085,0,0,0,0,0
2020-03-18,Kern,029,883053,66,1,0,1,0
2020-03-18,Kings,031,150075,12,0,0,0,0
2020-03-18,Lake,033,64148,0,0,0,0,0
2020-03-18,Lassen,035,31185,1,0,1,1,0
2020-03-18,Los Angeles,037,10098052,2074,47,9,56,0
2020-03-18,Madera,039,155013,30,2,0,2,0
2020-03-18,Marin,041,260295,58,10,0,10,0
2020-03-18,Mariposa,043,17540,0,0,0,0,0
2020-03-18,Mendocino,045,87422,2,0,0,0,0
2020-03-18,Merced,047,269075,9,0,0,0,0
2020-03-18,Modoc,049,8938,0,0,0,0,0
2020-03-18,Mono,051,14174,11,0,0,0,0
2020-03-18,Monterey,053,433212,31,1,0,1,0
2020-03-18,Napa,055,140530,11,0,0,0,0
2020-03-18,Nevada,057,99092,16,2,1,3,0
2020-03-18,Orange,059,3164182,576,38,4,42,0
2020-03-18,Placer,061,380077,57,8,0,8,1
2020-03-18,Plumas,063,18699,0,0,0,0,0
2020-03-18,Riverside,065,2383286,333,11,5,16,2
2020-03-18,Sacramento,067,1510023,257,46,0,46,3
2020-03-18,San Benito,069,59416,13,3,0,3,0
2020-03-18,San Bernardino,071,2135413,191,3,0,3,0
2020-03-18,San Diego,073,3302833,681,40,0,40,0
2020-03-18,San Francisco,075,870044,332,65,0,65,0
2020-03-18,San Joaquin,077,732212,90,14,3,17,2
2020-03-18,San Luis Obispo,079,281455,70,5,0,5,0
2020-03-18,San Mateo,081,765935,340,57,2,59,1
2020-03-18,Santa Barbara,083,443738,77,2,0,2,0
2020-03-18,Santa Clara,085,1922200,796,151,2,153,6
2020-03-18,Santa Cruz,087,273765,55,11,0,11,0
2020-03-18,Shasta,089,179085,9,1,0,1,0
2020-03-18,Sierra,091,2930,0,0,0,0,0
2020-03-18,Siskiyou,093,43540,3,0,0,0,0
2020-03-18,Solano,095,438530,51,26,0,26,0
2020-03-18,Sonoma,097,501317,78,6,0,6,0
2020-03-18,Stanislaus,099,539301,34,5,2,7,0
2020-03-18,Sutter,101,95872,5,0,0,0,0
2020-03-18,Tehama,103,63373,0,0,0,0,0
2020-03-18,Trinity,105,12862,0,0,0,0,0
2020-03-18,Tulare,107,460477,34,3,3,6,0
2020-03-18,Tuolumne,109,53932,2,0,0,0,0
2020-03-18,Ventura,111,848112,115,11,0,11,0
2020-03-18,Yolo,113,214977,24,4,0,4,0
2020-03-18,Yuba,115,75493,4,0,0,0,0
2020-03-17,Alameda,001,1643700,291,19,0,19,0
2020-03-17,Alpine,003,1148,0,0,0,0,0
2020-03-17,Amador,005,37829,1,0,0,0,0
2020-03-17,Butte,007,227075,4,0,0,0,0
2020-03-17,Calaveras,009,45235,4,2,0,2,0
2020-03-17,Colusa,011,21464,0,0,0,0,0
2020-03-17,Contra Costa,013,1133247,213,37,0,37,0
2020-03-17,Del Norte,015,27424,0,0,0,0,0
2020-03-17,El Dorado,017,186661,16,0,0,0,0
2020-03-17,Fresno,019,978130,68,2,1,3,0
2020-03-17,Glenn,021,27897,1,0,0,0,0
2020-03-17,Humboldt,023,135768,17,1,0,1,0
2020-03-17,Imperial,025,180216,24,2,0,2,0
2020-03-17,Inyo,027,18085,0,0,0,0,0
2020-03-17,Kern,029,883053,52,0,0,0,0
2020-03-17,Kings,031,150075,9,0,0,0,0
2020-03-17,Lake,033,64148,0,0,0,0,0
2020-03-17,Lassen,035,31185,1,0,1,1,0
2020-03-17,Los Angeles,037,10098052,1865,41,9,50,0
2020-03-17,Madera,039,155013,22,2,0,2,0
2020-03-17,Marin,041,260295,51,4,0,4,0
2020-03-17,Mariposa,043,17540,0,0,0,0,0
2020-03-17,Mendocino,045,87422,2,0,0,0,0
2020-03-17,Merced,047,269075,9,0,0,0,0
2020-03-17,Modoc,049,8938,0,0,0,0,0
2020-03-17,Mono,051,14174,9,0,0,0,0
2020-03-17,Monterey,053,433212,29,0,0,0,0
2020-03-17,Napa,055,140530,8,0,0,0,0
2020-03-17,Nevada,057,99092,15,1,1,2,0
2020-03-17,Orange,059,3164182,498,24,3,27,0
2020-03-17,Placer,061,380077,47,7,0,7,1
2020-03-17,Plumas,063,18699,0,0,0,0,0
2020-03-17,Riverside,065,2383286,271,11,5,16,0
2020-03-17,Sacramento,067,1510023,237,36,0,36,1
2020-03-17,San Benito,069,59416,12,2,0,2,0
2020-03-17,San Bernardino,071,2135413,163,2,0,2,0
2020-03-17,San Diego,073,3302833,614,17,0,17,0
2020-03-17,San Francisco,075,870044,305,46,0,46,0
2020-03-17,San Joaquin,077,732212,84,11,3,14,0
2020-03-17,San Luis Obispo,079,281455,62,1,0,1,0
2020-03-17,San Mateo,081,765935,308,46,2,48,1
2020-03-17,Santa Barbara,083,443738,65,0,0,0,0
2020-03-17,Santa Clara,085,1922200,738,121,2,123,4
2020-03-17,Santa Cruz,087,273765,52,10,0,10,0
2020-03-17,Shasta,089,179085,5,1,0,1,0
2020-03-17,Sierra,091,2930,0,0,0,0,0
2020-03-17,Siskiyou,093,43540,3,0,0,0,0
2020-03-17,Solano,095,438530,48,27,0,27,0
2020-03-17,Sonoma,097,501317,70,4,0,4,0
2020-03-17,Stanislaus,099,539301,31,4,2,6,0
2020-03-17,Sutter,101,95872,5,0,0,0,0
2020-03-17,Tehama,103,63373,0,0,0,0,0
2020-03-17,Trinity,105,12862,0,0,0,0,0
2020-03-17,Tulare,107,460477,29,2,3,5,0
2020-03-17,Tuolumne,109,53932,2,0,0,0,0
2020-03-17,Ventura,111,848112,98,7,0,7,0
2020-03-17,Yolo,113,214977,20,2,0,2,0
2020-03-17,Yuba,115,75493,4,0,0,0,0
2020-03-16,Alameda,001,1643700,262,17,0,17,0
2020-03-16,Alpine,003,1148,0,0,0,0,0
2020-03-16,Amador,005,37829,1,0,0,0,0
2020-03-16,Butte,007,227075,3,0,0,0,0
2020-03-16,Calaveras,009,45235,4,2,0,2,0
2020-03-16,Colusa,011,21464,0,0,0,0,0
2020-03-16,Contra Costa,013,1133247,189,36,0,36,0
2020-03-16,Del Norte,015,27424,0,0,0,0,0
2020-03-16,El Dorado,017,186661,15,0,0,0,0
2020-03-16,Fresno,019,978130,53,2,1,3,0
2020-03-16,Glenn,021,27897,0,0,0,0,0
2020-03-16,Humboldt,023,135768,13,1,0,1,0
2020-03-16,Imperial,025,180216,19,2,0,2,0
2020-03-16,Inyo,027,18085,0,0,0,0,0
2020-03-16,Kern,029,883053,43,0,0,0,0
2020-03-16,Kings,031,150075,8,0,0,0,0
2020-03-16,Lake,033,64148,0,0,0,0,0
2020-03-16,Lassen,035,31185,1,0,0,0,0
2020-03-16,Los Angeles,037,10098052,1627,43,9,52,0
2020-03-16,Madera,039,155013,21,2,0,2,0
2020-03-16,Marin,041,260295,48,4,0,4,0
2020-03-16,Mariposa,043,17540,0,0,0,0,0
2020-03-16,Mendocino,045,87422,2,0,0,0,0
2020-03-16,Merced,047,269075,7,0,0,0,0
2020-03-16,Modoc,049,8938,0,0,0,0,0
2020-03-16,Mono,051,14174,7,0,0,0,0
2020-03-16,Monterey,053,433212,28,0,0,0,0
2020-03-16,Napa,055,140530,7,0,0,0,0
2020-03-16,Nevada,057,99092,11,1,1,2,0
2020-03-16,Orange,059,3164182,415,18,3,21,0
2020-03-16,Placer,061,380077,39,7,0,7,1
2020-03-16,Plumas,063,18699,0,0,0,0,0
2020-03-16,Riverside,065,2383286,235,10,5,15,0
2020-03-16,Sacramento,067,1510023,210,34,0,34,1
2020-03-16,San Benito,069,59416,8,2,0,2,0
2020-03-16,San Bernardino,071,2135413,143,1,0,1,0
2020-03-16,San Diego,073,3302833,523,17,0,17,0
2020-03-16,San Francisco,075,870044,267,40,0,40,0
2020-03-16,San Joaquin,077,732212,74,9,3,12,0
2020-03-16,San Luis Obispo,079,281455,55,1,0,1,0
2020-03-16,San Mateo,081,765935,269,42,2,44,1
2020-03-16,Santa Barbara,083,443738,55,0,0,0,0
2020-03-16,Santa Clara,085,1922200,658,115,1,116,2
2020-03-16,Santa Cruz,087,273765,45,9,0,9,0
2020-03-16,Shasta,089,179085,5,1,0,1,0
2020-03-16,Sierra,091,2930,0,0,0,0,0
2020-03-16,Siskiyou,093,43540,2,0,0,0,0
2020-03-16,Solano,095,438530,43,27,0,27,0
2020-03-16,Sonoma,097,501317,62,4,0,4,0
2020-03-16,Stanislaus,099,539301,27,2,2,4,0
2020-03-16,Sutter,101,95872,3,0,0,0,0
2020-03-16,Tehama,103,63373,0,0,0,0,0
2020-03-16,Trinity,105,12862,0,0,0,0,0
2020-03-16,Tulare,107,460477,25,2,3,5,0
2020-03-16,Tuolumne,109,53932,2,0,0,0,0
2020-03-16,Ventura,111,848112,88,7,0,7,0
2020-03-16,Yolo,113,214977,18,2,0,2,0
2020-03-16,Yuba,115,75493,3,0,0,0,0
2020-03-15,Alameda,001,1643700,215,17,0,17,0
2020-03-15,Alpine,003,1148,0,0,0,0,0
2020-03-15,Amador,005,37829,1,0,0,0,0
2020-03-15,Butte,007,227075,3,0,0,0,0
2020-03-15,Calaveras,009,45235,2,2,0,2,0
2020-03-15,Colusa,011,21464,0,0,0,0,0
2020-03-15,Contra Costa,013,1133247,164,34,0,34,0
2020-03-15,Del Norte,015,27424,0,0,0,0,0
2020-03-15,El Dorado,017,186661,14,0,0,0,0
2020-03-15,Fresno,019,978130,33,1,1,2,0
2020-03-15,Glenn,021,27897,0,0,0,0,0
2020-03-15,Humboldt,023,135768,11,1,0,1,0
2020-03-15,Imperial,025,180216,14,2,0,2,0
2020-03-15,Inyo,027,18085,0,0,0,0,0
2020-03-15,Kern,029,883053,37,0,0,0,0
2020-03-15,Kings,031,150075,8,0,0,0,0
2020-03-15,Lake,033,64148,0,0,0,0,0
2020-03-15,Lassen,035,31185,1,0,0,0,0
2020-03-15,Los Angeles,037,10098052,1379,41,9,50,0
2020-03-15,Madera,039,155013,20,2,0,2,0
2020-03-15,Marin,041,260295,41,3,0,3,0
2020-03-15,Mariposa,043,17540,0,0,0,0,0
2020-03-15,Mendocino,045,87422,2,0,0,0,0
2020-03-15,Merced,047,269075,4,0,0,0,0
2020-03-15,Modoc,049,8938,0,0,0,0,0
2020-03-15,Mono,051,14174,6,0,0,0,0
2020-03-15,Monterey,053,433212,21,0,0,0,0
2020-03-15,Napa,055,140530,7,0,0,0,0
2020-03-15,Nevada,057,99092,11,0,1,1,0
2020-03-15,Orange,059,3164182,347,16,1,17,0
2020-03-15,Placer,061,380077,33,7,0,7,1
2020-03-15,Plumas,063,18699,0,0,0,0,0
2020-03-15,Riverside,065,2383286,183,10,5,15,0
2020-03-15,Sacramento,067,1510023,174,30,0,30,1
2020-03-15,San Benito,069,59416,8,2,0,2,0
2020-03-15,San Bernardino,071,2135413,121,0,0,0,0
2020-03-15,San Diego,073,3302833,436,16,0,16,0
2020-03-15,San Francisco,075,870044,209,31,0,31,0
2020-03-15,San Joaquin,077,732212,63,6,3,9,0
2020-03-15,San Luis Obispo,079,281455,45,1,0,1,0
2020-03-15,San Mateo,081,765935,235,29,1,30,1
2020-03-15,Santa Barbara,083,443738,46,0,0,0,0
2020-03-15,Santa Clara,085,1922200,586,79,1,80,2
2020-03-15,Santa Cruz,087,273765,38,8,0,8,0
2020-03-15,Shasta,089,179085,5,1,0,1,0
2020-03-15,Sierra,091,2930,0,0,0,0,0
2020-03-15,Siskiyou,093,43540,2,0,0,0,0
2020-03-15,Solano,095,438530,42,26,0,26,0
2020-03-15,Sonoma,097,501317,53,4,0,4,0
2020-03-15,Stanislaus,099,539301,26,2,2,4,0
2020-03-15,Sutter,101,95872,2,0,0,0,0
2020-03-15,Tehama,103,63373,0,0,0,0,0
2020-03-15,Trinity,105,12862,0,0,0,0,0
2020-03-15,Tulare,107,460477,19,2,3,5,0
2020-03-15,Tuolumne,109,53932,1,0,0,0,0
2020-03-15,Ventura,111,848112,77,5,0,5,0
2020-03-15,Yolo,113,214977,15,2,0,2,0
2020-03-15,Yuba,115,75493,2,0,0,0,0
2020-03-14,Alameda,001,1643700,196,11,0,11,0
2020-03-14,Alpine,003,1148,0,0,0,0,0
2020-03-14,Amador,005,37829,1,0,0,0,0
2020-03-14,Butte,007,227075,2,0,0,0,0
2020-03-14,Calaveras,009,45235,2,2,0,2,0
2020-03-14,Colusa,011,21464,0,0,0,0,0
2020-03-14,Contra Costa,013,1133247,142,30,0,30,0
2020-03-14,Del Norte,015,27424,0,0,0,0,0
2020-03-14,El Dorado,017,186661,12,0,0,0,0
2020-03-14,Fresno,019,978130,25,1,1,2,0
2020-03-14,Glenn,021,27897,0,0,0,0,0
2020-03-14,Humboldt,023,135768,7,1,0,1,0
2020-03-14,Imperial,025,180216,10,2,0,2,0
2020-03-14,Inyo,027,18085,0,0,0,0,0
2020-03-14,Kern,029,883053,32,0,0,0,0
2020-03-14,Kings,031,150075,8,0,0,0,0
2020-03-14,Lake,033,64148,0,0,0,0,0
2020-03-14,Lassen,035,31185,1,0,0,0,0
2020-03-14,Los Angeles,037,10098052,1197,35,9,44,0
2020-03-14,Madera,039,155013,19,2,0,2,0
2020-03-14,Marin,041,260295,37,3,0,3,0
2020-03-14,Mariposa,043,17540,0,0,0,0,0
2020-03-14,Mendocino,045,87422,2,0,0,0,0
2020-03-14,Merced,047,269075,4,0,0,0,0
2020-03-14,Modoc,049,8938,0,0,0,0,0
2020-03-14,Mono,051,14174,5,0,0,0,0
2020-03-14,Monterey,053,433212,15,0,0,0,0
2020-03-14,Napa,055,140530,5,0,0,0,0
2020-03-14,Nevada,057,99092,8,0,1,1,0
2020-03-14,Orange,059,3164182,308,14,0,14,0
2020-03-14,Placer,061,380077,29,6,0,6,1
2020-03-14,Plumas,063,18699,0,0,0,0,0
2020-03-14,Riverside,065,2383286,163,10,5,15,0
2020-03-14,Sacramento,067,1510023,152,31,0,31,1
2020-03-14,San Benito,069,59416,8,2,0,2,0
2020-03-14,San Bernardino,071,2135413,102,0,0,0,0
2020-03-14,San Diego,073,3302833,361,10,0,10,0
2020-03-14,San Francisco,075,870044,188,29,0,29,0
2020-03-14,San Joaquin,077,732212,54,6,3,9,0
2020-03-14,San Luis Obispo,079,281455,40,0,0,0,0
2020-03-14,San Mateo,081,765935,212,27,1,28,0
2020-03-14,Santa Barbara,083,443738,37,0,0,0,0
2020-03-14,Santa Clara,085,1922200,531,62,1,63,2
2020-03-14,Santa Cruz,087,273765,33,8,0,8,0
2020-03-14,Shasta,089,179085,5,1,0,1,0
2020-03-14,Sierra,091,2930,0,0,0,0,0
2020-03-14,Siskiyou,093,43540,1,0,0,0,0
2020-03-14,Solano,095,438530,40,26,0,26,0
2020-03-14,Sonoma,097,501317,40,2,0,2,0
2020-03-14,Stanislaus,099,539301,22,2,2,4,0
2020-03-14,Sutter,101,95872,2,0,0,0,0
2020-03-14,Tehama,103,63373,0,0,0,0,0
2020-03-14,Trinity,105,12862,0,0,0,0,0
2020-03-14,Tulare,107,460477,17,2,2,4,0
2020-03-14,Tuolumne,109,53932,1,0,0,0,0
2020-03-14,Ventura,111,848112,68,5,0,5,0
2020-03-14,Yolo,113,214977,15,2,0,2,0
2020-03-14,Yuba,115,75493,1,0,0,0,0
2020-03-13,Alameda,001,1643700,177,12,0,12,0
2020-03-13,Alpine,003,1148,0,0,0,0,0
2020-03-13,Amador,005,37829,1,0,0,0,0
2020-03-13,Butte,007,227075,0,0,0,0,0
2020-03-13,Calaveras,009,45235,2,2,0,2,0
2020-03-13,Colusa,011,21464,0,0,0,0,0
2020-03-13,Contra Costa,013,1133247,128,22,0,22,0
2020-03-13,Del Norte,015,27424,0,0,0,0,0
2020-03-13,El Dorado,017,186661,11,0,0,0,0
2020-03-13,Fresno,019,978130,20,1,1,2,0
2020-03-13,Glenn,021,27897,0,0,0,0,0
2020-03-13,Humboldt,023,135768,7,1,0,1,0
2020-03-13,Imperial,025,180216,9,2,0,2,0
2020-03-13,Inyo,027,18085,0,0,0,0,0
2020-03-13,Kern,029,883053,27,0,0,0,0
2020-03-13,Kings,031,150075,7,0,0,0,0
2020-03-13,Lake,033,64148,0,0,0,0,0
2020-03-13,Lassen,035,31185,1,0,0,0,0
2020-03-13,Los Angeles,037,10098052,1040,30,7,37,0
2020-03-13,Madera,039,155013,18,1,0,1,0
2020-03-13,Marin,041,260295,34,3,0,3,0
2020-03-13,Mariposa,043,17540,0,0,0,0,0
2020-03-13,Mendocino,045,87422,2,0,0,0,0
2020-03-13,Merced,047,269075,2,0,0,0,0
2020-03-13,Modoc,049,8938,0,0,0,0,0
2020-03-13,Mono,051,14174,3,0,0,0,0
2020-03-13,Monterey,053,433212,10,0,0,0,0
2020-03-13,Napa,055,140530,3,0,0,0,0
2020-03-13,Nevada,057,99092,7,0,1,1,0
2020-03-13,Orange,059,3164182,268,10,0,10,0
2020-03-13,Placer,061,380077,27,6,0,6,1
2020-03-13,Plumas,063,18699,0,0,0,0,0
2020-03-13,Riverside,065,2383286,133,5,4,9,0
2020-03-13,Sacramento,067,1510023,130,18,0,18,1
2020-03-13,San Benito,069,59416,6,2,0,2,0
2020-03-13,San Bernardino,071,2135413,96,0,0,0,0
2020-03-13,San Diego,073,3302833,311,8,0,8,0
2020-03-13,San Francisco,075,870044,174,28,0,28,0
2020-03-13,San Joaquin,077,732212,50,6,3,9,0
2020-03-13,San Luis Obispo,079,281455,33,0,0,0,0
2020-03-13,San Mateo,081,765935,191,24,1,25,0
2020-03-13,Santa Barbara,083,443738,33,0,0,0,0
2020-03-13,Santa Clara,085,1922200,469,59,1,60,1
2020-03-13,Santa Cruz,087,273765,32,7,0,7,0
2020-03-13,Shasta,089,179085,3,1,0,1,0
2020-03-13,Sierra,091,2930,0,0,0,0,0
2020-03-13,Siskiyou,093,43540,0,0,0,0,0
2020-03-13,Solano,095,438530,39,26,0,26,0
2020-03-13,Sonoma,097,501317,39,2,0,2,0
2020-03-13,Stanislaus,099,539301,17,2,2,4,0
2020-03-13,Sutter,101,95872,2,0,0,0,0
2020-03-13,Tehama,103,63373,0,0,0,0,0
2020-03-13,Trinity,105,12862,0,0,0,0,0
2020-03-13,Tulare,107,460477,14,2,2,4,0
2020-03-13,Tuolumne,109,53932,1,0,0,0,0
2020-03-13,Ventura,111,848112,54,5,0,5,0
2020-03-13,Yolo,113,214977,14,1,0,1,0
2020-03-13,Yuba,115,75493,1,0,0,0,0
2020-03-12,Alameda,001,1643700,152,9,0,9,0
2020-03-12,Alpine,003,1148,0,0,0,0,0
2020-03-12,Amador,005,37829,1,0,0,0,0
2020-03-12,Butte,007,227075,0,0,0,0,0
2020-03-12,Calaveras,009,45235,2,2,0,2,0
2020-03-12,Colusa,011,21464,0,0,0,0,0
2020-03-12,Contra Costa,013,1133247,110,18,0,18,0
2020-03-12,Del Norte,015,27424,0,0,0,0,0
2020-03-12,El Dorado,017,186661,9,0,0,0,0
2020-03-12,Fresno,019,978130,12,1,1,2,0
2020-03-12,Glenn,021,27897,0,0,0,0,0
2020-03-12,Humboldt,023,135768,6,1,0,1,0
2020-03-12,Imperial,025,180216,8,2,0,2,0
2020-03-12,Inyo,027,18085,0,0,0,0,0
2020-03-12,Kern,029,883053,18,0,0,0,0
2020-03-12,Kings,031,150075,4,0,0,0,0
2020-03-12,Lake,033,64148,0,0,0,0,0
2020-03-12,Lassen,035,31185,1,0,0,0,0
2020-03-12,Los Angeles,037,10098052,876,30,7,37,0
2020-03-12,Madera,039,155013,15,1,0,1,0
2020-03-12,Marin,041,260295,24,1,0,1,0
2020-03-12,Mariposa,043,17540,0,0,0,0,0
2020-03-12,Mendocino,045,87422,2,0,0,0,0
2020-03-12,Merced,047,269075,2,0,0,0,0
2020-03-12,Modoc,049,8938,0,0,0,0,0
2020-03-12,Mono,051,14174,3,0,0,0,0
2020-03-12,Monterey,053,433212,8,0,0,0,0
2020-03-12,Napa,055,140530,3,0,0,0,0
2020-03-12,Nevada,057,99092,4,0,1,1,0
2020-03-12,Orange,059,3164182,231,7,0,7,0
2020-03-12,Placer,061,380077,23,6,0,6,1
2020-03-12,Plumas,063,18699,0,0,0,0,0
2020-03-12,Riverside,065,2383286,107,5,2,7,0
2020-03-12,Sacramento,067,1510023,106,17,0,17,1
2020-03-12,San Benito,069,59416,5,2,0,2,0
2020-03-12,San Bernardino,071,2135413,80,0,0,0,0
2020-03-12,San Diego,073,3302833,256,9,0,9,0
2020-03-12,San Francisco,075,870044,149,20,0,20,0
2020-03-12,San Joaquin,077,732212,44,3,3,6,1
2020-03-12,San Luis Obispo,079,281455,26,0,0,0,0
2020-03-12,San Mateo,081,765935,157,21,1,22,0
2020-03-12,Santa Barbara,083,443738,22,0,0,0,0
2020-03-12,Santa Clara,085,1922200,411,51,1,52,1
2020-03-12,Santa Cruz,087,273765,29,5,0,5,0
2020-03-12,Shasta,089,179085,2,1,0,1,0
2020-03-12,Sierra,091,2930,0,0,0,0,0
2020-03-12,Siskiyou,093,43540,0,0,0,0,0
2020-03-12,Solano,095,438530,34,26,0,26,0
2020-03-12,Sonoma,097,501317,34,2,0,2,0
2020-03-12,Stanislaus,099,539301,15,2,2,4,0
2020-03-12,Sutter,101,95872,0,0,0,0,0
2020-03-12,Tehama,103,63373,0,0,0,0,0
2020-03-12,Trinity,105,12862,0,0,0,0,0
2020-03-12,Tulare,107,460477,12,1,1,2,0
2020-03-12,Tuolumne,109,53932,1,0,0,0,0
2020-03-12,Ventura,111,848112,45,3,0,3,0
2020-03-12,Yolo,113,214977,13,1,0,1,0
2020-03-12,Yuba,115,75493,1,0,0,0,0
2020-03-11,Alameda,001,1643700,122,5,0,5,0
2020-03-11,Alpine,003,1148,0,0,0,0,0
2020-03-11,Amador,005,37829,1,0,0,0,0
2020-03-11,Butte,007,227075,0,0,0,0,0
2020-03-11,Calaveras,009,45235,2,2,0,2,0
2020-03-11,Colusa,011,21464,0,0,0,0,0
2020-03-11,Contra Costa,013,1133247,94,16,0,16,0
2020-03-11,Del Norte,015,27424,0,0,0,0,0
2020-03-11,El Dorado,017,186661,8,0,0,0,0
2020-03-11,Fresno,019,978130,9,1,1,2,0
2020-03-11,Glenn,021,27897,0,0,0,0,0
2020-03-11,Humboldt,023,135768,6,1,0,1,0
2020-03-11,Imperial,025,180216,6,0,0,0,0
2020-03-11,Inyo,027,18085,0,0,0,0,0
2020-03-11,Kern,029,883053,16,0,0,0,0
2020-03-11,Kings,031,150075,2,0,0,0,0
2020-03-11,Lake,033,64148,0,0,0,0,0
2020-03-11,Lassen,035,31185,1,0,0,0,0
2020-03-11,Los Angeles,037,10098052,703,21,7,28,0
2020-03-11,Madera,039,155013,12,1,0,1,0
2020-03-11,Marin,041,260295,17,1,0,1,0
2020-03-11,Mariposa,043,17540,0,0,0,0,0
2020-03-11,Mendocino,045,87422,1,0,0,0,0
2020-03-11,Merced,047,269075,2,0,0,0,0
2020-03-11,Modoc,049,8938,0,0,0,0,0
2020-03-11,Mono,051,14174,3,0,0,0,0
2020-03-11,Monterey,053,433212,7,0,0,0,0
2020-03-11,Napa,055,140530,2,0,0,0,0
2020-03-11,Nevada,057,99092,4,0,1,1,0
2020-03-11,Orange,059,3164182,202,6,0,6,0
2020-03-11,Placer,061,380077,18,6,0,6,1
2020-03-11,Plumas,063,18699,0,0,0,0,0
2020-03-11,Riverside,065,2383286,81,4,1,5,0
2020-03-11,Sacramento,067,1510023,88,9,0,9,1
2020-03-11,San Benito,069,59416,5,2,0,2,0
2020-03-11,San Bernardino,071,2135413,73,0,0,0,0
2020-03-11,San Diego,073,3302833,206,4,0,4,0
2020-03-11,San Francisco,075,870044,124,17,0,17,0
2020-03-11,San Joaquin,077,732212,33,1,3,4,0
2020-03-11,San Luis Obispo,079,281455,23,0,0,0,0
2020-03-11,San Mateo,081,765935,139,16,0,16,0
2020-03-11,Santa Barbara,083,443738,13,0,0,0,0
2020-03-11,Santa Clara,085,1922200,370,48,1,49,1
2020-03-11,Santa Cruz,087,273765,26,2,0,2,0
2020-03-11,Shasta,089,179085,2,1,0,1,0
2020-03-11,Sierra,091,2930,0,0,0,0,0
2020-03-11,Siskiyou,093,43540,0,0,0,0,0
2020-03-11,Solano,095,438530,29,26,0,26,0
2020-03-11,Sonoma,097,501317,30,2,0,2,0
2020-03-11,Stanislaus,099,539301,15,2,2,4,0
2020-03-11,Sutter,101,95872,0,0,0,0,0
2020-03-11,Tehama,103,63373,0,0,0,0,0
2020-03-11,Trinity,105,12862,0,0,0,0,0
2020-03-11,Tulare,107,460477,10,0,1,1,0
2020-03-11,Tuolumne,109,53932,1,0,0,0,0
2020-03-11,Ventura,111,848112,37,3,0,3,0
2020-03-11,Yolo,113,214977,9,1,0,1,0
2020-03-11,Yuba,115,75493,1,0,0,0,0
2020-03-10,Alameda,001,1643700,101,4,0,4,0
2020-03-10,Alpine,003,1148,0,0,0,0,0
2020-03-10,Amador,005,37829,1,0,0,0,0
2020-03-10,Butte,007,227075,0,0,0,0,0
2020-03-10,Calaveras,009,45235,2,2,0,2,0
2020-03-10,Colusa,011,21464,0,0,0,0,0
2020-03-10,Contra Costa,013,1133247,84,11,0,11,0
2020-03-10,Del Norte,015,27424,0,0,0,0,0
2020-03-10,El Dorado,017,186661,7,0,0,0,0
2020-03-10,Fresno,019,978130,7,1,1,2,0
2020-03-10,Glenn,021,27897,0,0,0,0,0
2020-03-10,Humboldt,023,135768,6,1,0,1,0
2020-03-10,Imperial,025,180216,5,0,0,0,0
2020-03-10,Inyo,027,18085,0,0,0,0,0
2020-03-10,Kern,029,883053,11,0,0,0,0
2020-03-10,Kings,031,150075,2,0,0,0,0
2020-03-10,Lake,033,64148,0,0,0,0,0
2020-03-10,Lassen,035,31185,1,0,0,0,0
2020-03-10,Los Angeles,037,10098052,567,20,7,27,0
2020-03-10,Madera,039,155013,7,1,0,1,0
2020-03-10,Marin,041,260295,16,1,0,1,0
2020-03-10,Mariposa,043,17540,0,0,0,0,0
2020-03-10,Mendocino,045,87422,0,0,0,0,0
2020-03-10,Merced,047,269075,2,0,0,0,0
2020-03-10,Modoc,049,8938,0,0,0,0,0
2020-03-10,Mono,051,14174,3,0,0,0,0
2020-03-10,Monterey,053,433212,5,0,0,0,0
2020-03-10,Napa,055,140530,2,0,0,0,0
2020-03-10,Nevada,057,99092,3,0,1,1,0
2020-03-10,Orange,059,3164182,182,5,0,5,1
2020-03-10,Placer,061,380077,14,7,0,7,1
2020-03-10,Plumas,063,18699,0,0,0,0,0
2020-03-10,Riverside,065,2383286,59,4,1,5,0
2020-03-10,Sacramento,067,1510023,79,8,0,8,0
2020-03-10,San Benito,069,59416,5,2,0,2,0
2020-03-10,San Bernardino,071,2135413,65,0,0,0,0
2020-03-10,San Diego,073,3302833,163,3,0,3,0
2020-03-10,San Francisco,075,870044,92,16,0,16,0
2020-03-10,San Joaquin,077,732212,30,1,3,4,0
2020-03-10,San Luis Obispo,079,281455,15,0,0,0,0
2020-03-10,San Mateo,081,765935,123,11,0,11,0
2020-03-10,Santa Barbara,083,443738,10,0,0,0,0
2020-03-10,Santa Clara,085,1922200,322,45,1,46,1
2020-03-10,Santa Cruz,087,273765,22,2,0,2,0
2020-03-10,Shasta,089,179085,2,1,0,1,0
2020-03-10,Sierra,091,2930,0,0,0,0,0
2020-03-10,Siskiyou,093,43540,0,0,0,0,0
2020-03-10,Solano,095,438530,27,26,0,26,0
2020-03-10,Sonoma,097,501317,27,2,0,2,0
2020-03-10,Stanislaus,099,539301,11,0,2,2,0
2020-03-10,Sutter,101,95872,0,0,0,0,0
2020-03-10,Tehama,103,63373,0,0,0,0,0
2020-03-10,Trinity,105,12862,0,0,0,0,0
2020-03-10,Tulare,107,460477,9,0,1,1,0
2020-03-10,Tuolumne,109,53932,1,0,0,0,0
2020-03-10,Ventura,111,848112,29,1,0,1,0
2020-03-10,Yolo,113,214977,6,2,0,2,0
2020-03-10,Yuba,115,75493,1,0,0,0,0
2020-03-09,Alameda,001,1643700,73,4,0,4,0
2020-03-09,Alpine,003,1148,0,0,0,0,0
2020-03-09,Amador,005,37829,0,0,0,0,0
2020-03-09,Butte,007,227075,0,0,0,0,0
2020-03-09,Calaveras,009,45235,2,0,0,0,0
2020-03-09,Colusa,011,21464,0,0,0,0,0
2020-03-09,Contra Costa,013,1133247,72,9,0,9,0
2020-03-09,Del Norte,015,27424,0,0,0,0,0
2020-03-09,El Dorado,017,186661,5,0,0,0,0
2020-03-09,Fresno,019,978130,7,1,1,2,0
2020-03-09,Glenn,021,27897,0,0,0,0,0
2020-03-09,Humboldt,023,135768,5,1,0,1,0
2020-03-09,Imperial,025,180216,5,0,0,0,0
2020-03-09,Inyo,027,18085,0,0,0,0,0
2020-03-09,Kern,029,883053,8,0,0,0,0
2020-03-09,Kings,031,150075,1,0,0,0,0
2020-03-09,Lake,033,64148,0,0,0,0,0
2020-03-09,Lassen,035,31185,1,0,0,0,0
2020-03-09,Los Angeles,037,10098052,463,17,6,23,0
2020-03-09,Madera,039,155013,7,1,0,1,0
2020-03-09,Marin,041,260295,15,1,0,1,0
2020-03-09,Mariposa,043,17540,0,0,0,0,0
2020-03-09,Mendocino,045,87422,0,0,0,0,0
2020-03-09,Merced,047,269075,2,0,0,0,0
2020-03-09,Modoc,049,8938,0,0,0,0,0
2020-03-09,Mono,051,14174,3,0,0,0,0
2020-03-09,Monterey,053,433212,3,0,0,0,0
2020-03-09,Napa,055,140530,2,0,0,0,0
2020-03-09,Nevada,057,99092,2,0,1,1,0
2020-03-09,Orange,059,3164182,154,4,0,4,0
2020-03-09,Placer,061,380077,12,7,0,7,1
2020-03-09,Plumas,063,18699,0,0,0,0,0
2020-03-09,Riverside,065,2383286,49,4,1,5,0
2020-03-09,Sacramento,067,1510023,75,8,0,8,0
2020-03-09,San Benito,069,59416,3,2,0,2,0
2020-03-09,San Bernardino,071,2135413,54,0,0,0,0
2020-03-09,San Diego,073,3302833,124,2,0,2,0
2020-03-09,San Francisco,075,870044,72,14,0,14,0
2020-03-09,San Joaquin,077,732212,21,0,3,3,0
2020-03-09,San Luis Obispo,079,281455,15,0,0,0,0
2020-03-09,San Mateo,081,765935,109,6,0,6,0
2020-03-09,Santa Barbara,083,443738,8,0,0,0,0
2020-03-09,Santa Clara,085,1922200,278,42,1,43,1
2020-03-09,Santa Cruz,087,273765,19,2,0,2,0
2020-03-09,Shasta,089,179085,2,1,0,1,0
2020-03-09,Sierra,091,2930,0,0,0,0,0
2020-03-09,Siskiyou,093,43540,0,0,0,0,0
2020-03-09,Solano,095,438530,25,26,0,26,0
2020-03-09,Sonoma,097,501317,22,2,0,2,0
2020-03-09,Stanislaus,099,539301,11,0,2,2,0
2020-03-09,Sutter,101,95872,0,0,0,0,0
2020-03-09,Tehama,103,63373,0,0,0,0,0
2020-03-09,Trinity,105,12862,0,0,0,0,0
2020-03-09,Tulare,107,460477,9,0,1,1,0
2020-03-09,Tuolumne,109,53932,1,0,0,0,0
2020-03-09,Ventura,111,848112,25,1,0,1,0
2020-03-09,Yolo,113,214977,5,2,0,2,0
2020-03-09,Yuba,115,75493,0,0,0,0,0
2020-03-08,Alameda,001,1643700,48,4,0,4,0
2020-03-08,Alpine,003,1148,0,0,0,0,0
2020-03-08,Amador,005,37829,0,0,0,0,0
2020-03-08,Butte,007,227075,0,0,0,0,0
2020-03-08,Calaveras,009,45235,2,0,0,0,0
2020-03-08,Colusa,011,21464,0,0,0,0,0
2020-03-08,Contra Costa,013,1133247,58,9,0,9,0
2020-03-08,Del Norte,015,27424,0,0,0,0,0
2020-03-08,El Dorado,017,186661,5,0,0,0,0
2020-03-08,Fresno,019,978130,5,1,1,2,0
2020-03-08,Glenn,021,27897,0,0,0,0,0
2020-03-08,Humboldt,023,135768,5,1,0,1,0
2020-03-08,Imperial,025,180216,5,0,0,0,0
2020-03-08,Inyo,027,18085,0,0,0,0,0
2020-03-08,Kern,029,883053,8,0,0,0,0
2020-03-08,Kings,031,150075,0,0,0,0,0
2020-03-08,Lake,033,64148,0,0,0,0,0
2020-03-08,Lassen,035,31185,0,0,0,0,0
2020-03-08,Los Angeles,037,10098052,368,14,6,20,0
2020-03-08,Madera,039,155013,7,1,0,1,0
2020-03-08,Marin,041,260295,13,1,0,1,0
2020-03-08,Mariposa,043,17540,0,0,0,0,0
2020-03-08,Mendocino,045,87422,0,0,0,0,0
2020-03-08,Merced,047,269075,2,0,0,0,0
2020-03-08,Modoc,049,8938,0,0,0,0,0
2020-03-08,Mono,051,14174,3,0,0,0,0
2020-03-08,Monterey,053,433212,3,0,0,0,0
2020-03-08,Napa,055,140530,2,0,0,0,0
2020-03-08,Nevada,057,99092,1,0,1,1,0
2020-03-08,Orange,059,3164182,129,4,0,4,0
2020-03-08,Placer,061,380077,11,7,0,7,1
2020-03-08,Plumas,063,18699,0,0,0,0,0
2020-03-08,Riverside,065,2383286,41,1,1,2,0
2020-03-08,Sacramento,067,1510023,65,5,0,5,0
2020-03-08,San Benito,069,59416,3,2,0,2,0
2020-03-08,San Bernardino,071,2135413,43,0,0,0,0
2020-03-08,San Diego,073,3302833,90,2,0,2,0
2020-03-08,San Francisco,075,870044,53,9,0,9,0
2020-03-08,San Joaquin,077,732212,18,0,3,3,0
2020-03-08,San Luis Obispo,079,281455,9,0,0,0,0
2020-03-08,San Mateo,081,765935,96,4,0,4,0
2020-03-08,Santa Barbara,083,443738,5,0,0,0,0
2020-03-08,Santa Clara,085,1922200,236,36,1,37,0
2020-03-08,Santa Cruz,087,273765,17,1,0,1,0
2020-03-08,Shasta,089,179085,2,0,0,0,0
2020-03-08,Sierra,091,2930,0,0,0,0,0
2020-03-08,Siskiyou,093,43540,0,0,0,0,0
2020-03-08,Solano,095,438530,24,26,0,26,0
2020-03-08,Sonoma,097,501317,17,2,0,2,0
2020-03-08,Stanislaus,099,539301,10,0,2,2,0
2020-03-08,Sutter,101,95872,0,0,0,0,0
2020-03-08,Tehama,103,63373,0,0,0,0,0
2020-03-08,Trinity,105,12862,0,0,0,0,0
2020-03-08,Tulare,107,460477,9,0,0,0,0
2020-03-08,Tuolumne,109,53932,1,0,0,0,0
2020-03-08,Ventura,111,848112,21,1,0,1,0
2020-03-08,Yolo,113,214977,2,2,0,2,0
2020-03-08,Yuba,115,75493,0,0,0,0,0
2020-03-07,Alameda,001,1643700,43,3,0,3,0
2020-03-07,Alpine,003,1148,0,0,0,0,0
2020-03-07,Amador,005,37829,0,0,0,0,0
2020-03-07,Butte,007,227075,0,0,0,0,0
2020-03-07,Calaveras,009,45235,2,0,0,0,0
2020-03-07,Colusa,011,21464,0,0,0,0,0
2020-03-07,Contra Costa,013,1133247,55,4,0,4,0
2020-03-07,Del Norte,015,27424,0,0,0,0,0
2020-03-07,El Dorado,017,186661,4,0,0,0,0
2020-03-07,Fresno,019,978130,4,1,1,2,0
2020-03-07,Glenn,021,27897,0,0,0,0,0
2020-03-07,Humboldt,023,135768,5,1,0,1,0
2020-03-07,Imperial,025,180216,4,0,0,0,0
2020-03-07,Inyo,027,18085,0,0,0,0,0
2020-03-07,Kern,029,883053,7,0,0,0,0
2020-03-07,Kings,031,150075,0,0,0,0,0
2020-03-07,Lake,033,64148,0,0,0,0,0
2020-03-07,Lassen,035,31185,0,0,0,0,0
2020-03-07,Los Angeles,037,10098052,317,14,6,20,0
2020-03-07,Madera,039,155013,6,1,0,1,0
2020-03-07,Marin,041,260295,11,0,0,0,0
2020-03-07,Mariposa,043,17540,0,0,0,0,0
2020-03-07,Mendocino,045,87422,0,0,0,0,0
2020-03-07,Merced,047,269075,2,0,0,0,0
2020-03-07,Modoc,049,8938,0,0,0,0,0
2020-03-07,Mono,051,14174,3,0,0,0,0
2020-03-07,Monterey,053,433212,3,0,0,0,0
2020-03-07,Napa,055,140530,1,0,0,0,0
2020-03-07,Nevada,057,99092,1,0,1,1,0
2020-03-07,Orange,059,3164182,121,4,0,4,0
2020-03-07,Placer,061,380077,11,6,0,6,1
2020-03-07,Plumas,063,18699,0,0,0,0,0
2020-03-07,Riverside,065,2383286,31,0,1,1,0
2020-03-07,Sacramento,067,1510023,52,4,0,4,0
2020-03-07,San Benito,069,59416,3,2,0,2,0
2020-03-07,San Bernardino,071,2135413,41,0,0,0,0
2020-03-07,San Diego,073,3302833,72,2,0,2,0
2020-03-07,San Francisco,075,870044,47,9,0,9,0
2020-03-07,San Joaquin,077,732212,16,0,3,3,0
2020-03-07,San Luis Obispo,079,281455,6,0,0,0,0
2020-03-07,San Mateo,081,765935,86,1,0,1,0
2020-03-07,Santa Barbara,083,443738,5,0,0,0,0
2020-03-07,Santa Clara,085,1922200,206,31,1,32,0
2020-03-07,Santa Cruz,087,273765,17,1,0,1,0
2020-03-07,Shasta,089,179085,2,0,0,0,0
2020-03-07,Sierra,091,2930,0,0,0,0,0
2020-03-07,Siskiyou,093,43540,0,0,0,0,0
2020-03-07,Solano,095,438530,23,25,0,25,0
2020-03-07,Sonoma,097,501317,13,2,0,2,0
2020-03-07,Stanislaus,099,539301,9,0,2,2,0
2020-03-07,Sutter,101,95872,0,0,0,0,0
2020-03-07,Tehama,103,63373,0,0,0,0,0
2020-03-07,Trinity,105,12862,0,0,0,0,0
2020-03-07,Tulare,107,460477,6,0,0,0,0
2020-03-07,Tuolumne,109,53932,1,0,0,0,0
2020-03-07,Ventura,111,848112,18,1,0,1,0
2020-03-07,Yolo,113,214977,2,2,0,2,0
2020-03-07,Yuba,115,75493,0,0,0,0,0
2020-03-06,Alameda,001,1643700,41,3,0,3,0
2020-03-06,Alpine,003,1148,0,0,0,0,0
2020-03-06,Amador,005,37829,0,0,0,0,0
2020-03-06,Butte,007,227075,0,0,0,0,0
2020-03-06,Calaveras,009,45235,2,0,0,0,0
2020-03-06,Colusa,011,21464,0,0,0,0,0
2020-03-06,Contra Costa,013,1133247,46,4,0,4,0
2020-03-06,Del Norte,015,27424,0,0,0,0,0
2020-03-06,El Dorado,017,186661,3,0,0,0,0
2020-03-06,Fresno,019,978130,3,0,1,1,0
2020-03-06,Glenn,021,27897,0,0,0,0,0
2020-03-06,Humboldt,023,135768,4,1,0,1,0
2020-03-06,Imperial,025,180216,3,0,0,0,0
2020-03-06,Inyo,027,18085,0,0,0,0,0
2020-03-06,Kern,029,883053,6,0,0,0,0
2020-03-06,Kings,031,150075,0,0,0,0,0
2020-03-06,Lake,033,64148,0,0,0,0,0
2020-03-06,Lassen,035,31185,0,0,0,0,0
2020-03-06,Los Angeles,037,10098052,274,13,6,19,0
2020-03-06,Madera,039,155013,5,0,0,0,0
2020-03-06,Marin,041,260295,10,0,0,0,0
2020-03-06,Mariposa,043,17540,0,0,0,0,0
2020-03-06,Mendocino,045,87422,0,0,0,0,0
2020-03-06,Merced,047,269075,2,0,0,0,0
2020-03-06,Modoc,049,8938,0,0,0,0,0
2020-03-06,Mono,051,14174,1,0,0,0,0
2020-03-06,Monterey,053,433212,3,0,0,0,0
2020-03-06,Napa,055,140530,1,0,0,0,0
2020-03-06,Nevada,057,99092,1,0,1,1,0
2020-03-06,Orange,059,3164182,95,4,0,4,0
2020-03-06,Placer,061,380077,10,5,0,5,1
2020-03-06,Plumas,063,18699,0,0,0,0,0
2020-03-06,Riverside,065,2383286,30,0,1,1,0
2020-03-06,Sacramento,067,1510023,43,2,0,2,0
2020-03-06,San Benito,069,59416,3,2,0,2,0
2020-03-06,San Bernardino,071,2135413,39,0,0,0,0
2020-03-06,San Diego,073,3302833,59,2,0,2,0
2020-03-06,San Francisco,075,870044,41,2,0,2,0
2020-03-06,San Joaquin,077,732212,13,0,3,3,0
2020-03-06,San Luis Obispo,079,281455,4,0,0,0,0
2020-03-06,San Mateo,081,765935,78,1,0,1,0
2020-03-06,Santa Barbara,083,443738,3,0,0,0,0
2020-03-06,Santa Clara,085,1922200,188,20,1,21,0
2020-03-06,Santa Cruz,087,273765,15,0,0,0,0
2020-03-06,Shasta,089,179085,2,0,0,0,0
2020-03-06,Sierra,091,2930,0,0,0,0,0
2020-03-06,Siskiyou,093,43540,0,0,0,0,0
2020-03-06,Solano,095,438530,22,25,0,25,0
2020-03-06,Sonoma,097,501317,13,2,0,2,0
2020-03-06,Stanislaus,099,539301,5,0,2,2,0
2020-03-06,Sutter,101,95872,0,0,0,0,0
2020-03-06,Tehama,103,63373,0,0,0,0,0
2020-03-06,Trinity,105,12862,0,0,0,0,0
2020-03-06,Tulare,107,460477,6,0,0,0,0
2020-03-06,Tuolumne,109,53932,1,0,0,0,0
2020-03-06,Ventura,111,848112,15,1,0,1,0
2020-03-06,Yolo,113,214977,2,1,0,1,0
2020-03-06,Yuba,115,75493,0,0,0,0,0
2020-03-05,Alameda,001,1643700,35,2,0,2,0
2020-03-05,Alpine,003,1148,0,0,0,0,0
2020-03-05,Amador,005,37829,0,0,0,0,0
2020-03-05,Butte,007,227075,0,0,0,0,0
2020-03-05,Calaveras,009,45235,2,0,0,0,0
2020-03-05,Colusa,011,21464,0,0,0,0,0
2020-03-05,Contra Costa,013,1133247,39,1,0,1,0
2020-03-05,Del Norte,015,27424,0,0,0,0,0
2020-03-05,El Dorado,017,186661,1,0,0,0,0
2020-03-05,Fresno,019,978130,3,0,1,1,0
2020-03-05,Glenn,021,27897,0,0,0,0,0
2020-03-05,Humboldt,023,135768,4,1,0,1,0
2020-03-05,Imperial,025,180216,2,0,0,0,0
2020-03-05,Inyo,027,18085,0,0,0,0,0
2020-03-05,Kern,029,883053,6,0,0,0,0
2020-03-05,Kings,031,150075,0,0,0,0,0
2020-03-05,Lake,033,64148,0,0,0,0,0
2020-03-05,Lassen,035,31185,0,0,0,0,0
2020-03-05,Los Angeles,037,10098052,227,11,6,17,0
2020-03-05,Madera,039,155013,5,0,0,0,0
2020-03-05,Marin,041,260295,10,0,0,0,0
2020-03-05,Mariposa,043,17540,0,0,0,0,0
2020-03-05,Mendocino,045,87422,0,0,0,0,0
2020-03-05,Merced,047,269075,2,0,0,0,0
2020-03-05,Modoc,049,8938,0,0,0,0,0
2020-03-05,Mono,051,14174,1,0,0,0,0
2020-03-05,Monterey,053,433212,3,0,0,0,0
2020-03-05,Napa,055,140530,1,0,0,0,0
2020-03-05,Nevada,057,99092,0,0,1,1,0
2020-03-05,Orange,059,3164182,80,3,0,3,0
2020-03-05,Placer,061,380077,10,2,0,2,1
2020-03-05,Plumas,063,18699,0,0,0,0,0
2020-03-05,Riverside,065,2383286,27,0,1,1,0
2020-03-05,Sacramento,067,1510023,37,2,0,2,0
2020-03-05,San Benito,069,59416,1,2,0,2,0
2020-03-05,San Bernardino,071,2135413,34,0,0,0,0
2020-03-05,San Diego,073,3302833,52,2,0,2,0
2020-03-05,San Francisco,075,870044,31,2,0,2,0
2020-03-05,San Joaquin,077,732212,10,0,3,3,0
2020-03-05,San Luis Obispo,079,281455,4,0,0,0,0
2020-03-05,San Mateo,081,765935,65,1,0,1,0
2020-03-05,Santa Barbara,083,443738,2,0,0,0,0
2020-03-05,Santa Clara,085,1922200,164,14,1,15,0
2020-03-05,Santa Cruz,087,273765,13,0,0,0,0
2020-03-05,Shasta,089,179085,2,0,0,0,0
2020-03-05,Sierra,091,2930,0,0,0,0,0
2020-03-05,Siskiyou,093,43540,0,0,0,0,0
2020-03-05,Solano,095,438530,22,24,0,24,0
2020-03-05,Sonoma,097,501317,12,2,0,2,0
2020-03-05,Stanislaus,099,539301,4,0,2,2,0
2020-03-05,Sutter,101,95872,0,0,0,0,0
2020-03-05,Tehama,103,63373,0,0,0,0,0
2020-03-05,Trinity,105,12862,0,0,0,0,0
2020-03-05,Tulare,107,460477,6,0,0,0,0
2020-03-05,Tuolumne,109,53932,1,0,0,0,0
2020-03-05,Ventura,111,848112,13,0,0,0,0
2020-03-05,Yolo,113,214977,2,0,0,0,0
2020-03-05,Yuba,115,75493,0,0,0,0,0
2020-03-04,Alameda,001,1643700,31,2,0,2,0
2020-03-04,Alpine,003,1148,0,0,0,0,0
2020-03-04,Amador,005,37829,0,0,0,0,0
2020-03-04,Butte,007,227075,0,0,0,0,0
2020-03-04,Calaveras,009,45235,0,0,0,0,0
2020-03-04,Colusa,011,21464,0,0,0,0,0
2020-03-04,Contra Costa,013,1133247,34,1,0,1,0
2020-03-04,Del Norte,015,27424,0,0,0,0,0
2020-03-04,El Dorado,017,186661,1,0,0,0,0
2020-03-04,Fresno,019,978130,3,0,1,1,0
2020-03-04,Glenn,021,27897,0,0,0,0,0
2020-03-04,Humboldt,023,135768,1,1,0,1,0
2020-03-04,Imperial,025,180216,2,0,0,0,0
2020-03-04,Inyo,027,18085,0,0,0,0,0
2020-03-04,Kern,029,883053,6,0,0,0,0
2020-03-04,Kings,031,150075,0,0,0,0,0
2020-03-04,Lake,033,64148,0,0,0,0,0
2020-03-04,Lassen,035,31185,0,0,0,0,0
2020-03-04,Los Angeles,037,10098052,191,7,6,13,0
2020-03-04,Madera,039,155013,5,0,0,0,0
2020-03-04,Marin,041,260295,10,0,0,0,0
2020-03-04,Mariposa,043,17540,0,0,0,0,0
2020-03-04,Mendocino,045,87422,0,0,0,0,0
2020-03-04,Merced,047,269075,2,0,0,0,0
2020-03-04,Modoc,049,8938,0,0,0,0,0
2020-03-04,Mono,051,14174,1,0,0,0,0
2020-03-04,Monterey,053,433212,3,0,0,0,0
2020-03-04,Napa,055,140530,1,0,0,0,0
2020-03-04,Nevada,057,99092,0,0,1,1,0
2020-03-04,Orange,059,3164182,77,3,0,3,0
2020-03-04,Placer,061,380077,9,2,0,2,1
2020-03-04,Plumas,063,18699,0,0,0,0,0
2020-03-04,Riverside,065,2383286,23,0,1,1,0
2020-03-04,Sacramento,067,1510023,32,1,0,1,0
2020-03-04,San Benito,069,59416,1,2,0,2,0
2020-03-04,San Bernardino,071,2135413,31,0,0,0,0
2020-03-04,San Diego,073,3302833,39,2,0,2,0
2020-03-04,San Francisco,075,870044,26,0,0,0,0
2020-03-04,San Joaquin,077,732212,9,0,3,3,0
2020-03-04,San Luis Obispo,079,281455,4,0,0,0,0
2020-03-04,San Mateo,081,765935,60,1,0,1,0
2020-03-04,Santa Barbara,083,443738,2,0,0,0,0
2020-03-04,Santa Clara,085,1922200,147,12,1,13,0
2020-03-04,Santa Cruz,087,273765,13,0,0,0,0
2020-03-04,Shasta,089,179085,2,0,0,0,0
2020-03-04,Sierra,091,2930,0,0,0,0,0
2020-03-04,Siskiyou,093,43540,0,0,0,0,0
2020-03-04,Solano,095,438530,21,24,0,24,0
2020-03-04,Sonoma,097,501317,11,2,0,2,0
2020-03-04,Stanislaus,099,539301,4,0,2,2,0
2020-03-04,Sutter,101,95872,0,0,0,0,0
2020-03-04,Tehama,103,63373,0,0,0,0,0
2020-03-04,Trinity,105,12862,0,0,0,0,0
2020-03-04,Tulare,107,460477,6,0,0,0,0
2020-03-04,Tuolumne,109,53932,0,0,0,0,0
2020-03-04,Ventura,111,848112,12,0,0,0,0
2020-03-04,Yolo,113,214977,2,0,0,0,0
2020-03-04,Yuba,115,75493,0,0,0,0,0
2020-03-03,Alameda,001,1643700,25,2,0,2,0
2020-03-03,Alpine,003,1148,0,0,0,0,0
2020-03-03,Amador,005,37829,0,0,0,0,0
2020-03-03,Butte,007,227075,0,0,0,0,0
2020-03-03,Calaveras,009,45235,0,0,0,0,0
2020-03-03,Colusa,011,21464,0,0,0,0,0
2020-03-03,Contra Costa,013,1133247,30,0,0,0,0
2020-03-03,Del Norte,015,27424,0,0,0,0,0
2020-03-03,El Dorado,017,186661,1,0,0,0,0
2020-03-03,Fresno,019,978130,2,0,1,1,0
2020-03-03,Glenn,021,27897,0,0,0,0,0
2020-03-03,Humboldt,023,135768,1,1,0,1,0
2020-03-03,Imperial,025,180216,2,0,0,0,0
2020-03-03,Inyo,027,18085,0,0,0,0,0
2020-03-03,Kern,029,883053,4,0,0,0,0
2020-03-03,Kings,031,150075,0,0,0,0,0
2020-03-03,Lake,033,64148,0,0,0,0,0
2020-03-03,Lassen,035,31185,0,0,0,0,0
2020-03-03,Los Angeles,037,10098052,172,5,6,11,0
2020-03-03,Madera,039,155013,4,0,0,0,0
2020-03-03,Marin,041,260295,6,0,0,0,0
2020-03-03,Mariposa,043,17540,0,0,0,0,0
2020-03-03,Mendocino,045,87422,0,0,0,0,0
2020-03-03,Merced,047,269075,2,0,0,0,0
2020-03-03,Modoc,049,8938,0,0,0,0,0
2020-03-03,Mono,051,14174,1,0,0,0,0
2020-03-03,Monterey,053,433212,2,0,0,0,0
2020-03-03,Napa,055,140530,1,0,0,0,0
2020-03-03,Nevada,057,99092,0,0,1,1,0
2020-03-03,Orange,059,3164182,69,1,0,1,0
2020-03-03,Placer,061,380077,8,2,0,2,0
2020-03-03,Plumas,063,18699,0,0,0,0,0
2020-03-03,Riverside,065,2383286,20,0,1,1,0
2020-03-03,Sacramento,067,1510023,31,1,0,1,0
2020-03-03,San Benito,069,59416,1,2,0,2,0
2020-03-03,San Bernardino,071,2135413,28,0,0,0,0
2020-03-03,San Diego,073,3302833,32,2,0,2,0
2020-03-03,San Francisco,075,870044,24,0,0,0,0
2020-03-03,San Joaquin,077,732212,8,0,3,3,0
2020-03-03,San Luis Obispo,079,281455,2,0,0,0,0
2020-03-03,San Mateo,081,765935,53,1,0,1,0
2020-03-03,Santa Barbara,083,443738,1,0,0,0,0
2020-03-03,Santa Clara,085,1922200,132,11,1,12,0
2020-03-03,Santa Cruz,087,273765,10,0,0,0,0
2020-03-03,Shasta,089,179085,2,0,0,0,0
2020-03-03,Sierra,091,2930,0,0,0,0,0
2020-03-03,Siskiyou,093,43540,0,0,0,0,0
2020-03-03,Solano,095,438530,20,24,0,24,0
2020-03-03,Sonoma,097,501317,11,1,0,1,0
2020-03-03,Stanislaus,099,539301,4,0,2,2,0
2020-03-03,Sutter,101,95872,0,0,0,0,0
2020-03-03,Tehama,103,63373,0,0,0,0,0
2020-03-03,Trinity,105,12862,0,0,0,0,0
2020-03-03,Tulare,107,460477,6,0,0,0,0
2020-03-03,Tuolumne,109,53932,0,0,0,0,0
2020-03-03,Ventura,111,848112,11,0,0,0,0
2020-03-03,Yolo,113,214977,1,0,0,0,0
2020-03-03,Yuba,115,75493,0,0,0,0,0
2020-03-02,Alameda,001,1643700,22,1,0,1,0
2020-03-02,Alpine,003,1148,0,0,0,0,0
2020-03-02,Amador,005,37829,0,0,0,0,0
2020-03-02,Butte,007,227075,0,0,0,0,0
2020-03-02,Calaveras,009,45235,0,0,0,0,0
2020-03-02,Colusa,011,21464,0,0,0,0,0
2020-03-02,Contra Costa,013,1133247,27,0,0,0,0
2020-03-02,Del Norte,015,27424,0,0,0,0,0
2020-03-02,El Dorado,017,186661,1,0,0,0,0
2020-03-02,Fresno,019,978130,2,0,1,1,0
2020-03-02,Glenn,021,27897,0,0,0,0,0
2020-03-02,Humboldt,023,135768,1,1,0,1,0
2020-03-02,Imperial,025,180216,2,0,0,0,0
2020-03-02,Inyo,027,18085,0,0,0,0,0
2020-03-02,Kern,029,883053,4,0,0,0,0
2020-03-02,Kings,031,150075,0,0,0,0,0
2020-03-02,Lake,033,64148,0,0,0,0,0
2020-03-02,Lassen,035,31185,0,0,0,0,0
2020-03-02,Los Angeles,037,10098052,157,1,6,7,0
2020-03-02,Madera,039,155013,4,0,0,0,0
2020-03-02,Marin,041,260295,6,0,0,0,0
2020-03-02,Mariposa,043,17540,0,0,0,0,0
2020-03-02,Mendocino,045,87422,0,0,0,0,0
2020-03-02,Merced,047,269075,1,0,0,0,0
2020-03-02,Modoc,049,8938,0,0,0,0,0
2020-03-02,Mono,051,14174,1,0,0,0,0
2020-03-02,Monterey,053,433212,2,0,0,0,0
2020-03-02,Napa,055,140530,1,0,0,0,0
2020-03-02,Nevada,057,99092,0,0,1,1,0
2020-03-02,Orange,059,3164182,64,1,0,1,0
2020-03-02,Placer,061,380077,8,1,0,1,0
2020-03-02,Plumas,063,18699,0,0,0,0,0
2020-03-02,Riverside,065,2383286,19,0,1,1,0
2020-03-02,Sacramento,067,1510023,25,1,0,1,0
2020-03-02,San Benito,069,59416,1,2,0,2,0
2020-03-02,San Bernardino,071,2135413,28,0,0,0,0
2020-03-02,San Diego,073,3302833,26,2,0,2,0
2020-03-02,San Francisco,075,870044,17,0,0,0,0
2020-03-02,San Joaquin,077,732212,7,0,3,3,0
2020-03-02,San Luis Obispo,079,281455,2,0,0,0,0
2020-03-02,San Mateo,081,765935,44,1,0,1,0
2020-03-02,Santa Barbara,083,443738,1,0,0,0,0
2020-03-02,Santa Clara,085,1922200,110,7,1,8,0
2020-03-02,Santa Cruz,087,273765,9,0,0,0,0
2020-03-02,Shasta,089,179085,2,0,0,0,0
2020-03-02,Sierra,091,2930,0,0,0,0,0
2020-03-02,Siskiyou,093,43540,0,0,0,0,0
2020-03-02,Solano,095,438530,19,24,0,24,0
2020-03-02,Sonoma,097,501317,10,1,0,1,0
2020-03-02,Stanislaus,099,539301,2,0,2,2,0
2020-03-02,Sutter,101,95872,0,0,0,0,0
2020-03-02,Tehama,103,63373,0,0,0,0,0
2020-03-02,Trinity,105,12862,0,0,0,0,0
2020-03-02,Tulare,107,460477,6,0,0,0,0
2020-03-02,Tuolumne,109,53932,0,0,0,0,0
2020-03-02,Ventura,111,848112,10,0,0,0,0
2020-03-02,Yolo,113,214977,1,0,0,0,0
2020-03-02,Yuba,115,75493,0,0,0,0,0
2020-03-01,Alameda,001,1643700,21,1,0,1,0
2020-03-01,Alpine,003,1148,0,0,0,0,0
2020-03-01,Amador,005,37829,0,0,0,0,0
2020-03-01,Butte,007,227075,0,0,0,0,0
2020-03-01,Calaveras,009,45235,0,0,0,0,0
2020-03-01,Colusa,011,21464,0,0,0,0,0
2020-03-01,Contra Costa,013,1133247,24,0,0,0,0
2020-03-01,Del Norte,015,27424,0,0,0,0,0
2020-03-01,El Dorado,017,186661,1,0,0,0,0
2020-03-01,Fresno,019,978130,1,0,1,1,0
2020-03-01,Glenn,021,27897,0,0,0,0,0
2020-03-01,Humboldt,023,135768,1,1,0,1,0
2020-03-01,Imperial,025,180216,2,0,0,0,0
2020-03-01,Inyo,027,18085,0,0,0,0,0
2020-03-01,Kern,029,883053,2,0,0,0,0
2020-03-01,Kings,031,150075,0,0,0,0,0
2020-03-01,Lake,033,64148,0,0,0,0,0
2020-03-01,Lassen,035,31185,0,0,0,0,0
2020-03-01,Los Angeles,037,10098052,138,1,6,7,0
2020-03-01,Madera,039,155013,2,0,0,0,0
2020-03-01,Marin,041,260295,5,0,0,0,0
2020-03-01,Mariposa,043,17540,0,0,0,0,0
2020-03-01,Mendocino,045,87422,0,0,0,0,0
2020-03-01,Merced,047,269075,1,0,0,0,0
2020-03-01,Modoc,049,8938,0,0,0,0,0
2020-03-01,Mono,051,14174,1,0,0,0,0
2020-03-01,Monterey,053,433212,1,0,0,0,0
2020-03-01,Napa,055,140530,1,0,0,0,0
2020-03-01,Nevada,057,99092,0,0,1,1,0
2020-03-01,Orange,059,3164182,61,1,0,1,0
2020-03-01,Placer,061,380077,8,0,0,0,0
2020-03-01,Plumas,063,18699,0,0,0,0,0
2020-03-01,Riverside,065,2383286,18,0,1,1,0
2020-03-01,Sacramento,067,1510023,21,1,0,1,0
2020-03-01,San Benito,069,59416,0,2,0,2,0
2020-03-01,San Bernardino,071,2135413,27,0,0,0,0
2020-03-01,San Diego,073,3302833,19,2,0,2,0
2020-03-01,San Francisco,075,870044,13,0,0,0,0
2020-03-01,San Joaquin,077,732212,7,0,3,3,0
2020-03-01,San Luis Obispo,079,281455,2,0,0,0,0
2020-03-01,San Mateo,081,765935,36,0,0,0,0
2020-03-01,Santa Barbara,083,443738,1,0,0,0,0
2020-03-01,Santa Clara,085,1922200,97,6,1,7,0
2020-03-01,Santa Cruz,087,273765,8,0,0,0,0
2020-03-01,Shasta,089,179085,2,0,0,0,0
2020-03-01,Sierra,091,2930,0,0,0,0,0
2020-03-01,Siskiyou,093,43540,0,0,0,0,0
2020-03-01,Solano,095,438530,19,24,0,24,0
2020-03-01,Sonoma,097,501317,9,0,0,0,0
2020-03-01,Stanislaus,099,539301,2,0,2,2,0
2020-03-01,Sutter,101,95872,0,0,0,0,0
2020-03-01,Tehama,103,63373,0,0,0,0,0
2020-03-01,Trinity,105,12862,0,0,0,0,0
2020-03-01,Tulare,107,460477,6,0,0,0,0
2020-03-01,Tuolumne,109,53932,0,0,0,0,0
2020-03-01,Ventura,111,848112,8,0,0,0,0
2020-03-01,Yolo,113,214977,1,0,0,0,0
2020-03-01,Yuba,115,75493,0,0,0,0,0
2020-02-29,Alameda,001,1643700,17,0,0,0,0
2020-02-29,Alpine,003,1148,0,0,0,0,0
2020-02-29,Amador,005,37829,0,0,0,0,0
2020-02-29,Butte,007,227075,0,0,0,0,0
2020-02-29,Calaveras,009,45235,0,0,0,0,0
2020-02-29,Colusa,011,21464,0,0,0,0,0
2020-02-29,Contra Costa,013,1133247,20,0,0,0,0
2020-02-29,Del Norte,015,27424,0,0,0,0,0
2020-02-29,El Dorado,017,186661,1,0,0,0,0
2020-02-29,Fresno,019,978130,1,0,0,0,0
2020-02-29,Glenn,021,27897,0,0,0,0,0
2020-02-29,Humboldt,023,135768,1,1,0,1,0
2020-02-29,Imperial,025,180216,1,0,0,0,0
2020-02-29,Inyo,027,18085,0,0,0,0,0
2020-02-29,Kern,029,883053,2,0,0,0,0
2020-02-29,Kings,031,150075,0,0,0,0,0
2020-02-29,Lake,033,64148,0,0,0,0,0
2020-02-29,Lassen,035,31185,0,0,0,0,0
2020-02-29,Los Angeles,037,10098052,110,1,6,7,0
2020-02-29,Madera,039,155013,2,0,0,0,0
2020-02-29,Marin,041,260295,4,0,0,0,0
2020-02-29,Mariposa,043,17540,0,0,0,0,0
2020-02-29,Mendocino,045,87422,0,0,0,0,0
2020-02-29,Merced,047,269075,1,0,0,0,0
2020-02-29,Modoc,049,8938,0,0,0,0,0
2020-02-29,Mono,051,14174,1,0,0,0,0
2020-02-29,Monterey,053,433212,1,0,0,0,0
2020-02-29,Napa,055,140530,1,0,0,0,0
2020-02-29,Nevada,057,99092,0,0,1,1,0
2020-02-29,Orange,059,3164182,56,1,0,1,0
2020-02-29,Placer,061,380077,7,0,0,0,0
2020-02-29,Plumas,063,18699,0,0,0,0,0
2020-02-29,Riverside,065,2383286,15,0,1,1,0
2020-02-29,Sacramento,067,1510023,16,1,0,1,0
2020-02-29,San Benito,069,59416,0,2,0,2,0
2020-02-29,San Bernardino,071,2135413,25,0,0,0,0
2020-02-29,San Diego,073,3302833,14,2,0,2,0
2020-02-29,San Francisco,075,870044,12,0,0,0,0
2020-02-29,San Joaquin,077,732212,6,0,3,3,0
2020-02-29,San Luis Obispo,079,281455,2,0,0,0,0
2020-02-29,San Mateo,081,765935,29,0,0,0,0
2020-02-29,Santa Barbara,083,443738,0,0,0,0,0
2020-02-29,Santa Clara,085,1922200,75,3,1,4,0
2020-02-29,Santa Cruz,087,273765,8,0,0,0,0
2020-02-29,Shasta,089,179085,2,0,0,0,0
2020-02-29,Sierra,091,2930,0,0,0,0,0
2020-02-29,Siskiyou,093,43540,0,0,0,0,0
2020-02-29,Solano,095,438530,18,23,0,23,0
2020-02-29,Sonoma,097,501317,6,0,0,0,0
2020-02-29,Stanislaus,099,539301,2,0,2,2,0
2020-02-29,Sutter,101,95872,0,0,0,0,0
2020-02-29,Tehama,103,63373,0,0,0,0,0
2020-02-29,Trinity,105,12862,0,0,0,0,0
2020-02-29,Tulare,107,460477,4,0,0,0,0
2020-02-29,Tuolumne,109,53932,0,0,0,0,0
2020-02-29,Ventura,111,848112,6,0,0,0,0
2020-02-29,Yolo,113,214977,1,0,0,0,0
2020-02-29,Yuba,115,75493,0,0,0,0,0
2020-02-28,Alameda,001,1643700,15,0,0,0,0
2020-02-28,Alpine,003,1148,0,0,0,0,0
2020-02-28,Amador,005,37829,0,0,0,0,0
2020-02-28,Butte,007,227075,0,0,0,0,0
2020-02-28,Calaveras,009,45235,0,0,0,0,0
2020-02-28,Colusa,011,21464,0,0,0,0,0
2020-02-28,Contra Costa,013,1133247,20,0,0,0,0
2020-02-28,Del Norte,015,27424,0,0,0,0,0
2020-02-28,El Dorado,017,186661,0,0,0,0,0
2020-02-28,Fresno,019,978130,1,0,0,0,0
2020-02-28,Glenn,021,27897,0,0,0,0,0
2020-02-28,Humboldt,023,135768,1,1,0,1,0
2020-02-28,Imperial,025,180216,1,0,0,0,0
2020-02-28,Inyo,027,18085,0,0,0,0,0
2020-02-28,Kern,029,883053,2,0,0,0,0
2020-02-28,Kings,031,150075,0,0,0,0,0
2020-02-28,Lake,033,64148,0,0,0,0,0
2020-02-28,Lassen,035,31185,0,0,0,0,0
2020-02-28,Los Angeles,037,10098052,102,1,6,7,0
2020-02-28,Madera,039,155013,2,0,0,0,0
2020-02-28,Marin,041,260295,2,0,0,0,0
2020-02-28,Mariposa,043,17540,0,0,0,0,0
2020-02-28,Mendocino,045,87422,0,0,0,0,0
2020-02-28,Merced,047,269075,1,0,0,0,0
2020-02-28,Modoc,049,8938,0,0,0,0,0
2020-02-28,Mono,051,14174,0,0,0,0,0
2020-02-28,Monterey,053,433212,1,0,0,0,0
2020-02-28,Napa,055,140530,1,0,0,0,0
2020-02-28,Nevada,057,99092,0,0,1,1,0
2020-02-28,Orange,059,3164182,54,1,0,1,0
2020-02-28,Placer,061,380077,7,0,0,0,0
2020-02-28,Plumas,063,18699,0,0,0,0,0
2020-02-28,Riverside,065,2383286,13,0,1,1,0
2020-02-28,Sacramento,067,1510023,10,1,0,1,0
2020-02-28,San Benito,069,59416,0,2,0,2,0
2020-02-28,San Bernardino,071,2135413,25,0,0,0,0
2020-02-28,San Diego,073,3302833,11,2,0,2,0
2020-02-28,San Francisco,075,870044,10,0,0,0,0
2020-02-28,San Joaquin,077,732212,6,0,3,3,0
2020-02-28,San Luis Obispo,079,281455,2,0,0,0,0
2020-02-28,San Mateo,081,765935,24,0,0,0,0
2020-02-28,Santa Barbara,083,443738,0,0,0,0,0
2020-02-28,Santa Clara,085,1922200,70,3,1,4,0
2020-02-28,Santa Cruz,087,273765,8,0,0,0,0
2020-02-28,Shasta,089,179085,2,0,0,0,0
2020-02-28,Sierra,091,2930,0,0,0,0,0
2020-02-28,Siskiyou,093,43540,0,0,0,0,0
2020-02-28,Solano,095,438530,17,23,0,23,0
2020-02-28,Sonoma,097,501317,6,0,0,0,0
2020-02-28,Stanislaus,099,539301,2,0,2,2,0
2020-02-28,Sutter,101,95872,0,0,0,0,0
2020-02-28,Tehama,103,63373,0,0,0,0,0
2020-02-28,Trinity,105,12862,0,0,0,0,0
2020-02-28,Tulare,107,460477,3,0,0,0,0
2020-02-28,Tuolumne,109,53932,0,0,0,0,0
2020-02-28,Ventura,111,848112,6,0,0,0,0
2020-02-28,Yolo,113,214977,1,0,0,0,0
2020-02-28,Yuba,115,75493,0,0,0,0,0
2020-02-27,Alameda,001,1643700,14,0,0,0,0
2020-02-27,Alpine,003,1148,0,0,0,0,0
2020-02-27,Amador,005,37829,0,0,0,0,0
2020-02-27,Butte,007,227075,0,0,0,0,0
2020-02-27,Calaveras,009,45235,0,0,0,0,0
2020-02-27,Colusa,011,21464,0,0,0,0,0
2020-02-27,Contra Costa,013,1133247,14,0,0,0,0
2020-02-27,Del Norte,015,27424,0,0,0,0,0
2020-02-27,El Dorado,017,186661,0,0,0,0,0
2020-02-27,Fresno,019,978130,1,0,0,0,0
2020-02-27,Glenn,021,27897,0,0,0,0,0
2020-02-27,Humboldt,023,135768,1,1,0,1,0
2020-02-27,Imperial,025,180216,1,0,0,0,0
2020-02-27,Inyo,027,18085,0,0,0,0,0
2020-02-27,Kern,029,883053,2,0,0,0,0
2020-02-27,Kings,031,150075,0,0,0,0,0
2020-02-27,Lake,033,64148,0,0,0,0,0
2020-02-27,Lassen,035,31185,0,0,0,0,0
2020-02-27,Los Angeles,037,10098052,94,1,6,7,0
2020-02-27,Madera,039,155013,2,0,0,0,0
2020-02-27,Marin,041,260295,1,0,0,0,0
2020-02-27,Mariposa,043,17540,0,0,0,0,0
2020-02-27,Mendocino,045,87422,0,0,0,0,0
2020-02-27,Merced,047,269075,1,0,0,0,0
2020-02-27,Modoc,049,8938,0,0,0,0,0
2020-02-27,Mono,051,14174,0,0,0,0,0
2020-02-27,Monterey,053,433212,1,0,0,0,0
2020-02-27,Napa,055,140530,1,0,0,0,0
2020-02-27,Nevada,057,99092,0,0,1,1,0
2020-02-27,Orange,059,3164182,48,1,0,1,0
2020-02-27,Placer,061,380077,6,0,0,0,0
2020-02-27,Plumas,063,18699,0,0,0,0,0
2020-02-27,Riverside,065,2383286,12,0,1,1,0
2020-02-27,Sacramento,067,1510023,10,1,0,1,0
2020-02-27,San Benito,069,59416,0,2,0,2,0
2020-02-27,San Bernardino,071,2135413,25,0,0,0,0
2020-02-27,San Diego,073,3302833,10,2,0,2,0
2020-02-27,San Francisco,075,870044,9,0,0,0,0
2020-02-27,San Joaquin,077,732212,5,0,3,3,0
2020-02-27,San Luis Obispo,079,281455,2,0,0,0,0
2020-02-27,San Mateo,081,765935,20,0,0,0,0
2020-02-27,Santa Barbara,083,443738,0,0,0,0,0
2020-02-27,Santa Clara,085,1922200,59,2,1,3,0
2020-02-27,Santa Cruz,087,273765,6,0,0,0,0
2020-02-27,Shasta,089,179085,0,0,0,0,0
2020-02-27,Sierra,091,2930,0,0,0,0,0
2020-02-27,Siskiyou,093,43540,0,0,0,0,0
2020-02-27,Solano,095,438530,17,23,0,23,0
2020-02-27,Sonoma,097,501317,5,0,0,0,0
2020-02-27,Stanislaus,099,539301,2,0,2,2,0
2020-02-27,Sutter,101,95872,0,0,0,0,0
2020-02-27,Tehama,103,63373,0,0,0,0,0
2020-02-27,Trinity,105,12862,0,0,0,0,0
2020-02-27,Tulare,107,460477,3,0,0,0,0
2020-02-27,Tuolumne,109,53932,0,0,0,0,0
2020-02-27,Ventura,111,848112,4,0,0,0,0
2020-02-27,Yolo,113,214977,1,0,0,0,0
2020-02-27,Yuba,115,75493,0,0,0,0,0
2020-02-26,Alameda,001,1643700,14,0,0,0,0
2020-02-26,Alpine,003,1148,0,0,0,0,0
2020-02-26,Amador,005,37829,0,0,0,0,0
2020-02-26,Butte,007,227075,0,0,0,0,0
2020-02-26,Calaveras,009,45235,0,0,0,0,0
2020-02-26,Colusa,011,21464,0,0,0,0,0
2020-02-26,Contra Costa,013,1133247,13,0,0,0,0
2020-02-26,Del Norte,015,27424,0,0,0,0,0
2020-02-26,El Dorado,017,186661,0,0,0,0,0
2020-02-26,Fresno,019,978130,1,0,0,0,0
2020-02-26,Glenn,021,27897,0,0,0,0,0
2020-02-26,Humboldt,023,135768,1,1,0,1,0
2020-02-26,Imperial,025,180216,1,0,0,0,0
2020-02-26,Inyo,027,18085,0,0,0,0,0
2020-02-26,Kern,029,883053,2,0,0,0,0
2020-02-26,Kings,031,150075,0,0,0,0,0
2020-02-26,Lake,033,64148,0,0,0,0,0
2020-02-26,Lassen,035,31185,0,0,0,0,0
2020-02-26,Los Angeles,037,10098052,88,1,6,7,0
2020-02-26,Madera,039,155013,2,0,0,0,0
2020-02-26,Marin,041,260295,1,0,0,0,0
2020-02-26,Mariposa,043,17540,0,0,0,0,0
2020-02-26,Mendocino,045,87422,0,0,0,0,0
2020-02-26,Merced,047,269075,1,0,0,0,0
2020-02-26,Modoc,049,8938,0,0,0,0,0
2020-02-26,Mono,051,14174,0,0,0,0,0
2020-02-26,Monterey,053,433212,1,0,0,0,0
2020-02-26,Napa,055,140530,0,0,0,0,0
2020-02-26,Nevada,057,99092,0,0,1,1,0
2020-02-26,Orange,059,3164182,47,1,0,1,0
2020-02-26,Placer,061,380077,5,0,0,0,0
2020-02-26,Plumas,063,18699,0,0,0,0,0
2020-02-26,Riverside,065,2383286,10,0,1,1,0
2020-02-26,Sacramento,067,1510023,10,1,0,1,0
2020-02-26,San Benito,069,59416,0,2,0,2,0
2020-02-26,San Bernardino,071,2135413,23,0,0,0,0
2020-02-26,San Diego,073,3302833,9,2,0,2,0
2020-02-26,San Francisco,075,870044,9,0,0,0,0
2020-02-26,San Joaquin,077,732212,5,0,3,3,0
2020-02-26,San Luis Obispo,079,281455,2,0,0,0,0
2020-02-26,San Mateo,081,765935,18,0,0,0,0
2020-02-26,Santa Barbara,083,443738,0,0,0,0,0
2020-02-26,Santa Clara,085,1922200,50,2,1,3,0
2020-02-26,Santa Cruz,087,273765,6,0,0,0,0
2020-02-26,Shasta,089,179085,0,0,0,0,0
2020-02-26,Sierra,091,2930,0,0,0,0,0
2020-02-26,Siskiyou,093,43540,0,0,0,0,0
2020-02-26,Solano,095,438530,17,23,0,23,0
2020-02-26,Sonoma,097,501317,5,0,0,0,0
2020-02-26,Stanislaus,099,539301,2,0,2,2,0
2020-02-26,Sutter,101,95872,0,0,0,0,0
2020-02-26,Tehama,103,63373,0,0,0,0,0
2020-02-26,Trinity,105,12862,0,0,0,0,0
2020-02-26,Tulare,107,460477,3,0,0,0,0
2020-02-26,Tuolumne,109,53932,0,0,0,0,0
2020-02-26,Ventura,111,848112,4,0,0,0,0
2020-02-26,Yolo,113,214977,1,0,0,0,0
2020-02-26,Yuba,115,75493,0,0,0,0,0
2020-02-25,Alameda,001,1643700,14,0,0,0,0
2020-02-25,Alpine,003,1148,0,0,0,0,0
2020-02-25,Amador,005,37829,0,0,0,0,0
2020-02-25,Butte,007,227075,0,0,0,0,0
2020-02-25,Calaveras,009,45235,0,0,0,0,0
2020-02-25,Colusa,011,21464,0,0,0,0,0
2020-02-25,Contra Costa,013,1133247,11,0,0,0,0
2020-02-25,Del Norte,015,27424,0,0,0,0,0
2020-02-25,El Dorado,017,186661,0,0,0,0,0
2020-02-25,Fresno,019,978130,1,0,0,0,0
2020-02-25,Glenn,021,27897,0,0,0,0,0
2020-02-25,Humboldt,023,135768,1,1,0,1,0
2020-02-25,Imperial,025,180216,1,0,0,0,0
2020-02-25,Inyo,027,18085,0,0,0,0,0
2020-02-25,Kern,029,883053,2,0,0,0,0
2020-02-25,Kings,031,150075,0,0,0,0,0
2020-02-25,Lake,033,64148,0,0,0,0,0
2020-02-25,Lassen,035,31185,0,0,0,0,0
2020-02-25,Los Angeles,037,10098052,76,1,6,7,0
2020-02-25,Madera,039,155013,2,0,0,0,0
2020-02-25,Marin,041,260295,1,0,0,0,0
2020-02-25,Mariposa,043,17540,0,0,0,0,0
2020-02-25,Mendocino,045,87422,0,0,0,0,0
2020-02-25,Merced,047,269075,0,0,0,0,0
2020-02-25,Modoc,049,8938,0,0,0,0,0
2020-02-25,Mono,051,14174,0,0,0,0,0
2020-02-25,Monterey,053,433212,1,0,0,0,0
2020-02-25,Napa,055,140530,0,0,0,0,0
2020-02-25,Nevada,057,99092,0,0,1,1,0
2020-02-25,Orange,059,3164182,46,1,0,1,0
2020-02-25,Placer,061,380077,5,0,0,0,0
2020-02-25,Plumas,063,18699,0,0,0,0,0
2020-02-25,Riverside,065,2383286,10,0,1,1,0
2020-02-25,Sacramento,067,1510023,8,1,0,1,0
2020-02-25,San Benito,069,59416,0,2,0,2,0
2020-02-25,San Bernardino,071,2135413,21,0,0,0,0
2020-02-25,San Diego,073,3302833,5,2,0,2,0
2020-02-25,San Francisco,075,870044,7,0,0,0,0
2020-02-25,San Joaquin,077,732212,5,0,2,2,0
2020-02-25,San Luis Obispo,079,281455,2,0,0,0,0
2020-02-25,San Mateo,081,765935,17,0,0,0,0
2020-02-25,Santa Barbara,083,443738,0,0,0,0,0
2020-02-25,Santa Clara,085,1922200,40,2,1,3,0
2020-02-25,Santa Cruz,087,273765,5,0,0,0,0
2020-02-25,Shasta,089,179085,0,0,0,0,0
2020-02-25,Sierra,091,2930,0,0,0,0,0
2020-02-25,Siskiyou,093,43540,0,0,0,0,0
2020-02-25,Solano,095,438530,16,21,0,21,0
2020-02-25,Sonoma,097,501317,5,0,0,0,0
2020-02-25,Stanislaus,099,539301,2,0,2,2,0
2020-02-25,Sutter,101,95872,0,0,0,0,0
2020-02-25,Tehama,103,63373,0,0,0,0,0
2020-02-25,Trinity,105,12862,0,0,0,0,0
2020-02-25,Tulare,107,460477,3,0,0,0,0
2020-02-25,Tuolumne,109,53932,0,0,0,0,0
2020-02-25,Ventura,111,848112,4,0,0,0,0
2020-02-25,Yolo,113,214977,1,0,0,0,0
2020-02-25,Yuba,115,75493,0,0,0,0,0
2020-02-24,Alameda,001,1643700,14,0,0,0,0
2020-02-24,Alpine,003,1148,0,0,0,0,0
2020-02-24,Amador,005,37829,0,0,0,0,0
2020-02-24,Butte,007,227075,0,0,0,0,0
2020-02-24,Calaveras,009,45235,0,0,0,0,0
2020-02-24,Colusa,011,21464,0,0,0,0,0
2020-02-24,Contra Costa,013,1133247,9,0,0,0,0
2020-02-24,Del Norte,015,27424,0,0,0,0,0
2020-02-24,El Dorado,017,186661,0,0,0,0,0
2020-02-24,Fresno,019,978130,1,0,0,0,0
2020-02-24,Glenn,021,27897,0,0,0,0,0
2020-02-24,Humboldt,023,135768,1,1,0,1,0
2020-02-24,Imperial,025,180216,1,0,0,0,0
2020-02-24,Inyo,027,18085,0,0,0,0,0
2020-02-24,Kern,029,883053,2,0,0,0,0
2020-02-24,Kings,031,150075,0,0,0,0,0
2020-02-24,Lake,033,64148,0,0,0,0,0
2020-02-24,Lassen,035,31185,0,0,0,0,0
2020-02-24,Los Angeles,037,10098052,70,1,6,7,0
2020-02-24,Madera,039,155013,1,0,0,0,0
2020-02-24,Marin,041,260295,1,0,0,0,0
2020-02-24,Mariposa,043,17540,0,0,0,0,0
2020-02-24,Mendocino,045,87422,0,0,0,0,0
2020-02-24,Merced,047,269075,0,0,0,0,0
2020-02-24,Modoc,049,8938,0,0,0,0,0
2020-02-24,Mono,051,14174,0,0,0,0,0
2020-02-24,Monterey,053,433212,1,0,0,0,0
2020-02-24,Napa,055,140530,0,0,0,0,0
2020-02-24,Nevada,057,99092,0,0,1,1,0
2020-02-24,Orange,059,3164182,44,1,0,1,0
2020-02-24,Placer,061,380077,3,0,0,0,0
2020-02-24,Plumas,063,18699,0,0,0,0,0
2020-02-24,Riverside,065,2383286,9,0,1,1,0
2020-02-24,Sacramento,067,1510023,7,1,0,1,0
2020-02-24,San Benito,069,59416,0,2,0,2,0
2020-02-24,San Bernardino,071,2135413,21,0,0,0,0
2020-02-24,San Diego,073,3302833,5,2,0,2,0
2020-02-24,San Francisco,075,870044,6,0,0,0,0
2020-02-24,San Joaquin,077,732212,5,0,1,1,0
2020-02-24,San Luis Obispo,079,281455,2,0,0,0,0
2020-02-24,San Mateo,081,765935,13,0,0,0,0
2020-02-24,Santa Barbara,083,443738,0,0,0,0,0
2020-02-24,Santa Clara,085,1922200,38,2,1,3,0
2020-02-24,Santa Cruz,087,273765,5,0,0,0,0
2020-02-24,Shasta,089,179085,0,0,0,0,0
2020-02-24,Sierra,091,2930,0,0,0,0,0
2020-02-24,Siskiyou,093,43540,0,0,0,0,0
2020-02-24,Solano,095,438530,13,15,0,15,0
2020-02-24,Sonoma,097,501317,5,0,0,0,0
2020-02-24,Stanislaus,099,539301,2,0,2,2,0
2020-02-24,Sutter,101,95872,0,0,0,0,0
2020-02-24,Tehama,103,63373,0,0,0,0,0
2020-02-24,Trinity,105,12862,0,0,0,0,0
2020-02-24,Tulare,107,460477,3,0,0,0,0
2020-02-24,Tuolumne,109,53932,0,0,0,0,0
2020-02-24,Ventura,111,848112,4,0,0,0,0
2020-02-24,Yolo,113,214977,1,0,0,0,0
2020-02-24,Yuba,115,75493,0,0,0,0,0
2020-02-23,Alameda,001,1643700,12,0,0,0,0
2020-02-23,Alpine,003,1148,0,0,0,0,0
2020-02-23,Amador,005,37829,0,0,0,0,0
2020-02-23,Butte,007,227075,0,0,0,0,0
2020-02-23,Calaveras,009,45235,0,0,0,0,0
2020-02-23,Colusa,011,21464,0,0,0,0,0
2020-02-23,Contra Costa,013,1133247,6,0,0,0,0
2020-02-23,Del Norte,015,27424,0,0,0,0,0
2020-02-23,El Dorado,017,186661,0,0,0,0,0
2020-02-23,Fresno,019,978130,1,0,0,0,0
2020-02-23,Glenn,021,27897,0,0,0,0,0
2020-02-23,Humboldt,023,135768,1,1,0,1,0
2020-02-23,Imperial,025,180216,1,0,0,0,0
2020-02-23,Inyo,027,18085,0,0,0,0,0
2020-02-23,Kern,029,883053,2,0,0,0,0
2020-02-23,Kings,031,150075,0,0,0,0,0
2020-02-23,Lake,033,64148,0,0,0,0,0
2020-02-23,Lassen,035,31185,0,0,0,0,0
2020-02-23,Los Angeles,037,10098052,62,1,6,7,0
2020-02-23,Madera,039,155013,1,0,0,0,0
2020-02-23,Marin,041,260295,1,0,0,0,0
2020-02-23,Mariposa,043,17540,0,0,0,0,0
2020-02-23,Mendocino,045,87422,0,0,0,0,0
2020-02-23,Merced,047,269075,0,0,0,0,0
2020-02-23,Modoc,049,8938,0,0,0,0,0
2020-02-23,Mono,051,14174,0,0,0,0,0
2020-02-23,Monterey,053,433212,1,0,0,0,0
2020-02-23,Napa,055,140530,0,0,0,0,0
2020-02-23,Nevada,057,99092,0,0,1,1,0
2020-02-23,Orange,059,3164182,44,1,0,1,0
2020-02-23,Placer,061,380077,3,0,0,0,0
2020-02-23,Plumas,063,18699,0,0,0,0,0
2020-02-23,Riverside,065,2383286,9,0,0,0,0
2020-02-23,Sacramento,067,1510023,6,1,0,1,0
2020-02-23,San Benito,069,59416,0,2,0,2,0
2020-02-23,San Bernardino,071,2135413,20,0,0,0,0
2020-02-23,San Diego,073,3302833,4,2,0,2,0
2020-02-23,San Francisco,075,870044,5,0,0,0,0
2020-02-23,San Joaquin,077,732212,4,0,1,1,0
2020-02-23,San Luis Obispo,079,281455,2,0,0,0,0
2020-02-23,San Mateo,081,765935,10,0,0,0,0
2020-02-23,Santa Barbara,083,443738,0,0,0,0,0
2020-02-23,Santa Clara,085,1922200,26,2,1,3,0
2020-02-23,Santa Cruz,087,273765,2,0,0,0,0
2020-02-23,Shasta,089,179085,0,0,0,0,0
2020-02-23,Sierra,091,2930,0,0,0,0,0
2020-02-23,Siskiyou,093,43540,0,0,0,0,0
2020-02-23,Solano,095,438530,11,15,0,15,0
2020-02-23,Sonoma,097,501317,5,0,0,0,0
2020-02-23,Stanislaus,099,539301,2,0,2,2,0
2020-02-23,Sutter,101,95872,0,0,0,0,0
2020-02-23,Tehama,103,63373,0,0,0,0,0
2020-02-23,Trinity,105,12862,0,0,0,0,0
2020-02-23,Tulare,107,460477,2,0,0,0,0
2020-02-23,Tuolumne,109,53932,0,0,0,0,0
2020-02-23,Ventura,111,848112,4,0,0,0,0
2020-02-23,Yolo,113,214977,1,0,0,0,0
2020-02-23,Yuba,115,75493,0,0,0,0,0
2020-02-22,Alameda,001,1643700,11,0,0,0,0
2020-02-22,Alpine,003,1148,0,0,0,0,0
2020-02-22,Amador,005,37829,0,0,0,0,0
2020-02-22,Butte,007,227075,0,0,0,0,0
2020-02-22,Calaveras,009,45235,0,0,0,0,0
2020-02-22,Colusa,011,21464,0,0,0,0,0
2020-02-22,Contra Costa,013,1133247,5,0,0,0,0
2020-02-22,Del Norte,015,27424,0,0,0,0,0
2020-02-22,El Dorado,017,186661,0,0,0,0,0
2020-02-22,Fresno,019,978130,1,0,0,0,0
2020-02-22,Glenn,021,27897,0,0,0,0,0
2020-02-22,Humboldt,023,135768,1,1,0,1,0
2020-02-22,Imperial,025,180216,0,0,0,0,0
2020-02-22,Inyo,027,18085,0,0,0,0,0
2020-02-22,Kern,029,883053,2,0,0,0,0
2020-02-22,Kings,031,150075,0,0,0,0,0
2020-02-22,Lake,033,64148,0,0,0,0,0
2020-02-22,Lassen,035,31185,0,0,0,0,0
2020-02-22,Los Angeles,037,10098052,60,1,6,7,0
2020-02-22,Madera,039,155013,0,0,0,0,0
2020-02-22,Marin,041,260295,1,0,0,0,0
2020-02-22,Mariposa,043,17540,0,0,0,0,0
2020-02-22,Mendocino,045,87422,0,0,0,0,0
2020-02-22,Merced,047,269075,0,0,0,0,0
2020-02-22,Modoc,049,8938,0,0,0,0,0
2020-02-22,Mono,051,14174,0,0,0,0,0
2020-02-22,Monterey,053,433212,1,0,0,0,0
2020-02-22,Napa,055,140530,0,0,0,0,0
2020-02-22,Nevada,057,99092,0,0,1,1,0
2020-02-22,Orange,059,3164182,43,1,0,1,0
2020-02-22,Placer,061,380077,3,0,0,0,0
2020-02-22,Plumas,063,18699,0,0,0,0,0
2020-02-22,Riverside,065,2383286,9,0,0,0,0
2020-02-22,Sacramento,067,1510023,6,1,0,1,0
2020-02-22,San Benito,069,59416,0,2,0,2,0
2020-02-22,San Bernardino,071,2135413,18,0,0,0,0
2020-02-22,San Diego,073,3302833,3,2,0,2,0
2020-02-22,San Francisco,075,870044,3,0,0,0,0
2020-02-22,San Joaquin,077,732212,4,0,1,1,0
2020-02-22,San Luis Obispo,079,281455,2,0,0,0,0
2020-02-22,San Mateo,081,765935,8,0,0,0,0
2020-02-22,Santa Barbara,083,443738,0,0,0,0,0
2020-02-22,Santa Clara,085,1922200,23,2,1,3,0
2020-02-22,Santa Cruz,087,273765,2,0,0,0,0
2020-02-22,Shasta,089,179085,0,0,0,0,0
2020-02-22,Sierra,091,2930,0,0,0,0,0
2020-02-22,Siskiyou,093,43540,0,0,0,0,0
2020-02-22,Solano,095,438530,11,11,0,11,0
2020-02-22,Sonoma,097,501317,4,0,0,0,0
2020-02-22,Stanislaus,099,539301,2,0,2,2,0
2020-02-22,Sutter,101,95872,0,0,0,0,0
2020-02-22,Tehama,103,63373,0,0,0,0,0
2020-02-22,Trinity,105,12862,0,0,0,0,0
2020-02-22,Tulare,107,460477,2,0,0,0,0
2020-02-22,Tuolumne,109,53932,0,0,0,0,0
2020-02-22,Ventura,111,848112,4,0,0,0,0
2020-02-22,Yolo,113,214977,0,0,0,0,0
2020-02-22,Yuba,115,75493,0,0,0,0,0
2020-02-21,Alameda,001,1643700,10,0,0,0,0
2020-02-21,Alpine,003,1148,0,0,0,0,0
2020-02-21,Amador,005,37829,0,0,0,0,0
2020-02-21,Butte,007,227075,0,0,0,0,0
2020-02-21,Calaveras,009,45235,0,0,0,0,0
2020-02-21,Colusa,011,21464,0,0,0,0,0
2020-02-21,Contra Costa,013,1133247,4,0,0,0,0
2020-02-21,Del Norte,015,27424,0,0,0,0,0
2020-02-21,El Dorado,017,186661,0,0,0,0,0
2020-02-21,Fresno,019,978130,1,0,0,0,0
2020-02-21,Glenn,021,27897,0,0,0,0,0
2020-02-21,Humboldt,023,135768,1,1,0,1,0
2020-02-21,Imperial,025,180216,0,0,0,0,0
2020-02-21,Inyo,027,18085,0,0,0,0,0
2020-02-21,Kern,029,883053,2,0,0,0,0
2020-02-21,Kings,031,150075,0,0,0,0,0
2020-02-21,Lake,033,64148,0,0,0,0,0
2020-02-21,Lassen,035,31185,0,0,0,0,0
2020-02-21,Los Angeles,037,10098052,56,1,6,7,0
2020-02-21,Madera,039,155013,0,0,0,0,0
2020-02-21,Marin,041,260295,1,0,0,0,0
2020-02-21,Mariposa,043,17540,0,0,0,0,0
2020-02-21,Mendocino,045,87422,0,0,0,0,0
2020-02-21,Merced,047,269075,0,0,0,0,0
2020-02-21,Modoc,049,8938,0,0,0,0,0
2020-02-21,Mono,051,14174,0,0,0,0,0
2020-02-21,Monterey,053,433212,1,0,0,0,0
2020-02-21,Napa,055,140530,0,0,0,0,0
2020-02-21,Nevada,057,99092,0,0,1,1,0
2020-02-21,Orange,059,3164182,41,1,0,1,0
2020-02-21,Placer,061,380077,2,0,0,0,0
2020-02-21,Plumas,063,18699,0,0,0,0,0
2020-02-21,Riverside,065,2383286,9,0,0,0,0
2020-02-21,Sacramento,067,1510023,5,1,0,1,0
2020-02-21,San Benito,069,59416,0,2,0,2,0
2020-02-21,San Bernardino,071,2135413,17,0,0,0,0
2020-02-21,San Diego,073,3302833,3,2,0,2,0
2020-02-21,San Francisco,075,870044,3,0,0,0,0
2020-02-21,San Joaquin,077,732212,2,0,1,1,0
2020-02-21,San Luis Obispo,079,281455,2,0,0,0,0
2020-02-21,San Mateo,081,765935,8,0,0,0,0
2020-02-21,Santa Barbara,083,443738,0,0,0,0,0
2020-02-21,Santa Clara,085,1922200,21,2,1,3,0
2020-02-21,Santa Cruz,087,273765,2,0,0,0,0
2020-02-21,Shasta,089,179085,0,0,0,0,0
2020-02-21,Sierra,091,2930,0,0,0,0,0
2020-02-21,Siskiyou,093,43540,0,0,0,0,0
2020-02-21,Solano,095,438530,10,11,0,11,0
2020-02-21,Sonoma,097,501317,3,0,0,0,0
2020-02-21,Stanislaus,099,539301,2,0,2,2,0
2020-02-21,Sutter,101,95872,0,0,0,0,0
2020-02-21,Tehama,103,63373,0,0,0,0,0
2020-02-21,Trinity,105,12862,0,0,0,0,0
2020-02-21,Tulare,107,460477,2,0,0,0,0
2020-02-21,Tuolumne,109,53932,0,0,0,0,0
2020-02-21,Ventura,111,848112,4,0,0,0,0
2020-02-21,Yolo,113,214977,0,0,0,0,0
2020-02-21,Yuba,115,75493,0,0,0,0,0
2020-02-20,Alameda,001,1643700,8,0,0,0,0
2020-02-20,Alpine,003,1148,0,0,0,0,0
2020-02-20,Amador,005,37829,0,0,0,0,0
2020-02-20,Butte,007,227075,0,0,0,0,0
2020-02-20,Calaveras,009,45235,0,0,0,0,0
2020-02-20,Colusa,011,21464,0,0,0,0,0
2020-02-20,Contra Costa,013,1133247,3,0,0,0,0
2020-02-20,Del Norte,015,27424,0,0,0,0,0
2020-02-20,El Dorado,017,186661,0,0,0,0,0
2020-02-20,Fresno,019,978130,1,0,0,0,0
2020-02-20,Glenn,021,27897,0,0,0,0,0
2020-02-20,Humboldt,023,135768,1,1,0,1,0
2020-02-20,Imperial,025,180216,0,0,0,0,0
2020-02-20,Inyo,027,18085,0,0,0,0,0
2020-02-20,Kern,029,883053,2,0,0,0,0
2020-02-20,Kings,031,150075,0,0,0,0,0
2020-02-20,Lake,033,64148,0,0,0,0,0
2020-02-20,Lassen,035,31185,0,0,0,0,0
2020-02-20,Los Angeles,037,10098052,55,1,5,6,0
2020-02-20,Madera,039,155013,0,0,0,0,0
2020-02-20,Marin,041,260295,0,0,0,0,0
2020-02-20,Mariposa,043,17540,0,0,0,0,0
2020-02-20,Mendocino,045,87422,0,0,0,0,0
2020-02-20,Merced,047,269075,0,0,0,0,0
2020-02-20,Modoc,049,8938,0,0,0,0,0
2020-02-20,Mono,051,14174,0,0,0,0,0
2020-02-20,Monterey,053,433212,1,0,0,0,0
2020-02-20,Napa,055,140530,0,0,0,0,0
2020-02-20,Nevada,057,99092,0,0,1,1,0
2020-02-20,Orange,059,3164182,41,1,0,1,0
2020-02-20,Placer,061,380077,2,0,0,0,0
2020-02-20,Plumas,063,18699,0,0,0,0,0
2020-02-20,Riverside,065,2383286,7,0,0,0,0
2020-02-20,Sacramento,067,1510023,2,1,0,1,0
2020-02-20,San Benito,069,59416,0,2,0,2,0
2020-02-20,San Bernardino,071,2135413,15,0,0,0,0
2020-02-20,San Diego,073,3302833,3,2,0,2,0
2020-02-20,San Francisco,075,870044,3,0,0,0,0
2020-02-20,San Joaquin,077,732212,2,0,1,1,0
2020-02-20,San Luis Obispo,079,281455,2,0,0,0,0
2020-02-20,San Mateo,081,765935,7,0,0,0,0
2020-02-20,Santa Barbara,083,443738,0,0,0,0,0
2020-02-20,Santa Clara,085,1922200,17,2,1,3,0
2020-02-20,Santa Cruz,087,273765,2,0,0,0,0
2020-02-20,Shasta,089,179085,0,0,0,0,0
2020-02-20,Sierra,091,2930,0,0,0,0,0
2020-02-20,Siskiyou,093,43540,0,0,0,0,0
2020-02-20,Solano,095,438530,8,7,0,7,0
2020-02-20,Sonoma,097,501317,2,0,0,0,0
2020-02-20,Stanislaus,099,539301,2,0,2,2,0
2020-02-20,Sutter,101,95872,0,0,0,0,0
2020-02-20,Tehama,103,63373,0,0,0,0,0
2020-02-20,Trinity,105,12862,0,0,0,0,0
2020-02-20,Tulare,107,460477,2,0,0,0,0
2020-02-20,Tuolumne,109,53932,0,0,0,0,0
2020-02-20,Ventura,111,848112,4,0,0,0,0
2020-02-20,Yolo,113,214977,0,0,0,0,0
2020-02-20,Yuba,115,75493,0,0,0,0,0
2020-02-19,Alameda,001,1643700,7,0,0,0,0
2020-02-19,Alpine,003,1148,0,0,0,0,0
2020-02-19,Amador,005,37829,0,0,0,0,0
2020-02-19,Butte,007,227075,0,0,0,0,0
2020-02-19,Calaveras,009,45235,0,0,0,0,0
2020-02-19,Colusa,011,21464,0,0,0,0,0
2020-02-19,Contra Costa,013,1133247,3,0,0,0,0
2020-02-19,Del Norte,015,27424,0,0,0,0,0
2020-02-19,El Dorado,017,186661,0,0,0,0,0
2020-02-19,Fresno,019,978130,1,0,0,0,0
2020-02-19,Glenn,021,27897,0,0,0,0,0
2020-02-19,Humboldt,023,135768,1,0,0,0,0
2020-02-19,Imperial,025,180216,0,0,0,0,0
2020-02-19,Inyo,027,18085,0,0,0,0,0
2020-02-19,Kern,029,883053,2,0,0,0,0
2020-02-19,Kings,031,150075,0,0,0,0,0
2020-02-19,Lake,033,64148,0,0,0,0,0
2020-02-19,Lassen,035,31185,0,0,0,0,0
2020-02-19,Los Angeles,037,10098052,53,1,5,6,0
2020-02-19,Madera,039,155013,0,0,0,0,0
2020-02-19,Marin,041,260295,0,0,0,0,0
2020-02-19,Mariposa,043,17540,0,0,0,0,0
2020-02-19,Mendocino,045,87422,0,0,0,0,0
2020-02-19,Merced,047,269075,0,0,0,0,0
2020-02-19,Modoc,049,8938,0,0,0,0,0
2020-02-19,Mono,051,14174,0,0,0,0,0
2020-02-19,Monterey,053,433212,1,0,0,0,0
2020-02-19,Napa,055,140530,0,0,0,0,0
2020-02-19,Nevada,057,99092,0,0,1,1,0
2020-02-19,Orange,059,3164182,40,1,0,1,0
2020-02-19,Placer,061,380077,2,0,0,0,0
2020-02-19,Plumas,063,18699,0,0,0,0,0
2020-02-19,Riverside,065,2383286,5,0,0,0,0
2020-02-19,Sacramento,067,1510023,2,0,0,0,0
2020-02-19,San Benito,069,59416,0,2,0,2,0
2020-02-19,San Bernardino,071,2135413,14,0,0,0,0
2020-02-19,San Diego,073,3302833,2,2,0,2,0
2020-02-19,San Francisco,075,870044,2,0,0,0,0
2020-02-19,San Joaquin,077,732212,2,0,1,1,0
2020-02-19,San Luis Obispo,079,281455,2,0,0,0,0
2020-02-19,San Mateo,081,765935,6,0,0,0,0
2020-02-19,Santa Barbara,083,443738,0,0,0,0,0
2020-02-19,Santa Clara,085,1922200,15,2,1,3,0
2020-02-19,Santa Cruz,087,273765,0,0,0,0,0
2020-02-19,Shasta,089,179085,0,0,0,0,0
2020-02-19,Sierra,091,2930,0,0,0,0,0
2020-02-19,Siskiyou,093,43540,0,0,0,0,0
2020-02-19,Solano,095,438530,5,7,0,7,0
2020-02-19,Sonoma,097,501317,2,0,0,0,0
2020-02-19,Stanislaus,099,539301,1,0,2,2,0
2020-02-19,Sutter,101,95872,0,0,0,0,0
2020-02-19,Tehama,103,63373,0,0,0,0,0
2020-02-19,Trinity,105,12862,0,0,0,0,0
2020-02-19,Tulare,107,460477,2,0,0,0,0
2020-02-19,Tuolumne,109,53932,0,0,0,0,0
2020-02-19,Ventura,111,848112,2,0,0,0,0
2020-02-19,Yolo,113,214977,0,0,0,0,0
2020-02-19,Yuba,115,75493,0,0,0,0,0
2020-02-18,Alameda,001,1643700,7,0,0,0,0
2020-02-18,Alpine,003,1148,0,0,0,0,0
2020-02-18,Amador,005,37829,0,0,0,0,0
2020-02-18,Butte,007,227075,0,0,0,0,0
2020-02-18,Calaveras,009,45235,0,0,0,0,0
2020-02-18,Colusa,011,21464,0,0,0,0,0
2020-02-18,Contra Costa,013,1133247,3,0,0,0,0
2020-02-18,Del Norte,015,27424,0,0,0,0,0
2020-02-18,El Dorado,017,186661,0,0,0,0,0
2020-02-18,Fresno,019,978130,0,0,0,0,0
2020-02-18,Glenn,021,27897,0,0,0,0,0
2020-02-18,Humboldt,023,135768,1,0,0,0,0
2020-02-18,Imperial,025,180216,0,0,0,0,0
2020-02-18,Inyo,027,18085,0,0,0,0,0
2020-02-18,Kern,029,883053,2,0,0,0,0
2020-02-18,Kings,031,150075,0,0,0,0,0
2020-02-18,Lake,033,64148,0,0,0,0,0
2020-02-18,Lassen,035,31185,0,0,0,0,0
2020-02-18,Los Angeles,037,10098052,50,1,4,5,0
2020-02-18,Madera,039,155013,0,0,0,0,0
2020-02-18,Marin,041,260295,0,0,0,0,0
2020-02-18,Mariposa,043,17540,0,0,0,0,0
2020-02-18,Mendocino,045,87422,0,0,0,0,0
2020-02-18,Merced,047,269075,0,0,0,0,0
2020-02-18,Modoc,049,8938,0,0,0,0,0
2020-02-18,Mono,051,14174,0,0,0,0,0
2020-02-18,Monterey,053,433212,1,0,0,0,0
2020-02-18,Napa,055,140530,0,0,0,0,0
2020-02-18,Nevada,057,99092,0,0,1,1,0
2020-02-18,Orange,059,3164182,39,1,0,1,0
2020-02-18,Placer,061,380077,0,0,0,0,0
2020-02-18,Plumas,063,18699,0,0,0,0,0
2020-02-18,Riverside,065,2383286,5,0,0,0,0
2020-02-18,Sacramento,067,1510023,2,0,0,0,0
2020-02-18,San Benito,069,59416,0,2,0,2,0
2020-02-18,San Bernardino,071,2135413,13,0,0,0,0
2020-02-18,San Diego,073,3302833,2,2,0,2,0
2020-02-18,San Francisco,075,870044,2,0,0,0,0
2020-02-18,San Joaquin,077,732212,1,0,1,1,0
2020-02-18,San Luis Obispo,079,281455,2,0,0,0,0
2020-02-18,San Mateo,081,765935,5,0,0,0,0
2020-02-18,Santa Barbara,083,443738,0,0,0,0,0
2020-02-18,Santa Clara,085,1922200,14,2,1,3,0
2020-02-18,Santa Cruz,087,273765,0,0,0,0,0
2020-02-18,Shasta,089,179085,0,0,0,0,0
2020-02-18,Sierra,091,2930,0,0,0,0,0
2020-02-18,Siskiyou,093,43540,0,0,0,0,0
2020-02-18,Solano,095,438530,5,7,0,7,0
2020-02-18,Sonoma,097,501317,1,0,0,0,0
2020-02-18,Stanislaus,099,539301,1,0,2,2,0
2020-02-18,Sutter,101,95872,0,0,0,0,0
2020-02-18,Tehama,103,63373,0,0,0,0,0
2020-02-18,Trinity,105,12862,0,0,0,0,0
2020-02-18,Tulare,107,460477,2,0,0,0,0
2020-02-18,Tuolumne,109,53932,0,0,0,0,0
2020-02-18,Ventura,111,848112,2,0,0,0,0
2020-02-18,Yolo,113,214977,0,0,0,0,0
2020-02-18,Yuba,115,75493,0,0,0,0,0
2020-02-17,Alameda,001,1643700,7,0,0,0,0
2020-02-17,Alpine,003,1148,0,0,0,0,0
2020-02-17,Amador,005,37829,0,0,0,0,0
2020-02-17,Butte,007,227075,0,0,0,0,0
2020-02-17,Calaveras,009,45235,0,0,0,0,0
2020-02-17,Colusa,011,21464,0,0,0,0,0
2020-02-17,Contra Costa,013,1133247,3,0,0,0,0
2020-02-17,Del Norte,015,27424,0,0,0,0,0
2020-02-17,El Dorado,017,186661,0,0,0,0,0
2020-02-17,Fresno,019,978130,0,0,0,0,0
2020-02-17,Glenn,021,27897,0,0,0,0,0
2020-02-17,Humboldt,023,135768,1,0,0,0,0
2020-02-17,Imperial,025,180216,0,0,0,0,0
2020-02-17,Inyo,027,18085,0,0,0,0,0
2020-02-17,Kern,029,883053,2,0,0,0,0
2020-02-17,Kings,031,150075,0,0,0,0,0
2020-02-17,Lake,033,64148,0,0,0,0,0
2020-02-17,Lassen,035,31185,0,0,0,0,0
2020-02-17,Los Angeles,037,10098052,47,1,4,5,0
2020-02-17,Madera,039,155013,0,0,0,0,0
2020-02-17,Marin,041,260295,0,0,0,0,0
2020-02-17,Mariposa,043,17540,0,0,0,0,0
2020-02-17,Mendocino,045,87422,0,0,0,0,0
2020-02-17,Merced,047,269075,0,0,0,0,0
2020-02-17,Modoc,049,8938,0,0,0,0,0
2020-02-17,Mono,051,14174,0,0,0,0,0
2020-02-17,Monterey,053,433212,1,0,0,0,0
2020-02-17,Napa,055,140530,0,0,0,0,0
2020-02-17,Nevada,057,99092,0,0,1,1,0
2020-02-17,Orange,059,3164182,39,1,0,1,0
2020-02-17,Placer,061,380077,0,0,0,0,0
2020-02-17,Plumas,063,18699,0,0,0,0,0
2020-02-17,Riverside,065,2383286,5,0,0,0,0
2020-02-17,Sacramento,067,1510023,2,0,0,0,0
2020-02-17,San Benito,069,59416,0,2,0,2,0
2020-02-17,San Bernardino,071,2135413,11,0,0,0,0
2020-02-17,San Diego,073,3302833,2,2,0,2,0
2020-02-17,San Francisco,075,870044,2,0,0,0,0
2020-02-17,San Joaquin,077,732212,1,0,1,1,0
2020-02-17,San Luis Obispo,079,281455,1,0,0,0,0
2020-02-17,San Mateo,081,765935,5,0,0,0,0
2020-02-17,Santa Barbara,083,443738,0,0,0,0,0
2020-02-17,Santa Clara,085,1922200,12,2,1,3,0
2020-02-17,Santa Cruz,087,273765,0,0,0,0,0
2020-02-17,Shasta,089,179085,0,0,0,0,0
2020-02-17,Sierra,091,2930,0,0,0,0,0
2020-02-17,Siskiyou,093,43540,0,0,0,0,0
2020-02-17,Solano,095,438530,3,5,0,5,0
2020-02-17,Sonoma,097,501317,1,0,0,0,0
2020-02-17,Stanislaus,099,539301,1,0,2,2,0
2020-02-17,Sutter,101,95872,0,0,0,0,0
2020-02-17,Tehama,103,63373,0,0,0,0,0
2020-02-17,Trinity,105,12862,0,0,0,0,0
2020-02-17,Tulare,107,460477,2,0,0,0,0
2020-02-17,Tuolumne,109,53932,0,0,0,0,0
2020-02-17,Ventura,111,848112,2,0,0,0,0
2020-02-17,Yolo,113,214977,0,0,0,0,0
2020-02-17,Yuba,115,75493,0,0,0,0,0
2020-02-16,Alameda,001,1643700,6,0,0,0,0
2020-02-16,Alpine,003,1148,0,0,0,0,0
2020-02-16,Amador,005,37829,0,0,0,0,0
2020-02-16,Butte,007,227075,0,0,0,0,0
2020-02-16,Calaveras,009,45235,0,0,0,0,0
2020-02-16,Colusa,011,21464,0,0,0,0,0
2020-02-16,Contra Costa,013,1133247,3,0,0,0,0
2020-02-16,Del Norte,015,27424,0,0,0,0,0
2020-02-16,El Dorado,017,186661,0,0,0,0,0
2020-02-16,Fresno,019,978130,0,0,0,0,0
2020-02-16,Glenn,021,27897,0,0,0,0,0
2020-02-16,Humboldt,023,135768,1,0,0,0,0
2020-02-16,Imperial,025,180216,0,0,0,0,0
2020-02-16,Inyo,027,18085,0,0,0,0,0
2020-02-16,Kern,029,883053,2,0,0,0,0
2020-02-16,Kings,031,150075,0,0,0,0,0
2020-02-16,Lake,033,64148,0,0,0,0,0
2020-02-16,Lassen,035,31185,0,0,0,0,0
2020-02-16,Los Angeles,037,10098052,42,1,4,5,0
2020-02-16,Madera,039,155013,0,0,0,0,0
2020-02-16,Marin,041,260295,0,0,0,0,0
2020-02-16,Mariposa,043,17540,0,0,0,0,0
2020-02-16,Mendocino,045,87422,0,0,0,0,0
2020-02-16,Merced,047,269075,0,0,0,0,0
2020-02-16,Modoc,049,8938,0,0,0,0,0
2020-02-16,Mono,051,14174,0,0,0,0,0
2020-02-16,Monterey,053,433212,1,0,0,0,0
2020-02-16,Napa,055,140530,0,0,0,0,0
2020-02-16,Nevada,057,99092,0,0,0,0,0
2020-02-16,Orange,059,3164182,38,1,0,1,0
2020-02-16,Placer,061,380077,0,0,0,0,0
2020-02-16,Plumas,063,18699,0,0,0,0,0
2020-02-16,Riverside,065,2383286,5,0,0,0,0
2020-02-16,Sacramento,067,1510023,2,0,0,0,0
2020-02-16,San Benito,069,59416,0,2,0,2,0
2020-02-16,San Bernardino,071,2135413,10,0,0,0,0
2020-02-16,San Diego,073,3302833,2,2,0,2,0
2020-02-16,San Francisco,075,870044,2,0,0,0,0
2020-02-16,San Joaquin,077,732212,1,0,1,1,0
2020-02-16,San Luis Obispo,079,281455,1,0,0,0,0
2020-02-16,San Mateo,081,765935,4,0,0,0,0
2020-02-16,Santa Barbara,083,443738,0,0,0,0,0
2020-02-16,Santa Clara,085,1922200,10,2,1,3,0
2020-02-16,Santa Cruz,087,273765,0,0,0,0,0
2020-02-16,Shasta,089,179085,0,0,0,0,0
2020-02-16,Sierra,091,2930,0,0,0,0,0
2020-02-16,Siskiyou,093,43540,0,0,0,0,0
2020-02-16,Solano,095,438530,1,0,0,0,0
2020-02-16,Sonoma,097,501317,1,0,0,0,0
2020-02-16,Stanislaus,099,539301,1,0,2,2,0
2020-02-16,Sutter,101,95872,0,0,0,0,0
2020-02-16,Tehama,103,63373,0,0,0,0,0
2020-02-16,Trinity,105,12862,0,0,0,0,0
2020-02-16,Tulare,107,460477,2,0,0,0,0
2020-02-16,Tuolumne,109,53932,0,0,0,0,0
2020-02-16,Ventura,111,848112,2,0,0,0,0
2020-02-16,Yolo,113,214977,0,0,0,0,0
2020-02-16,Yuba,115,75493,0,0,0,0,0
2020-02-15,Alameda,001,1643700,6,0,0,0,0
2020-02-15,Alpine,003,1148,0,0,0,0,0
2020-02-15,Amador,005,37829,0,0,0,0,0
2020-02-15,Butte,007,227075,0,0,0,0,0
2020-02-15,Calaveras,009,45235,0,0,0,0,0
2020-02-15,Colusa,011,21464,0,0,0,0,0
2020-02-15,Contra Costa,013,1133247,3,0,0,0,0
2020-02-15,Del Norte,015,27424,0,0,0,0,0
2020-02-15,El Dorado,017,186661,0,0,0,0,0
2020-02-15,Fresno,019,978130,0,0,0,0,0
2020-02-15,Glenn,021,27897,0,0,0,0,0
2020-02-15,Humboldt,023,135768,1,0,0,0,0
2020-02-15,Imperial,025,180216,0,0,0,0,0
2020-02-15,Inyo,027,18085,0,0,0,0,0
2020-02-15,Kern,029,883053,2,0,0,0,0
2020-02-15,Kings,031,150075,0,0,0,0,0
2020-02-15,Lake,033,64148,0,0,0,0,0
2020-02-15,Lassen,035,31185,0,0,0,0,0
2020-02-15,Los Angeles,037,10098052,39,1,4,5,0
2020-02-15,Madera,039,155013,0,0,0,0,0
2020-02-15,Marin,041,260295,0,0,0,0,0
2020-02-15,Mariposa,043,17540,0,0,0,0,0
2020-02-15,Mendocino,045,87422,0,0,0,0,0
2020-02-15,Merced,047,269075,0,0,0,0,0
2020-02-15,Modoc,049,8938,0,0,0,0,0
2020-02-15,Mono,051,14174,0,0,0,0,0
2020-02-15,Monterey,053,433212,1,0,0,0,0
2020-02-15,Napa,055,140530,0,0,0,0,0
2020-02-15,Nevada,057,99092,0,0,0,0,0
2020-02-15,Orange,059,3164182,37,1,0,1,0
2020-02-15,Placer,061,380077,0,0,0,0,0
2020-02-15,Plumas,063,18699,0,0,0,0,0
2020-02-15,Riverside,065,2383286,4,0,0,0,0
2020-02-15,Sacramento,067,1510023,2,0,0,0,0
2020-02-15,San Benito,069,59416,0,2,0,2,0
2020-02-15,San Bernardino,071,2135413,9,0,0,0,0
2020-02-15,San Diego,073,3302833,2,2,0,2,0
2020-02-15,San Francisco,075,870044,2,0,0,0,0
2020-02-15,San Joaquin,077,732212,1,0,1,1,0
2020-02-15,San Luis Obispo,079,281455,1,0,0,0,0
2020-02-15,San Mateo,081,765935,4,0,0,0,0
2020-02-15,Santa Barbara,083,443738,0,0,0,0,0
2020-02-15,Santa Clara,085,1922200,10,2,1,3,0
2020-02-15,Santa Cruz,087,273765,0,0,0,0,0
2020-02-15,Shasta,089,179085,0,0,0,0,0
2020-02-15,Sierra,091,2930,0,0,0,0,0
2020-02-15,Siskiyou,093,43540,0,0,0,0,0
2020-02-15,Solano,095,438530,1,0,0,0,0
2020-02-15,Sonoma,097,501317,0,0,0,0,0
2020-02-15,Stanislaus,099,539301,1,0,2,2,0
2020-02-15,Sutter,101,95872,0,0,0,0,0
2020-02-15,Tehama,103,63373,0,0,0,0,0
2020-02-15,Trinity,105,12862,0,0,0,0,0
2020-02-15,Tulare,107,460477,2,0,0,0,0
2020-02-15,Tuolumne,109,53932,0,0,0,0,0
2020-02-15,Ventura,111,848112,2,0,0,0,0
2020-02-15,Yolo,113,214977,0,0,0,0,0
2020-02-15,Yuba,115,75493,0,0,0,0,0
2020-02-14,Alameda,001,1643700,5,0,0,0,0
2020-02-14,Alpine,003,1148,0,0,0,0,0
2020-02-14,Amador,005,37829,0,0,0,0,0
2020-02-14,Butte,007,227075,0,0,0,0,0
2020-02-14,Calaveras,009,45235,0,0,0,0,0
2020-02-14,Colusa,011,21464,0,0,0,0,0
2020-02-14,Contra Costa,013,1133247,3,0,0,0,0
2020-02-14,Del Norte,015,27424,0,0,0,0,0
2020-02-14,El Dorado,017,186661,0,0,0,0,0
2020-02-14,Fresno,019,978130,0,0,0,0,0
2020-02-14,Glenn,021,27897,0,0,0,0,0
2020-02-14,Humboldt,023,135768,1,0,0,0,0
2020-02-14,Imperial,025,180216,0,0,0,0,0
2020-02-14,Inyo,027,18085,0,0,0,0,0
2020-02-14,Kern,029,883053,2,0,0,0,0
2020-02-14,Kings,031,150075,0,0,0,0,0
2020-02-14,Lake,033,64148,0,0,0,0,0
2020-02-14,Lassen,035,31185,0,0,0,0,0
2020-02-14,Los Angeles,037,10098052,34,1,4,5,0
2020-02-14,Madera,039,155013,0,0,0,0,0
2020-02-14,Marin,041,260295,0,0,0,0,0
2020-02-14,Mariposa,043,17540,0,0,0,0,0
2020-02-14,Mendocino,045,87422,0,0,0,0,0
2020-02-14,Merced,047,269075,0,0,0,0,0
2020-02-14,Modoc,049,8938,0,0,0,0,0
2020-02-14,Mono,051,14174,0,0,0,0,0
2020-02-14,Monterey,053,433212,1,0,0,0,0
2020-02-14,Napa,055,140530,0,0,0,0,0
2020-02-14,Nevada,057,99092,0,0,0,0,0
2020-02-14,Orange,059,3164182,37,1,0,1,0
2020-02-14,Placer,061,380077,0,0,0,0,0
2020-02-14,Plumas,063,18699,0,0,0,0,0
2020-02-14,Riverside,065,2383286,4,0,0,0,0
2020-02-14,Sacramento,067,1510023,1,0,0,0,0
2020-02-14,San Benito,069,59416,0,2,0,2,0
2020-02-14,San Bernardino,071,2135413,9,0,0,0,0
2020-02-14,San Diego,073,3302833,1,2,0,2,0
2020-02-14,San Francisco,075,870044,2,0,0,0,0
2020-02-14,San Joaquin,077,732212,1,0,1,1,0
2020-02-14,San Luis Obispo,079,281455,0,0,0,0,0
2020-02-14,San Mateo,081,765935,3,0,0,0,0
2020-02-14,Santa Barbara,083,443738,0,0,0,0,0
2020-02-14,Santa Clara,085,1922200,8,2,1,3,0
2020-02-14,Santa Cruz,087,273765,0,0,0,0,0
2020-02-14,Shasta,089,179085,0,0,0,0,0
2020-02-14,Sierra,091,2930,0,0,0,0,0
2020-02-14,Siskiyou,093,43540,0,0,0,0,0
2020-02-14,Solano,095,438530,1,0,0,0,0
2020-02-14,Sonoma,097,501317,0,0,0,0,0
2020-02-14,Stanislaus,099,539301,1,0,2,2,0
2020-02-14,Sutter,101,95872,0,0,0,0,0
2020-02-14,Tehama,103,63373,0,0,0,0,0
2020-02-14,Trinity,105,12862,0,0,0,0,0
2020-02-14,Tulare,107,460477,2,0,0,0,0
2020-02-14,Tuolumne,109,53932,0,0,0,0,0
2020-02-14,Ventura,111,848112,2,0,0,0,0
2020-02-14,Yolo,113,214977,0,0,0,0,0
2020-02-14,Yuba,115,75493,0,0,0,0,0
2020-02-13,Alameda,001,1643700,5,0,0,0,0
2020-02-13,Alpine,003,1148,0,0,0,0,0
2020-02-13,Amador,005,37829,0,0,0,0,0
2020-02-13,Butte,007,227075,0,0,0,0,0
2020-02-13,Calaveras,009,45235,0,0,0,0,0
2020-02-13,Colusa,011,21464,0,0,0,0,0
2020-02-13,Contra Costa,013,1133247,3,0,0,0,0
2020-02-13,Del Norte,015,27424,0,0,0,0,0
2020-02-13,El Dorado,017,186661,0,0,0,0,0
2020-02-13,Fresno,019,978130,0,0,0,0,0
2020-02-13,Glenn,021,27897,0,0,0,0,0
2020-02-13,Humboldt,023,135768,1,0,0,0,0
2020-02-13,Imperial,025,180216,0,0,0,0,0
2020-02-13,Inyo,027,18085,0,0,0,0,0
2020-02-13,Kern,029,883053,2,0,0,0,0
2020-02-13,Kings,031,150075,0,0,0,0,0
2020-02-13,Lake,033,64148,0,0,0,0,0
2020-02-13,Lassen,035,31185,0,0,0,0,0
2020-02-13,Los Angeles,037,10098052,31,1,3,4,0
2020-02-13,Madera,039,155013,0,0,0,0,0
2020-02-13,Marin,041,260295,0,0,0,0,0
2020-02-13,Mariposa,043,17540,0,0,0,0,0
2020-02-13,Mendocino,045,87422,0,0,0,0,0
2020-02-13,Merced,047,269075,0,0,0,0,0
2020-02-13,Modoc,049,8938,0,0,0,0,0
2020-02-13,Mono,051,14174,0,0,0,0,0
2020-02-13,Monterey,053,433212,1,0,0,0,0
2020-02-13,Napa,055,140530,0,0,0,0,0
2020-02-13,Nevada,057,99092,0,0,0,0,0
2020-02-13,Orange,059,3164182,36,1,0,1,0
2020-02-13,Placer,061,380077,0,0,0,0,0
2020-02-13,Plumas,063,18699,0,0,0,0,0
2020-02-13,Riverside,065,2383286,4,0,0,0,0
2020-02-13,Sacramento,067,1510023,1,0,0,0,0
2020-02-13,San Benito,069,59416,0,2,0,2,0
2020-02-13,San Bernardino,071,2135413,8,0,0,0,0
2020-02-13,San Diego,073,3302833,0,2,0,2,0
2020-02-13,San Francisco,075,870044,2,0,0,0,0
2020-02-13,San Joaquin,077,732212,1,0,1,1,0
2020-02-13,San Luis Obispo,079,281455,0,0,0,0,0
2020-02-13,San Mateo,081,765935,2,0,0,0,0
2020-02-13,Santa Barbara,083,443738,0,0,0,0,0
2020-02-13,Santa Clara,085,1922200,7,2,0,2,0
2020-02-13,Santa Cruz,087,273765,0,0,0,0,0
2020-02-13,Shasta,089,179085,0,0,0,0,0
2020-02-13,Sierra,091,2930,0,0,0,0,0
2020-02-13,Siskiyou,093,43540,0,0,0,0,0
2020-02-13,Solano,095,438530,0,0,0,0,0
2020-02-13,Sonoma,097,501317,0,0,0,0,0
2020-02-13,Stanislaus,099,539301,1,0,1,1,0
2020-02-13,Sutter,101,95872,0,0,0,0,0
2020-02-13,Tehama,103,63373,0,0,0,0,0
2020-02-13,Trinity,105,12862,0,0,0,0,0
2020-02-13,Tulare,107,460477,2,0,0,0,0
2020-02-13,Tuolumne,109,53932,0,0,0,0,0
2020-02-13,Ventura,111,848112,2,0,0,0,0
2020-02-13,Yolo,113,214977,0,0,0,0,0
2020-02-13,Yuba,115,75493,0,0,0,0,0
2020-02-12,Alameda,001,1643700,5,0,0,0,0
2020-02-12,Alpine,003,1148,0,0,0,0,0
2020-02-12,Amador,005,37829,0,0,0,0,0
2020-02-12,Butte,007,227075,0,0,0,0,0
2020-02-12,Calaveras,009,45235,0,0,0,0,0
2020-02-12,Colusa,011,21464,0,0,0,0,0
2020-02-12,Contra Costa,013,1133247,3,0,0,0,0
2020-02-12,Del Norte,015,27424,0,0,0,0,0
2020-02-12,El Dorado,017,186661,0,0,0,0,0
2020-02-12,Fresno,019,978130,0,0,0,0,0
2020-02-12,Glenn,021,27897,0,0,0,0,0
2020-02-12,Humboldt,023,135768,1,0,0,0,0
2020-02-12,Imperial,025,180216,0,0,0,0,0
2020-02-12,Inyo,027,18085,0,0,0,0,0
2020-02-12,Kern,029,883053,2,0,0,0,0
2020-02-12,Kings,031,150075,0,0,0,0,0
2020-02-12,Lake,033,64148,0,0,0,0,0
2020-02-12,Lassen,035,31185,0,0,0,0,0
2020-02-12,Los Angeles,037,10098052,30,1,3,4,0
2020-02-12,Madera,039,155013,0,0,0,0,0
2020-02-12,Marin,041,260295,0,0,0,0,0
2020-02-12,Mariposa,043,17540,0,0,0,0,0
2020-02-12,Mendocino,045,87422,0,0,0,0,0
2020-02-12,Merced,047,269075,0,0,0,0,0
2020-02-12,Modoc,049,8938,0,0,0,0,0
2020-02-12,Mono,051,14174,0,0,0,0,0
2020-02-12,Monterey,053,433212,1,0,0,0,0
2020-02-12,Napa,055,140530,0,0,0,0,0
2020-02-12,Nevada,057,99092,0,0,0,0,0
2020-02-12,Orange,059,3164182,36,1,0,1,0
2020-02-12,Placer,061,380077,0,0,0,0,0
2020-02-12,Plumas,063,18699,0,0,0,0,0
2020-02-12,Riverside,065,2383286,4,0,0,0,0
2020-02-12,Sacramento,067,1510023,1,0,0,0,0
2020-02-12,San Benito,069,59416,0,2,0,2,0
2020-02-12,San Bernardino,071,2135413,8,0,0,0,0
2020-02-12,San Diego,073,3302833,0,2,0,2,0
2020-02-12,San Francisco,075,870044,2,0,0,0,0
2020-02-12,San Joaquin,077,732212,1,0,1,1,0
2020-02-12,San Luis Obispo,079,281455,0,0,0,0,0
2020-02-12,San Mateo,081,765935,2,0,0,0,0
2020-02-12,Santa Barbara,083,443738,0,0,0,0,0
2020-02-12,Santa Clara,085,1922200,6,2,0,2,0
2020-02-12,Santa Cruz,087,273765,0,0,0,0,0
2020-02-12,Shasta,089,179085,0,0,0,0,0
2020-02-12,Sierra,091,2930,0,0,0,0,0
2020-02-12,Siskiyou,093,43540,0,0,0,0,0
2020-02-12,Solano,095,438530,0,0,0,0,0
2020-02-12,Sonoma,097,501317,0,0,0,0,0
2020-02-12,Stanislaus,099,539301,1,0,1,1,0
2020-02-12,Sutter,101,95872,0,0,0,0,0
2020-02-12,Tehama,103,63373,0,0,0,0,0
2020-02-12,Trinity,105,12862,0,0,0,0,0
2020-02-12,Tulare,107,460477,2,0,0,0,0
2020-02-12,Tuolumne,109,53932,0,0,0,0,0
2020-02-12,Ventura,111,848112,2,0,0,0,0
2020-02-12,Yolo,113,214977,0,0,0,0,0
2020-02-12,Yuba,115,75493,0,0,0,0,0
2020-02-11,Alameda,001,1643700,5,0,0,0,0
2020-02-11,Alpine,003,1148,0,0,0,0,0
2020-02-11,Amador,005,37829,0,0,0,0,0
2020-02-11,Butte,007,227075,0,0,0,0,0
2020-02-11,Calaveras,009,45235,0,0,0,0,0
2020-02-11,Colusa,011,21464,0,0,0,0,0
2020-02-11,Contra Costa,013,1133247,3,0,0,0,0
2020-02-11,Del Norte,015,27424,0,0,0,0,0
2020-02-11,El Dorado,017,186661,0,0,0,0,0
2020-02-11,Fresno,019,978130,0,0,0,0,0
2020-02-11,Glenn,021,27897,0,0,0,0,0
2020-02-11,Humboldt,023,135768,1,0,0,0,0
2020-02-11,Imperial,025,180216,0,0,0,0,0
2020-02-11,Inyo,027,18085,0,0,0,0,0
2020-02-11,Kern,029,883053,2,0,0,0,0
2020-02-11,Kings,031,150075,0,0,0,0,0
2020-02-11,Lake,033,64148,0,0,0,0,0
2020-02-11,Lassen,035,31185,0,0,0,0,0
2020-02-11,Los Angeles,037,10098052,30,1,3,4,0
2020-02-11,Madera,039,155013,0,0,0,0,0
2020-02-11,Marin,041,260295,0,0,0,0,0
2020-02-11,Mariposa,043,17540,0,0,0,0,0
2020-02-11,Mendocino,045,87422,0,0,0,0,0
2020-02-11,Merced,047,269075,0,0,0,0,0
2020-02-11,Modoc,049,8938,0,0,0,0,0
2020-02-11,Mono,051,14174,0,0,0,0,0
2020-02-11,Monterey,053,433212,1,0,0,0,0
2020-02-11,Napa,055,140530,0,0,0,0,0
2020-02-11,Nevada,057,99092,0,0,0,0,0
2020-02-11,Orange,059,3164182,35,1,0,1,0
2020-02-11,Placer,061,380077,0,0,0,0,0
2020-02-11,Plumas,063,18699,0,0,0,0,0
2020-02-11,Riverside,065,2383286,4,0,0,0,0
2020-02-11,Sacramento,067,1510023,1,0,0,0,0
2020-02-11,San Benito,069,59416,0,2,0,2,0
2020-02-11,San Bernardino,071,2135413,8,0,0,0,0
2020-02-11,San Diego,073,3302833,0,1,0,1,0
2020-02-11,San Francisco,075,870044,2,0,0,0,0
2020-02-11,San Joaquin,077,732212,0,0,1,1,0
2020-02-11,San Luis Obispo,079,281455,0,0,0,0,0
2020-02-11,San Mateo,081,765935,2,0,0,0,0
2020-02-11,Santa Barbara,083,443738,0,0,0,0,0
2020-02-11,Santa Clara,085,1922200,5,2,0,2,0
2020-02-11,Santa Cruz,087,273765,0,0,0,0,0
2020-02-11,Shasta,089,179085,0,0,0,0,0
2020-02-11,Sierra,091,2930,0,0,0,0,0
2020-02-11,Siskiyou,093,43540,0,0,0,0,0
2020-02-11,Solano,095,438530,0,0,0,0,0
2020-02-11,Sonoma,097,501317,0,0,0,0,0
2020-02-11,Stanislaus,099,539301,1,0,1,1,0
2020-02-11,Sutter,101,95872,0,0,0,0,0
2020-02-11,Tehama,103,63373,0,0,0,0,0
2020-02-11,Trinity,105,12862,0,0,0,0,0
2020-02-11,Tulare,107,460477,2,0,0,0,0
2020-02-11,Tuolumne,109,53932,0,0,0,0,0
2020-02-11,Ventura,111,848112,2,0,0,0,0
2020-02-11,Yolo,113,214977,0,0,0,0,0
2020-02-11,Yuba,115,75493,0,0,0,0,0
2020-02-10,Alameda,001,1643700,5,0,0,0,0
2020-02-10,Alpine,003,1148,0,0,0,0,0
2020-02-10,Amador,005,37829,0,0,0,0,0
2020-02-10,Butte,007,227075,0,0,0,0,0
2020-02-10,Calaveras,009,45235,0,0,0,0,0
2020-02-10,Colusa,011,21464,0,0,0,0,0
2020-02-10,Contra Costa,013,1133247,3,0,0,0,0
2020-02-10,Del Norte,015,27424,0,0,0,0,0
2020-02-10,El Dorado,017,186661,0,0,0,0,0
2020-02-10,Fresno,019,978130,0,0,0,0,0
2020-02-10,Glenn,021,27897,0,0,0,0,0
2020-02-10,Humboldt,023,135768,0,0,0,0,0
2020-02-10,Imperial,025,180216,0,0,0,0,0
2020-02-10,Inyo,027,18085,0,0,0,0,0
2020-02-10,Kern,029,883053,2,0,0,0,0
2020-02-10,Kings,031,150075,0,0,0,0,0
2020-02-10,Lake,033,64148,0,0,0,0,0
2020-02-10,Lassen,035,31185,0,0,0,0,0
2020-02-10,Los Angeles,037,10098052,28,1,3,4,0
2020-02-10,Madera,039,155013,0,0,0,0,0
2020-02-10,Marin,041,260295,0,0,0,0,0
2020-02-10,Mariposa,043,17540,0,0,0,0,0
2020-02-10,Mendocino,045,87422,0,0,0,0,0
2020-02-10,Merced,047,269075,0,0,0,0,0
2020-02-10,Modoc,049,8938,0,0,0,0,0
2020-02-10,Mono,051,14174,0,0,0,0,0
2020-02-10,Monterey,053,433212,1,0,0,0,0
2020-02-10,Napa,055,140530,0,0,0,0,0
2020-02-10,Nevada,057,99092,0,0,0,0,0
2020-02-10,Orange,059,3164182,35,1,0,1,0
2020-02-10,Placer,061,380077,0,0,0,0,0
2020-02-10,Plumas,063,18699,0,0,0,0,0
2020-02-10,Riverside,065,2383286,4,0,0,0,0
2020-02-10,Sacramento,067,1510023,1,0,0,0,0
2020-02-10,San Benito,069,59416,0,2,0,2,0
2020-02-10,San Bernardino,071,2135413,7,0,0,0,0
2020-02-10,San Diego,073,3302833,0,0,0,0,0
2020-02-10,San Francisco,075,870044,2,0,0,0,0
2020-02-10,San Joaquin,077,732212,0,0,1,1,0
2020-02-10,San Luis Obispo,079,281455,0,0,0,0,0
2020-02-10,San Mateo,081,765935,2,0,0,0,0
2020-02-10,Santa Barbara,083,443738,0,0,0,0,0
2020-02-10,Santa Clara,085,1922200,5,2,0,2,0
2020-02-10,Santa Cruz,087,273765,0,0,0,0,0
2020-02-10,Shasta,089,179085,0,0,0,0,0
2020-02-10,Sierra,091,2930,0,0,0,0,0
2020-02-10,Siskiyou,093,43540,0,0,0,0,0
2020-02-10,Solano,095,438530,0,0,0,0,0
2020-02-10,Sonoma,097,501317,0,0,0,0,0
2020-02-10,Stanislaus,099,539301,1,0,0,0,0
2020-02-10,Sutter,101,95872,0,0,0,0,0
2020-02-10,Tehama,103,63373,0,0,0,0,0
2020-02-10,Trinity,105,12862,0,0,0,0,0
2020-02-10,Tulare,107,460477,2,0,0,0,0
2020-02-10,Tuolumne,109,53932,0,0,0,0,0
2020-02-10,Ventura,111,848112,2,0,0,0,0
2020-02-10,Yolo,113,214977,0,0,0,0,0
2020-02-10,Yuba,115,75493,0,0,0,0,0
2020-02-09,Alameda,001,1643700,5,0,0,0,0
2020-02-09,Alpine,003,1148,0,0,0,0,0
2020-02-09,Amador,005,37829,0,0,0,0,0
2020-02-09,Butte,007,227075,0,0,0,0,0
2020-02-09,Calaveras,009,45235,0,0,0,0,0
2020-02-09,Colusa,011,21464,0,0,0,0,0
2020-02-09,Contra Costa,013,1133247,3,0,0,0,0
2020-02-09,Del Norte,015,27424,0,0,0,0,0
2020-02-09,El Dorado,017,186661,0,0,0,0,0
2020-02-09,Fresno,019,978130,0,0,0,0,0
2020-02-09,Glenn,021,27897,0,0,0,0,0
2020-02-09,Humboldt,023,135768,0,0,0,0,0
2020-02-09,Imperial,025,180216,0,0,0,0,0
2020-02-09,Inyo,027,18085,0,0,0,0,0
2020-02-09,Kern,029,883053,2,0,0,0,0
2020-02-09,Kings,031,150075,0,0,0,0,0
2020-02-09,Lake,033,64148,0,0,0,0,0
2020-02-09,Lassen,035,31185,0,0,0,0,0
2020-02-09,Los Angeles,037,10098052,27,1,3,4,0
2020-02-09,Madera,039,155013,0,0,0,0,0
2020-02-09,Marin,041,260295,0,0,0,0,0
2020-02-09,Mariposa,043,17540,0,0,0,0,0
2020-02-09,Mendocino,045,87422,0,0,0,0,0
2020-02-09,Merced,047,269075,0,0,0,0,0
2020-02-09,Modoc,049,8938,0,0,0,0,0
2020-02-09,Mono,051,14174,0,0,0,0,0
2020-02-09,Monterey,053,433212,1,0,0,0,0
2020-02-09,Napa,055,140530,0,0,0,0,0
2020-02-09,Nevada,057,99092,0,0,0,0,0
2020-02-09,Orange,059,3164182,35,1,0,1,0
2020-02-09,Placer,061,380077,0,0,0,0,0
2020-02-09,Plumas,063,18699,0,0,0,0,0
2020-02-09,Riverside,065,2383286,4,0,0,0,0
2020-02-09,Sacramento,067,1510023,0,0,0,0,0
2020-02-09,San Benito,069,59416,0,2,0,2,0
2020-02-09,San Bernardino,071,2135413,7,0,0,0,0
2020-02-09,San Diego,073,3302833,0,0,0,0,0
2020-02-09,San Francisco,075,870044,1,0,0,0,0
2020-02-09,San Joaquin,077,732212,0,0,1,1,0
2020-02-09,San Luis Obispo,079,281455,0,0,0,0,0
2020-02-09,San Mateo,081,765935,2,0,0,0,0
2020-02-09,Santa Barbara,083,443738,0,0,0,0,0
2020-02-09,Santa Clara,085,1922200,4,2,0,2,0
2020-02-09,Santa Cruz,087,273765,0,0,0,0,0
2020-02-09,Shasta,089,179085,0,0,0,0,0
2020-02-09,Sierra,091,2930,0,0,0,0,0
2020-02-09,Siskiyou,093,43540,0,0,0,0,0
2020-02-09,Solano,095,438530,0,0,0,0,0
2020-02-09,Sonoma,097,501317,0,0,0,0,0
2020-02-09,Stanislaus,099,539301,0,0,0,0,0
2020-02-09,Sutter,101,95872,0,0,0,0,0
2020-02-09,Tehama,103,63373,0,0,0,0,0
2020-02-09,Trinity,105,12862,0,0,0,0,0
2020-02-09,Tulare,107,460477,2,0,0,0,0
2020-02-09,Tuolumne,109,53932,0,0,0,0,0
2020-02-09,Ventura,111,848112,1,0,0,0,0
2020-02-09,Yolo,113,214977,0,0,0,0,0
2020-02-09,Yuba,115,75493,0,0,0,0,0
2020-02-08,Alameda,001,1643700,4,0,0,0,0
2020-02-08,Alpine,003,1148,0,0,0,0,0
2020-02-08,Amador,005,37829,0,0,0,0,0
2020-02-08,Butte,007,227075,0,0,0,0,0
2020-02-08,Calaveras,009,45235,0,0,0,0,0
2020-02-08,Colusa,011,21464,0,0,0,0,0
2020-02-08,Contra Costa,013,1133247,2,0,0,0,0
2020-02-08,Del Norte,015,27424,0,0,0,0,0
2020-02-08,El Dorado,017,186661,0,0,0,0,0
2020-02-08,Fresno,019,978130,0,0,0,0,0
2020-02-08,Glenn,021,27897,0,0,0,0,0
2020-02-08,Humboldt,023,135768,0,0,0,0,0
2020-02-08,Imperial,025,180216,0,0,0,0,0
2020-02-08,Inyo,027,18085,0,0,0,0,0
2020-02-08,Kern,029,883053,2,0,0,0,0
2020-02-08,Kings,031,150075,0,0,0,0,0
2020-02-08,Lake,033,64148,0,0,0,0,0
2020-02-08,Lassen,035,31185,0,0,0,0,0
2020-02-08,Los Angeles,037,10098052,24,1,1,2,0
2020-02-08,Madera,039,155013,0,0,0,0,0
2020-02-08,Marin,041,260295,0,0,0,0,0
2020-02-08,Mariposa,043,17540,0,0,0,0,0
2020-02-08,Mendocino,045,87422,0,0,0,0,0
2020-02-08,Merced,047,269075,0,0,0,0,0
2020-02-08,Modoc,049,8938,0,0,0,0,0
2020-02-08,Mono,051,14174,0,0,0,0,0
2020-02-08,Monterey,053,433212,1,0,0,0,0
2020-02-08,Napa,055,140530,0,0,0,0,0
2020-02-08,Nevada,057,99092,0,0,0,0,0
2020-02-08,Orange,059,3164182,35,1,0,1,0
2020-02-08,Placer,061,380077,0,0,0,0,0
2020-02-08,Plumas,063,18699,0,0,0,0,0
2020-02-08,Riverside,065,2383286,4,0,0,0,0
2020-02-08,Sacramento,067,1510023,0,0,0,0,0
2020-02-08,San Benito,069,59416,0,2,0,2,0
2020-02-08,San Bernardino,071,2135413,7,0,0,0,0
2020-02-08,San Diego,073,3302833,0,0,0,0,0
2020-02-08,San Francisco,075,870044,1,0,0,0,0
2020-02-08,San Joaquin,077,732212,0,0,1,1,0
2020-02-08,San Luis Obispo,079,281455,0,0,0,0,0
2020-02-08,San Mateo,081,765935,2,0,0,0,0
2020-02-08,Santa Barbara,083,443738,0,0,0,0,0
2020-02-08,Santa Clara,085,1922200,4,2,0,2,0
2020-02-08,Santa Cruz,087,273765,0,0,0,0,0
2020-02-08,Shasta,089,179085,0,0,0,0,0
2020-02-08,Sierra,091,2930,0,0,0,0,0
2020-02-08,Siskiyou,093,43540,0,0,0,0,0
2020-02-08,Solano,095,438530,0,0,0,0,0
2020-02-08,Sonoma,097,501317,0,0,0,0,0
2020-02-08,Stanislaus,099,539301,0,0,0,0,0
2020-02-08,Sutter,101,95872,0,0,0,0,0
2020-02-08,Tehama,103,63373,0,0,0,0,0
2020-02-08,Trinity,105,12862,0,0,0,0,0
2020-02-08,Tulare,107,460477,2,0,0,0,0
2020-02-08,Tuolumne,109,53932,0,0,0,0,0
2020-02-08,Ventura,111,848112,1,0,0,0,0
2020-02-08,Yolo,113,214977,0,0,0,0,0
2020-02-08,Yuba,115,75493,0,0,0,0,0
2020-02-07,Alameda,001,1643700,4,0,0,0,0
2020-02-07,Alpine,003,1148,0,0,0,0,0
2020-02-07,Amador,005,37829,0,0,0,0,0
2020-02-07,Butte,007,227075,0,0,0,0,0
2020-02-07,Calaveras,009,45235,0,0,0,0,0
2020-02-07,Colusa,011,21464,0,0,0,0,0
2020-02-07,Contra Costa,013,1133247,2,0,0,0,0
2020-02-07,Del Norte,015,27424,0,0,0,0,0
2020-02-07,El Dorado,017,186661,0,0,0,0,0
2020-02-07,Fresno,019,978130,0,0,0,0,0
2020-02-07,Glenn,021,27897,0,0,0,0,0
2020-02-07,Humboldt,023,135768,0,0,0,0,0
2020-02-07,Imperial,025,180216,0,0,0,0,0
2020-02-07,Inyo,027,18085,0,0,0,0,0
2020-02-07,Kern,029,883053,2,0,0,0,0
2020-02-07,Kings,031,150075,0,0,0,0,0
2020-02-07,Lake,033,64148,0,0,0,0,0
2020-02-07,Lassen,035,31185,0,0,0,0,0
2020-02-07,Los Angeles,037,10098052,23,1,0,1,0
2020-02-07,Madera,039,155013,0,0,0,0,0
2020-02-07,Marin,041,260295,0,0,0,0,0
2020-02-07,Mariposa,043,17540,0,0,0,0,0
2020-02-07,Mendocino,045,87422,0,0,0,0,0
2020-02-07,Merced,047,269075,0,0,0,0,0
2020-02-07,Modoc,049,8938,0,0,0,0,0
2020-02-07,Mono,051,14174,0,0,0,0,0
2020-02-07,Monterey,053,433212,1,0,0,0,0
2020-02-07,Napa,055,140530,0,0,0,0,0
2020-02-07,Nevada,057,99092,0,0,0,0,0
2020-02-07,Orange,059,3164182,33,1,0,1,0
2020-02-07,Placer,061,380077,0,0,0,0,0
2020-02-07,Plumas,063,18699,0,0,0,0,0
2020-02-07,Riverside,065,2383286,4,0,0,0,0
2020-02-07,Sacramento,067,1510023,0,0,0,0,0
2020-02-07,San Benito,069,59416,0,2,0,2,0
2020-02-07,San Bernardino,071,2135413,4,0,0,0,0
2020-02-07,San Diego,073,3302833,0,0,0,0,0
2020-02-07,San Francisco,075,870044,1,0,0,0,0
2020-02-07,San Joaquin,077,732212,0,0,1,1,0
2020-02-07,San Luis Obispo,079,281455,0,0,0,0,0
2020-02-07,San Mateo,081,765935,1,0,0,0,0
2020-02-07,Santa Barbara,083,443738,0,0,0,0,0
2020-02-07,Santa Clara,085,1922200,4,2,0,2,0
2020-02-07,Santa Cruz,087,273765,0,0,0,0,0
2020-02-07,Shasta,089,179085,0,0,0,0,0
2020-02-07,Sierra,091,2930,0,0,0,0,0
2020-02-07,Siskiyou,093,43540,0,0,0,0,0
2020-02-07,Solano,095,438530,0,0,0,0,0
2020-02-07,Sonoma,097,501317,0,0,0,0,0
2020-02-07,Stanislaus,099,539301,0,0,0,0,0
2020-02-07,Sutter,101,95872,0,0,0,0,0
2020-02-07,Tehama,103,63373,0,0,0,0,0
2020-02-07,Trinity,105,12862,0,0,0,0,0
2020-02-07,Tulare,107,460477,2,0,0,0,0
2020-02-07,Tuolumne,109,53932,0,0,0,0,0
2020-02-07,Ventura,111,848112,1,0,0,0,0
2020-02-07,Yolo,113,214977,0,0,0,0,0
2020-02-07,Yuba,115,75493,0,0,0,0,0
2020-02-06,Alameda,001,1643700,4,0,0,0,0
2020-02-06,Alpine,003,1148,0,0,0,0,0
2020-02-06,Amador,005,37829,0,0,0,0,0
2020-02-06,Butte,007,227075,0,0,0,0,0
2020-02-06,Calaveras,009,45235,0,0,0,0,0
2020-02-06,Colusa,011,21464,0,0,0,0,0
2020-02-06,Contra Costa,013,1133247,2,0,0,0,0
2020-02-06,Del Norte,015,27424,0,0,0,0,0
2020-02-06,El Dorado,017,186661,0,0,0,0,0
2020-02-06,Fresno,019,978130,0,0,0,0,0
2020-02-06,Glenn,021,27897,0,0,0,0,0
2020-02-06,Humboldt,023,135768,0,0,0,0,0
2020-02-06,Imperial,025,180216,0,0,0,0,0
2020-02-06,Inyo,027,18085,0,0,0,0,0
2020-02-06,Kern,029,883053,2,0,0,0,0
2020-02-06,Kings,031,150075,0,0,0,0,0
2020-02-06,Lake,033,64148,0,0,0,0,0
2020-02-06,Lassen,035,31185,0,0,0,0,0
2020-02-06,Los Angeles,037,10098052,22,1,0,1,0
2020-02-06,Madera,039,155013,0,0,0,0,0
2020-02-06,Marin,041,260295,0,0,0,0,0
2020-02-06,Mariposa,043,17540,0,0,0,0,0
2020-02-06,Mendocino,045,87422,0,0,0,0,0
2020-02-06,Merced,047,269075,0,0,0,0,0
2020-02-06,Modoc,049,8938,0,0,0,0,0
2020-02-06,Mono,051,14174,0,0,0,0,0
2020-02-06,Monterey,053,433212,1,0,0,0,0
2020-02-06,Napa,055,140530,0,0,0,0,0
2020-02-06,Nevada,057,99092,0,0,0,0,0
2020-02-06,Orange,059,3164182,3,1,0,1,0
2020-02-06,Placer,061,380077,0,0,0,0,0
2020-02-06,Plumas,063,18699,0,0,0,0,0
2020-02-06,Riverside,065,2383286,4,0,0,0,0
2020-02-06,Sacramento,067,1510023,0,0,0,0,0
2020-02-06,San Benito,069,59416,0,2,0,2,0
2020-02-06,San Bernardino,071,2135413,4,0,0,0,0
2020-02-06,San Diego,073,3302833,0,0,0,0,0
2020-02-06,San Francisco,075,870044,1,0,0,0,0
2020-02-06,San Joaquin,077,732212,0,0,1,1,0
2020-02-06,San Luis Obispo,079,281455,0,0,0,0,0
2020-02-06,San Mateo,081,765935,1,0,0,0,0
2020-02-06,Santa Barbara,083,443738,0,0,0,0,0
2020-02-06,Santa Clara,085,1922200,4,2,0,2,0
2020-02-06,Santa Cruz,087,273765,0,0,0,0,0
2020-02-06,Shasta,089,179085,0,0,0,0,0
2020-02-06,Sierra,091,2930,0,0,0,0,0
2020-02-06,Siskiyou,093,43540,0,0,0,0,0
2020-02-06,Solano,095,438530,0,0,0,0,0
2020-02-06,Sonoma,097,501317,0,0,0,0,0
2020-02-06,Stanislaus,099,539301,0,0,0,0,0
2020-02-06,Sutter,101,95872,0,0,0,0,0
2020-02-06,Tehama,103,63373,0,0,0,0,0
2020-02-06,Trinity,105,12862,0,0,0,0,0
2020-02-06,Tulare,107,460477,2,0,0,0,0
2020-02-06,Tuolumne,109,53932,0,0,0,0,0
2020-02-06,Ventura,111,848112,1,0,0,0,0
2020-02-06,Yolo,113,214977,0,0,0,0,0
2020-02-06,Yuba,115,75493,0,0,0,0,0
2020-02-05,Alameda,001,1643700,3,0,0,0,0
2020-02-05,Alpine,003,1148,0,0,0,0,0
2020-02-05,Amador,005,37829,0,0,0,0,0
2020-02-05,Butte,007,227075,0,0,0,0,0
2020-02-05,Calaveras,009,45235,0,0,0,0,0
2020-02-05,Colusa,011,21464,0,0,0,0,0
2020-02-05,Contra Costa,013,1133247,2,0,0,0,0
2020-02-05,Del Norte,015,27424,0,0,0,0,0
2020-02-05,El Dorado,017,186661,0,0,0,0,0
2020-02-05,Fresno,019,978130,0,0,0,0,0
2020-02-05,Glenn,021,27897,0,0,0,0,0
2020-02-05,Humboldt,023,135768,0,0,0,0,0
2020-02-05,Imperial,025,180216,0,0,0,0,0
2020-02-05,Inyo,027,18085,0,0,0,0,0
2020-02-05,Kern,029,883053,1,0,0,0,0
2020-02-05,Kings,031,150075,0,0,0,0,0
2020-02-05,Lake,033,64148,0,0,0,0,0
2020-02-05,Lassen,035,31185,0,0,0,0,0
2020-02-05,Los Angeles,037,10098052,22,1,0,1,0
2020-02-05,Madera,039,155013,0,0,0,0,0
2020-02-05,Marin,041,260295,0,0,0,0,0
2020-02-05,Mariposa,043,17540,0,0,0,0,0
2020-02-05,Mendocino,045,87422,0,0,0,0,0
2020-02-05,Merced,047,269075,0,0,0,0,0
2020-02-05,Modoc,049,8938,0,0,0,0,0
2020-02-05,Mono,051,14174,0,0,0,0,0
2020-02-05,Monterey,053,433212,1,0,0,0,0
2020-02-05,Napa,055,140530,0,0,0,0,0
2020-02-05,Nevada,057,99092,0,0,0,0,0
2020-02-05,Orange,059,3164182,2,1,0,1,0
2020-02-05,Placer,061,380077,0,0,0,0,0
2020-02-05,Plumas,063,18699,0,0,0,0,0
2020-02-05,Riverside,065,2383286,4,0,0,0,0
2020-02-05,Sacramento,067,1510023,0,0,0,0,0
2020-02-05,San Benito,069,59416,0,2,0,2,0
2020-02-05,San Bernardino,071,2135413,4,0,0,0,0
2020-02-05,San Diego,073,3302833,0,0,0,0,0
2020-02-05,San Francisco,075,870044,1,0,0,0,0
2020-02-05,San Joaquin,077,732212,0,0,1,1,0
2020-02-05,San Luis Obispo,079,281455,0,0,0,0,0
2020-02-05,San Mateo,081,765935,1,0,0,0,0
2020-02-05,Santa Barbara,083,443738,0,0,0,0,0
2020-02-05,Santa Clara,085,1922200,2,2,0,2,0
2020-02-05,Santa Cruz,087,273765,0,0,0,0,0
2020-02-05,Shasta,089,179085,0,0,0,0,0
2020-02-05,Sierra,091,2930,0,0,0,0,0
2020-02-05,Siskiyou,093,43540,0,0,0,0,0
2020-02-05,Solano,095,438530,0,0,0,0,0
2020-02-05,Sonoma,097,501317,0,0,0,0,0
2020-02-05,Stanislaus,099,539301,0,0,0,0,0
2020-02-05,Sutter,101,95872,0,0,0,0,0
2020-02-05,Tehama,103,63373,0,0,0,0,0
2020-02-05,Trinity,105,12862,0,0,0,0,0
2020-02-05,Tulare,107,460477,2,0,0,0,0
2020-02-05,Tuolumne,109,53932,0,0,0,0,0
2020-02-05,Ventura,111,848112,0,0,0,0,0
2020-02-05,Yolo,113,214977,0,0,0,0,0
2020-02-05,Yuba,115,75493,0,0,0,0,0
2020-02-04,Alameda,001,1643700,3,0,0,0,0
2020-02-04,Alpine,003,1148,0,0,0,0,0
2020-02-04,Amador,005,37829,0,0,0,0,0
2020-02-04,Butte,007,227075,0,0,0,0,0
2020-02-04,Calaveras,009,45235,0,0,0,0,0
2020-02-04,Colusa,011,21464,0,0,0,0,0
2020-02-04,Contra Costa,013,1133247,2,0,0,0,0
2020-02-04,Del Norte,015,27424,0,0,0,0,0
2020-02-04,El Dorado,017,186661,0,0,0,0,0
2020-02-04,Fresno,019,978130,0,0,0,0,0
2020-02-04,Glenn,021,27897,0,0,0,0,0
2020-02-04,Humboldt,023,135768,0,0,0,0,0
2020-02-04,Imperial,025,180216,0,0,0,0,0
2020-02-04,Inyo,027,18085,0,0,0,0,0
2020-02-04,Kern,029,883053,0,0,0,0,0
2020-02-04,Kings,031,150075,0,0,0,0,0
2020-02-04,Lake,033,64148,0,0,0,0,0
2020-02-04,Lassen,035,31185,0,0,0,0,0
2020-02-04,Los Angeles,037,10098052,22,1,0,1,0
2020-02-04,Madera,039,155013,0,0,0,0,0
2020-02-04,Marin,041,260295,0,0,0,0,0
2020-02-04,Mariposa,043,17540,0,0,0,0,0
2020-02-04,Mendocino,045,87422,0,0,0,0,0
2020-02-04,Merced,047,269075,0,0,0,0,0
2020-02-04,Modoc,049,8938,0,0,0,0,0
2020-02-04,Mono,051,14174,0,0,0,0,0
2020-02-04,Monterey,053,433212,1,0,0,0,0
2020-02-04,Napa,055,140530,0,0,0,0,0
2020-02-04,Nevada,057,99092,0,0,0,0,0
2020-02-04,Orange,059,3164182,2,1,0,1,0
2020-02-04,Placer,061,380077,0,0,0,0,0
2020-02-04,Plumas,063,18699,0,0,0,0,0
2020-02-04,Riverside,065,2383286,4,0,0,0,0
2020-02-04,Sacramento,067,1510023,0,0,0,0,0
2020-02-04,San Benito,069,59416,0,2,0,2,0
2020-02-04,San Bernardino,071,2135413,3,0,0,0,0
2020-02-04,San Diego,073,3302833,0,0,0,0,0
2020-02-04,San Francisco,075,870044,1,0,0,0,0
2020-02-04,San Joaquin,077,732212,0,0,1,1,0
2020-02-04,San Luis Obispo,079,281455,0,0,0,0,0
2020-02-04,San Mateo,081,765935,0,0,0,0,0
2020-02-04,Santa Barbara,083,443738,0,0,0,0,0
2020-02-04,Santa Clara,085,1922200,2,2,0,2,0
2020-02-04,Santa Cruz,087,273765,0,0,0,0,0
2020-02-04,Shasta,089,179085,0,0,0,0,0
2020-02-04,Sierra,091,2930,0,0,0,0,0
2020-02-04,Siskiyou,093,43540,0,0,0,0,0
2020-02-04,Solano,095,438530,0,0,0,0,0
2020-02-04,Sonoma,097,501317,0,0,0,0,0
2020-02-04,Stanislaus,099,539301,0,0,0,0,0
2020-02-04,Sutter,101,95872,0,0,0,0,0
2020-02-04,Tehama,103,63373,0,0,0,0,0
2020-02-04,Trinity,105,12862,0,0,0,0,0
2020-02-04,Tulare,107,460477,2,0,0,0,0
2020-02-04,Tuolumne,109,53932,0,0,0,0,0
2020-02-04,Ventura,111,848112,0,0,0,0,0
2020-02-04,Yolo,113,214977,0,0,0,0,0
2020-02-04,Yuba,115,75493,0,0,0,0,0
2020-02-03,Alameda,001,1643700,3,0,0,0,0
2020-02-03,Alpine,003,1148,0,0,0,0,0
2020-02-03,Amador,005,37829,0,0,0,0,0
2020-02-03,Butte,007,227075,0,0,0,0,0
2020-02-03,Calaveras,009,45235,0,0,0,0,0
2020-02-03,Colusa,011,21464,0,0,0,0,0
2020-02-03,Contra Costa,013,1133247,2,0,0,0,0
2020-02-03,Del Norte,015,27424,0,0,0,0,0
2020-02-03,El Dorado,017,186661,0,0,0,0,0
2020-02-03,Fresno,019,978130,0,0,0,0,0
2020-02-03,Glenn,021,27897,0,0,0,0,0
2020-02-03,Humboldt,023,135768,0,0,0,0,0
2020-02-03,Imperial,025,180216,0,0,0,0,0
2020-02-03,Inyo,027,18085,0,0,0,0,0
2020-02-03,Kern,029,883053,0,0,0,0,0
2020-02-03,Kings,031,150075,0,0,0,0,0
2020-02-03,Lake,033,64148,0,0,0,0,0
2020-02-03,Lassen,035,31185,0,0,0,0,0
2020-02-03,Los Angeles,037,10098052,21,1,0,1,0
2020-02-03,Madera,039,155013,0,0,0,0,0
2020-02-03,Marin,041,260295,0,0,0,0,0
2020-02-03,Mariposa,043,17540,0,0,0,0,0
2020-02-03,Mendocino,045,87422,0,0,0,0,0
2020-02-03,Merced,047,269075,0,0,0,0,0
2020-02-03,Modoc,049,8938,0,0,0,0,0
2020-02-03,Mono,051,14174,0,0,0,0,0
2020-02-03,Monterey,053,433212,1,0,0,0,0
2020-02-03,Napa,055,140530,0,0,0,0,0
2020-02-03,Nevada,057,99092,0,0,0,0,0
2020-02-03,Orange,059,3164182,1,1,0,1,0
2020-02-03,Placer,061,380077,0,0,0,0,0
2020-02-03,Plumas,063,18699,0,0,0,0,0
2020-02-03,Riverside,065,2383286,4,0,0,0,0
2020-02-03,Sacramento,067,1510023,0,0,0,0,0
2020-02-03,San Benito,069,59416,0,2,0,2,0
2020-02-03,San Bernardino,071,2135413,3,0,0,0,0
2020-02-03,San Diego,073,3302833,0,0,0,0,0
2020-02-03,San Francisco,075,870044,1,0,0,0,0
2020-02-03,San Joaquin,077,732212,0,0,1,1,0
2020-02-03,San Luis Obispo,079,281455,0,0,0,0,0
2020-02-03,San Mateo,081,765935,0,0,0,0,0
2020-02-03,Santa Barbara,083,443738,0,0,0,0,0
2020-02-03,Santa Clara,085,1922200,2,2,0,2,0
2020-02-03,Santa Cruz,087,273765,0,0,0,0,0
2020-02-03,Shasta,089,179085,0,0,0,0,0
2020-02-03,Sierra,091,2930,0,0,0,0,0
2020-02-03,Siskiyou,093,43540,0,0,0,0,0
2020-02-03,Solano,095,438530,0,0,0,0,0
2020-02-03,Sonoma,097,501317,0,0,0,0,0
2020-02-03,Stanislaus,099,539301,0,0,0,0,0
2020-02-03,Sutter,101,95872,0,0,0,0,0
2020-02-03,Tehama,103,63373,0,0,0,0,0
2020-02-03,Trinity,105,12862,0,0,0,0,0
2020-02-03,Tulare,107,460477,2,0,0,0,0
2020-02-03,Tuolumne,109,53932,0,0,0,0,0
2020-02-03,Ventura,111,848112,0,0,0,0,0
2020-02-03,Yolo,113,214977,0,0,0,0,0
2020-02-03,Yuba,115,75493,0,0,0,0,0
2020-02-02,Alameda,001,1643700,3,0,0,0,0
2020-02-02,Alpine,003,1148,0,0,0,0,0
2020-02-02,Amador,005,37829,0,0,0,0,0
2020-02-02,Butte,007,227075,0,0,0,0,0
2020-02-02,Calaveras,009,45235,0,0,0,0,0
2020-02-02,Colusa,011,21464,0,0,0,0,0
2020-02-02,Contra Costa,013,1133247,1,0,0,0,0
2020-02-02,Del Norte,015,27424,0,0,0,0,0
2020-02-02,El Dorado,017,186661,0,0,0,0,0
2020-02-02,Fresno,019,978130,0,0,0,0,0
2020-02-02,Glenn,021,27897,0,0,0,0,0
2020-02-02,Humboldt,023,135768,0,0,0,0,0
2020-02-02,Imperial,025,180216,0,0,0,0,0
2020-02-02,Inyo,027,18085,0,0,0,0,0
2020-02-02,Kern,029,883053,0,0,0,0,0
2020-02-02,Kings,031,150075,0,0,0,0,0
2020-02-02,Lake,033,64148,0,0,0,0,0
2020-02-02,Lassen,035,31185,0,0,0,0,0
2020-02-02,Los Angeles,037,10098052,17,1,0,1,0
2020-02-02,Madera,039,155013,0,0,0,0,0
2020-02-02,Marin,041,260295,0,0,0,0,0
2020-02-02,Mariposa,043,17540,0,0,0,0,0
2020-02-02,Mendocino,045,87422,0,0,0,0,0
2020-02-02,Merced,047,269075,0,0,0,0,0
2020-02-02,Modoc,049,8938,0,0,0,0,0
2020-02-02,Mono,051,14174,0,0,0,0,0
2020-02-02,Monterey,053,433212,1,0,0,0,0
2020-02-02,Napa,055,140530,0,0,0,0,0
2020-02-02,Nevada,057,99092,0,0,0,0,0
2020-02-02,Orange,059,3164182,1,1,0,1,0
2020-02-02,Placer,061,380077,0,0,0,0,0
2020-02-02,Plumas,063,18699,0,0,0,0,0
2020-02-02,Riverside,065,2383286,3,0,0,0,0
2020-02-02,Sacramento,067,1510023,0,0,0,0,0
2020-02-02,San Benito,069,59416,0,2,0,2,0
2020-02-02,San Bernardino,071,2135413,2,0,0,0,0
2020-02-02,San Diego,073,3302833,0,0,0,0,0
2020-02-02,San Francisco,075,870044,1,0,0,0,0
2020-02-02,San Joaquin,077,732212,0,0,1,1,0
2020-02-02,San Luis Obispo,079,281455,0,0,0,0,0
2020-02-02,San Mateo,081,765935,0,0,0,0,0
2020-02-02,Santa Barbara,083,443738,0,0,0,0,0
2020-02-02,Santa Clara,085,1922200,2,2,0,2,0
2020-02-02,Santa Cruz,087,273765,0,0,0,0,0
2020-02-02,Shasta,089,179085,0,0,0,0,0
2020-02-02,Sierra,091,2930,0,0,0,0,0
2020-02-02,Siskiyou,093,43540,0,0,0,0,0
2020-02-02,Solano,095,438530,0,0,0,0,0
2020-02-02,Sonoma,097,501317,0,0,0,0,0
2020-02-02,Stanislaus,099,539301,0,0,0,0,0
2020-02-02,Sutter,101,95872,0,0,0,0,0
2020-02-02,Tehama,103,63373,0,0,0,0,0
2020-02-02,Trinity,105,12862,0,0,0,0,0
2020-02-02,Tulare,107,460477,2,0,0,0,0
2020-02-02,Tuolumne,109,53932,0,0,0,0,0
2020-02-02,Ventura,111,848112,0,0,0,0,0
2020-02-02,Yolo,113,214977,0,0,0,0,0
2020-02-02,Yuba,115,75493,0,0,0,0,0
2020-02-01,Alameda,001,1643700,3,0,0,0,0
2020-02-01,Alpine,003,1148,0,0,0,0,0
2020-02-01,Amador,005,37829,0,0,0,0,0
2020-02-01,Butte,007,227075,0,0,0,0,0
2020-02-01,Calaveras,009,45235,0,0,0,0,0
2020-02-01,Colusa,011,21464,0,0,0,0,0
2020-02-01,Contra Costa,013,1133247,0,0,0,0,0
2020-02-01,Del Norte,015,27424,0,0,0,0,0
2020-02-01,El Dorado,017,186661,0,0,0,0,0
2020-02-01,Fresno,019,978130,0,0,0,0,0
2020-02-01,Glenn,021,27897,0,0,0,0,0
2020-02-01,Humboldt,023,135768,0,0,0,0,0
2020-02-01,Imperial,025,180216,0,0,0,0,0
2020-02-01,Inyo,027,18085,0,0,0,0,0
2020-02-01,Kern,029,883053,0,0,0,0,0
2020-02-01,Kings,031,150075,0,0,0,0,0
2020-02-01,Lake,033,64148,0,0,0,0,0
2020-02-01,Lassen,035,31185,0,0,0,0,0
2020-02-01,Los Angeles,037,10098052,13,1,0,1,0
2020-02-01,Madera,039,155013,0,0,0,0,0
2020-02-01,Marin,041,260295,0,0,0,0,0
2020-02-01,Mariposa,043,17540,0,0,0,0,0
2020-02-01,Mendocino,045,87422,0,0,0,0,0
2020-02-01,Merced,047,269075,0,0,0,0,0
2020-02-01,Modoc,049,8938,0,0,0,0,0
2020-02-01,Mono,051,14174,0,0,0,0,0
2020-02-01,Monterey,053,433212,0,0,0,0,0
2020-02-01,Napa,055,140530,0,0,0,0,0
2020-02-01,Nevada,057,99092,0,0,0,0,0
2020-02-01,Orange,059,3164182,1,1,0,1,0
2020-02-01,Placer,061,380077,0,0,0,0,0
2020-02-01,Plumas,063,18699,0,0,0,0,0
2020-02-01,Riverside,065,2383286,2,0,0,0,0
2020-02-01,Sacramento,067,1510023,0,0,0,0,0
2020-02-01,San Benito,069,59416,0,0,0,0,0
2020-02-01,San Bernardino,071,2135413,1,0,0,0,0
2020-02-01,San Diego,073,3302833,0,0,0,0,0
2020-02-01,San Francisco,075,870044,1,0,0,0,0
2020-02-01,San Joaquin,077,732212,0,0,1,1,0
2020-02-01,San Luis Obispo,079,281455,0,0,0,0,0
2020-02-01,San Mateo,081,765935,0,0,0,0,0
2020-02-01,Santa Barbara,083,443738,0,0,0,0,0
2020-02-01,Santa Clara,085,1922200,2,1,0,1,0
2020-02-01,Santa Cruz,087,273765,0,0,0,0,0
2020-02-01,Shasta,089,179085,0,0,0,0,0
2020-02-01,Sierra,091,2930,0,0,0,0,0
2020-02-01,Siskiyou,093,43540,0,0,0,0,0
2020-02-01,Solano,095,438530,0,0,0,0,0
2020-02-01,Sonoma,097,501317,0,0,0,0,0
2020-02-01,Stanislaus,099,539301,0,0,0,0,0
2020-02-01,Sutter,101,95872,0,0,0,0,0
2020-02-01,Tehama,103,63373,0,0,0,0,0
2020-02-01,Trinity,105,12862,0,0,0,0,0
2020-02-01,Tulare,107,460477,1,0,0,0,0
2020-02-01,Tuolumne,109,53932,0,0,0,0,0
2020-02-01,Ventura,111,848112,0,0,0,0,0
2020-02-01,Yolo,113,214977,0,0,0,0,0
2020-02-01,Yuba,115,75493,0,0,0,0,0
